audience_percent,critic_percent,title,audience_number,critic_number,release_year,genre,runtime,differential,bubble_width
86,92,Skyfall,250000,380,2012.0,Action/Adventure,2:23,6,40.96045270139262
83,76,Avengers: Age of Ultron,250000,371,2015.0,Sci fi/Adventure,2:21,-7,40.35140801415813
90,87,The Dark Knight Rises,250000,370,2012.0,Fantasy/Mystery and thriller,2:45,-3,40.28339617709587
91,91,Marvel's the Avengers,250000,361,2012.0,Adventure/Sci fi,2:23,0,39.66815496866703
91,87,Inception,250000,360,2010.0,Sci fi/Action,2:28,-4,39.59944169921377
80,95,Gravity,250000,355,2013.0,Drama/Sci fi,1:31,15,39.25479563004856
91,94,Star Trek,250000,354,2009.0,Sci fi/Action,2:06,3,39.18564852510176
94,94,The Dark Knight,250000,344,2008.0,Adventure/Fantasy,2:32,0,38.49009886410603
75,56,Man of Steel,250000,337,2013.0,Sci fi/Action,2:23,-19,37.99869554865583
77,72,The Amazing Spider-Man,250000,334,2012.0,Action/Adventure,2:16,-5,37.78692414196535
88,89,Inglourious Basterds,250000,332,2009.0,Comedy/War,2:32,1,37.64534679752864
89,96,Harry Potter and the Deathly Hallows: Part 2,250000,331,2011.0,Adventure/Fantasy,2:11,7,37.57443821930846
92,92,Guardians of the Galaxy,250000,330,2014.0,Comedy/Fantasy,2:01,0,37.50344926092717
91,90,X-Men: Days of Future Past,250000,329,2014.0,Sci fi/Action,2:11,-1,37.43237958727603
78,79,Iron Man 3,250000,327,2013.0,Sci fi/Action,2:10,1,37.28999674160195
82,82,Avatar,250000,319,2009.0,Sci fi/Action,2:35,0,36.717168023699735
82,90,District 9,250000,314,2009.0,Sci fi,1:51,8,36.3564131496096
81,84,The Hunger Games,250000,312,2012.0,Adventure/Sci fi,2:22,3,36.21150885156392
71,65,Watchmen,250000,312,2009.0,Adventure/Fantasy,2:43,-6,36.21150885156392
90,98,Toy Story 3,250000,309,2010.0,Comedy/Animation,1:42,8,35.99349753310109
68,73,Prometheus,250000,306,2012.0,Sci fi/Horror,2:03,5,35.77469102259483
83,64,The Hobbit: An Unexpected Journey,250000,305,2012.0,Adventure/Fantasy,2:49,-19,35.701576960735366
92,90,Captain America: The Winter Soldier,250000,305,2014.0,Action/Adventure,2:15,-2,35.701576960735366
71,72,Iron Man 2,250000,303,2010.0,Adventure/Sci fi,2:04,1,35.55507858047231
90,98,Up,250000,298,2009.0,Kids and family/Comedy,1:29,8,35.18723690988606
58,64,Quantum of Solace,250000,296,2008.0,Action/Adventure,1:45,6,35.03945313093506
89,90,The Hunger Games: Catching Fire,250000,293,2013.0,Sci fi/Action,2:26,1,34.81707337301227
89,84,Star Trek Into Darkness,250000,293,2013.0,Sci fi/Action,2:12,-5,34.81707337301227
91,87,Django Unchained,250000,291,2012.0,Western/Action,2:45,-4,34.66834566630047
90,91,Slumdog Millionaire,250000,289,2008.0,Drama/Comedy,1:56,1,34.51923414277182
86,93,No Country for Old Men,250000,288,2007.0,Drama/Crime,2:02,7,34.44453330922775
85,77,Harry Potter and the Deathly Hallows: Part 1,250000,287,2010.0,Adventure/Fantasy,2:26,-8,34.36973514538876
75,66,Thor: The Dark World,250000,283,2013.0,Action/Adventure,1:51,-9,34.0695597964397
54,33,Terminator Salvation,250000,282,2009.0,Sci fi/Action,1:56,-21,33.994267903729856
59,68,Public Enemies,250000,281,2009.0,Drama/Action,2:20,9,33.91887582197262
91,94,Iron Man,250000,280,2008.0,Sci fi/Action,2:06,3,33.84338306058975
78,84,Harry Potter and the Half-Blood Prince,250000,280,2009.0,Kids and family/Adventure,2:33,6,33.84338306058975
72,66,World War Z,250000,278,2013.0,Adventure/Horror,1:55,-6,33.69209351576394
53,78,Indiana Jones and the Kingdom of the Crystal Skull,250000,277,2008.0,Action/Adventure,2:02,25,33.61629573014229
56,57,Oz the Great and Powerful,250000,273,2013.0,Adventure/Fantasy,2:10,1,33.3120726055166
77,82,Rise of the Planet of the Apes,250000,271,2011.0,Sci fi/Action,1:45,5,33.159334577751565
57,73,Where the Wild Things Are,250000,270,2009.0,Kids and family/Adventure,1:41,16,33.08280709664308
73,90,Coraline,250000,269,2009.0,Animation/Fantasy,1:40,17,33.006173253232014
62,92,Drag Me to Hell,250000,269,2009.0,Horror/Mystery and thriller,1:39,30,33.006173253232014
91,92,The Bourne Ultimatum,250000,269,2007.0,Action/Mystery and thriller,1:55,1,33.006173253232014
86,99,Finding Nemo,250000,268,2003.0,Comedy/Animation,1:40,13,32.929432503463254
81,76,Kick-Ass,250000,267,2010.0,Comedy/Action,1:57,-5,32.85258429845689
40,27,Clash of the Titans,250000,266,2010.0,Action/Adventure,1:46,-13,32.7756280844472
58,37,X-Men Origins: Wolverine,250000,263,2009.0,Sci fi/Action,1:48,-21,32.54410577614366
55,35,Transformers: Dark of the Moon,250000,263,2011.0,Sci fi/Action,2:34,-20,32.54410577614366
51,63,Spider-Man 3,250000,262,2007.0,Action/Adventure,2:13,12,32.46671188855409
86,92,Silver Linings Playbook,250000,260,2012.0,Drama/Romance,2:02,6,32.311590968974485
57,37,Angels & Demons,250000,260,2009.0,Action/Mystery and thriller,2:18,-20,32.311590968974485
90,95,WALL-E,250000,260,2008.0,Comedy/Animation,1:37,5,32.311590968974485
46,35,Dark Shadows,250000,259,2012.0,Fantasy/Comedy,1:52,-11,32.23386276280209
77,68,Shutter Island,250000,259,2010.0,Drama/Mystery and thriller,2:18,-9,32.23386276280209
69,71,The Wolverine,250000,258,2013.0,Sci fi/Action,2:06,2,32.15602193394618
80,71,The Curious Case of Benjamin Button,250000,258,2008.0,Romance/Drama,2:47,-9,32.15602193394618
86,89,Zombieland,250000,257,2009.0,Comedy/Horror,1:27,3,32.07806788174952
81,77,Harry Potter and the Order of the Phoenix,250000,257,2007.0,Adventure/Fantasy,2:18,-4,32.07806788174952
79,70,Les Misérables,250000,256,2012.0,Drama/Musical,2:38,-9,32.0
57,20,Transformers: Revenge of the Fallen,250000,252,2009.0,Adventure/Sci fi,2:29,-37,31.686577854669387
70,82,Tropic Thunder,250000,252,2008.0,Comedy/Action,1:47,12,31.686577854669387
75,78,Brave,250000,251,2012.0,Adventure/Animation,1:33,3,31.60793153235044
70,68,Men in Black 3,250000,251,2012.0,Sci fi/Action,1:44,-2,31.60793153235044
76,93,Mission: Impossible -- Ghost Protocol,250000,251,2011.0,Action/Adventure,2:13,17,31.60793153235044
87,96,Ratatouille,250000,251,2007.0,Kids and family/Comedy,1:51,9,31.60793153235044
85,74,The Hobbit: The Desolation of Smaug,250000,250,2013.0,Fantasy/Adventure,2:40,-11,31.529167622359036
85,90,Frozen,250000,250,2013.0,Comedy/Fantasy,1:42,5,31.529167622359036
71,86,Hellboy II: The Golden Army,250000,250,2008.0,Sci fi/Action,2:00,15,31.529167622359036
77,69,Sherlock Holmes,250000,248,2009.0,Action/Adventure,2:08,-8,31.371284444297096
52,32,The Lovely Bones,250000,247,2009.0,Mystery and thriller/Drama,2:16,-20,31.292163863166575
47,39,2012,250000,247,2009.0,Drama/Mystery and thriller,2:38,-8,31.292163863166575
60,48,The Twilight Saga: Eclipse,250000,247,2010.0,Romance/Fantasy,2:04,-12,31.292163863166575
86,91,There Will Be Blood,250000,243,2007.0,Drama,2:38,5,30.97447264187668
84,78,The Hangover,250000,240,2009.0,Comedy,1:39,-6,30.734915685705186
52,49,Snow White and the Huntsman,250000,238,2012.0,Action/Adventure,2:07,-3,30.574586918379627
48,69,Funny People,250000,238,2009.0,Comedy/Drama,2:26,21,30.574586918379627
90,81,Gran Torino,250000,237,2008.0,Drama,1:57,-9,30.494233135441753
70,67,The Incredible Hulk,250000,237,2008.0,Sci fi/Action,1:52,-3,30.494233135441753
84,85,(500) Days of Summer,250000,233,2009.0,Comedy/Romance,1:35,1,30.17153811508654
44,79,The Informant!,250000,233,2009.0,Drama/Crime,1:48,35,30.17153811508654
52,51,The Taking of Pelham 123,250000,232,2009.0,Drama/Crime,1:46,-1,30.090540621339713
58,55,The Bourne Legacy,250000,232,2012.0,Action/Mystery and thriller,2:15,-3,30.090540621339713
81,86,Sweeney Todd: The Demon Barber of Fleet Street,250000,231,2007.0,Drama/Crime,1:57,5,30.00941209857022
41,67,Brüno,250000,230,2009.0,Gay and lesbian/Comedy,1:22,26,29.928151766205126
61,28,The Twilight Saga: New Moon,250000,230,2009.0,Romance/Fantasy,2:10,-33,29.928151766205126
58,37,Prince of Persia: The Sands of Time,250000,229,2010.0,Adventure/Fantasy,1:56,-21,29.846758835604586
72,44,Pirates of the Caribbean: At World's End,250000,228,2007.0,Action/Adventure,2:48,-28,29.76523250994286
59,41,Hancock,250000,227,2008.0,Comedy/Action,1:32,-18,29.683571984087028
70,77,Julie & Julia,250000,227,2009.0,Comedy/Drama,2:04,7,29.683571984087028
82,85,21 Jump Street,250000,226,2012.0,Comedy/Action,1:50,3,29.601776444473394
54,34,Battleship,250000,225,2012.0,Sci fi/Action,2:11,-20,29.519845068981457
67,51,Get Smart,250000,223,2008.0,Comedy/Action,1:51,-16,29.355571478323455
65,55,Australia,250000,223,2008.0,Western/Drama,2:45,-10,29.355571478323455
86,89,3:10 to Yuma,250000,223,2007.0,Western/Drama,2:00,3,29.355571478323455
77,87,The Simpsons Movie,250000,222,2007.0,Comedy/Animation,1:26,10,29.273227574963673
73,49,Twilight,250000,222,2008.0,Romance/Fantasy,2:01,-24,29.273227574963673
73,69,Ted,250000,221,2012.0,Comedy/Fantasy,1:46,-4,29.190744459068426
84,91,Hairspray,250000,221,2007.0,Comedy/Musical,1:55,7,29.190744459068426
43,16,Sex and the City 2,250000,219,2010.0,Romance,2:27,-27,29.025357112775033
61,89,Adventureland,250000,219,2009.0,Comedy/Romance,1:46,28,29.025357112775033
87,91,Sicko,250000,219,2007.0,Documentary,1:53,4,29.025357112775033
59,73,Monsters vs. Aliens,250000,218,2009.0,Sci fi/Comedy,1:34,14,28.942451120368005
49,55,Edge of Darkness,250000,217,2010.0,Drama/Crime,1:57,6,28.8594023911159
60,41,Speed Racer,250000,217,2008.0,Action/Adventure,2:15,-19,28.8594023911159
87,81,American Gangster,250000,216,2007.0,Drama/Biography,2:37,-6,28.776210019791854
88,94,Juno,250000,216,2007.0,Comedy/Drama,1:36,6,28.776210019791854
68,68,I Am Legend,250000,215,2007.0,Sci fi/Drama,1:41,0,28.69287309120695
37,51,Observe and Report,250000,214,2009.0,Comedy,1:26,14,28.609390680053693
52,42,Shrek the Third,250000,214,2007.0,Kids and family/Comedy,1:33,-10,28.609390680053693
68,78,Cloverfield,250000,212,2008.0,Sci fi/Mystery and thriller,1:25,10,28.441985657257728
91,99,How to Train Your Dragon,250000,212,2010.0,Kids and family/Comedy,1:38,8,28.441985657257728
67,66,The Karate Kid,250000,211,2010.0,Drama/Sports and fitness,2:20,-1,28.358061142953193
86,82,Live Free or Die Hard,250000,210,2007.0,Action/Mystery and thriller,2:09,-4,28.273987340420472
64,42,The Expendables,250000,209,2010.0,Action/Adventure,1:43,-22,28.18976327129646
84,70,Fast & Furious 6,250000,209,2013.0,Action,2:10,-14,28.18976327129646
74,83,"I Love You, Man",250000,209,2009.0,Comedy,1:45,9,28.18976327129646
87,88,Superbad,250000,209,2007.0,Comedy,1:53,1,28.18976327129646
69,71,Wanted,250000,209,2008.0,Action/Mystery and thriller,1:50,2,28.18976327129646
35,45,Jennifer's Body,250000,208,2009.0,Comedy/Horror,1:41,10,28.10538794609019
56,57,The Soloist,250000,207,2009.0,Drama/Biography,1:57,1,28.02086036400211
62,70,Paul,250000,207,2011.0,Comedy/Sci fi,1:44,8,28.02086036400211
64,46,The Book of Eli,250000,207,2010.0,Action/Adventure,1:52,-18,28.02086036400211
85,66,The Blind Side,250000,206,2009.0,Biography/Drama,2:08,-19,27.93617951273954
57,83,Paranormal Activity,250000,205,2007.0,Horror/Mystery and thriller,1:26,26,27.85134436832817
73,68,Pineapple Express,250000,205,2008.0,Comedy/Action,1:52,-5,27.85134436832817
69,55,Step Brothers,250000,205,2008.0,Comedy,1:35,-14,27.85134436832817
69,91,Michael Clayton,250000,205,2007.0,Drama,2:00,22,27.85134436832817
81,80,Monsters University,250000,203,2013.0,Comedy/Animation,1:42,-1,27.681207044594718
82,81,Despicable Me,250000,202,2010.0,Kids and family/Comedy,1:35,-1,27.595902757162747
58,53,Disney's A Christmas Carol,250000,202,2009.0,Kids and family/Animation,1:35,-5,27.595902757162747
74,85,The Princess and the Frog,250000,201,2009.0,Comedy/Fantasy,1:35,11,27.510439959956123
54,58,Shrek Forever After,250000,201,2010.0,Comedy/Animation,1:35,4,27.510439959956123
75,69,Ocean's Thirteen,250000,201,2007.0,Comedy/Drama,2:02,-6,27.510439959956123
51,42,The Golden Compass,250000,198,2007.0,Kids and family/Adventure,1:58,-9,27.253089591424086
90,96,"Monsters, Inc.",250000,197,2001.0,Kids and family/Comedy,1:32,6,27.166981771469644
37,75,Splice,250000,197,2009.0,Sci fi/Horror,1:47,38,27.166981771469644
70,49,The Twilight Saga: Breaking Dawn Part 2,250000,197,2012.0,Romance/Fantasy,1:55,-21,27.166981771469644
60,64,The Imaginarium of Doctor Parnassus,250000,197,2009.0,Mystery and thriller/Adventure,2:02,4,27.166981771469644
27,20,The Day the Earth Stood Still,250000,196,2008.0,Sci fi,1:44,-7,27.08070988374737
75,27,Seven Pounds,250000,195,2008.0,Drama,2:04,-48,26.9942727761599
73,66,The Chronicles of Narnia: Prince Caspian,250000,194,2008.0,Kids and family/Adventure,2:24,-7,26.907669282564235
69,89,Titanic,250000,193,1997.0,Romance/Drama,3:15,20,26.820898222527152
30,5,The Last Airbender,250000,193,2010.0,Fantasy/Adventure,1:43,-25,26.820898222527152
37,65,Duplicity,250000,192,2009.0,Drama/Romance,2:05,28,26.733958401075075
80,93,Enchanted,250000,192,2007.0,Kids and family/Romance,1:48,13,26.733958401075075
32,26,Land of the Lost,250000,191,2009.0,Comedy/Adventure,1:42,-6,26.646848608438216
47,18,Valentine's Day,250000,190,2010.0,Gay and lesbian/Romance,1:59,-29,26.559567619788876
45,37,You Don't Mess With the Zohan,250000,190,2008.0,Comedy,1:53,-8,26.559567619788876
67,44,The Proposal,250000,189,2009.0,Romance,1:48,-23,26.47211419497369
74,89,Bolt,250000,189,2008.0,Kids and family/Comedy,1:36,15,26.47211419497369
39,56,The Invention of Lying,250000,189,2009.0,Comedy,1:39,17,26.47211419497369
83,87,Kung Fu Panda,250000,189,2008.0,Adventure/Comedy,1:31,4,26.47211419497369
76,51,The Kingdom,250000,189,2007.0,Action/Drama,1:50,-25,26.47211419497369
72,58,Defiance,250000,188,2008.0,Drama/War,2:16,-14,26.384487078239673
56,57,9,250000,187,2009.0,Sci fi/War,1:19,1,26.296684997953903
60,85,Ghost Town,250000,187,2008.0,Comedy/Romance,1:43,25,26.296684997953903
85,75,Despicable Me 2,250000,186,2013.0,Comedy/Adventure,1:38,-10,26.20870666631663
64,44,The Brave One,250000,186,2007.0,Action/Drama,2:02,-20,26.20870666631663
63,45,American Reunion,250000,185,2012.0,Comedy,1:52,-18,26.120550779067592
66,55,Mamma Mia!,250000,185,2008.0,Comedy/Musical,1:49,-11,26.120550779067592
76,83,Forgetting Sarah Marshall,250000,185,2008.0,Romance,1:52,7,26.120550779067592
24,17,The Happening,250000,185,2008.0,Sci fi/Mystery and thriller,1:29,-7,26.120550779067592
47,48,Taking Woodstock,250000,184,2009.0,Drama/Gay and lesbian,2:00,1,26.03221601518546
42,34,Knowing,250000,184,2009.0,Sci fi/Mystery and thriller,1:55,-8,26.03221601518546
77,49,Sex and the City,250000,183,2008.0,Romance,2:25,-28,25.943701036580038
62,26,Eagle Eye,250000,183,2008.0,Action/Mystery and thriller,1:58,-36,25.943701036580038
51,64,The Five-Year Engagement,250000,179,2012.0,Romance,1:59,13,25.587811597850912
82,53,Across the Universe,250000,179,2007.0,Romance/Musical,2:11,-29,25.587811597850912
77,41,The Bucket List,250000,178,2007.0,Comedy/Drama,1:37,-36,25.49837485437685
85,59,Taken,250000,177,2008.0,Action/Mystery and thriller,1:31,-26,25.40874949100198
30,12,The Mummy: Tomb of the Dragon Emperor,250000,177,2008.0,Action/Adventure,1:52,-18,25.40874949100198
67,28,Fast & Furious,250000,176,2009.0,Mystery and thriller/Action,1:47,-39,25.31893404088985
23,14,Year One,250000,175,2009.0,Comedy/Adventure,1:37,-9,25.228927017388646
53,49,Bee Movie,250000,174,2007.0,Kids and family/Comedy,1:31,-4,25.13872691364861
74,89,Waitress,250000,174,2007.0,Comedy/Romance,1:47,15,25.13872691364861
66,36,21,250000,171,2008.0,Drama,2:02,-30,24.86695274122312
50,34,G.I. Joe: The Rise of Cobra,250000,170,2009.0,Adventure/Action,1:58,-16,24.775964830134004
44,15,Jumper,250000,170,2008.0,Sci fi/Action,1:28,-29,24.775964830134004
69,65,Dan in Real Life,250000,170,2007.0,Romance,1:38,-4,24.775964830134004
62,11,Grown Ups,250000,169,2010.0,Comedy,1:42,-51,24.684775987507244
59,41,He's Just Not That Into You,250000,169,2009.0,Romance,2:09,-18,24.684775987507244
49,26,Confessions of a Shopaholic,250000,169,2009.0,Comedy,1:45,-23,24.684775987507244
47,44,Night at the Museum: Battle of the Smithsonian,250000,169,2009.0,Kids and family/Comedy,1:45,-3,24.684775987507244
32,32,The X-Files: I Want to Believe,250000,168,2008.0,Sci fi/Mystery and thriller,1:44,0,24.59338457671065
71,59,Pirate Radio,250000,167,2009.0,Comedy/Drama,2:09,-12,24.501788937948916
52,43,The Last House on the Left,250000,167,2009.0,Horror/Mystery and thriller,1:50,-9,24.501788937948916
59,35,Elizabeth: The Golden Age,250000,167,2007.0,Biography/Drama,1:55,-24,24.501788937948916
55,63,Baby Mama,250000,166,2008.0,Comedy,1:39,8,24.409987387794924
48,48,The Strangers,250000,165,2008.0,Horror/Mystery and thriller,1:25,0,24.317978218708763
62,46,Ice Age: Dawn of the Dinosaurs,250000,165,2009.0,Kids and family/Comedy,1:34,-16,24.317978218708763
69,15,I Now Pronounce You Chuck and Larry,250000,165,2007.0,Comedy/Gay and lesbian,1:55,-54,24.317978218708763
74,77,Role Models,250000,164,2008.0,Comedy,1:39,3,24.225759698543914
39,10,Couples Retreat,250000,164,2009.0,Comedy,1:54,-29,24.225759698543914
39,19,Cop Out,250000,163,2010.0,Comedy/Drama,1:43,-20,24.13333007004028
75,26,Law Abiding Citizen,250000,162,2009.0,Drama/Crime,1:48,-49,24.0406875503036
62,42,No Reservations,250000,162,2007.0,Romance/Drama,1:44,-20,24.0406875503036
65,67,Shoot 'Em Up,250000,162,2007.0,Action/Mystery and thriller,1:27,2,24.0406875503036
38,22,Semi-Pro,250000,161,2008.0,Comedy,1:31,-16,23.947830330270747
62,42,Letters to Juliet,250000,160,2010.0,Romance/Drama,1:45,-20,23.854756574160536
56,51,30 Days of Night,250000,159,2007.0,Horror/Mystery and thriller,1:53,-5,23.761464418909437
63,18,Rush Hour 3,250000,159,2007.0,Comedy/Action,1:31,-45,23.761464418909437
37,29,The Heartbreak Kid,250000,159,2007.0,Comedy,1:58,-8,23.761464418909437
57,34,Vantage Point,250000,158,2008.0,Action/Mystery and thriller,1:29,-23,23.667951973591787
66,64,Madagascar: Escape 2 Africa,250000,157,2008.0,Kids and family/Comedy,1:28,-2,23.574217318823912
66,46,Yes Man,250000,156,2008.0,Comedy,1:44,-20,23.480258506151625
44,42,Race to Witch Mountain,250000,156,2009.0,Kids and family/Sci fi,1:39,-2,23.480258506151625
62,47,Rendition,250000,155,2007.0,Mystery and thriller,2:02,-15,23.38607355742051
63,56,Orphan,250000,155,2009.0,Horror/Mystery and thriller,2:03,-7,23.38607355742051
61,57,We Own the Night,250000,153,2007.0,Drama/Crime,1:58,-4,23.197017186759677
57,41,27 Dresses,250000,153,2008.0,Romance,1:47,-16,23.197017186759677
69,37,Rambo,250000,153,2008.0,Action/Adventure,1:31,-32,23.197017186759677
53,49,Percy Jackson & the Olympians: The Lightning Thief,250000,150,2010.0,Kids and family/Adventure,1:59,-4,22.911685375307673
51,12,The Bounty Hunter,250000,150,2010.0,Action/Romance,1:51,-39,22.911685375307673
37,9,"10,000 B.C.",250000,150,2008.0,Drama/Action,1:49,-28,22.911685375307673
63,81,The Spiderwick Chronicles,250000,149,2008.0,Kids and family/Drama,1:37,18,22.816100321808104
67,56,17 Again,250000,149,2009.0,Comedy,1:42,-11,22.816100321808104
74,80,The Bank Job,250000,148,2008.0,Drama/Action,1:51,6,22.72027439676837
48,11,Fool's Gold,250000,147,2008.0,Romance/Action,1:52,-37,22.624205359490148
47,25,Four Christmases,250000,145,2008.0,Romance/Other,1:28,-22,22.43132880334213
26,65,Stop-Loss,250000,144,2008.0,War/Drama,1:53,39,22.33451661845039
40,28,Ghosts of Girlfriends Past,250000,144,2009.0,Romance,1:40,-12,22.33451661845039
72,86,Cloudy With a Chance of Meatballs,250000,144,2009.0,Kids and family/Comedy,1:30,14,22.33451661845039
45,21,Fred Claus,250000,143,2007.0,Comedy/Other,1:56,-24,22.237451987521194
58,52,The Hills Have Eyes,250000,142,2006.0,Horror,1:47,-6,22.14013247996374
42,38,Cirque du Freak: The Vampire's Assistant,250000,141,2009.0,Action/Adventure,1:49,-4,22.042555624480066
75,62,Marley & Me,250000,141,2008.0,Comedy/Drama,1:56,-13,22.042555624480066
30,6,All About Steve,250000,140,2009.0,Comedy/Romance,1:39,-24,21.944718908089367
69,27,Remember Me,250000,139,2010.0,Drama/Romance,1:53,-42,21.84661977512174
72,48,My Sister's Keeper,250000,138,2009.0,Drama,1:48,-24,21.748255626180264
55,28,Dear John,250000,138,2010.0,Drama/Romance,1:47,-27,21.748255626180264
73,80,Dr. Seuss' Horton Hears a Who!,250000,137,2008.0,Kids and family/Adventure,1:28,7,21.649623817070065
60,52,Harold & Kumar Escape From Guantanamo Bay,250000,136,2008.0,Comedy,1:42,-8,21.550721657693213
67,43,Hannah Montana: The Movie,250000,134,2009.0,Musical/Comedy,1:32,-24,21.35209529135088
72,78,Madagascar 3: Europe's Most Wanted,250000,134,2012.0,Kids and family/Comedy,1:25,6,21.35209529135088
65,26,What Happens in Vegas,250000,133,2008.0,Romance,1:39,-39,21.252365464220812
67,67,The Expendables 2,250000,132,2012.0,Action/Adventure,1:43,0,21.152354044022278
33,21,Balls of Fury,250000,132,2007.0,Comedy,1:30,-12,21.152354044022278
60,63,The Forbidden Kingdom,250000,131,2008.0,Sports and fitness/Action,1:45,3,21.05205809326756
72,63,High School Musical 3: Senior Year,250000,131,2008.0,Kids and family/Comedy,1:52,-9,21.05205809326756
36,39,Fighting,250000,130,2009.0,Action/Drama,1:45,3,20.951474621135226
67,36,National Treasure: Book of Secrets,250000,130,2007.0,Action/Adventure,2:10,-31,20.951474621135226
49,32,The Uninvited,250000,129,2009.0,Horror/Mystery and thriller,1:27,-17,20.850600582083427
42,23,Push,250000,128,2009.0,Sci fi/Action,1:51,-19,20.749432874416154
39,22,G-Force,250000,127,2009.0,Kids and family/Comedy,1:28,-17,20.647968338800368
44,10,My Life in Ruins,250000,126,2009.0,Romance,1:36,-34,20.546203756731995
55,16,Made of Honor,250000,126,2008.0,Comedy/Romance,1:41,-39,20.546203756731995
55,38,Mr. Magorium's Wonder Emporium,250000,125,2007.0,Kids and family/Comedy,1:35,-17,20.444135848948562
53,7,License to Wed,250000,125,2007.0,Romance,1:31,-46,20.444135848948562
27,12,Did You Hear About the Morgans?,250000,123,2009.0,Comedy/Romance,1:43,-15,20.23907662547856
75,62,The Express,250000,121,2008.0,Biography/Drama,2:09,-13,20.032763155216593
32,13,"I Love You, Beth Cooper",250000,120,2009.0,Comedy,1:42,-19,19.92912718504312
40,41,Imagine That,250000,120,2009.0,Kids and family/Comedy,1:47,1,19.92912718504312
30,10,The Unborn,250000,119,2009.0,Horror/Mystery and thriller,1:28,-20,19.82516684143501
64,39,Hot Rod,250000,119,2007.0,Comedy/Action,1:28,-25,19.82516684143501
21,7,Whiteout,250000,117,2009.0,Mystery and thriller,1:41,-14,19.616257942185833
57,5,Good Luck Chuck,250000,117,2007.0,Romance,1:39,-52,19.616257942185833
43,34,Paul Blart: Mall Cop,250000,117,2009.0,Comedy,1:31,-9,19.616257942185833
38,37,Surrogates,250000,117,2009.0,Sci fi/Action,1:28,-1,19.616257942185833
49,51,Mr. Bean's Holiday,250000,115,2007.0,Comedy,1:28,2,19.406005504006643
40,23,Planet 51,250000,110,2009.0,Comedy/Animation,1:31,-17,18.874281508207943
64,28,Alvin and the Chipmunks,250000,109,2007.0,Kids and family/Comedy,1:31,-36,18.76685771072333
31,19,Legion,250000,105,2010.0,Mystery and thriller/Horror,1:44,-12,18.333412575379587
57,16,Hitman,250000,105,2007.0,Action/Mystery and thriller,1:33,-41,18.333412575379587
45,17,The Haunting in Connecticut,250000,105,2009.0,Horror/Mystery and thriller,1:32,-28,18.333412575379587
80,25,P.S. I Love You,250000,104,2007.0,Comedy/Drama,2:06,-55,18.22408939365073
69,29,The Game Plan,250000,103,2007.0,Kids and family/Comedy,1:50,-40,18.1143712989759
58,25,Resident Evil: Extinction,250000,101,2007.0,Action/Horror,1:34,-33,17.893729120895756
35,28,The Final Destination,250000,100,2009.0,Horror/Mystery and thriller,1:22,-7,17.78279410038923
30,48,The Ruins,250000,97,2008.0,Horror/Mystery and thriller,1:31,18,17.447464924548626
30,18,Dance Flick,250000,96,2009.0,Comedy,1:23,-12,17.334827353454408
46,19,Obsessed,250000,90,2009.0,Drama/Mystery and thriller,1:48,-27,16.64951428545866
44,56,Quarantine,250000,86,2008.0,Horror/Mystery and thriller,1:29,12,16.183093078793917
70,35,Sydney White,250000,85,2007.0,Comedy,1:48,-35,16.06522559818003
49,20,Alvin and the Chipmunks: The Squeakquel,250000,84,2009.0,Comedy/Kids and family,1:29,-29,15.946836950911226
34,23,Never Back Down,250000,84,2008.0,Action,1:54,-11,15.946836950911226
62,19,Saw IV,250000,84,2007.0,Horror/Mystery and thriller,1:32,-43,15.946836950911226
39,30,Gamer,250000,81,2009.0,Sci fi/Action,1:35,-9,15.588457268119896
45,21,Halloween II,250000,80,2009.0,Mystery and thriller/Horror,1:45,-24,15.467895945971296
43,22,The Eye,250000,78,2008.0,Horror/Mystery and thriller,1:37,-21,15.225063992104127
23,9,Captivity,250000,78,2007.0,Horror/Mystery and thriller,1:25,-14,15.225063992104127
55,40,Saw VI,250000,75,2009.0,Horror/Mystery and thriller,1:31,-15,14.856389929209026
43,33,Aliens in the Attic,250000,75,2009.0,Kids and family/Comedy,1:26,-10,14.856389929209026
49,64,Crank: High Voltage,250000,70,2009.0,Action,1:37,15,14.229389747854103
38,7,Prom Night,250000,67,2008.0,Horror/Mystery and thriller,1:28,-31,13.8451208742507
34,11,The Stepfather,250000,63,2009.0,Horror/Mystery and thriller,1:41,-23,13.322564864824612
51,13,War,250000,60,2007.0,Action/Mystery and thriller,1:43,-38,12.922440211617326
73,100,Pinocchio,250000,56,1940.0,Kids and family/Animation,1:27,27,12.377060587439436
78,98,Snow White and the Seven Dwarfs,250000,53,1937.0,Kids and family/Animation,1:20,20,11.958381890942793
76,98,One Hundred and One Dalmatians,250000,52,1961.0,Kids and family/Comedy,1:19,22,11.8168599865911
80,93,Lady and the Tramp,250000,42,1955.0,Kids and family/Animation,1:15,13,10.34024446475599
78,81,Alice in Wonderland,250000,32,1951.0,Kids and family/Animation,1:15,3,8.724061861322062
72,82,High School Musical 2,250000,22,2007.0,Kids and family/Comedy,1:30,10,6.9026233386080005
31,8,Echelon Conspiracy,250000,13,2009.0,Action/Mystery and thriller,1:46,-23,4.968377601139757
45,79,Captain Marvel,100000,537,2019.0,Adventure/Sci fi,2:04,34,50.843323150650605
42,90,Star Wars: The Last Jedi,100000,477,2017.0,Sci fi/Action,2:32,48,47.21434693089449
83,93,Wonder Woman,100000,465,2017.0,Adventure/Fantasy,2:21,10,46.4684402789913
86,93,Star Wars: The Force Awakens,100000,440,2015.0,Sci fi/Fantasy,2:16,7,44.89085972025035
63,29,Batman v Superman: Dawn of Justice,100000,429,2016.0,Adventure/Sci fi,2:33,-34,44.18611388961366
86,97,Mad Max: Fury Road,100000,426,2015.0,Adventure/Action,2:00,11,43.99273872922982
89,90,Captain America: Civil War,100000,419,2016.0,Adventure/Fantasy,2:26,1,43.53953278107729
87,85,Guardians of the Galaxy Vol. 2,100000,419,2017.0,Sci fi/Comedy,2:15,-2,43.53953278107729
69,40,Justice League,100000,402,2017.0,Adventure/Fantasy,1:59,-29,42.426898317979536
84,78,The Revenant,100000,400,2015.0,Western/Drama,2:36,-6,42.294850537622565
87,92,Spider-Man: Homecoming,100000,391,2017.0,Comedy/Action,2:13,5,41.697543783301256
49,74,Ghostbusters,100000,389,2016.0,Action/Comedy,1:57,25,41.564111465284654
91,91,The Martian,100000,379,2015.0,Drama/Sci fi,2:22,0,40.8930502542442
85,89,Doctor Strange,100000,378,2016.0,Adventure/Fantasy,1:55,4,40.82558108292364
89,98,Inside Out,100000,374,2015.0,Comedy/Animation,1:35,9,40.555032276187106
90,95,12 Years a Slave,100000,371,2013.0,Biography/Drama,2:14,5,40.35140801415813
86,72,Interstellar,100000,366,2014.0,Sci fi/Action,2:45,-14,40.01065658976095
87,87,Gone Girl,100000,363,2014.0,Drama/Crime,2:29,0,39.80536775511781
61,63,Spectre,100000,361,2015.0,Mystery and thriller/Adventure,2:28,2,39.66815496866703
90,96,Argo,100000,358,2012.0,Mystery and thriller/Drama,2:00,6,39.46180004470454
78,71,Jurassic World,100000,352,2015.0,Sci fi/Action,2:04,-7,39.04713416564995
90,85,Deadpool,100000,346,2016.0,Adventure/Fantasy,1:48,-5,38.62980908069324
65,47,X-Men: Apocalypse,100000,343,2016.0,Sci fi/Action,2:23,-18,38.420129557772
84,94,Finding Dory,100000,332,2016.0,Comedy/Animation,1:43,10,37.64534679752864
86,83,Ant-Man,100000,332,2015.0,Adventure/Fantasy,1:57,-3,37.64534679752864
86,96,The Social Network,100000,327,2010.0,Drama/Biography,2:00,10,37.28999674160195
66,76,Godzilla,100000,326,2014.0,Sci fi/Action,2:03,10,37.2186828871591
90,91,Edge of Tomorrow,100000,325,2014.0,Sci fi/Action,1:53,1,37.14728695255573
88,90,Dawn of the Planet of the Apes,100000,314,2014.0,Sci fi/Action,2:10,2,36.3564131496096
64,51,The Amazing Spider-Man 2,100000,309,2014.0,Adventure/Action,2:21,-13,35.99349753310109
71,68,"The Hunger Games: Mockingjay, Part 1",100000,301,2014.0,Adventure/Sci fi,2:03,-3,35.40821712816412
80,91,Zero Dark Thirty,100000,301,2012.0,Drama/War,2:37,11,35.40821712816412
67,48,The Great Gatsby,100000,301,2013.0,Drama,2:22,-19,35.40821712816412
84,72,American Sniper,100000,298,2014.0,Drama/Biography,2:12,-12,35.18723690988606
87,86,X-Men: First Class,100000,298,2011.0,Sci fi/Action,2:06,-1,35.18723690988606
92,94,The King's Speech,100000,297,2010.0,Drama/History,1:58,2,35.113391669429156
77,72,Pacific Rim,100000,294,2013.0,Sci fi/Action,2:11,-5,34.89129442165806
74,92,American Hustle,100000,293,2013.0,Crime/Drama,2:18,18,34.81707337301227
75,81,Super 8,100000,293,2011.0,Sci fi/Mystery and thriller,1:52,6,34.81707337301227
92,98,Zootopia,100000,293,2016.0,Kids and family/Comedy,1:48,6,34.81707337301227
76,90,Bridesmaids,100000,292,2011.0,Comedy,2:05,14,34.74275727052265
66,69,"The Hunger Games: Mockingjay, Part 2",100000,290,2015.0,Adventure/Sci fi,2:16,3,34.59383810879918
76,77,Thor,100000,289,2011.0,Adventure/Fantasy,1:53,1,34.51923414277182
79,90,Up in the Air,100000,288,2009.0,Comedy/Drama,1:49,11,34.44453330922775
61,29,Pirates of the Caribbean: Dead Men Tell No Tales,100000,287,2017.0,Action/Fantasy,2:03,-32,34.36973514538876
74,92,The Cabin in the Woods,100000,286,2011.0,Horror/Comedy,1:35,18,34.294839184644516
83,79,The Wolf of Wall Street,100000,286,2013.0,Comedy/Biography,2:59,-4,34.294839184644516
91,89,The Imitation Game,100000,284,2014.0,Gay and lesbian/History,1:53,-2,34.144751986566035
81,89,Lincoln,100000,284,2012.0,Drama/Biography,2:29,8,34.144751986566035
66,66,Cloud Atlas,100000,284,2012.0,Drama/Mystery and thriller,2:52,0,34.144751986566035
82,94,Her,100000,282,2013.0,Comedy/Romance,1:59,12,33.994267903729856
89,93,Captain Phillips,100000,279,2013.0,Drama/Mystery and thriller,2:13,4,33.76778912483905
54,33,Pirates of the Caribbean: On Stranger Tides,100000,278,2011.0,Action/Adventure,2:16,-21,33.69209351576394
82,82,Furious 7,100000,276,2015.0,Mystery and thriller/Adventure,2:17,0,33.54039526043435
85,95,True Grit,100000,274,2010.0,Western/Drama,1:50,10,33.38828421669504
70,54,Maleficent,100000,273,2014.0,Adventure/Fantasy,1:38,-16,33.3120726055166
84,82,Scott Pilgrim vs. the World,100000,272,2010.0,Action/Romance,1:52,-2,33.23575623584784
74,80,Captain America: The First Avenger,100000,272,2011.0,Action/Adventure,2:04,6,33.23575623584784
82,93,Looper,100000,269,2012.0,Sci fi/Action,1:59,11,33.006173253232014
74,59,The Hobbit: The Battle of the Five Armies,100000,265,2014.0,Adventure/Fantasy,2:24,-15,32.69856330272059
84,79,Saving Mr. Banks,100000,265,2013.0,Drama/Comedy,2:05,-5,32.69856330272059
86,93,Moonrise Kingdom,100000,264,2012.0,Comedy/Romance,1:34,7,32.62138938955259
82,92,Source Code,100000,263,2011.0,Sci fi/Action,1:29,10,32.54410577614366
58,65,Elysium,100000,261,2013.0,Sci fi/Drama,1:49,7,32.3892071476377
67,71,The Adjustment Bureau,100000,261,2011.0,Sci fi/Romance,1:45,4,32.3892071476377
41,76,Noah,100000,261,2014.0,Fantasy/Adventure,2:17,35,32.3892071476377
84,75,Kingsman: The Secret Service,100000,260,2014.0,Adventure/Action,2:09,-9,32.311590968974485
18,9,Fantastic Four,100000,259,2015.0,Sci fi/Action,1:40,-9,32.23386276280209
84,76,Fury,100000,259,2014.0,War/Drama,2:14,-8,32.23386276280209
88,93,Frost/Nixon,100000,258,2008.0,Drama/History,2:02,5,32.15602193394618
43,44,Cowboys & Aliens,100000,257,2011.0,Western/Sci fi,1:58,1,32.07806788174952
61,53,Oblivion,100000,257,2013.0,Sci fi/Adventure,2:05,-8,32.07806788174952
87,96,The LEGO Movie,100000,253,2014.0,Comedy/Animation,1:35,9,31.765107230441497
84,86,Life of Pi,100000,253,2012.0,Adventure/Drama,2:05,2,31.765107230441497
87,81,Prisoners,100000,253,2013.0,Drama/Crime,2:33,-6,31.765107230441497
86,87,The Girl With the Dragon Tattoo,100000,253,2011.0,Drama/Crime,2:38,1,31.765107230441497
89,91,The Fighter,100000,253,2010.0,Biography/Drama,1:56,2,31.765107230441497
65,78,Burn After Reading,100000,250,2008.0,Comedy/Drama,1:35,13,31.529167622359036
52,33,The Hangover Part II,100000,248,2011.0,Comedy,1:42,-19,31.371284444297096
59,61,Salt,100000,248,2010.0,Action/Mystery and thriller,1:40,2,31.371284444297096
63,51,Tron: Legacy,100000,246,2010.0,Sci fi/Action,2:05,-12,31.212923068073856
45,26,Green Lantern,100000,246,2011.0,Sci fi/Action,1:54,-19,31.212923068073856
75,76,Invictus,100000,246,2009.0,Biography/Drama,2:14,1,31.212923068073856
89,93,Milk,100000,245,2008.0,Biography/Drama,2:08,4,31.133561386575195
85,93,Fantastic Mr. Fox,100000,244,2009.0,Kids and family/Comedy,1:28,8,31.054078139703236
43,44,The Green Hornet,100000,240,2011.0,Action/Adventure,1:59,1,30.734915685705186
60,52,John Carter,100000,238,2012.0,Sci fi/Adventure,2:12,-8,30.574586918379627
47,66,Lucy,100000,238,2014.0,Sci fi/Action,1:28,19,30.574586918379627
44,55,Wall Street: Money Never Sleeps,100000,238,2010.0,Drama,2:10,11,30.574586918379627
69,41,Divergent,100000,236,2014.0,Adventure/Sci fi,2:20,-28,30.41375210935341
78,79,"Crazy, Stupid, Love.",100000,236,2011.0,Romance,1:58,1,30.41375210935341
47,31,Total Recall,100000,235,2012.0,Action/Sci fi,1:57,-16,30.333143098167753
85,92,The Town,100000,235,2010.0,Drama/Crime,2:04,7,30.333143098167753
73,60,Real Steel,100000,233,2011.0,Sci fi/Drama,2:07,-13,30.17153811508654
88,98,The Wrestler,100000,233,2008.0,Drama,1:50,10,30.17153811508654
49,52,Knight and Day,100000,232,2010.0,Comedy/Action,1:49,3,30.090540621339713
55,66,Date Night,100000,232,2010.0,Action/Romance,1:28,11,30.090540621339713
55,43,Rock of Ages,100000,231,2012.0,Musical,1:58,-12,30.00941209857022
40,14,A Good Day to Die Hard,100000,230,2013.0,Mystery and thriller/Action,1:38,-26,29.928151766205126
44,73,Killing Them Softly,100000,230,2012.0,Drama/Crime,1:37,29,29.928151766205126
89,76,The Help,100000,230,2011.0,Drama,2:26,-13,29.928151766205126
77,59,Sherlock Holmes: A Game of Shadows,100000,229,2011.0,Action/Adventure,2:09,-18,29.846758835604586
87,89,Tangled,100000,227,2010.0,Comedy/Fantasy,1:41,2,29.683571984087028
71,83,This Is the End,100000,227,2013.0,Comedy/Fantasy,1:47,12,29.683571984087028
85,81,The Fault in Our Stars,100000,226,2014.0,Drama/Romance,2:06,-4,29.601776444473394
91,90,Big Hero 6,100000,226,2014.0,Comedy/Animation,1:42,-1,29.601776444473394
87,75,Lone Survivor,100000,226,2013.0,War/Drama,2:01,-12,29.601776444473394
65,62,Ender's Game,100000,224,2013.0,Sci fi/Action,1:54,-3,29.43777702680547
42,58,W.,100000,224,2008.0,Comedy/Biography,2:11,16,29.43777702680547
83,86,The Conjuring,100000,223,2013.0,Horror/Mystery and thriller,1:51,3,29.355571478323455
70,69,Horrible Bosses,100000,223,2011.0,Comedy,1:38,-1,29.355571478323455
77,84,22 Jump Street,100000,222,2014.0,Comedy/Action,1:52,7,29.273227574963673
33,34,The Wolfman,100000,222,2010.0,Action/Horror,1:42,1,29.273227574963673
69,88,Rango,100000,222,2011.0,Kids and family/Comedy,1:45,19,29.273227574963673
44,57,The Dictator,100000,222,2012.0,Comedy,1:23,13,29.273227574963673
49,55,Minions,100000,221,2015.0,Comedy/Animation,1:31,6,29.190744459068426
49,48,RoboCop,100000,221,2014.0,Sci fi/Action,1:57,-1,29.190744459068426
78,79,Doubt,100000,220,2008.0,Drama,1:44,1,29.108121263755205
49,40,Cars 2,100000,219,2011.0,Kids and family/Comedy,1:47,-9,29.025357112775033
71,83,Seven Psychopaths,100000,219,2012.0,Comedy,1:51,12,29.025357112775033
74,66,Lawless,100000,218,2012.0,Drama/Crime,1:55,-8,28.942451120368005
80,83,Atonement,100000,218,2007.0,Drama/Romance,2:03,3,28.942451120368005
66,49,The A-Team,100000,217,2010.0,Adventure/Action,1:58,-17,28.8594023911159
73,84,State of Play,100000,217,2009.0,Drama/Crime,2:07,11,28.8594023911159
62,55,Body of Lies,100000,216,2008.0,Action/Drama,2:08,-7,28.776210019791854
60,79,Magic Mike,100000,214,2012.0,Drama/Comedy,1:50,19,28.609390680053693
71,67,Revolutionary Road,100000,214,2008.0,Drama,1:59,-4,28.609390680053693
37,58,The International,100000,213,2009.0,Drama/Mystery and thriller,1:58,21,28.52576185074631
50,17,Transformers: Age of Extinction,100000,212,2014.0,Adventure/Sci fi,2:45,-33,28.441985657257728
74,81,Vicky Cristina Barcelona,100000,212,2008.0,Comedy/Romance,1:36,7,28.441985657257728
36,11,After Earth,100000,211,2013.0,Action/Sci fi,1:39,-25,28.358061142953193
57,32,Kick-Ass 2,100000,211,2013.0,Action/Comedy,1:43,-25,28.358061142953193
76,90,Crazy Heart,100000,211,2009.0,Drama/Romance,1:52,14,28.358061142953193
56,64,Hot Tub Time Machine,100000,211,2010.0,Comedy/Fantasy,1:39,8,28.358061142953193
60,25,The Twilight Saga: Breaking Dawn Part 1,100000,210,2011.0,Romance/Fantasy,1:57,-35,28.273987340420472
82,62,Changeling,100000,210,2008.0,Drama/Mystery and thriller,2:21,-20,28.273987340420472
73,81,Warm Bodies,100000,209,2013.0,Romance/Horror,1:38,8,28.18976327129646
61,79,The Grey,100000,209,2012.0,Adventure/Drama,1:57,18,28.18976327129646
60,78,The Other Guys,100000,209,2010.0,Comedy/Action,1:47,18,28.18976327129646
57,31,Gangster Squad,100000,208,2013.0,Drama/Crime,1:50,-26,28.10538794609019
51,66,The Campaign,100000,208,2012.0,Comedy,1:25,15,28.10538794609019
37,39,Nine,100000,207,2009.0,Musical/Romance,1:58,2,28.02086036400211
44,20,The Hangover Part III,100000,206,2013.0,Comedy,1:40,-24,27.93617951273954
42,36,Eat Pray Love,100000,206,2010.0,Romance/Drama,2:20,-6,27.93617951273954
52,75,Anchorman 2: The Legend Continues,100000,204,2013.0,Comedy,1:59,23,27.76635389491961
52,64,Predators,100000,204,2010.0,Sci fi/Action,1:47,12,27.76635389491961
73,82,Charlie Wilson's War,100000,204,2007.0,Comedy/Drama,1:42,9,27.76635389491961
79,63,The Reader,100000,204,2008.0,Romance/Drama,2:03,-16,27.76635389491961
83,77,Fast Five,100000,203,2011.0,Action,2:10,-6,27.681207044594718
62,52,White House Down,100000,203,2013.0,Action/Mystery and thriller,2:11,-10,27.681207044594718
66,65,Zack and Miri Make a Porno,100000,201,2008.0,Romance,1:41,-1,27.510439959956123
83,89,Eastern Promises,100000,201,2007.0,Drama/Crime,1:40,6,27.510439959956123
87,84,In Bruges,100000,200,2008.0,Drama/Action,1:47,-3,27.42481756762073
66,49,Olympus Has Fallen,100000,199,2013.0,Action/Mystery and thriller,2:00,-17,27.33903448190164
65,62,Valkyrie,100000,199,2008.0,Mystery and thriller/Drama,2:00,-3,27.33903448190164
44,50,Mirror Mirror,100000,198,2012.0,Kids and family/Comedy,1:46,6,27.253089591424086
51,45,300: Rise of an Empire,100000,197,2014.0,Adventure/Drama,1:43,-6,27.166981771469644
85,81,42,100000,195,2013.0,Biography/History,2:08,-4,26.9942727761599
54,50,Savages,100000,195,2012.0,Mystery and thriller/Crime,2:10,-4,26.9942727761599
63,72,Machete,100000,195,2010.0,Action,1:44,9,26.9942727761599
52,39,Due Date,100000,195,2010.0,Comedy,1:35,-13,26.9942727761599
50,34,Abraham Lincoln: Vampire Hunter,100000,194,2012.0,Action/Horror,1:45,-16,26.907669282564235
63,53,Safe House,100000,194,2012.0,Action/Mystery and thriller,1:55,-10,26.907669282564235
72,87,Unstoppable,100000,194,2010.0,Action/Drama,1:34,15,26.907669282564235
78,69,The Darjeeling Limited,100000,193,2007.0,Comedy/Drama,1:31,-9,26.820898222527152
77,85,Easy A,100000,191,2010.0,Comedy,1:33,8,26.646848608438216
74,84,Whip It,100000,190,2009.0,Drama/Comedy,1:51,10,26.559567619788876
57,53,Green Zone,100000,190,2010.0,War/Mystery and thriller,1:55,-4,26.559567619788876
44,43,Frank Miller's Sin City: A Dame to Kill For,100000,190,2014.0,Drama/Action,1:41,-1,26.559567619788876
86,87,Wreck-It Ralph,100000,189,2012.0,Kids and family/Comedy,1:41,1,26.47211419497369
66,65,2 Guns,100000,189,2013.0,Comedy/Action,1:49,-1,26.47211419497369
38,62,Extract,100000,189,2009.0,Comedy,1:31,24,26.47211419497369
90,91,How to Train Your Dragon 2,100000,188,2014.0,Kids and family/Comedy,1:42,1,26.384487078239673
82,81,Michael Jackson's This Is It,100000,187,2009.0,Documentary,1:51,-1,26.296684997953903
71,85,Chronicle,100000,186,2012.0,Sci fi/Drama,1:24,14,26.20870666631663
47,27,Lions for Lambs,100000,185,2007.0,Drama,1:32,-20,26.120550779067592
43,15,A Nightmare on Elm Street,100000,184,2010.0,Horror,1:36,-28,26.03221601518546
71,66,The Heat,100000,183,2013.0,Comedy/Action,1:57,-5,25.943701036580038
72,72,Megamind,100000,183,2010.0,Kids and family/Comedy,1:36,0,25.943701036580038
60,58,It's Complicated,100000,183,2009.0,Romance,2:00,-2,25.943701036580038
67,64,Jack Reacher,100000,182,2012.0,Mystery and thriller/Action,2:10,-3,25.855004487777162
74,81,Kung Fu Panda 2,100000,182,2011.0,Kids and family/Comedy,1:30,7,25.855004487777162
86,94,Gone Baby Gone,100000,181,2007.0,Drama/Crime,1:55,8,25.766124995595995
82,94,In the Loop,100000,179,2009.0,Comedy,1:46,12,25.587811597850912
48,28,G.I. Joe: Retaliation,100000,179,2013.0,Action/Adventure,1:50,-20,25.587811597850912
63,74,Sunshine Cleaning,100000,179,2008.0,Comedy/Drama,1:42,11,25.587811597850912
78,87,Kung Fu Panda 3,100000,179,2016.0,Kids and family/Comedy,1:35,9,25.587811597850912
53,19,Identity Thief,100000,178,2013.0,Comedy,1:46,-34,25.49837485437685
84,65,The Kite Runner,100000,178,2007.0,Drama,2:08,-19,25.49837485437685
62,66,Insidious,100000,177,2010.0,Horror/Mystery and thriller,1:41,4,25.40874949100198
33,14,The Love Guru,100000,177,2008.0,Comedy,1:27,-19,25.40874949100198
92,94,The Diving Bell and the Butterfly,100000,176,2007.0,Biography/Drama,1:54,2,25.31893404088985
46,26,Friday the 13th,100000,175,2009.0,Horror,1:37,-20,25.228927017388646
53,40,The Sorcerer's Apprentice,100000,174,2010.0,Adventure/Fantasy,1:48,-13,25.13872691364861
52,22,Taken 2,100000,172,2012.0,Mystery and thriller/Action,1:32,-30,24.957741334700298
71,65,We Bought a Zoo,100000,172,2011.0,Comedy/Kids and family,2:04,-6,24.957741334700298
52,66,Youth in Revolt,100000,172,2009.0,Romance,1:30,14,24.957741334700298
75,90,The Savages,100000,172,2007.0,Comedy/Drama,1:53,15,24.957741334700298
40,18,Star Wars: The Clone Wars,100000,172,2008.0,Animation/Fantasy,1:38,-22,24.957741334700298
37,27,New in Town,100000,171,2009.0,Romance,1:36,-10,24.86695274122312
73,77,Sunshine,100000,171,2007.0,Sci fi,1:47,4,24.86695274122312
38,52,Leatherheads,100000,170,2008.0,Romance,1:54,14,24.775964830134004
70,50,Now You See Me,100000,169,2013.0,Comedy/Drama,1:56,-20,24.684775987507244
54,48,The Losers,100000,168,2010.0,Adventure/Action,1:37,-6,24.59338457671065
89,85,The Perks of Being a Wallflower,100000,168,2012.0,Gay and lesbian/Drama,1:43,-4,24.59338457671065
39,44,Lakeview Terrace,100000,167,2008.0,Drama/Mystery and thriller,1:46,5,24.501788937948916
58,50,The Chronicles of Narnia: The Voyage of the Dawn Treader,100000,167,2010.0,Kids and family/Adventure,1:52,-8,24.501788937948916
72,79,Dredd,100000,167,2012.0,Sci fi/Action,1:36,7,24.501788937948916
55,63,Mama,100000,166,2013.0,Horror/Mystery and thriller,1:40,8,24.409987387794924
40,19,The Invasion,100000,164,2007.0,Sci fi/Mystery and thriller,1:39,-21,24.225759698543914
50,21,Teenage Mutant Ninja Turtles,100000,163,2014.0,Comedy/Action,1:41,-29,24.13333007004028
75,90,Rescue Dawn,100000,163,2006.0,Drama/History,2:05,15,24.13333007004028
60,74,Premium Rush,100000,162,2012.0,Action/Mystery and thriller,1:31,14,24.0406875503036
54,38,From Paris With Love,100000,162,2010.0,Action/Adventure,1:32,-16,24.0406875503036
69,77,I'm Not There,100000,162,2007.0,Biography/Drama,2:15,8,24.0406875503036
80,75,Rise of the Guardians,100000,161,2012.0,Adventure/Animation,1:37,-5,23.947830330270747
60,42,Death Race,100000,160,2008.0,Action/Mystery and thriller,1:45,-18,23.854756574160536
72,48,We're the Millers,100000,159,2013.0,Comedy/Action,1:50,-24,23.761464418909437
91,97,Once,100000,158,2006.0,Drama/Romance,1:26,6,23.667951973591787
63,54,Dr. Seuss' the Lorax,100000,157,2012.0,Kids and family/Animation,1:26,-9,23.574217318823912
74,76,The Young Victoria,100000,156,2009.0,Romance/History,1:44,2,23.480258506151625
64,46,Run Fat Boy Run,100000,156,2007.0,Romance,1:40,-18,23.480258506151625
56,70,The Crazies,100000,155,2010.0,Horror/Mystery and thriller,1:41,14,23.38607355742051
49,69,Daybreakers,100000,154,2009.0,Sci fi/Horror,1:38,20,23.291660464128444
41,22,Repo Men,100000,154,2010.0,Sci fi/Action,1:51,-19,23.291660464128444
46,44,Brooklyn's Finest,100000,153,2009.0,Drama/Crime,2:05,-2,23.197017186759677
20,12,Jonah Hex,100000,153,2010.0,Fantasy/Western,1:21,-8,23.197017186759677
59,70,American Teen,100000,153,2008.0,Documentary,1:40,11,23.197017186759677
84,74,La môme,100000,153,2007.0,Biography/Drama,2:20,-10,23.197017186759677
35,48,MacGruber,100000,152,2010.0,Comedy/Action,1:30,13,23.102141654099842
58,36,Street Kings,100000,152,2008.0,Drama/Crime,1:47,-22,23.102141654099842
34,9,Little Fockers,100000,151,2010.0,Comedy,1:37,-25,23.007031762531238
39,50,Smart People,100000,151,2008.0,Drama/Romance,1:34,11,23.007031762531238
47,51,The Three Stooges,100000,150,2012.0,Comedy,1:32,4,22.911685375307673
46,17,The Back-up Plan,100000,149,2010.0,Romance,1:44,-29,22.816100321808104
67,20,The Lucky One,100000,148,2012.0,Drama/Romance,1:41,-47,22.72027439676837
62,43,The Other Boleyn Girl,100000,148,2008.0,Drama/History,1:55,-19,22.72027439676837
52,16,Untraceable,100000,148,2008.0,Drama/Crime,1:41,-36,22.72027439676837
65,71,The Mist,100000,146,2007.0,Sci fi/Horror,2:05,6,22.52789093302636
72,45,Hotel Transylvania,100000,145,2012.0,Kids and family/Comedy,1:35,-27,22.43132880334213
45,39,Inkheart,100000,145,2009.0,Kids and family/Adventure,1:45,-6,22.43132880334213
77,72,The Croods,100000,144,2013.0,Kids and family/Comedy,1:31,-5,22.33451661845039
85,64,The Boy in the Striped Pajamas,100000,143,2008.0,Drama,1:34,-21,22.237451987521194
47,23,Leap Year,100000,142,2010.0,Romance,1:40,-24,22.14013247996374
46,22,The Raven,100000,141,2012.0,Mystery and thriller,1:51,-24,22.042555624480066
74,58,Becoming Jane,100000,140,2007.0,Biography/Romance,2:00,-16,21.944718908089367
46,37,Lockout,100000,139,2012.0,Sci fi/Mystery and thriller,1:35,-9,21.84661977512174
78,59,The Secret Life of Bees,100000,139,2008.0,Drama,1:50,-19,21.84661977512174
50,50,Astro Boy,100000,139,2009.0,Kids and family/Sci fi,1:34,0,21.84661977512174
53,24,Hop,100000,139,2011.0,Kids and family/Comedy,1:35,-29,21.84661977512174
45,43,Death at a Funeral,100000,138,2010.0,Comedy,1:28,-2,21.748255626180264
84,81,Lars and the Real Girl,100000,138,2007.0,Comedy/Drama,1:47,-3,21.748255626180264
59,49,Nancy Drew,100000,138,2007.0,Kids and family/Adventure,1:39,-10,21.748255626180264
52,62,A Perfect Getaway,100000,138,2009.0,Action/Mystery and thriller,1:37,10,21.748255626180264
48,58,Paranormal Activity 2,100000,137,2010.0,Horror/Mystery and thriller,1:31,10,21.649623817070065
42,12,The Pink Panther 2,100000,137,2009.0,Comedy,1:32,-30,21.649623817070065
47,23,What to Expect When You're Expecting,100000,136,2012.0,Romance/Drama,1:50,-24,21.550721657693213
62,37,Ice Age: Continental Drift,100000,135,2012.0,Kids and family/Comedy,1:27,-25,21.451546410907937
29,16,Max Payne,100000,135,2008.0,Fantasy/Drama,1:39,-13,21.451546410907937
52,30,Nights in Rodanthe,100000,135,2008.0,Drama/Romance,1:36,-22,21.451546410907937
63,31,The Vow,100000,135,2012.0,Drama/Romance,1:44,-32,21.451546410907937
59,58,She's Out of My League,100000,133,2010.0,Romance,1:46,-1,21.252365464220812
86,80,The Great Debaters,100000,132,2007.0,Drama,2:07,-6,21.152354044022278
59,45,Journey 2: The Mysterious Island,100000,132,2012.0,Kids and family/Adventure,1:34,-14,21.152354044022278
67,36,The Odd Life of Timothy Green,100000,132,2012.0,Kids and family/Comedy,1:44,-31,21.152354044022278
71,58,Charlie Bartlett,100000,132,2007.0,Comedy/Drama,1:38,-13,21.152354044022278
51,34,The Nanny Diaries,100000,132,2007.0,Comedy,1:44,-17,21.152354044022278
56,65,Be Kind Rewind,100000,131,2008.0,Comedy,1:41,9,21.05205809326756
54,55,Gnomeo & Juliet,100000,128,2011.0,Comedy/Adventure,1:24,1,20.749432874416154
65,65,Epic,100000,127,2013.0,Comedy/Animation,1:43,0,20.647968338800368
50,43,The House Bunny,100000,125,2008.0,Comedy,1:37,-7,20.444135848948562
66,71,Cloudy With a Chance of Meatballs 2,100000,124,2013.0,Comedy/Animation,1:35,5,20.341761273786197
64,47,Step Up 3,100000,124,2010.0,Romance/Drama,1:46,-17,20.341761273786197
44,5,88 Minutes,100000,124,2007.0,Drama/Crime,1:47,-39,20.341761273786197
82,37,August Rush,100000,123,2007.0,Fantasy/Drama,1:53,-45,20.23907662547856
54,46,Hotel for Dogs,100000,123,2009.0,Kids and family/Comedy,1:40,-8,20.23907662547856
36,24,Fame,100000,122,2009.0,Drama/Musical,1:47,-12,20.136078432395202
48,58,Hercules,100000,122,2014.0,Action/Adventure,1:37,10,20.136078432395202
66,20,The Last Song,100000,122,2010.0,Drama,1:48,-46,20.136078432395202
55,42,Percy Jackson: Sea of Monsters,100000,118,2013.0,Adventure/Fantasy,1:46,-13,19.720878370380042
49,46,Cassandra's Dream,100000,118,2007.0,Drama,1:48,-3,19.720878370380042
54,26,Ninja Assassin,100000,117,2009.0,Action/Sports and fitness,1:39,-28,19.616257942185833
55,39,Feast of Love,100000,117,2007.0,Romance/Drama,1:42,-16,19.616257942185833
52,44,In the Land of Women,100000,117,2007.0,Comedy/Drama,1:40,-8,19.616257942185833
41,17,Tooth Fairy,100000,116,2010.0,Kids and family/Comedy,1:42,-24,19.511301649293156
58,48,Rio 2,100000,115,2014.0,Comedy/Animation,1:41,-10,19.406005504006643
51,20,That's My Boy,100000,115,2012.0,Comedy,1:56,-31,19.406005504006643
48,40,Transporter 3,100000,115,2008.0,Action,1:45,-8,19.406005504006643
62,28,Takers,100000,115,2010.0,Drama/Action,1:47,-34,19.406005504006643
53,8,Grown Ups 2,100000,115,2013.0,Comedy,1:40,-45,19.406005504006643
41,18,The Fourth Kind,100000,115,2009.0,Mystery and thriller,1:38,-23,19.406005504006643
25,14,The Spirit,100000,115,2008.0,Romance/Action,1:42,-11,19.406005504006643
31,18,Ghost Rider: Spirit of Vengeance,100000,114,2011.0,Fantasy/Action,1:36,-13,19.300365436139025
41,17,When in Rome,100000,114,2010.0,Romance,1:31,-24,19.300365436139025
57,47,Night at the Museum: Secret of the Tomb,100000,113,2014.0,Kids and family/Comedy,1:37,-10,19.194377290564812
60,61,Jackass Presents: Bad Grandpa,100000,112,2013.0,Comedy,1:32,1,19.088036824679065
55,27,Bedtime Stories,100000,112,2008.0,Kids and family/Comedy,1:39,-28,19.088036824679065
44,57,The Tale of Despereaux,100000,112,2008.0,Kids and family/Animation,1:34,13,19.088036824679065
34,23,Paranormal Activity 4,100000,112,2012.0,Horror/Mystery and thriller,1:27,-11,19.088036824679065
84,86,"Paris, je t'aime",100000,112,2006.0,Comedy/Drama,2:00,2,19.088036824679065
32,14,Mr. Woodcock,100000,112,2007.0,Comedy,1:27,-18,19.088036824679065
59,59,Safe,100000,111,2012.0,Action/Mystery and thriller,1:35,0,18.981339705756774
37,16,Love Happens,100000,110,2009.0,Drama/Romance,1:49,-21,18.874281508207943
44,5,Old Dogs,100000,110,2009.0,Kids and family/Comedy,1:28,-39,18.874281508207943
61,46,Just Wright,100000,109,2010.0,Romance,1:41,-15,18.76685771072333
44,61,My Bloody Valentine,100000,109,2009.0,Mystery and thriller/Horror,1:41,17,18.76685771072333
42,14,Over Her Dead Body,100000,109,2008.0,Romance,1:35,-28,18.76685771072333
48,21,Resident Evil: Afterlife,100000,107,2010.0,Horror/Action,1:37,-27,18.55089473417879
52,24,Fired Up,100000,107,2009.0,Comedy,1:29,-28,18.55089473417879
48,22,Mad Money,100000,106,2008.0,Comedy,1:43,-26,18.442346006574258
49,54,Diary of a Wimpy Kid,100000,106,2010.0,Kids and family/Comedy,1:32,5,18.442346006574258
64,82,Bandslam,100000,105,2009.0,Romance/Musical,1:51,18,18.333412575379587
46,51,Nim's Island,100000,105,2008.0,Kids and family/Comedy,1:34,5,18.333412575379587
26,6,Babylon A.D.,100000,104,2008.0,Sci fi/Action,1:30,-20,18.22408939365073
67,27,Colombiana,100000,103,2011.0,Action/Mystery and thriller,1:47,-40,18.1143712989759
32,47,Shorts,100000,103,2009.0,Comedy/Action,1:29,15,18.1143712989759
35,20,Meet Dave,100000,102,2008.0,Comedy/Sci fi,1:30,-15,18.004253009684938
79,54,Think Like a Man,100000,102,2012.0,Romance,2:02,-25,18.004253009684938
37,37,"New York, I Love You",100000,100,2009.0,Drama/Romance,1:43,0,17.78279410038923
66,65,The Sisterhood of the Traveling Pants 2,100000,100,2008.0,Comedy/Romance,1:51,-1,17.78279410038923
27,8,Post Grad,100000,100,2009.0,Comedy,1:29,-19,17.78279410038923
51,40,Beverly Hills Chihuahua,100000,99,2008.0,Kids and family/Comedy,1:31,-11,17.67144228430324
26,8,Bangkok Dangerous,100000,96,2008.0,Action/Mystery and thriller,1:40,-18,17.334827353454408
82,86,Earth,100000,94,2007.0,Documentary,1:30,4,17.108223236119827
34,14,The Seeker: The Dark Is Rising,100000,94,2007.0,Sci fi/Action,1:39,-20,17.108223236119827
32,33,Space Chimps,100000,92,2008.0,Kids and family/Comedy,1:21,1,16.879803711855995
40,12,The Spy Next Door,100000,90,2010.0,Kids and family/Comedy,1:32,-28,16.64951428545866
28,19,Chernobyl Diaries,100000,89,2012.0,Horror/Mystery and thriller,1:26,-9,16.533650545237286
49,29,Pandorum,100000,89,2009.0,Sci fi/Action,1:48,-20,16.533650545237286
38,29,"War, Inc.",100000,86,2008.0,Comedy,1:46,-9,16.183093078793917
63,23,Welcome Home Roscoe Jenkins,100000,83,2008.0,Comedy,1:54,-40,15.827918586512368
38,1,Daddy Day Camp,100000,81,2007.0,Kids and family/Comedy,1:29,-37,15.588457268119896
40,19,Texas Chainsaw,100000,79,2013.0,Horror,1:32,-21,15.34676814846713
63,29,Underworld: Rise of the Lycans,100000,78,2009.0,Horror/Fantasy,1:32,-34,15.225063992104127
52,13,Saw V,100000,78,2008.0,Horror/Mystery and thriller,1:32,-39,15.225063992104127
26,9,I Know Who Killed Me,100000,78,2007.0,Horror/Mystery and thriller,1:48,-17,15.225063992104127
79,23,Jonas Brothers: The Concert Experience,100000,77,2009.0,Kids and family/Documentary,1:26,-56,15.102773291691431
30,12,Aliens vs. Predator: Requiem,100000,77,2007.0,Sci fi/Action,1:34,-18,15.102773291691431
81,96,"Bigger, Stronger, Faster",100000,76,2008.0,Documentary,1:45,15,14.979885547093689
57,12,First Sunday,100000,76,2008.0,Comedy,1:38,-45,14.979885547093689
21,1,Disaster Movie,100000,74,2008.0,Comedy,1:30,-20,14.732275265126917
51,28,Resident Evil: Retribution,100000,74,2012.0,Action/Horror,1:35,-23,14.732275265126917
50,12,College Road Trip,100000,74,2008.0,Kids and family/Comedy,1:23,-38,14.732275265126917
42,16,Underdog,100000,70,2007.0,Adventure/Comedy,1:20,-26,14.229389747854103
31,21,Next Day Air,100000,66,2009.0,Comedy/Drama,1:24,-10,13.715604699135167
33,9,Shutter,100000,66,2008.0,Horror/Mystery and thriller,1:25,-24,13.715604699135167
39,17,The Santa Clause 3: The Escape Clause,100000,66,2006.0,Kids and family/Comedy,1:32,-22,13.715604699135167
76,28,Step Up 2 the Streets,100000,65,2008.0,Romance/Drama,1:37,-48,13.58535050847747
85,94,Close Encounters of the Third Kind,100000,64,1977.0,Sci fi,2:15,9,13.454342644059432
20,15,Dragonball: Evolution,100000,62,2009.0,Action/Adventure,1:26,-5,13.190000315557024
58,5,"Big Mommas: Like Father, Like Son",100000,62,2011.0,Comedy,1:48,-53,13.190000315557024
52,19,The Perfect Holiday,100000,59,2007.0,Kids and family/Romance,1:36,-33,12.78740756158519
31,40,Armored,100000,55,2009.0,Drama/Mystery and thriller,1:28,9,12.238457412731087
32,17,Superhero Movie,100000,53,2008.0,Comedy,1:25,-15,11.958381890942793
38,4,Scary Movie V,100000,52,2013.0,Comedy,1:25,-34,11.8168599865911
23,4,In the Name of the King: A Dungeon Siege Tale,100000,52,2007.0,Action/Adventure,2:04,-19,11.8168599865911
68,27,Tyler Perry's Why Did I Get Married Too?,100000,49,2010.0,Comedy/Romance,2:01,-41,11.3860359318845
25,2,Meet the Spartans,100000,48,2008.0,Comedy,1:24,-23,11.240244892502977
35,2,Strange Wilderness,100000,48,2008.0,Comedy,1:26,-33,11.240244892502977
58,23,The Boondock Saints II: All Saints Day,100000,44,2009.0,Drama/Action,1:55,-35,10.645300436514761
25,13,Skinwalkers,100000,38,2006.0,Horror,1:33,-12,9.713254050808038
66,19,Tyler Perry's Madea's Witness Protection,100000,37,2012.0,Comedy,1:54,-47,9.552698646911638
19,30,Dragon Wars: D-War,100000,37,2007.0,Action/Drama,1:29,11,9.552698646911638
50,73,The Midnight Meat Train,100000,33,2008.0,Horror/Mystery and thriller,1:40,23,8.893469344897873
33,9,The Comebacks,100000,33,2007.0,Comedy,1:28,-24,8.893469344897873
81,48,Ocean's Eleven,100000,31,1960.0,Comedy/Drama,2:07,-33,8.552657067536824
42,11,Feel the Noise,100000,27,2007.0,Music/Drama,1:27,-31,7.845169885845621
39,52,Explicit Ills,100000,25,2008.0,Drama,1:27,13,7.476743906106103
88,68,Joker,50000,583,2019.0,Drama/Crime,2:02,-20,53.52329563020326
90,94,Avengers: Endgame,50000,541,2019.0,Adventure/Sci fi,3:01,4,51.0796944462134
79,96,Black Panther,50000,521,2018.0,Action/Adventure,2:14,17,49.89115717320071
86,51,Star Wars: The Rise of Skywalker,50000,507,2019.0,Sci fi/Adventure,2:22,-35,49.04897934060378
91,85,Avengers: Infinity War,50000,479,2018.0,Adventure/Sci fi,2:29,-6,47.33797717169064
81,91,La La Land,50000,464,2016.0,Musical/Drama,2:08,10,46.40595748860749
81,92,Dunkirk,50000,461,2017.0,Drama/History,1:47,11,46.21820540591317
95,90,Spider-Man: Far From Home,50000,448,2019.0,Adventure/Fantasy,2:09,-5,45.39925840668458
81,88,Blade Runner 2049,50000,441,2017.0,Sci fi/Mystery and thriller,2:44,7,44.95459800148952
87,93,Thor: Ragnarok,50000,432,2017.0,Comedy/Fantasy,2:10,6,44.378982606735455
82,94,Arrival,50000,431,2016.0,Sci fi/Mystery and thriller,1:56,12,44.31474900606718
88,52,The Lion King,50000,429,2019.0,Adventure/Kids and family,1:58,-36,44.18611388961366
90,93,Logan,50000,419,2017.0,Adventure/Fantasy,2:17,3,43.53953278107729
55,65,Alien: Covenant,50000,402,2017.0,Sci fi/Horror,2:02,10,42.426898317979536
86,98,Get Out,50000,393,2017.0,Horror/Mystery and thriller,1:44,12,41.83072040096504
86,92,Baby Driver,50000,392,2017.0,Mystery and thriller/Action,1:53,6,41.76416394244701
69,75,Kong: Skull Island,50000,388,2017.0,Adventure/Sci fi,1:58,6,41.49729885406728
84,86,It,50000,385,2017.0,Horror/Mystery and thriller,2:15,2,41.2964724683229
80,71,Beauty and the Beast,50000,379,2017.0,Kids and family/Romance,2:09,-9,40.8930502542442
94,57,Aladdin,50000,379,2019.0,Comedy/Fantasy,2:08,-37,40.8930502542442
84,94,War for the Planet of the Apes,50000,359,2017.0,Sci fi/Action,2:22,10,39.53065681603646
77,91,Birdman or (The Unexpected Virtue of Ignorance),50000,354,2014.0,Drama/Comedy,1:59,14,39.18564852510176
78,96,Manchester by the Sea,50000,351,2016.0,Drama,2:17,18,38.977766337971524
79,74,Fantastic Beasts and Where to Find Them,50000,341,2016.0,Adventure/Fantasy,2:07,-5,38.27996102016362
76,74,The Hateful Eight,50000,335,2015.0,Western,2:48,-2,37.85759356651663
88,89,The Big Short,50000,329,2015.0,Comedy/Drama,2:10,1,37.43237958727603
80,97,Boyhood,50000,325,2014.0,Drama,2:45,17,37.14728695255573
86,94,The Jungle Book,50000,324,2016.0,Kids and family/Action,1:45,8,37.07580859032812
87,94,Mission: Impossible Rogue Nation,50000,324,2015.0,Action/Adventure,2:11,7,37.07580859032812
55,54,Jason Bourne,50000,323,2016.0,Mystery and thriller/Action,2:03,-1,37.00424745046404
87,95,The Artist,50000,319,2011.0,Drama/Romance,1:40,8,36.717168023699735
93,93,Hidden Figures,50000,318,2016.0,Drama/History,2:07,0,36.64518765438774
79,91,The Nice Guys,50000,318,2016.0,Mystery and thriller/Action,1:56,12,36.64518765438774
79,90,10 Cloverfield Lane,50000,313,2016.0,Mystery and thriller,1:43,11,36.284004402515706
86,99,Selma,50000,311,2014.0,Drama/History,2:08,13,36.13892611397388
80,86,Star Trek Beyond,50000,310,2016.0,Sci fi/Adventure,2:02,6,36.0662558040403
86,92,The Grand Budapest Hotel,50000,310,2014.0,Comedy/Drama,1:39,6,36.0662558040403
79,77,Split,50000,309,2016.0,Horror/Mystery and thriller,1:57,-2,35.99349753310109
89,95,Creed,50000,309,2015.0,Drama,2:13,6,35.99349753310109
49,50,Tomorrowland,50000,298,2015.0,Sci fi/Adventure,2:09,1,35.18723690988606
84,97,The Hurt Locker,50000,289,2008.0,Action/War,2:07,13,34.51923414277182
60,84,The Tree of Life,50000,289,2011.0,Drama,2:18,24,34.51923414277182
66,84,Trainwreck,50000,288,2015.0,Romance,2:05,18,34.44453330922775
63,30,Passengers,50000,286,2016.0,Sci fi/Romance,1:51,-33,34.294839184644516
89,95,Moana,50000,281,2016.0,Comedy/Musical,1:53,6,33.91887582197262
41,25,Fifty Shades of Grey,50000,281,2015.0,Drama/Romance,2:05,-16,33.91887582197262
86,92,Ex Machina,50000,281,2015.0,Sci fi/Drama,1:47,6,33.91887582197262
91,84,Hacksaw Ridge,50000,280,2016.0,Biography/War,2:19,-7,33.84338306058975
85,92,Sicario,50000,278,2015.0,Drama/Crime,2:01,7,33.69209351576394
85,89,John Wick: Chapter 2,50000,276,2017.0,Mystery and thriller/Action,2:02,4,33.54039526043435
75,88,Wild,50000,276,2014.0,Drama/Biography,1:55,13,33.54039526043435
52,27,Terminator Genisys,50000,273,2015.0,Sci fi/Action,2:06,-25,33.3120726055166
84,80,The Theory of Everything,50000,271,2014.0,Romance/Biography,2:03,-4,33.159334577751565
86,90,How to Train Your Dragon: The Hidden World,50000,269,2019.0,Comedy/Adventure,1:44,4,33.006173253232014
79,87,The Descendants,50000,268,2011.0,Comedy/Drama,1:55,8,32.929432503463254
86,94,Moneyball,50000,267,2011.0,Drama,2:13,8,32.85258429845689
91,93,Dallas Buyers Club,50000,261,2013.0,Gay and lesbian/Drama,1:57,2,32.3892071476377
78,95,Spy,50000,258,2015.0,Action/Comedy,1:55,17,32.15602193394618
58,36,The Legend of Tarzan,50000,256,2016.0,Drama/Action,1:50,-22,32.0
62,84,The Master,50000,255,2012.0,Drama,2:16,22,31.921817676857298
72,94,Snowpiercer,50000,255,2013.0,Sci fi/Action,2:05,22,31.921817676857298
44,30,The Monuments Men,50000,254,2014.0,Drama/War,1:58,-14,31.843520294778347
81,80,The Conjuring 2,50000,253,2016.0,Horror/Mystery and thriller,2:13,-1,31.765107230441497
78,83,Cinderella,50000,251,2015.0,Kids and family/Romance,1:45,5,31.60793153235044
52,49,San Andreas,50000,249,2015.0,Action/Adventure,1:54,-3,31.450285477474228
66,87,Foxcatcher,50000,248,2014.0,Drama/Crime,2:14,21,31.371284444297096
73,83,The Ides of March,50000,247,2011.0,Drama,1:40,10,31.292163863166575
71,89,The World's End,50000,243,2013.0,Comedy/Sci fi,1:49,18,30.97447264187668
74,74,War Horse,50000,238,2011.0,Drama/War,2:26,0,30.574586918379627
76,88,Let Me In,50000,237,2010.0,Horror,1:55,12,30.494233135441753
85,93,127 Hours,50000,236,2010.0,Drama/Biography,1:33,8,30.41375210935341
50,82,Sausage Party,50000,236,2016.0,Comedy/Adventure,1:29,32,30.41375210935341
38,47,Hereafter,50000,236,2010.0,Drama,2:09,9,30.41375210935341
62,72,The Secret Life of Pets,50000,235,2016.0,Comedy/Animation,1:31,10,30.333143098167753
66,71,Hanna,50000,235,2011.0,Adventure/Mystery and thriller,1:51,5,30.333143098167753
88,89,Rush,50000,235,2013.0,Action/Drama,2:03,1,30.333143098167753
51,52,The Iron Lady,50000,235,2011.0,Biography/Drama,1:45,1,30.333143098167753
74,74,The Adventures of Tintin,50000,233,2011.0,Kids and family/Adventure,1:47,0,30.17153811508654
70,51,Unbroken,50000,232,2014.0,Biography/War,2:17,-19,30.090540621339713
65,83,Tinker Tailor Soldier Spy,50000,229,2011.0,Mystery and thriller,2:07,18,29.846758835604586
37,19,Transcendence,50000,229,2014.0,Sci fi/Action,1:59,-18,29.846758835604586
80,95,The Muppets,50000,229,2011.0,Kids and family/Comedy,1:38,15,29.846758835604586
78,93,Hugo,50000,228,2011.0,Drama/Adventure,2:06,15,29.76523250994286
63,62,Non-Stop,50000,228,2014.0,Action/Mystery and thriller,1:47,-1,29.76523250994286
30,30,Independence Day: Resurgence,50000,227,2016.0,Sci fi/Adventure,2:00,0,29.683571984087028
43,18,Assassin's Creed,50000,225,2016.0,Action/Adventure,1:56,-25,29.519845068981457
49,71,Into the Woods,50000,225,2014.0,Musical/Fantasy,2:04,22,29.519845068981457
74,92,The Kids Are All Right,50000,225,2010.0,Gay and lesbian/Comedy,1:44,18,29.519845068981457
68,89,A Serious Man,50000,225,2009.0,Comedy/Drama,1:45,21,29.519845068981457
39,66,The American,50000,224,2010.0,Drama/Mystery and thriller,1:45,27,29.43777702680547
75,78,The Place Beyond the Pines,50000,224,2012.0,Drama/Crime,2:20,3,29.43777702680547
83,93,Midnight in Paris,50000,224,2011.0,Romance/Fantasy,1:34,10,29.43777702680547
70,81,Side Effects,50000,223,2013.0,Drama/Mystery and thriller,1:45,11,29.355571478323455
70,87,Frankenweenie,50000,222,2012.0,Kids and family/Comedy,1:27,17,29.273227574963673
50,51,This Is 40,50000,221,2012.0,Romance,2:14,1,29.190744459068426
47,22,Sucker Punch,50000,220,2011.0,Action/Fantasy,1:50,-25,29.108121263755205
64,76,The Good Dinosaur,50000,218,2015.0,Comedy/Adventure,1:32,12,28.942451120368005
64,65,Pitch Perfect 2,50000,218,2015.0,Comedy/Musical,1:55,1,28.942451120368005
77,86,Blue Valentine,50000,212,2010.0,Romance/Drama,2:00,9,28.441985657257728
41,33,A Million Ways to Die in the West,50000,211,2014.0,Comedy/Western,1:55,-8,28.358061142953193
70,84,The Ghost Writer,50000,210,2010.0,Drama/Mystery and thriller,2:09,14,28.273987340420472
50,44,Ted 2,50000,209,2015.0,Fantasy/Comedy,1:55,-6,28.18976327129646
39,10,Red Riding Hood,50000,209,2011.0,Horror/Mystery and thriller,1:39,-29,28.18976327129646
35,31,Exodus: Gods and Kings,50000,209,2014.0,Drama/Action,2:30,-4,28.18976327129646
44,64,Neighbors 2: Sorority Rising,50000,208,2016.0,Comedy,1:32,20,28.10538794609019
55,52,Jack the Giant Slayer,50000,208,2013.0,Adventure/Fantasy,1:53,-3,28.10538794609019
58,28,The Divergent Series: Insurgent,50000,206,2015.0,Adventure/Sci fi,1:58,-30,27.93617951273954
55,55,Unknown,50000,206,2011.0,Drama/Mystery and thriller,1:53,0,27.93617951273954
58,80,Don Jon,50000,205,2013.0,Comedy/Romance,1:29,22,27.85134436832817
46,17,Pixels,50000,204,2015.0,Sci fi/Comedy,1:46,-29,27.76635389491961
47,50,Pain & Gain,50000,204,2013.0,Drama/Action,2:09,3,27.76635389491961
63,63,Evil Dead,50000,203,2013.0,Horror/Mystery and thriller,1:31,0,27.681207044594718
76,60,The Equalizer,50000,202,2014.0,Action/Mystery and thriller,2:12,-16,27.595902757162747
58,80,Muppets Most Wanted,50000,201,2014.0,Comedy/Adventure,1:46,22,27.510439959956123
40,27,Pan,50000,200,2015.0,Adventure/Fantasy,1:51,-13,27.42481756762073
78,72,Lee Daniels' The Butler,50000,200,2013.0,Drama/History,2:12,-6,27.42481756762073
48,68,Tower Heist,50000,200,2011.0,Comedy/Adventure,1:45,20,27.42481756762073
89,91,Philomena,50000,200,2013.0,Drama,1:37,2,27.42481756762073
88,93,50/50,50000,200,2011.0,Comedy/Drama,1:39,5,27.42481756762073
71,51,The Secret Life of Walter Mitty,50000,197,2013.0,Comedy/Adventure,1:54,-20,27.166981771469644
76,87,The Peanuts Movie,50000,197,2015.0,Comedy/Animation,1:29,11,27.166981771469644
53,58,Despicable Me 3,50000,197,2017.0,Kids and family/Comedy,1:30,5,27.166981771469644
70,60,Water for Elephants,50000,197,2011.0,Romance/Drama,2:01,-10,27.166981771469644
33,38,The Incredible Burt Wonderstone,50000,196,2013.0,Comedy,1:40,5,27.08070988374737
80,93,An Education,50000,196,2009.0,Drama,1:40,13,27.08070988374737
54,67,The Woman in Black,50000,195,2012.0,Horror/Mystery and thriller,1:35,13,26.9942727761599
53,33,Now You See Me 2,50000,195,2016.0,Comedy/Adventure,2:09,-20,26.9942727761599
38,67,Spring Breakers,50000,195,2012.0,Comedy/Drama,1:34,29,26.9942727761599
75,91,The Gift,50000,195,2015.0,Mystery and thriller,1:48,16,26.9942727761599
81,86,A Single Man,50000,195,2009.0,Gay and lesbian/Drama,1:39,5,26.9942727761599
71,69,"Synecdoche, New York",50000,194,2008.0,Comedy/Drama,2:04,-2,26.907669282564235
55,69,The Runaways,50000,193,2010.0,Biography/Drama,1:45,14,26.820898222527152
50,63,Anna Karenina,50000,192,2012.0,Drama/Romance,2:09,13,26.733958401075075
92,83,Warrior,50000,192,2011.0,Action/Drama,2:19,-9,26.733958401075075
85,87,Chef,50000,191,2014.0,Drama/Comedy,1:55,2,26.646848608438216
90,98,Let the Right One In,50000,191,2008.0,Horror,1:54,8,26.646848608438216
36,45,Bad Teacher,50000,191,2011.0,Comedy,1:32,9,26.646848608438216
74,66,Away We Go,50000,191,2009.0,Comedy/Drama,1:37,-8,26.646848608438216
61,45,Extremely Loud & Incredibly Close,50000,190,2011.0,Drama,2:09,-16,26.559567619788876
74,74,Capitalism: A Love Story,50000,189,2009.0,Documentary,2:07,0,26.47211419497369
62,71,Central Intelligence,50000,188,2016.0,Comedy/Action,1:47,9,26.384487078239673
53,54,Jack Ryan: Shadow Recruit,50000,187,2014.0,Mystery and thriller/Action,1:45,1,26.296684997953903
55,60,Scream 4,50000,187,2011.0,Comedy/Horror,1:52,5,26.296684997953903
57,23,Need for Speed,50000,186,2014.0,Action,2:10,-34,26.20870666631663
45,28,Get Hard,50000,186,2015.0,Comedy,1:39,-17,26.20870666631663
44,50,Carrie,50000,186,2013.0,Horror,1:39,6,26.20870666631663
84,83,"The Way, Way Back",50000,185,2013.0,Drama/Comedy,1:43,-1,26.120550779067592
72,89,ParaNorman,50000,185,2012.0,Comedy/Animation,1:36,17,26.120550779067592
56,26,This Means War,50000,183,2012.0,Comedy/Action,1:37,-30,25.943701036580038
34,27,Your Highness,50000,183,2011.0,Comedy/Adventure,1:42,-7,25.943701036580038
80,97,Mud,50000,182,2013.0,Drama/Adventure,2:10,17,25.855004487777162
86,85,End of Watch,50000,181,2012.0,Drama/Action,1:49,-1,25.766124995595995
51,55,Morning Glory,50000,181,2010.0,Romance,1:50,4,25.766124995595995
59,72,Fright Night,50000,180,2011.0,Comedy/Horror,1:46,13,25.677061168818504
40,33,Hall Pass,50000,177,2011.0,Comedy,1:46,-7,25.40874949100198
64,36,Burlesque,50000,177,2010.0,Drama/Musical,1:56,-28,25.40874949100198
86,87,The Orphanage,50000,177,2007.0,Drama/Horror,1:45,1,25.40874949100198
82,83,The Lincoln Lawyer,50000,176,2011.0,Drama/Crime,1:59,1,25.31893404088985
75,76,The Assassination of Jesse James by the Coward Robert Ford,50000,176,2007.0,Western/Drama,2:40,1,25.31893404088985
76,94,Winter's Bone,50000,175,2010.0,Drama,1:39,18,25.228927017388646
61,68,Footloose,50000,174,2011.0,Comedy/Drama,1:53,7,25.13872691364861
53,55,Seeking a Friend for the End of the World,50000,174,2012.0,Comedy/Romance,1:41,2,25.13872691364861
51,36,In Time,50000,174,2011.0,Sci fi/Action,1:49,-15,25.13872691364861
48,32,The Expendables 3,50000,173,2014.0,Adventure/Action,2:07,-16,25.048332202229876
40,21,The Rite,50000,173,2011.0,Mystery and thriller/Horror,1:54,-19,25.048332202229876
51,49,No Strings Attached,50000,173,2011.0,Romance,1:48,-2,25.048332202229876
42,20,The Tourist,50000,173,2010.0,Action/Romance,1:39,-22,25.048332202229876
83,91,Ponyo,50000,172,2008.0,Adventure/Anime,1:40,8,24.957741334700298
46,38,Teenage Mutant Ninja Turtles: Out of the Shadows,50000,172,2016.0,Adventure/Action,1:47,-8,24.957741334700298
68,65,The Maze Runner,50000,172,2014.0,Sci fi/Adventure,1:53,-3,24.957741334700298
56,57,Riddick,50000,172,2013.0,Sci fi/Mystery and thriller,1:58,1,24.957741334700298
62,87,Arbitrage,50000,171,2012.0,Drama/Mystery and thriller,1:40,25,24.86695274122312
65,68,Friends With Benefits,50000,170,2011.0,Romance,1:49,3,24.775964830134004
64,65,Traitor,50000,170,2008.0,Mystery and thriller/Action,1:53,1,24.775964830134004
51,35,The Internship,50000,170,2013.0,Comedy,1:59,-16,24.775964830134004
87,86,The Raid: Redemption,50000,170,2011.0,Crime/Drama,1:41,-1,24.775964830134004
61,79,Killer Joe,50000,170,2011.0,Drama/Crime,1:41,18,24.775964830134004
67,62,The Duchess,50000,170,2008.0,Drama/History,1:49,-5,24.775964830134004
66,50,The Next Three Days,50000,169,2010.0,Drama/Crime,2:13,-16,24.684775987507244
55,35,The Giver,50000,169,2014.0,Sci fi/Action,1:37,-20,24.684775987507244
53,49,Love & Other Drugs,50000,168,2010.0,Romance/Drama,1:52,-4,24.59338457671065
59,82,Two Lovers,50000,167,2008.0,Drama/Romance,1:49,23,24.501788937948916
52,54,Going the Distance,50000,167,2010.0,Romance,1:38,2,24.501788937948916
57,26,The Other Woman,50000,167,2014.0,Romance,1:49,-31,24.501788937948916
51,53,The Mechanic,50000,167,2011.0,Action/Mystery and thriller,1:32,2,24.501788937948916
31,20,Amelia,50000,166,2009.0,Biography/Drama,1:51,-11,24.409987387794924
57,51,Contraband,50000,165,2012.0,Mystery and thriller/Action,1:50,-6,24.317978218708763
39,16,The Watch,50000,165,2012.0,Sci fi/Comedy,1:41,-23,24.317978218708763
29,24,The Dilemma,50000,164,2011.0,Comedy,1:51,-5,24.225759698543914
62,78,Goosebumps,50000,164,2015.0,Comedy/Adventure,1:43,16,24.225759698543914
55,76,Appaloosa,50000,164,2008.0,Western/Drama,1:56,21,24.225759698543914
80,97,Paddington,50000,163,2014.0,Comedy/Adventure,1:35,17,24.13333007004028
35,72,The Last Exorcism,50000,163,2010.0,Horror/Mystery and thriller,1:30,37,24.13333007004028
59,28,Annie,50000,162,2014.0,Kids and family/Comedy,1:58,-31,24.0406875503036
81,69,About Time,50000,161,2013.0,Fantasy/Romance,2:04,-12,23.947830330270747
47,43,Blindness,50000,161,2008.0,Drama/Mystery and thriller,2:00,-4,23.947830330270747
47,35,Horrible Bosses 2,50000,160,2014.0,Comedy,1:48,-12,23.854756574160536
61,71,I Love You Phillip Morris,50000,159,2009.0,Drama/Romance,1:38,10,23.761464418909437
65,87,Buried,50000,157,2010.0,Drama/Mystery and thriller,1:34,22,23.574217318823912
64,68,The Brothers Bloom,50000,157,2008.0,Comedy/Romance,1:49,4,23.574217318823912
33,16,Sex Tape,50000,156,2014.0,Comedy,1:34,-17,23.480258506151625
36,39,The Purge,50000,156,2013.0,Horror/Mystery and thriller,1:25,3,23.480258506151625
49,35,Pride and Glory,50000,156,2008.0,Drama/Crime,2:09,-14,23.480258506151625
67,86,Puss in Boots,50000,155,2011.0,Kids and family/Comedy,1:30,19,23.38607355742051
44,52,The Switch,50000,155,2010.0,Romance,1:41,8,23.38607355742051
48,51,The Interview,50000,154,2014.0,Adventure/Action,1:51,3,23.291660464128444
61,63,Sinister,50000,154,2012.0,Horror/Mystery and thriller,1:49,2,23.291660464128444
57,86,Bad Lieutenant: Port of Call New Orleans,50000,154,2009.0,Drama/Crime,2:01,29,23.291660464128444
35,30,Dumb and Dumber To,50000,153,2014.0,Comedy,1:49,-5,23.197017186759677
63,44,Red 2,50000,153,2013.0,Action/Comedy,1:56,-19,23.197017186759677
61,29,Life as We Know It,50000,153,2010.0,Romance,1:53,-32,23.197017186759677
60,86,The Pirates! Band of Misfits,50000,153,2012.0,,,26,23.197017186759677
54,47,Maze Runner: The Scorch Trials,50000,152,2015.0,Sci fi/Adventure,2:11,-7,23.102141654099842
71,78,Miss Pettigrew Lives for a Day,50000,152,2008.0,Comedy/Drama,1:32,7,23.102141654099842
41,38,Swing Vote,50000,151,2008.0,Comedy,1:59,-3,23.007031762531238
73,48,The Book Thief,50000,150,2013.0,Drama/History,2:07,-25,22.911685375307673
71,72,Rio,50000,150,2011.0,Comedy/Animation,1:36,1,22.911685375307673
61,57,Snitch,50000,150,2013.0,Drama/Crime,1:52,-4,22.911685375307673
79,86,The White Ribbon,50000,149,2009.0,War/Drama,2:24,7,22.816100321808104
47,40,Delivery Man,50000,148,2013.0,Comedy,1:45,-7,22.72027439676837
38,14,The Women,50000,148,2008.0,Comedy/Drama,1:54,-24,22.72027439676837
84,72,"Lust, Caution",50000,148,2007.0,History/War,2:35,-12,22.72027439676837
59,46,Last Vegas,50000,147,2013.0,Comedy,1:44,-13,22.624205359490148
67,14,Safe Haven,50000,147,2013.0,Drama/Romance,1:55,-53,22.624205359490148
44,26,Drillbit Taylor,50000,147,2008.0,Comedy,1:42,-18,22.624205359490148
37,18,Righteous Kill,50000,147,2008.0,Drama/Crime,1:40,-19,22.624205359490148
71,60,RocknRolla,50000,147,2008.0,Comedy/Drama,1:54,-11,22.624205359490148
65,52,Notorious,50000,146,2009.0,Drama/Biography,2:02,-13,22.52789093302636
53,47,Mr. Popper's Penguins,50000,145,2011.0,Kids and family/Comedy,1:34,-6,22.43132880334213
53,28,Extraordinary Measures,50000,144,2010.0,Drama,1:46,-25,22.33451661845039
53,16,Hansel & Gretel: Witch Hunters,50000,144,2013.0,Action/Adventure,1:28,-37,22.33451661845039
51,15,Red Dawn,50000,143,2012.0,Action/Adventure,1:33,-36,22.237451987521194
56,57,The Purge: Anarchy,50000,142,2014.0,Horror/Mystery and thriller,1:43,1,22.14013247996374
72,27,Act of Valor,50000,142,2012.0,Action/Mystery and thriller,1:49,-45,22.14013247996374
45,7,New Year's Eve,50000,142,2011.0,Romance/Other,1:57,-38,22.14013247996374
39,12,Stealth,50000,141,2005.0,Action/Mystery and thriller,2:00,-27,22.042555624480066
64,15,Blended,50000,140,2014.0,Romance,1:57,-49,21.944718908089367
41,28,The Family,50000,139,2013.0,Action/Comedy,1:51,-13,21.84661977512174
61,28,Project X,50000,139,2012.0,Comedy,1:28,-33,21.84661977512174
59,19,Just Go With It,50000,139,2011.0,Romance,1:55,-40,21.84661977512174
73,81,Mr. Peabody & Sherman,50000,139,2014.0,Comedy/Animation,1:31,8,21.84661977512174
85,92,The Damned United,50000,139,2009.0,Biography/Drama,1:37,7,21.84661977512174
64,51,Home,50000,138,2015.0,Sci fi/Comedy,1:34,-13,21.748255626180264
74,88,Frozen River,50000,137,2008.0,Drama,1:36,14,21.649623817070065
52,62,Final Destination 5,50000,137,2011.0,Horror/Mystery and thriller,1:32,10,21.649623817070065
79,85,The Namesake,50000,136,2006.0,Drama,2:02,6,21.550721657693213
58,18,Ride Along,50000,135,2014.0,Comedy/Action,1:39,-40,21.451546410907937
63,52,Legend of the Guardians: The Owls of Ga'Hoole,50000,133,2010.0,Adventure/Animation,1:31,-11,21.252365464220812
65,44,The Call,50000,133,2013.0,Mystery and thriller,1:36,-21,21.252365464220812
48,46,Immortals,50000,132,2011.0,Action/Adventure,1:50,-2,21.152354044022278
43,74,Piranha,50000,131,2010.0,Mystery and thriller/Horror,1:28,31,21.05205809326756
83,90,Hunger,50000,131,2008.0,Drama/History,1:32,7,21.05205809326756
57,39,Insidious: Chapter 2,50000,129,2013.0,Horror/Mystery and thriller,1:45,-18,20.850600582083427
46,53,City of Ember,50000,129,2008.0,Kids and family/Adventure,1:35,7,20.850600582083427
58,13,The Mortal Instruments: City of Bones,50000,127,2013.0,Action/Adventure,2:10,-45,20.647968338800368
60,28,Charlie St. Cloud,50000,125,2010.0,Romance/Drama,1:39,-32,20.444135848948562
30,11,Season of the Witch,50000,125,2011.0,Action/Adventure,1:35,-19,20.444135848948562
51,66,Paranormal Activity 3,50000,125,2011.0,Horror/Mystery and thriller,1:21,15,20.444135848948562
65,66,Cadillac Records,50000,124,2008.0,Biography/Drama,1:48,1,20.341761273786197
61,75,Elegy,50000,123,2008.0,Romance/Drama,1:51,14,20.23907662547856
34,12,Seventh Son,50000,121,2014.0,Adventure/Fantasy,1:42,-22,20.032763155216593
55,75,Nanny McPhee Returns,50000,121,2010.0,Comedy/Fantasy,1:49,20,20.032763155216593
60,45,Happy Feet Two,50000,121,2011.0,Comedy/Musical,1:40,-15,20.032763155216593
42,79,The Innkeepers,50000,121,2011.0,Horror/Mystery and thriller,1:41,37,20.032763155216593
27,20,Gulliver's Travels,50000,121,2010.0,Kids and family/Comedy,1:25,-7,20.032763155216593
44,12,Taken 3,50000,121,2014.0,Action/Mystery and thriller,1:49,-32,20.032763155216593
72,88,2 Days in Paris,50000,120,2007.0,Comedy/Romance,1:36,16,19.92912718504312
67,88,World's Greatest Dad,50000,119,2009.0,Comedy/Drama,1:39,21,19.82516684143501
43,21,The Smurfs,50000,119,2011.0,Kids and family/Comedy,1:42,-22,19.82516684143501
79,73,Son of Rambow,50000,119,2007.0,Comedy,1:35,-6,19.82516684143501
78,95,The Imposter,50000,116,2012.0,Documentary,1:35,17,19.511301649293156
36,3,Jack and Jill,50000,116,2011.0,Comedy,1:30,-33,19.511301649293156
63,73,Penguins of Madagascar,50000,115,2014.0,Kids and family/Animation,1:32,10,19.406005504006643
55,50,Escape Plan,50000,115,2013.0,Mystery and thriller/Action,1:50,-5,19.406005504006643
65,67,Turbo,50000,114,2013.0,Comedy/Animation,1:36,2,19.300365436139025
86,95,"Food, Inc.",50000,114,2008.0,Documentary,1:34,9,19.300365436139025
35,42,House of My Father,50000,113,2012.0,Comedy,1:24,7,19.194377290564812
69,65,Jackass 3,50000,113,2010.0,Comedy,1:34,-4,19.194377290564812
60,20,Death Sentence,50000,113,2007.0,Action/Drama,1:50,-40,19.194377290564812
58,46,Sex Drive,50000,111,2008.0,Comedy,1:48,-12,18.981339705756774
63,55,Hotel Transylvania 2,50000,110,2015.0,Comedy/Animation,1:29,-8,18.874281508207943
49,15,Crossing Over,50000,110,2009.0,Drama,1:54,-34,18.874281508207943
72,35,Martian Child,50000,110,2007.0,Kids and family/Drama,1:46,-37,18.874281508207943
53,57,"For a Good Time, Call ...",50000,109,2012.0,Comedy,1:26,4,18.76685771072333
46,27,21 and Over,50000,109,2013.0,Comedy,1:33,-19,18.76685771072333
65,65,Justin Bieber: Never Say Never,50000,108,2011.0,Documentary,1:45,0,18.659063693305395
92,80,Departures,50000,108,2008.0,Drama,2:10,-12,18.659063693305395
38,5,"I, Frankenstein",50000,105,2014.0,Fantasy/Action,1:33,-33,18.333412575379587
54,81,The SpongeBob Movie: Sponge Out of Water,50000,105,2015.0,Kids and family/Comedy,1:32,27,18.333412575379587
69,80,Kit Kittredge: An American Girl,50000,105,2008.0,Kids and family/Comedy,1:40,11,18.333412575379587
34,12,Yogi Bear,50000,105,2010.0,Kids and family/Comedy,1:20,-22,18.333412575379587
38,13,R.I.P.D.,50000,104,2013.0,Comedy/Action,1:38,-25,18.22408939365073
42,9,Marmaduke,50000,103,2010.0,Kids and family/Comedy,1:28,-33,18.1143712989759
46,15,Priest,50000,101,2011.0,Action/Horror,1:27,-31,17.893729120895756
48,37,Resident Evil: The Final Chapter,50000,101,2016.0,Action/Horror,1:42,-11,17.893729120895756
63,85,The House of the Devil,50000,101,2009.0,Horror,1:33,22,17.893729120895756
31,11,Deception,50000,100,2008.0,Drama/Mystery and thriller,1:47,-20,17.78279410038923
43,49,Devil,50000,99,2010.0,Horror/Mystery and thriller,1:20,6,17.67144228430324
38,13,Cats & Dogs: The Revenge of Kitty Galore,50000,99,2010.0,Kids and family/Comedy,1:22,-25,17.67144228430324
48,39,The Possession,50000,99,2012.0,Horror/Mystery and thriller,1:31,-9,17.67144228430324
58,45,Soul Men,50000,99,2008.0,Comedy,1:40,-13,17.67144228430324
68,41,Step Up Revolution,50000,98,2012.0,Romance/Drama,1:38,-27,17.55966787263607
75,76,Chimpanzee,50000,98,2012.0,Documentary,1:18,1,17.55966787263607
90,93,Do the Right Thing,50000,98,1989.0,Drama,2:00,3,17.55966787263607
32,48,Sleeping Beauty,50000,97,2010.0,Drama,1:41,16,17.447464924548626
65,41,Here Comes the Boom,50000,97,2012.0,Comedy/Action,1:44,-24,17.447464924548626
83,70,The Best Man Holiday,50000,97,2013.0,Other/Drama,2:02,-13,17.447464924548626
41,48,Battle for Terra,50000,97,2007.0,Sci fi/Adventure,1:25,7,17.447464924548626
30,47,Management,50000,97,2008.0,Romance,1:33,17,17.447464924548626
57,32,Fanboys,50000,97,2008.0,Comedy,1:30,-25,17.447464924548626
43,19,You Again,50000,96,2010.0,Romance,1:45,-24,17.334827353454408
56,14,The Smurfs 2,50000,95,2013.0,Comedy/Adventure,1:45,-42,17.22174892188519
32,7,Furry Vengeance,50000,95,2010.0,Kids and family/Comedy,1:31,-25,17.22174892188519
90,93,This Is England,50000,94,2006.0,Drama,1:38,3,17.108223236119827
59,18,Parental Guidance,50000,93,2012.0,Comedy/Kids and family,1:44,-41,16.994243740562503
38,39,Igor,50000,93,2008.0,Kids and family/Comedy,1:26,1,16.994243740562503
71,70,Ramona and Beezus,50000,91,2010.0,Kids and family/Comedy,1:43,-1,16.764896252714394
29,4,Vampires Suck,50000,91,2010.0,Comedy,1:22,-25,16.764896252714394
66,51,Heaven Is for Real,50000,89,2014.0,Drama,1:40,-15,16.533650545237286
48,16,47 Ronin,50000,89,2013.0,Fantasy/Adventure,1:59,-32,16.533650545237286
44,15,Mirrors,50000,88,2008.0,Horror/Mystery and thriller,1:52,-29,16.417297572912943
48,15,Our Family Wedding,50000,87,2010.0,Romance,1:41,-33,16.300447707594707
30,6,Deck the Halls,50000,85,2006.0,Comedy/Other,1:35,-24,16.06522559818003
81,55,This Christmas,50000,84,2007.0,Comedy/Drama,1:57,-26,15.946836950911226
18,15,Skyline,50000,84,2010.0,Sci fi/Mystery and thriller,1:34,-3,15.946836950911226
51,18,Let's Be Cops,50000,83,2014.0,Comedy/Action,1:44,-33,15.827918586512368
34,36,Gigantic,50000,83,2008.0,Romance,1:39,2,15.827918586512368
51,12,Alvin and the Chipmunks: Chipwrecked,50000,82,2011.0,Comedy/Adventure,1:27,-39,15.708461709271033
41,10,Saw: The Final Chapter,50000,82,2010.0,Horror,1:31,-31,15.708461709271033
40,35,The Ten,50000,82,2007.0,Comedy,1:39,-5,15.708461709271033
29,5,Miss March,50000,81,2009.0,Romance,1:29,-24,15.588457268119896
75,80,Oceans,50000,81,2009.0,Documentary,1:42,5,15.588457268119896
29,0,One Missed Call,50000,81,2008.0,Horror/Mystery and thriller,1:27,-29,15.588457268119896
38,13,Howard the Duck,50000,78,1986.0,Sci fi/Action,1:51,-25,15.225063992104127
28,54,The Promotion,50000,78,2008.0,Comedy,1:26,26,15.225063992104127
66,31,The Children of Huang Shi,50000,78,2008.0,Drama/History,2:05,-35,15.225063992104127
62,26,Underworld: Awakening,50000,76,2012.0,Action/Horror,1:29,-36,14.979885547093689
39,21,Case 39,50000,76,2009.0,Horror/Mystery and thriller,1:49,-18,14.979885547093689
63,52,Diary of a Wimpy Kid: Dog Days,50000,75,2012.0,Kids and family/Comedy,1:34,-11,14.856389929209026
44,51,Doomsday,50000,75,2008.0,Sci fi/Action,1:49,7,14.856389929209026
48,28,The Collector,50000,74,2009.0,Horror/Mystery and thriller,1:28,-20,14.732275265126917
60,62,Grace Is Gone,50000,74,2007.0,Drama,1:32,2,14.732275265126917
31,16,The Brothers Solomon,50000,73,2007.0,Comedy,1:33,-15,14.607530022406213
45,30,12 Rounds,50000,71,2009.0,Mystery and thriller/Action,1:48,-15,14.356099772615265
49,24,Little Ashes,50000,70,2008.0,Gay and lesbian/Drama,1:37,-25,14.229389747854103
67,31,Not Easily Broken,50000,68,2009.0,Drama,1:39,-36,13.973914138485368
41,13,House at the End of the Street,50000,67,2012.0,Horror/Mystery and thriller,1:41,-28,13.8451208742507
88,88,Bonnie and Clyde,50000,64,1967.0,Drama/Crime,1:51,0,13.454342644059432
43,37,The Edge of Love,50000,59,2008.0,Drama/Romance,1:51,-6,12.78740756158519
47,0,A Thousand Words,50000,59,2012.0,Comedy,1:31,-47,12.78740756158519
46,14,My Best Friend's Girl,50000,59,2008.0,Romance,1:43,-32,12.78740756158519
84,73,Falling Down,50000,56,1993.0,Action,1:55,-11,12.377060587439436
70,63,Warlords (Tau ming chong),50000,56,2010.0,,,-7,12.377060587439436
34,15,The Last Legion,50000,55,2007.0,Action/Drama,1:42,-19,12.238457412731087
33,25,Blood: The Last Vampire,50000,53,2008.0,Action/Horror,1:29,-8,11.958381890942793
51,9,A Haunted House,50000,53,2013.0,Comedy/Horror,1:26,-42,11.958381890942793
84,96,To Catch a Thief,50000,50,1955.0,Romance/Mystery and thriller,1:46,12,11.530715390799685
89,88,Battle Royale,50000,48,2000.0,Mystery and thriller/Action,1:54,-1,11.240244892502977
53,33,Girl in Progress,50000,46,2012.0,Comedy/Drama,1:32,-20,10.945198564139895
34,9,Postal,50000,46,2007.0,Comedy/Action,1:46,-25,10.945198564139895
70,71,Hannah Montana and Miley Cyrus: Best of Both Worlds Concert,50000,45,2008.0,Kids and family/Documentary,1:22,1,10.795874345554918
87,61,Lost Highway,50000,44,1997.0,Drama,2:15,-26,10.645300436514761
61,53,Tyler Perry's the Family That Preys,50000,43,2008.0,Drama,1:51,-8,10.493437610589469
27,5,College,50000,43,2008.0,Comedy,1:34,-22,10.493437610589469
40,27,The Loss of a Teardrop Diamond,50000,41,2008.0,Romance/Drama,1:42,-13,10.185677243651742
18,2,The Haunting of Molly Hartley,50000,41,2008.0,Horror/Mystery and thriller,1:27,-16,10.185677243651742
82,89,Rec,50000,38,2007.0,Horror/Mystery and thriller,1:18,7,9.713254050808038
39,66,Carriers,50000,38,2009.0,Horror/Mystery and thriller,1:24,27,9.713254050808038
76,36,Tyler Perry's Good Deeds,50000,36,2012.0,Romance/Drama,1:51,-40,9.390507480439723
82,83,The Singing Revolution,50000,36,2006.0,Documentary,1:34,1,9.390507480439723
70,20,Tyler Perry's A Madea Christmas,50000,35,2013.0,Other/Comedy,1:40,-50,9.22661773178138
61,43,The Pirates Who Don't Do Anything: A VeggieTales Movie,50000,35,2008.0,Kids and family/Adventure,1:31,-18,9.22661773178138
52,42,Teen Wolf,50000,33,1985.0,Comedy/Fantasy,1:28,-10,8.893469344897873
53,37,Firestarter,50000,27,1984.0,Horror,1:53,-16,7.845169885845621
33,0,Homecoming,50000,24,2009.0,Horror/Mystery and thriller,1:28,-33,7.288397090280924
20,18,Mega Shark vs. Giant Octopus,50000,22,2009.0,Sci fi/Horror,1:30,-2,6.9026233386080005
75,45,Camp Rock,50000,20,2008.0,Kids and family/Comedy,1:36,-30,6.503449126242364
34,58,In the Electric Mist,50000,12,2009.0,Drama/Mystery and thriller,1:42,24,4.725940818339814
46,50,Assassination of a High School President,50000,10,2008.0,Comedy/Drama,1:39,4,4.216965034285822
32,11,Cinderella II: Dreams Come True,50000,9,2002.0,Kids and family/Animation,1:13,-21,3.9482220388574776
69,88,"DuckTales, the Movie: Treasure of the Lost Lamp",50000,8,1990.0,Comedy/Animation,1:13,19,3.668016172818685
18,17,Into the Blue 2: The Reef,50000,6,2009.0,Adventure/Mystery and thriller,1:32,-1,3.064393493081416
70,85,Once Upon a Time... In Hollywood,25000,564,2019.0,Comedy/Drama,2:39,15,52.42632796294989
64,69,Solo: A Star Wars Story,25000,477,2018.0,Sci fi/Adventure,2:15,5,47.21434693089449
92,97,Knives Out,25000,464,2019.0,Drama/Mystery and thriller,2:10,5,46.40595748860749
72,92,The Shape of Water,25000,454,2017.0,Fantasy/Romance,2:03,20,45.77832605063489
88,89,1917,25000,454,2019.0,War/Drama,1:59,1,45.77832605063489
77,72,Ready Player One,25000,438,2018.0,Sci fi/Adventure,2:20,-5,44.76321995065303
75,87,Ant-Man and The Wasp,25000,434,2018.0,Action/Fantasy,1:58,12,44.50728278238275
48,47,Jurassic World: Fallen Kingdom,25000,426,2018.0,Adventure/Sci fi,2:08,-1,43.99273872922982
85,84,Deadpool 2,25000,417,2018.0,Comedy/Action,2:00,-1,43.40952506736447
79,98,Moonlight,25000,390,2016.0,Gay and lesbian/Drama,1:51,19,41.63085969940867
51,68,mother!,25000,377,2017.0,Horror/Mystery and thriller,2:00,17,40.758044944596335
78,62,It: Chapter Two,25000,376,2019.0,Mystery and thriller/Horror,2:49,-16,40.69044159489715
64,78,Atomic Blonde,25000,362,2017.0,Gay and lesbian/Action,1:55,14,39.73679689702227
44,85,"Hail, Caesar!",25000,360,2016.0,Comedy,1:46,41,39.59944169921377
60,87,Jackie,25000,355,2016.0,Drama/Biography,1:39,27,39.25479563004856
81,29,Venom,25000,354,2018.0,Adventure/Sci fi,1:52,-52,39.18564852510176
86,89,John Wick: Chapter 3 -- Parabellum,25000,349,2019.0,Mystery and thriller/Action,2:11,3,38.838807939203264
83,42,Godzilla: King of the Monsters,25000,347,2019.0,Sci fi/Action,2:12,-41,38.69955059619104
84,85,Sully,25000,346,2016.0,Biography/Drama,1:36,1,38.62980908069324
88,67,Fast & Furious Presents: Hobbs & Shaw,25000,342,2019.0,Comedy/Adventure,2:18,-21,38.35008371242196
59,90,The Witch,25000,330,2015.0,Mystery and thriller/Drama,1:32,31,37.50344926092717
92,78,Frozen II,25000,330,2019.0,Comedy/Musical,1:43,-14,37.50344926092717
92,61,Alita: Battle Angel,25000,327,2019.0,Animation/Fantasy,2:02,-31,37.28999674160195
93,93,Room,25000,316,2015.0,Drama,1:58,0,36.50097174890849
73,85,Steve Jobs,25000,314,2015.0,Drama/Biography,2:01,12,36.3564131496096
80,90,The LEGO Batman Movie,25000,313,2017.0,Comedy/Adventure,1:46,10,36.284004402515706
72,64,The Magnificent Seven,25000,313,2016.0,Western/Action,2:08,-8,36.284004402515706
35,16,The Mummy,25000,313,2017.0,Action/Adventure,1:47,-19,36.284004402515706
72,67,The Fate of the Furious,25000,311,2017.0,Mystery and thriller/Adventure,2:16,-5,36.13892611397388
74,94,Carol,25000,310,2015.0,Drama/Romance,1:58,20,36.0662558040403
48,44,The Girl on the Train,25000,308,2016.0,Mystery and thriller,1:52,-4,35.92065090950503
64,51,Kingsman: The Golden Circle,25000,307,2017.0,Comedy/Action,2:21,-13,35.847715538579024
88,98,The Big Sick,25000,303,2017.0,Romance,2:00,10,35.55507858047231
57,74,The BFG,25000,301,2016.0,Adventure/Fantasy,1:55,17,35.40821712816412
73,73,Nocturnal Animals,25000,301,2016.0,Drama/Crime,1:56,0,35.40821712816412
68,84,The LEGO Movie 2: The Second Part,25000,298,2019.0,Comedy/Adventure,1:47,16,35.18723690988606
51,43,Ghost in the Shell,25000,296,2017.0,Sci fi/Adventure,1:47,-8,35.03945313093506
53,47,Valerian and the City of a Thousand Planets,25000,296,2017.0,Sci fi/Action,2:17,-6,35.03945313093506
73,68,The Man From U.N.C.L.E.,25000,291,2015.0,Adventure/Action,1:56,-5,34.66834566630047
76,51,The Accountant,25000,284,2016.0,Drama/Crime,2:08,-25,34.144751986566035
69,83,Silence,25000,284,2016.0,Drama/History,2:41,14,34.144751986566035
76,92,Logan Lucky,25000,283,2017.0,Drama/Crime,1:59,16,34.0695597964397
55,72,Crimson Peak,25000,282,2015.0,Romance/Horror,1:59,17,33.994267903729856
88,96,Hell or High Water,25000,282,2016.0,Western/Drama,1:37,8,33.994267903729856
77,83,The Walk,25000,276,2015.0,Biography/Adventure,2:04,6,33.54039526043435
45,16,The Dark Tower,25000,276,2017.0,Action/Adventure,1:35,-29,33.54039526043435
87,97,Brooklyn,25000,275,2015.0,Drama/Romance,1:52,10,33.46439159473001
69,30,King Arthur: Legend of the Sword,25000,274,2017.0,Action/Adventure,2:06,-39,33.38828421669504
57,60,Joy,25000,272,2015.0,Drama/Comedy,2:03,3,33.23575623584784
75,92,Fences,25000,269,2016.0,Drama,2:13,17,33.006173253232014
78,86,American Made,25000,269,2017.0,Drama/Adventure,1:55,8,33.006173253232014
91,84,Lion,25000,266,2016.0,Drama/Biography,2:01,-7,32.7756280844472
81,86,A Monster Calls,25000,266,2016.0,Drama/Adventure,1:48,5,32.7756280844472
82,83,Deepwater Horizon,25000,265,2016.0,Drama/Mystery and thriller,1:47,1,32.69856330272059
65,87,The Lobster,25000,264,2015.0,Drama/Romance,1:58,22,32.62138938955259
96,76,Bad Boys for Life,25000,263,2020.0,Comedy/Action,2:04,-20,32.54410577614366
66,95,It Follows,25000,261,2014.0,Horror/Mystery and thriller,1:41,29,32.3892071476377
70,61,Snowden,25000,260,2016.0,Drama/Biography,2:14,-9,32.311590968974485
38,42,Pacific Rim Uprising,25000,259,2018.0,Sci fi/Adventure,1:51,4,32.23386276280209
48,29,Alice Through the Looking Glass,25000,258,2016.0,Adventure/Fantasy,1:53,-19,32.15602193394618
54,67,Life,25000,257,2017.0,Sci fi/Horror,1:43,13,32.07806788174952
64,61,Allied,25000,254,2016.0,War/History,1:59,-3,31.843520294778347
55,84,Under the Skin,25000,254,2013.0,Sci fi,1:48,29,31.843520294778347
43,15,Transformers: The Last Knight,25000,252,2017.0,Adventure/Sci fi,2:28,-28,31.686577854669387
90,87,Wind River,25000,252,2017.0,Drama/Crime,1:51,-3,31.686577854669387
36,23,Inferno,25000,252,2016.0,Action/Adventure,1:56,-13,31.686577854669387
83,91,Nebraska,25000,251,2013.0,Drama,1:54,8,31.60793153235044
52,73,Inherent Vice,25000,251,2014.0,Mystery and thriller/Comedy,2:28,21,31.60793153235044
51,30,The Lone Ranger,25000,247,2013.0,Western/Adventure,2:29,-21,31.292163863166575
44,43,J. Edgar,25000,247,2011.0,Biography/Drama,2:17,-1,31.292163863166575
87,71,Jumanji: The Next Level,25000,246,2019.0,Comedy/Action,2:03,-16,31.212923068073856
72,88,Pete's Dragon,25000,244,2016.0,Kids and family/Adventure,1:43,16,31.054078139703236
72,66,The Danish Girl,25000,243,2015.0,Biography/Drama,2:00,-6,30.97447264187668
82,81,The Founder,25000,243,2016.0,Biography/Drama,1:55,-1,30.97447264187668
63,94,All Is Lost,25000,241,2013.0,Drama/Adventure,1:45,31,30.81489211741166
42,38,Jack Reacher: Never Go Back,25000,240,2016.0,Mystery and thriller/Action,1:53,-4,30.734915685705186
75,60,Southpaw,25000,239,2015.0,Drama,2:03,-15,30.654814192715765
72,98,The Babadook,25000,238,2014.0,Horror/Mystery and thriller,1:33,26,30.574586918379627
53,42,In the Heart of the Sea,25000,238,2015.0,Adventure/History,1:56,-11,30.574586918379627
78,88,Don't Breathe,25000,238,2016.0,Horror/Mystery and thriller,1:28,10,30.574586918379627
55,65,Magic Mike XXL,25000,237,2015.0,Comedy/Drama,1:55,10,30.494233135441753
86,81,Patriots Day,25000,236,2016.0,Drama/Mystery and thriller,2:10,-5,30.41375210935341
87,76,Jumanji: Welcome to the Jungle,25000,235,2017.0,Action/Fantasy,1:59,-11,30.333143098167753
20,22,Zoolander No. 2,25000,234,2016.0,Comedy/Adventure,1:42,2,30.252405352433488
69,61,War Dogs,25000,234,2016.0,Comedy/Drama,1:54,-8,30.252405352433488
76,28,Warcraft,25000,232,2016.0,Adventure/Fantasy,2:03,-48,30.090540621339713
77,90,Blue Jasmine,25000,231,2013.0,Drama,1:38,13,30.00941209857022
69,69,Cars 3,25000,230,2017.0,Comedy/Animation,1:49,0,29.928151766205126
68,73,Everest,25000,230,2015.0,Adventure/Mystery and thriller,2:01,5,29.928151766205126
51,68,The Visit,25000,229,2015.0,Comedy/Horror,1:34,17,29.846758835604586
69,89,A Most Violent Year,25000,228,2014.0,Drama/Crime,2:04,20,29.76523250994286
56,32,Chappie,25000,227,2015.0,Mystery and thriller/Sci fi,2:00,-24,29.683571984087028
75,79,Shame,25000,227,2011.0,Drama,1:39,4,29.683571984087028
67,43,The Hitman's Bodyguard,25000,225,2017.0,Comedy/Action,1:58,-24,29.519845068981457
82,51,13 Hours: The Secret Soldiers of Benghazi,25000,224,2016.0,Drama/War,2:24,-31,29.43777702680547
86,97,Kubo and the Two Strings,25000,221,2016.0,Adventure/Kids and family,1:42,11,29.190744459068426
59,78,The Shallows,25000,219,2016.0,Adventure/Mystery and thriller,1:27,19,29.025357112775033
23,33,The Counselor,25000,218,2013.0,Mystery and thriller/Drama,1:57,10,28.942451120368005
45,19,The Huntsman: Winter's War,25000,218,2016.0,Fantasy/Action,1:54,-26,28.942451120368005
82,94,Eye in the Sky,25000,218,2015.0,War/Drama,1:42,12,28.942451120368005
60,60,Hitchcock,25000,217,2012.0,Drama/Biography,1:38,0,28.8594023911159
72,91,Locke,25000,216,2013.0,Drama,1:24,19,28.776210019791854
83,94,The Edge of Seventeen,25000,215,2016.0,Drama/Comedy,1:45,11,28.69287309120695
87,94,Fruitvale Station,25000,213,2013.0,Drama,1:25,7,28.52576185074631
57,33,Entourage,25000,213,2015.0,Comedy,1:44,-24,28.52576185074631
86,81,Me and Earl and the Dying Girl,25000,212,2015.0,Drama/Comedy,1:45,-5,28.441985657257728
78,75,We Need to Talk About Kevin,25000,210,2011.0,Drama,1:51,-3,28.273987340420472
33,60,The Bling Ring,25000,208,2013.0,Drama/Crime,1:30,27,28.10538794609019
48,11,Fifty Shades Darker,25000,207,2017.0,Romance/Drama,1:58,-37,28.02086036400211
67,80,Melancholia,25000,207,2011.0,Sci fi/Drama,2:15,13,28.02086036400211
76,86,Beasts of the Southern Wild,25000,206,2012.0,Drama/Adventure,1:33,10,27.93617951273954
82,98,Before Midnight,25000,206,2013.0,Drama/Romance,1:49,16,27.93617951273954
65,67,August: Osage County,25000,206,2013.0,Comedy/Drama,1:59,2,27.93617951273954
74,59,Concussion,25000,205,2015.0,Drama/Biography,2:01,-15,27.85134436832817
85,85,Still Alice,25000,204,2014.0,Drama,1:37,0,27.76635389491961
66,51,Trouble With the Curve,25000,204,2012.0,Drama,1:51,-15,27.76635389491961
84,81,The Impossible,25000,202,2012.0,Drama,1:54,-3,27.595902757162747
41,37,Larry Crowne,25000,202,2011.0,Romance,1:38,-4,27.595902757162747
62,84,Rachel Getting Married,25000,202,2008.0,Comedy/Drama,1:51,22,27.595902757162747
72,87,Rabbit Hole,25000,201,2010.0,Drama,1:31,15,27.510439959956123
72,49,The Judge,25000,200,2014.0,Drama,2:21,-23,27.42481756762073
41,80,Haywire,25000,199,2011.0,Action/Mystery and thriller,1:32,39,27.33903448190164
73,59,The Intern,25000,198,2015.0,Drama/Comedy,2:01,-14,27.253089591424086
52,54,Out of the Furnace,25000,198,2013.0,Drama/Crime,1:56,2,27.253089591424086
51,28,London Has Fallen,25000,197,2016.0,Action/Mystery and thriller,1:39,-23,27.166981771469644
38,21,The Boss,25000,196,2016.0,Comedy,1:39,-17,27.08070988374737
41,11,The Divergent Series: Allegiant,25000,196,2016.0,Sci fi/Adventure,2:01,-30,27.08070988374737
48,70,Somewhere,25000,196,2010.0,Comedy/Drama,1:38,22,27.08070988374737
49,80,Young Adult,25000,196,2011.0,Comedy/Romance,1:34,31,27.08070988374737
45,46,Pride and Prejudice and Zombies,25000,195,2016.0,Comedy/Action,1:48,1,26.9942727761599
65,86,A Most Wanted Man,25000,195,2014.0,Drama/Mystery and thriller,2:01,21,26.9942727761599
37,15,Gods of Egypt,25000,194,2016.0,Fantasy/Adventure,2:01,-22,26.907669282564235
68,72,Big Eyes,25000,194,2014.0,Biography/Drama,1:46,4,26.907669282564235
44,26,Arthur,25000,193,2011.0,Romance,1:50,-18,26.820898222527152
78,77,St. Vincent,25000,192,2014.0,Comedy/Drama,1:43,-1,26.733958401075075
70,68,Conviction,25000,192,2010.0,Biography/Drama,1:46,-2,26.733958401075075
75,95,Enough Said,25000,191,2013.0,Romance,1:33,20,26.646848608438216
50,78,A Dangerous Method,25000,190,2011.0,Drama/Mystery and thriller,1:39,28,26.559567619788876
70,88,Mr. Holmes,25000,187,2015.0,Mystery and thriller/Drama,1:45,18,26.296684997953903
86,96,What We Do in the Shadows,25000,187,2014.0,Comedy/Horror,1:26,10,26.296684997953903
71,83,My Week With Marilyn,25000,187,2011.0,Drama,1:41,12,26.296684997953903
72,72,Sing,25000,187,2016.0,Kids and family/Comedy,1:48,0,26.296684997953903
64,85,Top Five,25000,186,2014.0,Comedy,1:41,21,26.20870666631663
36,62,Unfriended,25000,186,2014.0,Horror/Mystery and thriller,1:23,26,26.20870666631663
31,65,Cosmopolis,25000,185,2012.0,Drama/Crime,1:48,34,26.120550779067592
66,77,The Debt,25000,185,2010.0,Drama/Mystery and thriller,1:52,11,26.120550779067592
70,70,Never Let Me Go,25000,183,2010.0,Drama/Sci fi,1:44,0,25.943701036580038
54,47,Beautiful Creatures,25000,183,2013.0,Fantasy/Romance,2:03,-7,25.943701036580038
40,46,To Rome With Love,25000,181,2012.0,Romance,1:51,6,25.766124995595995
75,90,Attack the Block,25000,181,2011.0,Sci fi/Action,1:28,15,25.766124995595995
75,79,Ruby Sparks,25000,181,2012.0,Fantasy/Romance,1:44,4,25.766124995595995
51,53,The Boss Baby,25000,180,2017.0,Comedy/Animation,1:37,2,25.677061168818504
61,76,Lights Out,25000,180,2016.0,Horror/Mystery and thriller,1:17,15,25.677061168818504
73,54,Me Before You,25000,179,2016.0,Drama/Romance,1:50,-19,25.587811597850912
52,60,Sisters,25000,178,2015.0,Comedy,1:58,8,25.49837485437685
65,50,Saban's Power Rangers,25000,177,2017.0,Adventure/Sci fi,2:04,-15,25.40874949100198
55,53,Antichrist,25000,177,2009.0,Drama/Horror,1:49,-2,25.40874949100198
65,79,Fair Game,25000,177,2010.0,Drama/Mystery and thriller,1:47,14,25.40874949100198
85,94,Win Win,25000,177,2011.0,Comedy/Drama,1:46,9,25.40874949100198
34,60,Don't Be Afraid of the Dark,25000,176,2010.0,Mystery and thriller/Horror,1:39,26,25.31893404088985
77,86,Much Ado About Nothing,25000,176,2012.0,Romance,1:49,9,25.31893404088985
35,7,Hot Pursuit,25000,176,2015.0,Comedy/Action,1:27,-28,25.31893404088985
45,28,Vacation,25000,176,2015.0,Comedy/Adventure,1:39,-17,25.31893404088985
84,81,The Skin I Live In,25000,176,2011.0,Drama/Mystery and thriller,2:00,-3,25.31893404088985
42,76,Greenberg,25000,176,2010.0,Comedy/Romance,1:47,34,25.31893404088985
55,75,Hope Springs,25000,174,2012.0,Comedy/Drama,1:40,20,25.13872691364861
42,34,The Thing,25000,174,2011.0,Sci fi/Horror,1:43,-8,25.13872691364861
63,77,The Boxtrolls,25000,172,2014.0,Comedy/Animation,1:36,14,24.957741334700298
51,38,Mike and Dave Need Wedding Dates,25000,172,2016.0,Comedy,1:38,-13,24.957741334700298
59,44,This Is Where I Leave You,25000,171,2014.0,Drama/Comedy,1:43,-15,24.86695274122312
63,58,Bad Moms,25000,171,2016.0,Comedy,1:41,-5,24.86695274122312
68,80,Get On Up,25000,171,2014.0,Biography/Drama,2:18,12,24.86695274122312
37,30,Sanctum,25000,171,2011.0,Action/Adventure,1:49,-7,24.86695274122312
76,91,The Spectacular Now,25000,170,2013.0,Drama/Comedy,1:35,15,24.775964830134004
55,67,The Company Men,25000,170,2010.0,Drama,1:55,12,24.775964830134004
59,61,Legend,25000,170,2015.0,Drama/Biography,2:11,2,24.775964830134004
67,54,The Age of Adaline,25000,169,2015.0,Drama/Romance,1:53,-13,24.684775987507244
36,51,The Rum Diary,25000,169,2011.0,Drama/Comedy,1:59,15,24.684775987507244
61,50,Whatever Works,25000,168,2009.0,Romance,1:32,-11,24.59338457671065
34,27,Pompeii,25000,168,2014.0,Adventure/History,1:45,-7,24.59338457671065
69,86,The Skeleton Twins,25000,168,2014.0,Comedy/Gay and lesbian,1:31,17,24.59338457671065
59,86,Cedar Rapids,25000,168,2011.0,Comedy,1:27,27,24.59338457671065
37,41,Only God Forgives,25000,167,2013.0,Drama/Crime,1:30,4,24.501788937948916
81,83,Begin Again,25000,167,2013.0,Drama/Romance,1:44,2,24.501788937948916
53,61,The Last Stand,25000,167,2013.0,Action,1:46,8,24.501788937948916
76,84,Jane Eyre,25000,167,2011.0,Romance/Drama,1:58,8,24.501788937948916
73,88,Bernie,25000,167,2011.0,Comedy/Drama,1:44,15,24.501788937948916
28,20,Aloha,25000,166,2015.0,Comedy/Romance,1:45,-8,24.409987387794924
81,92,Take Shelter,25000,166,2011.0,Drama/Mystery and thriller,2:04,11,24.409987387794924
40,45,30 Minutes or Less,25000,165,2011.0,Comedy/Action,1:23,5,24.317978218708763
67,75,Trolls,25000,164,2016.0,Comedy/Musical,1:28,8,24.225759698543914
53,67,A Walk Among the Tombstones,25000,163,2014.0,Drama/Crime,1:54,14,24.13333007004028
83,94,Animal Kingdom,25000,163,2010.0,Drama/Crime,1:52,11,24.13333007004028
48,56,The Purge: Election Year,25000,163,2016.0,Action/Horror,1:49,8,24.13333007004028
39,51,Chloe,25000,163,2009.0,Romance/Drama,1:36,12,24.13333007004028
53,73,Monsters,25000,162,2010.0,Sci fi/Mystery and thriller,1:37,20,24.0406875503036
46,43,The Angry Birds Movie,25000,161,2016.0,Comedy/Adventure,1:33,-3,23.947830330270747
67,93,Happy-Go-Lucky,25000,161,2008.0,Comedy,1:58,26,23.947830330270747
52,32,Man on a Ledge,25000,161,2012.0,Drama/Crime,1:42,-20,23.947830330270747
83,88,Dope,25000,160,2015.0,Comedy,1:43,5,23.854756574160536
61,69,The Night Before,25000,160,2015.0,Other/Comedy,1:41,8,23.854756574160536
65,60,Draft Day,25000,160,2014.0,Drama,1:49,-5,23.854756574160536
68,69,The Girl Who Played With Fire,25000,160,2009.0,Drama/Crime,2:09,1,23.854756574160536
60,79,You're Next,25000,160,2011.0,Horror/Mystery and thriller,1:34,19,23.854756574160536
42,21,Into the Storm,25000,159,2014.0,Mystery and thriller/Action,1:29,-21,23.761464418909437
53,71,Last Chance Harvey,25000,159,2008.0,Romance,1:32,18,23.761464418909437
47,47,How to Be Single,25000,159,2016.0,Romance,1:50,0,23.761464418909437
32,39,Admission,25000,158,2013.0,Drama/Comedy,1:57,7,23.667951973591787
87,100,Man on Wire,25000,158,2008.0,Documentary,1:30,13,23.667951973591787
41,39,The Eagle,25000,158,2011.0,Drama/Action,1:54,-2,23.667951973591787
76,64,Secretariat,25000,157,2010.0,Drama/Biography,2:03,-12,23.574217318823912
70,91,Gomorra,25000,157,2008.0,Drama/Crime,2:17,21,23.574217318823912
78,69,Religulous,25000,157,2008.0,Documentary,1:41,-9,23.574217318823912
53,80,Cyrus,25000,157,2010.0,Comedy/Romance,1:31,27,23.574217318823912
47,25,The Change-Up,25000,157,2011.0,Comedy,1:52,-22,23.574217318823912
82,88,Submarine,25000,156,2010.0,Drama/Comedy,1:37,6,23.480258506151625
53,74,Oculus,25000,156,2013.0,Horror/Mystery and thriller,1:45,21,23.480258506151625
44,13,Winter's Tale,25000,155,2014.0,Romance/Fantasy,1:58,-31,23.38607355742051
71,80,Catfish,25000,154,2010.0,Documentary/Drama,1:28,9,23.291660464128444
82,84,Belle,25000,153,2013.0,Biography/Drama,1:43,2,23.197017186759677
40,28,Broken City,25000,153,2013.0,Drama/Crime,1:48,-12,23.197017186759677
49,67,Friends With Kids,25000,153,2011.0,Romance,1:40,18,23.197017186759677
91,96,Waltz With Bashir,25000,153,2008.0,Animation/Drama,1:30,5,23.197017186759677
30,25,Conan the Barbarian,25000,152,2011.0,Action/Adventure,1:53,-5,23.102141654099842
24,31,How Do You Know,25000,151,2010.0,Romance,2:01,7,23.007031762531238
37,39,Oldboy,25000,151,2013.0,Drama/Mystery and thriller,1:43,2,23.007031762531238
64,67,Salmon Fishing in the Yemen,25000,151,2011.0,Comedy/Romance,1:51,3,23.007031762531238
80,91,Safety Not Guaranteed,25000,150,2012.0,Comedy,1:24,11,22.911685375307673
37,44,xXx: Return of Xander Cage,25000,149,2017.0,Mystery and thriller/Adventure,1:42,7,22.816100321808104
81,68,The Hundred-Foot Journey,25000,148,2014.0,Drama/Comedy,2:02,-13,22.72027439676837
91,98,Inside Job,25000,148,2010.0,Documentary,1:48,7,22.72027439676837
68,65,Million Dollar Arm,25000,148,2014.0,Drama,2:03,-3,22.72027439676837
74,80,Nowhere Boy,25000,148,2009.0,Biography/Drama,1:37,6,22.72027439676837
39,59,Wanderlust,25000,147,2012.0,Comedy,1:38,20,22.624205359490148
39,45,Bullet to the Head,25000,145,2012.0,Mystery and thriller/Action,1:31,6,22.43132880334213
54,52,Funny Games,25000,145,2007.0,Mystery and thriller,1:52,-2,22.43132880334213
49,36,One Day,25000,145,2011.0,Romance,1:48,-13,22.43132880334213
62,77,"Jeff, Who Lives at Home",25000,144,2011.0,Comedy/Drama,1:23,15,22.33451661845039
46,31,Grudge Match,25000,144,2013.0,Comedy,1:53,-15,22.33451661845039
52,56,Choke,25000,144,2008.0,Comedy/Drama,1:32,4,22.33451661845039
86,96,"4 Months, 3 Weeks and 2 Days",25000,144,2007.0,Drama,1:53,10,22.33451661845039
35,27,Victor Frankenstein,25000,143,2015.0,Drama/Horror,1:50,-8,22.237451987521194
51,70,Our Idiot Brother,25000,143,2011.0,Comedy,1:36,19,22.237451987521194
46,22,That Awkward Moment,25000,142,2014.0,Romance,1:34,-24,22.14013247996374
78,85,Bully,25000,142,2011.0,Documentary,1:39,7,22.14013247996374
47,58,Paper Towns,25000,141,2015.0,Drama/Adventure,1:49,11,22.042555624480066
38,15,The 5th Wave,25000,141,2016.0,Sci fi/Adventure,1:52,-23,22.042555624480066
61,35,If I Stay,25000,141,2014.0,Drama/Romance,1:46,-26,22.042555624480066
35,66,The Girlfriend Experience,25000,140,2008.0,Drama,1:17,31,21.944718908089367
93,89,The Secret in Their Eyes,25000,140,2009.0,Drama/Crime,2:07,-4,21.944718908089367
75,86,Robot & Frank,25000,139,2012.0,Comedy/Sci fi,1:30,11,21.84661977512174
33,12,The Boy Next Door,25000,138,2015.0,Mystery and thriller,1:30,-21,21.748255626180264
44,11,Dirty Grandpa,25000,137,2016.0,Comedy,1:42,-33,21.649623817070065
58,25,Dracula Untold,25000,137,2014.0,Horror/Fantasy,1:32,-33,21.649623817070065
81,94,The Guard,25000,137,2011.0,Mystery and thriller/Comedy,1:35,13,21.649623817070065
49,48,Hit & Run,25000,137,2012.0,Action/Comedy,1:35,-1,21.649623817070065
43,18,The Last Witch Hunter,25000,137,2015.0,Adventure/Fantasy,1:46,-25,21.649623817070065
66,58,It's Kind of a Funny Story,25000,137,2010.0,Comedy/Drama,1:40,-8,21.649623817070065
61,65,Bad Words,25000,136,2014.0,Drama/Comedy,1:25,4,21.550721657693213
78,79,Veronica Mars,25000,136,2014.0,Drama/Crime,1:47,1,21.550721657693213
57,64,Coco Before Chanel,25000,136,2009.0,Biography/Drama,1:45,7,21.550721657693213
22,30,Poltergeist,25000,135,2015.0,Horror/Mystery and thriller,1:33,8,21.451546410907937
30,43,Silent House,25000,135,2011.0,Horror/Mystery and thriller,1:28,13,21.451546410907937
58,40,Red Tails,25000,135,2012.0,War/Drama,2:05,-18,21.451546410907937
72,70,The Wackness,25000,135,2008.0,Comedy/Drama,1:50,-2,21.451546410907937
37,7,The Emoji Movie,25000,134,2017.0,Comedy/Adventure,1:26,-30,21.35209529135088
40,28,Jobs,25000,134,2013.0,Drama/Biography,2:05,-12,21.35209529135088
69,74,What If,25000,134,2013.0,Romance,1:42,5,21.35209529135088
53,22,Country Strong,25000,134,2010.0,Romance/Drama,1:57,-31,21.35209529135088
42,28,Deliver Us From Evil,25000,134,2014.0,Horror/Mystery and thriller,1:57,-14,21.35209529135088
35,29,Annabelle,25000,134,2014.0,Horror/Mystery and thriller,1:38,-6,21.35209529135088
88,80,"McFarland, USA",25000,133,2015.0,Drama/Biography,2:09,-8,21.252365464220812
41,14,Zookeeper,25000,133,2011.0,Comedy/Fantasy,1:41,-27,21.252365464220812
76,96,The Kid with a Bike,25000,133,2011.0,Drama,1:27,20,21.252365464220812
94,95,The Cove,25000,133,2009.0,Documentary,1:34,1,21.252365464220812
77,83,Talk to Me,25000,132,2007.0,Biography/Drama,1:58,6,21.152354044022278
52,42,Faster,25000,131,2010.0,Mystery and thriller/Action,1:38,-10,21.05205809326756
59,68,A Very Harold & Kumar Christmas,25000,131,2011.0,Comedy/Other,1:30,9,21.05205809326756
90,98,Blackfish,25000,131,2013.0,Documentary,1:23,8,21.05205809326756
43,43,The Limits of Control,25000,131,2009.0,Drama,1:56,0,21.05205809326756
61,46,My Blueberry Nights,25000,131,2007.0,Romance/Drama,1:30,-15,21.05205809326756
51,67,Krampus,25000,130,2015.0,,,16,20.951474621135226
80,91,Winnie the Pooh,25000,130,2011.0,Kids and family/Adventure,1:09,11,20.951474621135226
65,32,Joyful Noise,25000,130,2012.0,Comedy/Drama,1:57,-33,20.951474621135226
40,8,Hitman: Agent 47,25000,130,2015.0,Action/Adventure,1:36,-32,20.951474621135226
41,62,Diary of the Dead,25000,130,2007.0,Horror/Mystery and thriller,1:35,21,20.951474621135226
51,57,Insidious: Chapter 3,25000,129,2015.0,Mystery and thriller/Horror,1:37,6,20.850600582083427
93,75,The Intouchables,25000,129,2011.0,Comedy/Drama,1:50,-18,20.850600582083427
73,65,Things We Lost in the Fire,25000,129,2007.0,Drama,1:58,-8,20.850600582083427
39,37,The Guilt Trip,25000,128,2012.0,Comedy,1:35,-2,20.749432874416154
49,24,The Words,25000,128,2012.0,Drama/Romance,1:36,-25,20.749432874416154
47,50,Earth to Echo,25000,127,2014.0,Kids and family/Drama,1:29,3,20.647968338800368
42,28,Killer Elite,25000,127,2011.0,Action/Mystery and thriller,1:57,-14,20.647968338800368
75,63,Harry Brown,25000,127,2009.0,Drama/Crime,1:37,-12,20.647968338800368
77,83,The Book of Life,25000,126,2014.0,Comedy/Adventure,1:35,6,20.546203756731995
47,11,Alex Cross,25000,126,2012.0,Action/Mystery and thriller,1:41,-36,20.546203756731995
54,75,Cold Souls,25000,126,2009.0,Comedy/Sci fi,1:41,21,20.546203756731995
74,86,Shine a Light,25000,126,2008.0,Documentary,2:02,12,20.546203756731995
47,52,Easy Virtue,25000,126,2008.0,Romance,1:36,5,20.546203756731995
34,29,Machete Kills,25000,125,2013.0,Action,1:47,-5,20.444135848948562
55,58,Interview,25000,125,2007.0,Drama,1:24,3,20.444135848948562
71,31,The Longest Ride,25000,124,2015.0,Romance/Drama,2:08,-40,20.341761273786197
37,48,Drive Angry,25000,124,2011.0,Mystery and thriller/Action,1:44,11,20.341761273786197
49,30,Daddy's Home,25000,123,2015.0,Comedy,1:36,-19,20.23907662547856
46,41,The Rocker,25000,123,2008.0,Comedy,1:42,-5,20.23907662547856
43,28,3 Days to Kill,25000,122,2014.0,Mystery and thriller/Adventure,1:56,-15,20.136078432395202
33,7,Runner Runner,25000,121,2013.0,Drama/Crime,1:31,-26,20.032763155216593
66,73,The DUFF,25000,121,2015.0,Romance,1:36,7,20.032763155216593
39,18,Ice Age: Collision Course,25000,120,2016.0,Kids and family/Comedy,1:34,-21,19.92912718504312
63,71,Enemy,25000,120,2013.0,Mystery and thriller,1:30,8,19.92912718504312
62,53,People Like Us,25000,120,2012.0,Drama,1:55,-9,19.92912718504312
60,60,Resurrecting the Champ,25000,120,2007.0,Drama,1:52,0,19.92912718504312
58,61,"Alexander and the Terrible, Horrible, No Good, Very Bad Day",25000,119,2014.0,Kids and family/Comedy,1:21,3,19.82516684143501
86,97,Monsieur Lazhar,25000,119,2011.0,Drama,1:34,11,19.82516684143501
87,93,Tell No One,25000,119,2006.0,Drama/Mystery and thriller,2:06,6,19.82516684143501
61,42,Homefront,25000,118,2013.0,Action/Mystery and thriller,1:40,-19,19.720878370380042
62,67,Babies,25000,118,2010.0,Documentary,1:19,5,19.720878370380042
48,15,Something Borrowed,25000,117,2011.0,Romance,1:52,-33,19.616257942185833
89,88,Control,25000,116,2007.0,Drama/Biography,2:01,-1,19.511301649293156
40,37,Mars Needs Moms,25000,116,2011.0,Sci fi/Comedy,1:28,-3,19.511301649293156
67,66,The Jane Austen Book Club,25000,116,2007.0,Romance/Drama,1:46,-1,19.511301649293156
85,85,Tucker & Dale vs Evil,25000,115,2010.0,Comedy/Horror,1:29,0,19.406005504006643
44,23,What's Your Number?,25000,115,2011.0,Romance,1:46,-21,19.406005504006643
68,66,God Bless America,25000,114,2011.0,Comedy,1:47,-2,19.300365436139025
80,82,Dolphin Tale,25000,114,2011.0,Kids and family/Adventure,1:53,2,19.300365436139025
71,83,The September Issue,25000,114,2009.0,Documentary,1:30,12,19.300365436139025
42,36,How to Lose Friends & Alienate People,25000,113,2008.0,Comedy,1:49,-6,19.194377290564812
90,95,Marley,25000,113,2012.0,Documentary/Music,2:24,5,19.194377290564812
63,29,The Wedding Ringer,25000,112,2015.0,Comedy,1:41,-34,19.088036824679065
40,7,The Big Wedding,25000,112,2013.0,Romance,1:30,-33,19.088036824679065
30,12,Mortdecai,25000,112,2015.0,Comedy/Action,1:46,-18,19.088036824679065
43,61,Centurion,25000,112,2010.0,Drama/Action,1:37,18,19.088036824679065
39,22,The Sitter,25000,112,2011.0,Comedy,1:21,-17,19.088036824679065
45,27,Love in the Time of Cholera,25000,112,2007.0,Drama/Romance,2:18,-18,19.088036824679065
83,94,Encounters at the End of the World,25000,111,2007.0,Documentary,1:39,11,18.981339705756774
45,60,Paper Heart,25000,111,2009.0,Romance/Drama,1:28,15,18.981339705756774
48,40,Parker,25000,109,2013.0,Drama/Crime,1:58,-8,18.76685771072333
26,13,Hot Tub Time Machine 2,25000,109,2015.0,Fantasy/Comedy,1:33,-13,18.76685771072333
73,32,For Colored Girls,25000,109,2010.0,Drama,2:14,-41,18.76685771072333
45,45,Redacted,25000,109,2007.0,War/Drama,1:31,0,18.76685771072333
95,98,Modern Times,25000,108,1936.0,Comedy,1:29,3,18.659063693305395
42,5,Abduction,25000,108,2011.0,Mystery and thriller/Action,1:46,-37,18.659063693305395
67,55,Eagle vs. Shark,25000,107,2007.0,Comedy/Romance,1:34,-12,18.55089473417879
75,45,Soul Surfer,25000,106,2011.0,Drama,1:46,-30,18.442346006574258
64,75,Big Miracle,25000,105,2012.0,Drama/Adventure,1:47,11,18.333412575379587
79,82,City Island,25000,105,2009.0,Comedy,1:43,3,18.333412575379587
60,68,Brick Lane,25000,103,2007.0,Drama,1:41,8,18.1143712989759
41,39,Southland Tales,25000,103,2006.0,Comedy/Drama,2:24,-2,18.1143712989759
93,97,The King of Kong: A Fistful of Quarters,25000,102,2007.0,Documentary/Biography,1:19,4,18.004253009684938
64,72,And When Did You Last See Your Father?,25000,101,2007.0,Drama/Biography,1:32,8,17.893729120895756
85,93,Headhunters,25000,101,2011.0,Drama/Action,1:40,8,17.893729120895756
62,47,Diary of a Wimpy Kid: Rodrick Rules,25000,100,2011.0,Comedy/Kids and family,1:35,-15,17.78279410038923
67,81,The Disappearance of Alice Creed,25000,99,2009.0,Mystery and thriller,1:40,14,17.67144228430324
35,34,Masterminds,25000,99,2016.0,Comedy/Action,1:35,-1,17.67144228430324
65,69,About Last Night,25000,99,2014.0,Drama/Romance,1:40,4,17.67144228430324
47,26,Brick Mansions,25000,99,2014.0,Drama/Action,1:30,-21,17.67144228430324
42,54,Nothing Like the Holidays,25000,99,2008.0,Comedy/Drama,1:38,12,17.67144228430324
82,86,Gonzo: The Life and Work of Dr. Hunter S. Thompson,25000,99,2008.0,Documentary,1:58,4,17.67144228430324
45,37,Project Almanac,25000,98,2015.0,Sci fi/Mystery and thriller,1:46,-8,17.55966787263607
37,35,All Good Things,25000,98,2010.0,Mystery and thriller,1:41,-2,17.55966787263607
54,40,Smurfs: The Lost Village,25000,97,2017.0,Fantasy/Animation,1:31,-14,17.447464924548626
43,12,The Nut Job,25000,97,2014.0,Kids and family/Comedy,1:26,-31,17.447464924548626
68,62,Day Watch,25000,97,2006.0,Horror,2:19,-6,17.447464924548626
39,26,The Three Musketeers,25000,96,2011.0,Drama/Action,1:50,-13,17.334827353454408
91,99,Jiro Dreams of Sushi,25000,95,2011.0,Documentary,1:21,8,17.22174892188519
82,73,Under the Same Moon,25000,95,2007.0,Drama,1:49,-9,17.22174892188519
69,67,The 11th Hour,25000,94,2007.0,Documentary,1:35,-2,17.108223236119827
49,71,The Great Buck Howard,25000,94,2008.0,Comedy/Drama,1:30,22,17.108223236119827
49,41,Dark Skies,25000,93,2013.0,Horror/Sci fi,1:37,-8,16.994243740562503
49,40,Monte Carlo,25000,93,2011.0,Romance,1:48,-9,16.994243740562503
79,63,One Direction: This Is Us,25000,93,2013.0,Documentary,1:35,-16,16.994243740562503
82,67,Wristcutters: A Love Story,25000,93,2006.0,Comedy/Drama,1:32,-15,16.994243740562503
45,38,Johnny English Reborn,25000,92,2011.0,Action/Comedy,1:42,-7,16.879803711855995
31,15,Sinister 2,25000,91,2015.0,Horror/Mystery and thriller,1:37,-16,16.764896252714394
44,20,Free Birds,25000,91,2013.0,Comedy/Animation,1:31,-24,16.764896252714394
22,6,The Devil Inside,25000,90,2012.0,Horror/Mystery and thriller,1:23,-16,16.64951428545866
89,32,Jigsaw,25000,90,2017.0,Horror/Mystery and thriller,1:32,-57,16.64951428545866
72,76,Katy Perry: Part of Me,25000,90,2012.0,Documentary,1:34,4,16.64951428545866
87,84,Paprika,25000,90,2006.0,Sci fi/Action,1:30,-3,16.64951428545866
24,6,Ouija,25000,89,2014.0,Horror/Mystery and thriller,1:25,-18,16.533650545237286
24,4,Movie 43,25000,89,2013.0,Comedy,1:34,-20,16.533650545237286
36,6,Dream House,25000,88,2011.0,Mystery and thriller,1:32,-30,16.417297572912943
62,86,Big Fan,25000,88,2009.0,Drama/Comedy,1:28,24,16.417297572912943
72,66,Dolphin Tale 2,25000,88,2014.0,Kids and family/Adventure,1:47,-6,16.417297572912943
57,30,Goya's Ghosts,25000,87,2006.0,Drama/History,1:57,-27,16.300447707594707
59,23,Think Like a Man Too,25000,86,2014.0,Romance,1:45,-36,16.183093078793917
27,3,The Roommate,25000,86,2011.0,Drama/Mystery and thriller,1:33,-24,16.183093078793917
40,51,The Man With the Iron Fists,25000,86,2012.0,Adventure/Sports and fitness,1:35,11,16.183093078793917
69,95,Good Hair,25000,84,2009.0,Documentary,1:35,26,15.946836950911226
33,5,The Legend of Hercules,25000,83,2014.0,Adventure/Fantasy,1:38,-28,15.827918586512368
34,39,Paranormal Activity: The Marked Ones,25000,83,2014.0,Horror/Mystery and thriller,1:24,5,15.827918586512368
46,10,Bratz,25000,80,2007.0,Kids and family/Comedy,1:50,-36,15.467895945971296
51,66,How She Move,25000,79,2007.0,Drama,1:38,15,15.34676814846713
41,23,Walking With Dinosaurs,25000,77,2013.0,Animation/Comedy,1:27,-18,15.102773291691431
27,14,Paranormal Activity: The Ghost Dimension,25000,77,2015.0,Horror/Mystery and thriller,1:28,-13,15.102773291691431
64,68,Fugitive Pieces,25000,76,2007.0,Drama,1:48,4,14.979885547093689
43,55,Surveillance,25000,76,2008.0,Drama/Crime,1:37,12,14.979885547093689
23,23,Apollo 18,25000,74,2011.0,Sci fi/Mystery and thriller,1:26,0,14.732275265126917
73,21,Son of God,25000,73,2014.0,Drama/History,2:18,-52,14.607530022406213
47,25,Fun Size,25000,73,2012.0,Comedy/Other,1:26,-22,14.607530022406213
74,34,Trade,25000,73,2007.0,Drama,1:59,-40,14.607530022406213
32,33,Good,25000,72,2008.0,Drama/History,1:36,1,14.482142292408389
22,18,Shark Night,25000,71,2011.0,Horror/Mystery and thriller,1:31,-4,14.356099772615265
45,80,Teeth,25000,70,2007.0,Comedy/Horror,1:34,35,14.229389747854103
42,12,Gone,25000,69,2012.0,Mystery and thriller,1:35,-30,14.101999070345963
31,46,All the Boys Love Mandy Lane,25000,68,2006.0,Horror/Mystery and thriller,1:30,15,13.973914138485368
51,15,Alvin and the Chipmunks: The Road Chip,25000,68,2015.0,Kids and family/Comedy,1:26,-36,13.973914138485368
56,15,Revolver,25000,67,2005.0,Drama/Crime,1:55,-41,13.8451208742507
92,95,Mary and Max,25000,65,2009.0,Comedy/Drama,1:32,3,13.58535050847747
35,11,Hoodwinked Too! Hood vs. Evil,25000,65,2011.0,Kids and family/Comedy,1:26,-24,13.58535050847747
50,27,Shrink,25000,64,2009.0,Drama,1:44,-23,13.454342644059432
44,38,Outlander,25000,64,2008.0,Sci fi/Action,1:55,-6,13.454342644059432
26,10,My Soul to Take,25000,63,2010.0,Horror/Mystery and thriller,1:47,-16,13.322564864824612
33,5,Paul Blart: Mall Cop 2,25000,62,2015.0,Comedy,1:34,-28,13.190000315557024
93,93,The Seventh Seal,25000,61,1956.0,Drama/Fantasy,1:36,0,13.056631493342596
35,10,Silent Hill: Revelation,25000,60,2012.0,Horror/Fantasy,1:35,-25,12.922440211617326
83,77,12,25000,60,2007.0,Drama/Crime,2:33,-6,12.922440211617326
84,95,Yellow Submarine,25000,60,1968.0,Comedy/Adventure,1:25,11,12.922440211617326
61,65,The Nines,25000,60,2007.0,Drama,1:39,4,12.922440211617326
37,22,Spy Kids: All the Time in the World in 4D,25000,60,2011.0,Kids and family/Action,1:29,-15,12.922440211617326
73,40,Repo! The Genetic Opera,25000,60,2008.0,Musical/Horror,1:38,-33,12.922440211617326
87,88,Boy A,25000,60,2007.0,Drama,1:39,1,12.922440211617326
43,17,Sleepwalking,25000,60,2008.0,Drama,1:41,-26,12.922440211617326
40,31,Mechanic: Resurrection,25000,59,2016.0,Adventure/Mystery and thriller,1:39,-9,12.78740756158519
25,12,The Darkest Hour,25000,59,2011.0,Sci fi/Mystery and thriller,1:29,-13,12.78740756158519
55,16,Vampire Academy,25000,58,2014.0,Action/Fantasy,1:44,-39,12.651513870765422
90,33,Meet the Browns,25000,58,2008.0,Comedy/Romance,1:40,-57,12.651513870765422
41,18,Alpha and Omega,25000,57,2010.0,Kids and family/Comedy,1:28,-23,12.514738658402138
55,12,No Good Deed,25000,57,2014.0,Mystery and thriller,1:24,-43,12.514738658402138
56,33,Wild Target,25000,55,2010.0,Drama/Action,1:36,-23,12.238457412731087
42,2,One for the Money,25000,55,2012.0,Action/Comedy,1:31,-40,12.238457412731087
82,89,The Wicker Man,25000,55,1973.0,Horror/Mystery and thriller,1:42,7,12.238457412731087
70,61,Phoebe in Wonderland,25000,54,2008.0,Drama,1:36,-9,12.098905925115496
45,22,Fireflies in the Garden,25000,54,2008.0,Drama,1:38,-23,12.098905925115496
57,42,Step Up: All In,25000,52,2014.0,Drama,1:52,-15,11.8168599865911
96,29,Tyler Perry's Madea Goes to Jail,25000,52,2009.0,Comedy,1:43,-67,11.8168599865911
49,66,Solomon Kane,25000,50,2009.0,Fantasy/Adventure,1:44,17,11.530715390799685
77,20,For Greater Glory,25000,49,2012.0,Drama/History,2:23,-57,11.3860359318845
74,96,Supercop,25000,49,1992.0,Action,1:31,22,11.3860359318845
65,98,Surfwise,25000,46,2007.0,Documentary,1:33,33,10.945198564139895
95,93,The Great Dictator,25000,45,1940.0,Comedy,2:08,-2,10.795874345554918
72,61,Kevin Hart: Let Me Explain,25000,44,2013.0,Comedy,1:15,-11,10.645300436514761
54,35,Escape From Planet Earth,25000,43,2013.0,Comedy/Animation,1:29,-19,10.493437610589469
55,31,St. Trinian's,25000,42,2007.0,Comedy,1:37,-24,10.34024446475599
74,38,Tyler Perry's Madea's Big Happy Family,25000,42,2011.0,Comedy/Drama,1:46,-36,10.34024446475599
43,41,Bonneville,25000,41,2006.0,Drama,1:44,-2,10.185677243651742
46,43,Tales From Earthsea,25000,40,2006.0,Anime/Adventure,1:55,-3,10.029689644980788
43,8,A Haunted House 2,25000,40,2014.0,Comedy/Horror,1:27,-35,10.029689644980788
79,25,October Baby,25000,40,2011.0,Drama,1:46,-54,10.029689644980788
66,80,Triangle,25000,40,2009.0,Horror/Mystery and thriller,1:39,14,10.029689644980788
39,44,Dorian Gray,25000,39,2009.0,Drama/Mystery and thriller,1:52,5,9.872232603526719
64,81,Death Race 2000,25000,37,1975.0,Action/Comedy,1:18,17,9.552698646911638
66,17,Temptation,25000,36,0.0,Drama,2:00,-49,9.390507480439723
46,39,The Killing of John Lennon,25000,36,2006.0,Drama,1:54,-7,9.390507480439723
54,77,Big Man Japan,25000,35,2007.0,Comedy/Sci fi,1:53,23,9.22661773178138
38,3,Deal,25000,35,2008.0,Drama,1:28,-35,9.22661773178138
73,26,2016: Obama's America,25000,34,2012.0,Documentary,1:27,-47,9.060962294042406
59,6,Who's Your Caddy?,25000,34,2007.0,Comedy,1:31,-53,9.060962294042406
63,58,Special,25000,33,2006.0,Comedy/Drama,1:22,-5,8.893469344897873
62,16,I Can't Think Straight,25000,32,2007.0,Drama/Romance,1:20,-46,8.724061861322062
76,68,Mr. Nobody,25000,31,2009.0,Sci fi/Drama,2:17,-8,8.552657067536824
37,35,Diminished Capacity,25000,31,2008.0,Romance,1:27,-2,8.552657067536824
87,65,An Affair to Remember,25000,31,1957.0,Romance,1:55,-22,8.552657067536824
71,83,Trick 'r Treat,25000,29,2007.0,Horror/Mystery and thriller,1:22,12,8.20349180691225
58,18,Tyler Perry's The Single Moms Club,25000,28,2014.0,Comedy/Drama,1:50,-40,8.02553087005176
93,86,Ip Man,25000,28,2008.0,Sports and fitness/Drama,1:46,-7,8.02553087005176
66,79,Eden Lake,25000,28,2008.0,Horror/Mystery and thriller,1:31,13,8.02553087005176
28,19,I Hate Valentine's Day,25000,27,2009.0,Romance,1:38,-9,7.845169885845621
46,41,The Rebound,25000,27,2009.0,Romance,1:37,-5,7.845169885845621
75,12,God's Not Dead,25000,26,2014.0,Drama,1:53,-63,7.662285721192069
86,88,Help!,25000,26,1965.0,Comedy/Musical,1:32,2,7.662285721192069
33,9,Everybody Wants to Be Italian,25000,23,2007.0,Romance/Comedy,1:45,-24,7.097083215743026
34,57,The Dukes,25000,23,2007.0,Comedy/Drama,1:36,23,7.097083215743026
39,45,Pathology,25000,22,2008.0,Mystery and thriller,1:33,6,6.9026233386080005
86,36,Courageous,25000,22,2011.0,Drama,2:10,-50,6.9026233386080005
45,14,St Trinian's 2: The Legend of Fritton's Gold,25000,21,2009.0,Adventure/Comedy,1:46,-31,6.704819013328363
89,57,Instructions Not Included,25000,21,2013.0,Comedy/Drama,1:55,-32,6.704819013328363
34,57,Dare,25000,21,2009.0,Gay and lesbian/Drama,1:30,23,6.704819013328363
59,76,Escape to Witch Mountain,25000,21,1975.0,Kids and family/Sci fi,1:37,17,6.704819013328363
82,38,Fireproof,25000,21,2008.0,Drama,2:02,-44,6.704819013328363
99,35,Dave Chappelle: Sticks & Stones,25000,17,2019.0,Comedy/Stand up,1:05,-64,5.875307153057772
77,76,Om Shanti Om,25000,17,2007.0,Romance,2:48,-1,5.875307153057772
19,8,Miss Conception,25000,13,2008.0,Romance,1:34,-11,4.968377601139757
13,23,Raising Flagg,25000,13,2006.0,Comedy/Drama,1:42,10,4.968377601139757
42,17,Love N' Dancing,25000,12,2008.0,Romance/Drama,1:35,-25,4.725940818339814
41,36,Delhi-6,25000,11,2009.0,Comedy/Drama,2:21,-5,4.475797488182033
80,100,Futurama: Bender's Big Score,25000,11,2007.0,Comedy/Sci fi,1:28,20,4.475797488182033
91,100,Fist of Legend,25000,10,1994.0,Action/Sports and fitness,1:43,9,4.216965034285822
61,67,It's a Boy Girl Thing,25000,9,2006.0,Romance,1:35,6,3.9482220388574776
69,75,Batman: Gotham Knight,25000,8,2008.0,Animation/Action,1:15,6,3.668016172818685
55,25,Tony 'n' Tina's Wedding,25000,8,2004.0,Comedy,1:48,-30,3.668016172818685
25,29,The Open Road,25000,7,2009.0,Drama/Comedy,1:30,4,3.374320069567275
60,60,Princess Protection Program,25000,5,2009.0,Kids and family/Comedy,1:30,0,2.734363528521053
59,93,Us,10000,549,2019.0,Horror/Mystery and thriller,1:56,34,51.55048021525585
83,96,BlacKkKlansman,10000,444,2018.0,Comedy/Drama,2:14,13,45.145488460739216
88,97,Mission: Impossible -- Fallout,10000,434,2018.0,Action/Adventure,2:27,9,44.50728278238275
78,79,Birds of Prey (and the Fantabulous Emancipation of One Harley Quinn),10000,428,2020.0,Comedy/Action,1:49,1,44.12171201510385
82,90,Shazam!,10000,409,2019.0,Adventure/Fantasy,2:12,8,42.88713821725131
85,60,Bohemian Rhapsody,10000,407,2018.0,History/Music,2:15,-25,42.755944609207006
88,91,The Invisible Man,10000,406,2020.0,Mystery and thriller/Horror,2:04,3,42.690257164532525
73,88,The Post,10000,401,2017.0,Drama/History,1:55,15,42.36090529935652
67,36,Glass,10000,398,2019.0,Drama/Mystery and thriller,2:09,-31,42.162554934189686
79,99,Lady Bird,10000,395,2017.0,Comedy/Drama,1:34,20,41.963643105837086
93,97,Spider-Man: Into the Spider-Verse,10000,390,2018.0,Comedy/Animation,1:57,4,41.63085969940867
88,89,Rocketman,10000,386,2019.0,Biography/Musical,2:01,1,41.36347958594597
82,96,A Quiet Place,10000,385,2018.0,Mystery and thriller/Horror,1:30,14,41.2964724683229
40,83,Ad Astra,10000,385,2019.0,Sci fi/Adventure,2:04,43,41.2964724683229
84,93,Incredibles 2,10000,383,2018.0,Comedy/Adventure,1:58,9,41.16226210347673
88,90,"I, Tonya",10000,382,2017.0,Comedy/Drama,2:01,2,41.09505838693994
67,89,Hereditary,10000,382,2018.0,Horror/Mystery and thriller,2:07,22,41.09505838693994
64,22,Dark Phoenix,10000,378,2019.0,Adventure/Sci fi,1:54,-42,40.82558108292364
70,79,Halloween,10000,378,2018.0,Mystery and thriller/Horror,1:46,9,40.82558108292364
76,91,Crazy Rich Asians,10000,362,2018.0,Romance,2:00,15,39.73679689702227
45,69,Ocean's 8,10000,362,2018.0,Comedy/Drama,1:50,24,39.73679689702227
86,94,Call Me by Your Name,10000,359,2017.0,Gay and lesbian/Drama,2:12,8,39.53065681603646
91,77,Green Book,10000,358,2018.0,Comedy/Drama,2:10,-14,39.46180004470454
89,63,Yesterday,10000,356,2019.0,Music/Romance,1:56,-26,39.3238697307296
85,91,The Disaster Artist,10000,349,2017.0,Drama/Comedy,1:43,6,38.838807939203264
65,87,Hustlers,10000,347,2019.0,Drama/Comedy,1:50,22,38.69955059619104
82,70,Terminator: Dark Fate,10000,344,2019.0,Sci fi/Action,2:08,-12,38.49009886410603
52,91,Uncut Gems,10000,339,2019.0,Mystery and thriller/Comedy,2:15,39,38.139483852603526
54,36,Fantastic Beasts: The Crimes of Grindelwald,10000,331,2018.0,Fantasy/Adventure,2:14,-18,37.57443821930846
48,79,The Beguiled,10000,325,2017.0,Drama/History,1:34,31,37.14728695255573
66,88,Annihilation,10000,320,2018.0,Sci fi/Adventure,1:55,22,36.78906382614162
66,23,Men in Black: International,10000,318,2019.0,Sci fi/Adventure,1:55,-43,36.64518765438774
55,52,Tomb Raider,10000,318,2018.0,Adventure/Action,1:58,-3,36.64518765438774
82,84,Darkest Hour,10000,315,2017.0,Drama/Biography,2:05,2,36.42873547273243
71,84,Battle of the Sexes,10000,314,2017.0,Drama/Comedy,2:01,13,36.3564131496096
80,96,The Florida Project,10000,313,2017.0,Drama,1:55,16,36.284004402515706
79,67,Pokémon Detective Pikachu,10000,310,2019.0,Kids and family/Comedy,1:44,-12,36.0662558040403
48,72,Mulan,10000,308,2020.0,Adventure/Action,1:56,24,35.92065090950503
79,82,Detroit,10000,302,2017.0,Drama/Crime,2:23,3,35.48169344468001
99,85,Just Mercy,10000,301,2019.0,Drama,2:16,-14,35.40821712816412
76,88,Loving,10000,293,2016.0,Drama/Biography,2:03,12,34.81707337301227
68,73,Black Mass,10000,289,2015.0,Drama/Biography,2:02,5,34.51923414277182
51,58,Money Monster,10000,281,2016.0,Drama/Mystery and thriller,1:38,7,33.91887582197262
73,51,Rampage,10000,280,2018.0,Action/Sci fi,1:47,-22,33.84338306058975
63,80,The Killing of a Sacred Deer,10000,279,2017.0,Horror/Mystery and thriller,2:01,17,33.76778912483905
66,91,A Ghost Story,10000,279,2017.0,Drama/Romance,1:30,25,33.76778912483905
71,92,Anomalisa,10000,275,2015.0,Drama/Animation,1:30,21,33.46439159473001
71,73,The Birth of a Nation,10000,268,2016.0,Biography/Drama,1:54,2,32.929432503463254
59,81,Colossal,10000,261,2016.0,Fantasy/Comedy,1:50,22,32.3892071476377
95,39,Maleficent: Mistress of Evil,10000,255,2019.0,Adventure/Fantasy,1:58,-56,31.921817676857298
56,71,Café Society,10000,255,2016.0,Romance,1:36,15,31.921817676857298
44,87,It Comes at Night,10000,254,2017.0,Horror/Mystery and thriller,1:37,43,31.843520294778347
94,84,Downton Abbey,10000,253,2019.0,Drama,2:02,-10,31.765107230441497
78,81,T2 Trainspotting,10000,251,2017.0,Comedy/Drama,1:57,3,31.60793153235044
88,69,Zombieland: Double Tap,10000,251,2019.0,Comedy/Horror,1:39,-19,31.60793153235044
74,90,Bumblebee,10000,249,2018.0,Adventure/Sci fi,1:54,16,31.450285477474228
91,89,Straight Outta Compton,10000,247,2015.0,Music/Drama,2:27,-2,31.292163863166575
68,17,Baywatch,10000,246,2017.0,Comedy/Action,1:56,-51,31.212923068073856
57,86,The Lost City of Z,10000,246,2016.0,Drama/Biography,2:21,29,31.212923068073856
86,80,Good Boys,10000,245,2019.0,Comedy,1:35,-6,31.133561386575195
68,87,Everybody Wants Some!!,10000,244,2016.0,Comedy,1:56,19,31.054078139703236
73,91,Elle,10000,242,2016.0,Drama/Mystery and thriller,2:11,18,30.894744200808365
75,90,Green Room,10000,242,2015.0,Horror/Mystery and thriller,1:34,15,30.894744200808365
93,63,Sonic the Hedgehog,10000,241,2020.0,Fantasy/Adventure,1:40,-30,30.81489211741166
42,35,Live by Night,10000,239,2016.0,Crime/Mystery and thriller,2:09,-7,30.654814192715765
81,87,Okja,10000,238,2017.0,Fantasy/Drama,1:58,6,30.574586918379627
76,14,Dolittle,10000,236,2020.0,Adventure/Fantasy,1:40,-62,30.41375210935341
42,35,The Great Wall,10000,236,2016.0,Action/Adventure,1:44,-7,30.41375210935341
67,83,Midnight Special,10000,235,2016.0,Sci fi/Mystery and thriller,1:51,16,30.333143098167753
61,61,The Light Between Oceans,10000,235,2016.0,Romance/Drama,2:13,0,30.333143098167753
79,96,Son of Saul,10000,233,2015.0,Drama/History,1:47,17,30.17153811508654
68,87,Florence Foster Jenkins,10000,229,2016.0,Music/Drama,1:50,19,29.846758835604586
53,56,Focus,10000,228,2015.0,Drama/Romance,1:45,3,29.76523250994286
85,82,Captain Fantastic,10000,227,2016.0,Drama/Comedy,1:59,-3,29.683571984087028
74,88,20th Century Women,10000,225,2016.0,Drama/Comedy,1:58,14,29.519845068981457
87,95,Amy,10000,224,2015.0,Music/Biography,2:08,8,29.43777702680547
82,93,Amour,10000,224,2012.0,Drama,2:07,11,29.43777702680547
31,38,Blair Witch,10000,223,2016.0,Horror/Mystery and thriller,1:29,7,29.355571478323455
92,83,Queen & Slim,10000,222,2019.0,Romance/Crime,2:12,-9,29.273227574963673
36,60,High-Rise,10000,221,2015.0,Drama/Horror,1:59,24,29.190744459068426
91,95,The Handmaiden,10000,220,2016.0,Romance/Drama,2:24,4,29.108121263755205
68,72,Suffragette,10000,217,2015.0,Biography/Drama,1:46,4,28.8594023911159
69,71,Youth,10000,217,2015.0,Drama,1:58,2,28.8594023911159
85,89,Love & Mercy,10000,216,2014.0,Drama/Biography,2:00,4,28.776210019791854
30,36,Snatched,10000,213,2017.0,Adventure/Action,1:30,6,28.52576185074631
60,96,Love & Friendship,10000,213,2016.0,Comedy,1:33,36,28.52576185074631
54,67,Whiskey Tango Foxtrot,10000,211,2016.0,Drama/Biography,1:51,13,28.358061142953193
65,78,Bridget Jones's Baby,10000,211,2016.0,Romance,2:02,13,28.358061142953193
71,90,Martha Marcy May Marlene,10000,211,2011.0,Mystery and thriller/Drama,1:41,19,28.358061142953193
92,95,Sing Street,10000,211,2016.0,Comedy/Romance,1:46,3,28.358061142953193
41,42,A Cure for Wellness,10000,210,2016.0,Horror/Drama,2:20,1,28.273987340420472
67,97,45 Years,10000,209,2015.0,Drama,1:33,30,28.18976327129646
72,72,Swiss Army Man,10000,208,2016.0,Fantasy/Comedy,1:35,0,28.10538794609019
83,99,I Am Not Your Negro,10000,208,2016.0,Documentary,1:35,16,28.10538794609019
79,74,Trumbo,10000,207,2015.0,Drama/Biography,2:04,-5,28.02086036400211
51,84,While We're Young,10000,205,2014.0,Comedy/Drama,1:34,33,27.85134436832817
75,86,Only Lovers Left Alive,10000,205,2013.0,Fantasy/Drama,2:02,11,27.85134436832817
91,97,Hunt for the Wilderpeople,10000,204,2016.0,Adventure/Comedy,1:41,6,27.76635389491961
60,70,Stoker,10000,204,2013.0,Horror/Mystery and thriller,1:38,10,27.76635389491961
80,91,The Sessions,10000,203,2012.0,Comedy/Biography,1:35,11,27.681207044594718
88,98,Life Itself,10000,202,2014.0,Documentary,2:00,10,27.595902757162747
76,89,The Drop,10000,201,2014.0,Drama/Crime,1:47,13,27.510439959956123
43,65,Ricki and the Flash,10000,200,2015.0,Drama/Comedy,1:40,22,27.42481756762073
54,35,Labor Day,10000,200,2013.0,Drama/Romance,1:51,-19,27.42481756762073
66,63,The Finest Hours,10000,199,2016.0,Adventure/History,1:56,-3,27.33903448190164
18,7,The Snowman,10000,199,2017.0,Drama/Crime,2:25,-11,27.33903448190164
77,78,Where to Invade Next,10000,199,2015.0,Comedy/Documentary,1:59,1,27.33903448190164
82,81,Eddie the Eagle,10000,199,2016.0,Comedy/Biography,1:45,-1,27.33903448190164
85,89,Blue Is the Warmest Color,10000,198,2013.0,Gay and lesbian/Drama,2:55,4,27.253089591424086
66,70,Carnage,10000,198,2011.0,Drama/Comedy,1:19,4,27.253089591424086
80,90,Stronger,10000,194,2017.0,Drama/Biography,1:59,10,26.907669282564235
71,92,Holy Motors,10000,194,2012.0,Comedy/Drama,1:56,21,26.907669282564235
56,97,Mr. Turner,10000,193,2014.0,History/Drama,2:29,41,26.820898222527152
75,84,Far From the Madding Crowd,10000,193,2015.0,Romance/Drama,1:58,9,26.820898222527152
50,59,Dr. Seuss' The Grinch,10000,192,2018.0,Animation/Other,1:26,9,26.733958401075075
24,32,Blackhat,10000,190,2015.0,Drama/Crime,2:14,8,26.559567619788876
45,51,Magic in the Moonlight,10000,190,2014.0,Romance,1:37,6,26.559567619788876
88,86,Wonder,10000,189,2017.0,Drama,1:53,-2,26.47211419497369
64,47,Free State of Jones,10000,188,2016.0,Drama/Biography,2:19,-17,26.384487078239673
93,38,Angel Has Fallen,10000,187,2019.0,Mystery and thriller/Action,2:01,-55,26.296684997953903
62,68,Trance,10000,187,2013.0,Drama/Crime,1:41,6,26.296684997953903
59,65,The Second Best Exotic Marigold Hotel,10000,187,2015.0,Drama/Comedy,2:02,6,26.296684997953903
56,59,Run All Night,10000,186,2015.0,Mystery and thriller/Drama,1:54,3,26.20870666631663
40,41,Office Christmas Party,10000,185,2016.0,Other/Comedy,1:45,1,26.120550779067592
55,62,The Beaver,10000,185,2011.0,Drama,1:31,7,26.120550779067592
67,85,Wendy and Lucy,10000,185,2008.0,Drama,1:20,18,26.120550779067592
77,92,Frances Ha,10000,184,2012.0,Comedy,1:25,15,26.03221601518546
64,14,Collateral Beauty,10000,184,2016.0,Drama/Fantasy,1:37,-50,26.03221601518546
76,97,Two Days One Night,10000,182,2014.0,Drama,1:35,21,25.855004487777162
36,35,The Fifth Estate,10000,181,2013.0,Drama/Mystery and thriller,2:08,-1,25.766124995595995
31,16,The Gunman,10000,181,2015.0,Action/Mystery and thriller,1:55,-15,25.766124995595995
76,64,The Zookeeper's Wife,10000,180,2017.0,History/Drama,2:05,-12,25.677061168818504
85,73,Gifted,10000,179,2017.0,Drama,1:41,-12,25.587811597850912
71,72,The Infiltrator,10000,179,2016.0,Drama/Crime,2:07,1,25.587811597850912
55,78,Keanu,10000,179,2016.0,Comedy/Action,1:40,23,25.587811597850912
92,99,A Separation,10000,179,2011.0,Drama,2:03,7,25.587811597850912
60,34,American Assassin,10000,179,2017.0,Action/Mystery and thriller,1:51,-26,25.587811597850912
85,88,The Wind Rises,10000,178,2013.0,Drama/Biography,2:06,3,25.49837485437685
45,43,American Ultra,10000,178,2015.0,Comedy/Action,1:36,-2,25.49837485437685
31,37,Hyde Park on Hudson,10000,178,2012.0,Drama/History,1:34,6,25.49837485437685
68,82,Bright Star,10000,177,2009.0,Romance/Drama,1:59,14,25.40874949100198
66,93,Love Is Strange,10000,176,2014.0,Drama/Gay and lesbian,1:34,27,25.31893404088985
53,45,Anonymous,10000,176,2011.0,Drama/History,2:10,-8,25.31893404088985
65,90,Clouds of Sils Maria,10000,176,2014.0,Drama,2:03,25,25.31893404088985
87,82,The Raid 2,10000,175,2014.0,Crime/Drama,2:28,-5,25.228927017388646
78,91,Girls Trip,10000,175,2017.0,Comedy,2:02,13,25.228927017388646
74,93,Another Year,10000,174,2010.0,Drama/Comedy,2:09,19,25.13872691364861
67,91,Grandma,10000,174,2015.0,Comedy/Drama,1:18,24,25.13872691364861
92,98,Short Term 12,10000,174,2013.0,Drama,1:36,6,25.13872691364861
47,38,The Mountain Between Us,10000,173,2017.0,Romance/Drama,1:44,-9,25.048332202229876
74,87,Margin Call,10000,172,2011.0,Drama/Mystery and thriller,1:49,13,24.957741334700298
65,79,Popstar: Never Stop Never Stopping,10000,172,2016.0,Music/Comedy,1:26,14,24.957741334700298
38,45,True Story,10000,171,2015.0,Drama/Mystery and thriller,1:44,7,24.86695274122312
61,56,The Conspirator,10000,171,2010.0,Drama/History,2:01,-5,24.86695274122312
57,47,Going in Style,10000,171,2017.0,Comedy,1:36,-10,24.86695274122312
58,43,Maze Runner: The Death Cure,10000,171,2018.0,Sci fi/Action,2:22,-15,24.86695274122312
80,89,Calvary,10000,171,2014.0,Comedy/Drama,1:45,9,24.86695274122312
81,99,Shaun the Sheep Movie,10000,170,2015.0,Animation/Comedy,1:25,18,24.775964830134004
51,66,The Rover,10000,169,2014.0,Drama/Mystery and thriller,1:42,15,24.684775987507244
76,92,Arthur Christmas,10000,169,2011.0,Kids and family/Comedy,1:40,16,24.684775987507244
40,52,Margot at the Wedding,10000,168,2007.0,Comedy/Drama,1:31,12,24.59338457671065
72,90,Obvious Child,10000,167,2014.0,Comedy,1:23,18,24.501788937948916
48,47,A Walk in the Woods,10000,166,2015.0,Adventure/Comedy,1:44,-1,24.409987387794924
73,95,The Diary of a Teenage Girl,10000,166,2015.0,Drama,1:42,22,24.409987387794924
80,82,Rust and Bone,10000,165,2012.0,Romance/Drama,2:02,2,24.317978218708763
79,96,Ida,10000,164,2013.0,Drama,1:20,17,24.225759698543914
91,87,Only the Brave,10000,163,2017.0,Drama/Adventure,2:14,-4,24.13333007004028
90,60,The Secret Life of Pets 2,10000,163,2019.0,Kids and family/Comedy,1:26,-30,24.13333007004028
89,96,A Prophet,10000,162,2009.0,Drama/Crime,2:34,7,24.0406875503036
82,95,The Class,10000,161,2008.0,Drama,2:09,13,23.947830330270747
81,92,The End of the Tour,10000,160,2015.0,Drama,1:46,11,23.854756574160536
44,28,Burnt,10000,160,2015.0,Drama,1:40,-16,23.854756574160536
92,51,The Promise,10000,160,2016.0,Romance/Drama,2:14,-41,23.854756574160536
78,92,99 Homes,10000,159,2014.0,Drama,1:50,14,23.761464418909437
35,52,In the Deep,10000,159,2017.0,Mystery and thriller/Adventure,1:29,17,23.761464418909437
44,8,Mother's Day,10000,159,2016.0,Comedy/Romance,1:58,-36,23.761464418909437
85,95,The Act of Killing,10000,159,2012.0,Drama/Documentary,2:02,10,23.761464418909437
67,72,Happy Death Day,10000,158,2017.0,Comedy/Mystery and thriller,1:36,5,23.667951973591787
44,61,Maps to the Stars,10000,158,2014.0,Comedy/Drama,1:52,17,23.667951973591787
76,96,Tangerine,10000,157,2015.0,Drama/Comedy,1:27,20,23.574217318823912
69,45,The Addams Family,10000,157,2019.0,Kids and family/Animation,1:27,-24,23.574217318823912
61,85,Me and Orson Welles,10000,157,2008.0,Drama,1:47,24,23.574217318823912
75,82,Broken Embraces,10000,157,2009.0,Drama/Mystery and thriller,2:08,7,23.574217318823912
52,80,The Homesman,10000,156,2014.0,Western/Drama,2:02,28,23.480258506151625
58,92,Coriolanus,10000,156,2011.0,Drama/War,2:02,34,23.480258506151625
92,94,Wild Tales,10000,156,2014.0,Comedy/Drama,2:02,2,23.480258506151625
51,39,Why Him?,10000,156,2016.0,Comedy/Other,1:51,-12,23.480258506151625
62,47,No Escape,10000,156,2015.0,Action/Mystery and thriller,1:43,-15,23.480258506151625
74,66,Biutiful,10000,155,2010.0,Romance/Drama,2:27,-8,23.38607355742051
83,92,The Past,10000,155,2013.0,Drama,2:10,9,23.38607355742051
61,72,Like Crazy,10000,155,2011.0,Romance/Drama,1:29,11,23.38607355742051
46,53,Promised Land,10000,154,2012.0,Drama,1:46,7,23.291660464128444
68,76,Rosewater,10000,154,2014.0,Drama,1:43,8,23.291660464128444
59,48,The 33,10000,154,2015.0,Drama,2:05,-11,23.291660464128444
34,45,On the Road,10000,154,2012.0,Drama,2:19,11,23.291660464128444
79,57,Woman in Gold,10000,153,2015.0,Drama,1:51,-22,23.197017186759677
60,76,Kill Your Darlings,10000,153,2013.0,Gay and lesbian/Drama,1:42,16,23.197017186759677
41,86,Night Moves,10000,152,2013.0,Drama/Mystery and thriller,1:52,45,23.102141654099842
60,62,The Water Diviner,10000,151,2014.0,War/Drama,1:52,2,23.007031762531238
85,95,The Secret World of Arrietty,10000,151,2010.0,Kids and family/Anime,1:35,10,23.007031762531238
54,70,A Hologram for the King,10000,150,2016.0,Drama/Comedy,1:37,16,22.911685375307673
80,97,Leviathan,10000,150,2014.0,Drama,2:22,17,22.911685375307673
43,29,Pitch Perfect 3,10000,150,2017.0,Comedy/Musical,1:34,-14,22.911685375307673
64,89,The Lady in the Van,10000,150,2015.0,Comedy/Drama,1:44,25,22.911685375307673
79,91,Fish Tank,10000,150,2009.0,Drama,2:04,12,22.911685375307673
41,39,Secret in Their Eyes,10000,149,2015.0,Mystery and thriller,1:51,-2,22.816100321808104
65,85,Goodnight Mommy,10000,149,2014.0,Mystery and thriller/Horror,1:40,20,22.816100321808104
35,74,Rampart,10000,149,2011.0,Drama/Crime,1:43,39,22.816100321808104
89,92,Pride,10000,149,2014.0,Comedy/Gay and lesbian,1:59,3,22.816100321808104
67,71,The Last Station,10000,149,2009.0,Biography/Drama,1:50,4,22.816100321808104
64,76,The East,10000,148,2013.0,Adventure/Mystery and thriller,1:56,12,22.72027439676837
69,86,Upstream Color,10000,148,2013.0,Drama,1:36,17,22.72027439676837
73,35,A Dog's Purpose,10000,147,2017.0,Fantasy/Comedy,2:00,-38,22.624205359490148
54,52,Hardcore Henry,10000,147,2015.0,Sci fi/Action,1:35,-2,22.624205359490148
79,94,Stories We Tell,10000,147,2012.0,Documentary,1:48,15,22.624205359490148
33,45,The Paperboy,10000,146,2012.0,Drama/Crime,1:47,12,22.52789093302636
65,67,Redbelt,10000,146,2008.0,Drama,1:39,2,22.52789093302636
87,96,Citizenfour,10000,146,2014.0,Documentary,1:54,9,22.52789093302636
84,97,Project Nim,10000,146,2011.0,Documentary,1:39,13,22.52789093302636
56,62,Hamlet 2,10000,146,2008.0,Comedy,1:34,6,22.52789093302636
66,83,Your Sister's Sister,10000,145,2011.0,Drama/Romance,1:30,17,22.43132880334213
75,85,Get Low,10000,145,2009.0,Comedy/Drama,1:42,10,22.43132880334213
35,3,Getaway,10000,144,2013.0,Mystery and thriller/Action,1:29,-32,22.33451661845039
21,15,The Circle,10000,144,2017.0,Mystery and thriller/Drama,1:50,-6,22.33451661845039
60,89,Compliance,10000,144,2012.0,Mystery and thriller,1:30,29,22.33451661845039
68,62,Mandela: Long Walk to Freedom,10000,144,2013.0,Biography/Drama,2:26,-6,22.33451661845039
74,72,Micmacs,10000,144,2009.0,Comedy/Drama,1:45,-2,22.33451661845039
62,71,Celeste and Jesse Forever,10000,143,2012.0,Romance,1:30,9,22.237451987521194
46,19,Self/less,10000,143,2015.0,Sci fi/Action,1:56,-27,22.237451987521194
31,44,The Gambler,10000,143,2014.0,Drama/Crime,1:51,13,22.237451987521194
64,87,Please Give,10000,143,2010.0,Comedy/Drama,1:30,23,22.237451987521194
39,75,Damsels in Distress,10000,143,2011.0,Comedy,1:39,36,22.237451987521194
75,68,Che: Part One,10000,142,2008.0,Biography/Drama,2:09,-7,22.14013247996374
79,96,Blue Ruin,10000,142,2013.0,Drama/Crime,1:30,17,22.14013247996374
22,50,What Just Happened?,10000,142,2008.0,Comedy/Drama,1:53,28,22.14013247996374
58,79,Take This Waltz,10000,141,2011.0,Drama,1:56,21,22.042555624480066
66,67,Nerve,10000,141,2016.0,Mystery and thriller/Action,1:36,1,22.042555624480066
52,80,The Deep Blue Sea,10000,141,2011.0,Romance/Drama,1:38,28,22.042555624480066
39,50,Chéri,10000,140,2009.0,Drama/Romance,1:32,11,21.944718908089367
52,62,Brideshead Revisited,10000,140,2008.0,Romance/Drama,2:14,10,21.944718908089367
81,96,'71,10000,139,2014.0,Mystery and thriller/Action,1:39,15,21.84661977512174
59,80,Black Sea,10000,139,2014.0,Adventure/Mystery and thriller,1:55,21,21.84661977512174
62,65,Storks,10000,139,2016.0,Kids and family/Comedy,1:23,3,21.84661977512174
47,30,Criminal,10000,138,2016.0,Mystery and thriller/Action,1:53,-17,21.748255626180264
78,78,Barney's Version,10000,138,2010.0,Drama/Comedy,2:12,0,21.748255626180264
59,78,The Grandmaster,10000,138,2013.0,Drama/Biography,2:10,19,21.748255626180264
22,10,The Forest,10000,138,2016.0,Horror/Mystery and thriller,1:33,-12,21.748255626180264
76,91,The Sapphires,10000,138,2012.0,Comedy/Musical,1:43,15,21.748255626180264
80,83,Four Lions,10000,138,2009.0,Comedy/Drama,1:42,3,21.748255626180264
80,92,Sugar,10000,138,2008.0,Drama,1:58,12,21.748255626180264
51,79,Humpday,10000,138,2009.0,Comedy,1:34,28,21.748255626180264
41,37,The Brothers Grimsby,10000,137,2016.0,Action/Comedy,1:23,-4,21.649623817070065
54,16,The Space Between Us,10000,137,2017.0,Adventure/Romance,2:00,-38,21.649623817070065
34,46,You Will Meet a Tall Dark Stranger,10000,137,2010.0,Comedy/Drama,1:38,12,21.649623817070065
73,96,Cave of Forgotten Dreams,10000,137,2010.0,Documentary,1:30,23,21.649623817070065
69,98,Don't Think Twice,10000,136,2016.0,Drama/Comedy,1:28,29,21.550721657693213
54,82,The Overnight,10000,135,2015.0,Comedy,1:18,28,21.451546410907937
31,43,Closed Circuit,10000,135,2013.0,Mystery and thriller,1:36,12,21.451546410907937
61,91,Dear White People,10000,135,2014.0,Drama/Comedy,1:46,30,21.451546410907937
66,66,Another Earth,10000,135,2011.0,Drama/Sci fi,1:32,0,21.451546410907937
33,24,Bad Santa 2,10000,135,2016.0,Comedy/Other,1:32,-9,21.451546410907937
32,60,Maggie,10000,135,2015.0,Drama/Horror,1:34,28,21.451546410907937
75,96,A Girl Walks Home Alone at Night,10000,134,2014.0,Drama/Horror,1:45,21,21.35209529135088
53,73,Everything Must Go,10000,134,2010.0,Drama/Comedy,1:37,20,21.35209529135088
74,92,Slow West,10000,134,2015.0,Western/Mystery and thriller,1:31,18,21.35209529135088
68,81,I Am Love,10000,134,2009.0,Romance/Drama,1:59,13,21.35209529135088
61,87,Captain Underpants: The First Epic Movie,10000,134,2017.0,Kids and family/Comedy,1:29,26,21.35209529135088
68,86,Joe,10000,134,2013.0,Drama,1:57,18,21.35209529135088
64,72,Pom Wonderful Presents: The Greatest Movie Ever Sold,10000,134,2011.0,Comedy/Documentary,1:26,8,21.35209529135088
80,91,The Great Beauty,10000,134,2013.0,Comedy/Drama,2:22,11,21.35209529135088
93,93,The Hunt,10000,134,2012.0,Drama,1:50,0,21.35209529135088
79,90,The Illusionist,10000,134,2010.0,Drama/Animation,1:30,11,21.35209529135088
40,25,Fist Fight,10000,133,2017.0,Comedy,1:31,-15,21.252365464220812
61,77,Ain't Them Bodies Saints,10000,133,2013.0,Drama,1:35,16,21.252365464220812
92,95,Searching for Sugar Man,10000,133,2011.0,Documentary,1:26,3,21.252365464220812
55,94,Room 237,10000,133,2012.0,Documentary,1:42,39,21.252365464220812
73,77,Danny Collins,10000,133,2015.0,Comedy/Drama,1:46,4,21.252365464220812
59,47,Wish I Was Here,10000,133,2014.0,Comedy/Drama,1:47,-12,21.252365464220812
70,53,Risen,10000,132,2016.0,Drama/History,1:48,-17,21.152354044022278
80,93,No,10000,132,2012.0,Drama/History,1:56,13,21.152354044022278
36,45,Tusk,10000,132,2014.0,Horror,1:41,9,21.152354044022278
46,36,The November Man,10000,132,2014.0,Action/Mystery and thriller,1:48,-10,21.152354044022278
59,83,The Double,10000,132,2013.0,Comedy,1:32,24,21.152354044022278
71,92,In a World ...,10000,132,2013.0,Comedy,1:33,21,21.152354044022278
38,53,I'm Still Here,10000,132,2010.0,Documentary/Music,1:48,15,21.152354044022278
66,86,A Christmas Tale,10000,132,2008.0,Comedy/Drama,2:30,20,21.152354044022278
88,95,13 Assassins,10000,131,2010.0,Adventure/History,2:06,7,21.05205809326756
78,98,Phoenix,10000,131,2014.0,Drama/History,1:38,20,21.05205809326756
69,77,Kill the Messenger,10000,130,2014.0,Drama/Mystery and thriller,1:52,8,20.951474621135226
47,62,The Joneses,10000,130,2009.0,Comedy/Drama,1:33,15,20.951474621135226
71,63,The Man Who Knew Infinity,10000,130,2015.0,Biography/Drama,1:54,-8,20.951474621135226
36,53,Lovelace,10000,129,2013.0,Drama/Biography,1:33,17,20.850600582083427
44,48,Cake,10000,129,2014.0,Drama/Comedy,1:42,4,20.850600582083427
44,32,A Bad Moms Christmas,10000,129,2017.0,Other/Comedy,1:44,-12,20.850600582083427
51,21,Daddy's Home 2,10000,129,2017.0,Comedy/Other,1:38,-30,20.850600582083427
40,55,The Killer Inside Me,10000,129,2010.0,Drama/Crime,1:48,15,20.850600582083427
62,66,The Iceman,10000,128,2012.0,Drama/Mystery and thriller,1:45,4,20.749432874416154
76,85,"Hello, My Name Is Doris",10000,128,2015.0,Comedy/Drama,1:30,9,20.749432874416154
82,99,20 Feet From Stardom,10000,128,2013.0,Documentary,1:30,17,20.749432874416154
88,93,The Counterfeiters,10000,128,2007.0,Drama/History,1:39,5,20.749432874416154
85,88,I've Loved You So Long,10000,128,2008.0,Drama,1:57,3,20.749432874416154
49,69,Palo Alto,10000,127,2013.0,Drama,1:37,20,20.647968338800368
34,43,Straw Dogs,10000,127,2011.0,Drama/Mystery and thriller,1:50,9,20.647968338800368
61,73,The Boys Are Back,10000,126,2009.0,Comedy/Drama,1:44,12,20.546203756731995
72,66,The Foreigner,10000,125,2017.0,Mystery and thriller/Action,1:54,-6,20.444135848948562
57,82,Ouija: Origin of Evil,10000,125,2016.0,Horror/Mystery and thriller,1:39,25,20.444135848948562
49,42,Horns,10000,125,2013.0,Comedy/Mystery and thriller,2:01,-7,20.444135848948562
68,66,The Railway Man,10000,125,2013.0,Biography/Drama,1:48,-2,20.444135848948562
58,48,Bottle Shock,10000,124,2008.0,Drama,1:50,-10,20.341761273786197
37,19,Keeping Up With the Joneses,10000,124,2016.0,Comedy/Action,1:40,-18,20.341761273786197
48,79,The Two Faces of January,10000,124,2014.0,Romance/Mystery and thriller,1:37,31,20.341761273786197
65,77,Paranoid Park,10000,124,2007.0,Drama,1:24,12,20.341761273786197
28,7,Rock the Kasbah,10000,124,2015.0,Comedy,1:46,-21,20.341761273786197
45,54,The Company You Keep,10000,123,2012.0,Mystery and thriller,2:01,9,20.23907662547856
53,82,Prince Avalanche,10000,123,2013.0,Comedy/Drama,1:33,29,20.23907662547856
92,92,Incendies,10000,123,2010.0,Drama,2:10,0,20.23907662547856
51,36,Sleuth,10000,123,2007.0,Drama/Crime,1:28,-15,20.23907662547856
88,99,Wadjda,10000,122,2012.0,Drama,1:38,11,20.136078432395202
36,18,Love the Coopers,10000,122,2015.0,Comedy/Drama,1:47,-18,20.136078432395202
49,84,Drinking Buddies,10000,122,2013.0,Drama/Romance,1:30,35,20.136078432395202
95,93,Senna,10000,122,2010.0,Documentary,1:44,-2,20.136078432395202
77,76,The Kings of Summer,10000,122,2013.0,Comedy/Adventure,1:33,-1,20.136078432395202
72,92,Tabloid,10000,121,2010.0,Documentary,1:28,20,20.032763155216593
51,65,Byzantium,10000,121,2012.0,Horror,1:58,14,20.032763155216593
89,98,Jodorowsky's Dune,10000,121,2013.0,Documentary,1:28,9,20.032763155216593
51,33,Miracle at St. Anna,10000,121,2008.0,War/Drama,2:40,-18,20.032763155216593
40,37,Before I Go to Sleep,10000,120,2014.0,Drama/Mystery and thriller,1:32,-3,19.92912718504312
71,82,Infinitely Polar Bear,10000,120,2014.0,Comedy/Drama,1:27,11,19.92912718504312
75,93,Of Gods and Men,10000,120,2010.0,Drama,2:02,18,19.92912718504312
89,88,Sin nombre,10000,120,2009.0,Adventure/Drama,1:36,-1,19.92912718504312
66,71,Pawn Sacrifice,10000,119,2014.0,Drama/Biography,1:54,5,19.82516684143501
71,75,The Whistleblower,10000,119,2010.0,Drama,1:52,4,19.82516684143501
43,50,Thanks for Sharing,10000,119,2012.0,Romance/Drama,1:52,7,19.82516684143501
84,90,Waiting for Superman,10000,119,2010.0,Documentary,1:42,6,19.82516684143501
86,98,The Band's Visit,10000,119,2007.0,Comedy/Drama,1:26,12,19.82516684143501
73,95,The Queen of Versailles,10000,119,2012.0,Documentary,1:40,22,19.82516684143501
57,66,Hobo With a Shotgun,10000,119,2011.0,Drama/Action,1:26,9,19.82516684143501
44,50,Then She Found Me,10000,119,2007.0,Drama/Romance,1:40,6,19.82516684143501
89,94,Train to Busan,10000,118,2016.0,Mystery and thriller/Action,1:58,5,19.720878370380042
88,96,Restrepo,10000,118,2010.0,War/History,1:33,8,19.720878370380042
22,14,The Gallows,10000,118,2015.0,Horror/Mystery and thriller,1:21,-8,19.720878370380042
88,96,Mother,10000,118,2009.0,Drama/Crime,2:08,8,19.720878370380042
87,97,The Lunchbox,10000,117,2013.0,Drama/Romance,1:45,10,19.616257942185833
78,91,Red Cliff,10000,117,2008.0,Drama/Action,2:28,13,19.616257942185833
71,84,Sleepwalk With Me,10000,117,2012.0,Comedy/Drama,1:30,13,19.616257942185833
94,98,Your Name,10000,116,2016.0,Romance/Fantasy,1:46,4,19.511301649293156
69,91,The Guest,10000,116,2014.0,Mystery and thriller/Action,1:39,22,19.511301649293156
62,28,Machine Gun Preacher,10000,116,2011.0,Drama/Biography,2:07,-34,19.511301649293156
67,84,Cold in July,10000,116,2014.0,Drama/Mystery and thriller,1:49,17,19.511301649293156
75,80,Thirst,10000,116,2009.0,Horror/Mystery and thriller,2:13,5,19.511301649293156
84,99,Starred Up,10000,115,2013.0,Drama/Crime,1:40,15,19.406005504006643
85,79,It Might Get Loud,10000,115,2008.0,Documentary/Music,1:37,-6,19.406005504006643
49,46,Creation,10000,114,2009.0,Drama/Biography,1:48,-3,19.300365436139025
36,22,Sabotage,10000,114,2014.0,,,-14,19.300365436139025
23,8,Rings,10000,114,2017.0,Horror/Mystery and thriller,1:37,-15,19.300365436139025
91,96,Exit Through the Gift Shop,10000,114,2010.0,Documentary,1:27,5,19.300365436139025
83,27,Bright,10000,113,2017.0,Action/Fantasy,1:57,-56,19.194377290564812
46,19,The Art of Getting By,10000,113,2011.0,Comedy/Drama,1:24,-27,19.194377290564812
66,73,The Beautiful Game,10000,113,2008.0,Comedy/Drama,1:43,7,19.194377290564812
32,17,I Don't Know How She Does It,10000,113,2011.0,Comedy,1:31,-15,19.194377290564812
52,38,Reservation Road,10000,113,2007.0,Drama,1:42,-14,19.194377290564812
72,84,Rocket Science,10000,112,2007.0,Drama/Comedy,1:41,12,19.088036824679065
76,96,A Hijacking,10000,112,2013.0,Drama/Mystery and thriller,1:39,20,19.088036824679065
60,85,The Immigrant,10000,112,2013.0,Drama/History,1:57,25,19.088036824679065
79,94,The Gatekeepers,10000,112,2012.0,Documentary,1:36,15,19.088036824679065
45,18,CHIPS,10000,111,2017.0,Action/Comedy,1:41,-27,18.981339705756774
75,84,Predestination,10000,111,2014.0,Sci fi/Action,1:37,9,18.981339705756774
23,16,Serena,10000,111,2014.0,Romance/Drama,1:49,-7,18.981339705756774
52,63,Lymelife,10000,111,2008.0,Drama,1:35,11,18.981339705756774
29,11,Point Break,10000,110,2015.0,,,-18,18.874281508207943
82,90,A Royal Affair,10000,110,2012.0,Romance/Drama,2:17,8,18.874281508207943
66,75,Sound of My Voice,10000,110,2011.0,Drama,1:24,9,18.874281508207943
70,71,Tetro,10000,110,2009.0,Drama,2:07,1,18.874281508207943
23,16,The Lazarus Effect,10000,109,2015.0,Horror/Mystery and thriller,1:23,-7,18.76685771072333
82,92,Joan Rivers: A Piece of Work,10000,109,2010.0,Comedy/Documentary,1:24,10,18.76685771072333
46,73,Welcome to Me,10000,109,2014.0,Comedy/Drama,1:26,27,18.76685771072333
35,7,Paranoia,10000,108,2013.0,Mystery and thriller/Drama,1:46,-28,18.659063693305395
73,86,Alan Partridge,10000,108,2013.0,Comedy,1:29,13,18.659063693305395
46,36,Stand Up Guys,10000,108,2012.0,Drama/Comedy,1:35,-10,18.659063693305395
72,81,Trollhunter,10000,108,2010.0,Adventure/Mystery and thriller,1:43,9,18.659063693305395
79,85,A Better Life,10000,108,2011.0,Drama/Crime,1:38,6,18.659063693305395
69,89,The Invitation,10000,107,2015.0,Drama/Mystery and thriller,1:39,20,18.55089473417879
68,83,Smashed,10000,107,2012.0,Drama,1:21,15,18.55089473417879
71,94,Behind the Candelabra,10000,107,2013.0,Gay and lesbian/Drama,1:58,23,18.55089473417879
70,87,The Autopsy of Jane Doe,10000,107,2016.0,Horror/Mystery and thriller,1:26,17,18.55089473417879
65,38,Black or White,10000,107,2014.0,Drama,2:01,-27,18.55089473417879
44,33,Youth Without Youth,10000,107,2007.0,Romance/Mystery and thriller,2:05,-11,18.55089473417879
61,35,Won't Back Down,10000,106,2012.0,Drama,2:01,-26,18.442346006574258
47,41,Dead Man Down,10000,106,2013.0,Drama/Crime,1:58,-6,18.442346006574258
70,94,Summer Hours,10000,106,2008.0,Drama,1:42,24,18.442346006574258
71,81,Goon,10000,106,2011.0,Comedy/Biography,1:31,10,18.442346006574258
70,90,Rare Exports: A Christmas Tale,10000,106,2010.0,Comedy/Adventure,1:24,20,18.442346006574258
18,12,The Informers,10000,106,2009.0,Drama/Crime,1:38,-6,18.442346006574258
41,57,VHS,10000,104,2012.0,Horror/Mystery and thriller,1:55,16,18.22408939365073
76,87,Mongol,10000,104,2007.0,Drama/Biography,2:06,11,18.22408939365073
41,42,The Big Year,10000,103,2011.0,Comedy,1:40,1,18.1143712989759
82,85,Megan Leavey,10000,103,2017.0,Biography/War,1:56,3,18.1143712989759
26,10,Unfinished Business,10000,103,2015.0,Comedy,1:30,-16,18.1143712989759
30,16,The Transporter Refueled,10000,103,2015.0,Action/Mystery and thriller,1:31,-14,18.1143712989759
60,69,Ondine,10000,102,2009.0,Drama/Fantasy,1:50,9,18.004253009684938
64,54,The Devil's Double,10000,102,2011.0,Drama/Biography,1:49,-10,18.004253009684938
21,50,Stone,10000,102,2010.0,Drama/Mystery and thriller,1:45,29,18.004253009684938
80,85,The Baader Meinhof Complex,10000,101,2008.0,Crime/Drama,2:30,5,17.893729120895756
34,56,Bachelorette,10000,101,2012.0,Comedy,1:33,22,17.893729120895756
65,91,Transsiberian,10000,101,2008.0,Drama/Crime,1:51,26,17.893729120895756
75,84,The Stanford Prison Experiment,10000,100,2015.0,Drama/History,1:57,9,17.78279410038923
50,78,Solitary Man,10000,99,2009.0,Drama/Comedy,1:29,28,17.67144228430324
60,89,Uncle Boonmee Who Can Recall His Past Lives,10000,99,2010.0,Fantasy,1:54,29,17.67144228430324
61,61,Arctic Tale,10000,99,2007.0,Documentary,1:36,0,17.67144228430324
70,37,Max,10000,99,2015.0,Adventure/Drama,1:51,-33,17.67144228430324
34,39,Casino Jack,10000,99,2010.0,Biography/Drama,1:48,5,17.67144228430324
54,80,Tiny Furniture,10000,98,2010.0,Comedy/Drama,1:39,26,17.55966787263607
29,38,The Green Inferno,10000,98,2013.0,Adventure/Horror,1:40,9,17.55966787263607
67,66,Filth,10000,97,2013.0,Drama/Crime,1:37,-1,17.447464924548626
57,75,The Voices,10000,97,2014.0,Horror/Mystery and thriller,1:43,18,17.447464924548626
73,91,Bone Tomahawk,10000,97,2015.0,Comedy/Western,2:12,18,17.447464924548626
92,99,Song of the Sea,10000,97,2014.0,Animation/Adventure,1:34,7,17.447464924548626
25,49,The Human Centipede,10000,97,2009.0,Horror,1:30,24,17.447464924548626
49,21,Underworld: Blood Wars,10000,96,2016.0,Horror/Fantasy,1:32,-28,17.334827353454408
90,100,The Tale of the Princess Kaguya,10000,96,2013.0,Anime/Fantasy,2:17,10,17.334827353454408
54,55,Flawless,10000,96,2007.0,Drama/Crime,1:46,1,17.334827353454408
38,38,Savage Grace,10000,96,2007.0,Gay and lesbian/Drama,1:37,0,17.334827353454408
33,23,Girl Most Likely,10000,95,2012.0,Comedy,1:42,-10,17.22174892188519
56,44,Planes: Fire & Rescue,10000,95,2014.0,Kids and family/Comedy,1:23,-12,17.22174892188519
80,88,Séraphine,10000,95,2008.0,Biography/War,2:05,8,17.22174892188519
62,72,The Hunter,10000,95,2011.0,Adventure/Drama,1:40,10,17.22174892188519
39,69,They Came Together,10000,94,2014.0,Romance,1:23,30,17.108223236119827
76,82,The One I Love,10000,94,2014.0,Romance/Fantasy,1:31,6,17.108223236119827
71,72,Enter the Void,10000,94,2009.0,Drama,2:42,1,17.108223236119827
50,35,Kidnap,10000,94,2017.0,Action/Mystery and thriller,1:22,-15,17.108223236119827
43,52,Coco Chanel & Igor Stravinsky,10000,94,2009.0,Romance/Drama,2:00,9,17.108223236119827
36,30,Red Lights,10000,94,2012.0,Mystery and thriller,1:58,-6,17.108223236119827
66,90,Barbershop: The Next Cut,10000,93,2016.0,Comedy,1:52,24,16.994243740562503
80,45,Miracles From Heaven,10000,93,2016.0,Drama,1:49,-35,16.994243740562503
53,18,All Eyez on Me,10000,92,2017.0,Music/Drama,2:20,-35,16.879803711855995
38,61,The Signal,10000,92,2014.0,Sci fi/Mystery and thriller,1:37,23,16.879803711855995
65,53,Agora,10000,92,2009.0,Romance/Drama,2:06,-12,16.879803711855995
68,93,I'll See You in My Dreams,10000,92,2015.0,Comedy/Drama,1:25,25,16.879803711855995
68,92,Vincere,10000,92,2009.0,Biography/Drama,2:08,24,16.879803711855995
64,86,White Material,10000,91,2009.0,Drama,1:45,22,16.764896252714394
39,35,Prom,10000,91,2011.0,Drama/Comedy,1:43,-4,16.764896252714394
35,16,Geostorm,10000,91,2017.0,Adventure/Sci fi,1:49,-19,16.764896252714394
29,21,Darling Companion,10000,91,2012.0,Drama/Comedy,1:43,-8,16.764896252714394
54,60,Red State,10000,91,2011.0,Horror/Mystery and thriller,1:29,6,16.764896252714394
41,4,Playing for Keeps,10000,91,2012.0,Romance,1:45,-37,16.764896252714394
50,86,We Are What We Are,10000,91,2013.0,Drama/Horror,1:46,36,16.764896252714394
72,89,Footnote,10000,90,2011.0,Drama/Comedy,1:46,17,16.64951428545866
40,18,And So It Goes,10000,90,2014.0,Drama/Romance,1:34,-22,16.64951428545866
64,60,Glee the Concert Movie,10000,90,2011.0,Documentary/Musical,1:24,-4,16.64951428545866
51,50,Black Nativity,10000,90,2013.0,Drama/Musical,1:33,-1,16.64951428545866
82,81,Mesrine: Part II - Public Enemy 1,10000,90,2008.0,Drama/Biography,2:10,-1,16.64951428545866
82,87,The Good Lie,10000,89,2014.0,Drama,1:49,5,16.533650545237286
54,60,John Dies at the End,10000,89,2012.0,Sci fi/Horror,1:39,6,16.533650545237286
80,94,Tokyo Sonata,10000,89,2008.0,Drama,1:59,14,16.533650545237286
79,69,Molière,10000,89,2007.0,Comedy/Drama,2:00,-10,16.533650545237286
46,68,Rubber,10000,88,2010.0,Comedy/Horror,1:22,22,16.417297572912943
50,51,Introducing the Dwights,10000,88,2007.0,Comedy/Drama,1:49,1,16.417297572912943
79,86,From Up on Poppy Hill,10000,87,2011.0,Drama/Anime,1:31,7,16.300447707594707
75,78,Ashes of Time Redux,10000,87,2008.0,Action,1:33,3,16.300447707594707
63,91,O'Horten,10000,86,2007.0,Comedy/Drama,1:29,28,16.183093078793917
58,58,Jumping the Broom,10000,85,2011.0,Comedy,1:48,0,16.06522559818003
62,11,The Choice,10000,85,2016.0,Drama/Romance,1:51,-51,16.06522559818003
87,81,I Saw the Devil,10000,85,2010.0,Mystery and thriller,2:21,-6,16.06522559818003
56,93,"Farewell, My Queen",10000,84,2012.0,Drama,1:40,37,15.946836950911226
25,37,The Quiet Ones,10000,84,2014.0,Horror,1:38,12,15.946836950911226
43,76,The Bay,10000,84,2012.0,Sci fi/Horror,1:24,33,15.946836950911226
48,15,Baggage Claim,10000,84,2013.0,Romance,1:36,-33,15.946836950911226
68,73,Gainsbourg,10000,83,2010.0,Music/Biography,2:10,5,15.827918586512368
58,54,Welcome to the Rileys,10000,83,2010.0,Drama,1:50,-4,15.827918586512368
85,90,The Secret of Kells,10000,83,2009.0,Kids and family/Animation,1:18,5,15.827918586512368
41,27,Child 44,10000,83,2015.0,Mystery and thriller,2:17,-14,15.827918586512368
74,76,Bronson,10000,82,2008.0,Drama/Biography,1:32,2,15.708461709271033
35,20,The House,10000,82,2017.0,Comedy,1:28,-15,15.708461709271033
41,21,Judy Moody and the NOT Bummer Summer,10000,82,2011.0,Kids and family/Comedy,1:27,-20,15.708461709271033
38,51,I Give It a Year,10000,82,2013.0,Romance,1:37,13,15.708461709271033
23,29,The Human Centipede II (Full Sequence),10000,82,2011.0,Horror,1:28,6,15.708461709271033
37,42,Jane Got a Gun,10000,81,2016.0,Western/Action,1:38,5,15.588457268119896
24,23,The Woman in Black 2: Angel of Death,10000,81,2014.0,Horror/Mystery and thriller,1:38,-1,15.588457268119896
36,41,44 Inch Chest,10000,81,2009.0,Drama/Mystery and thriller,1:35,5,15.588457268119896
70,32,Chasing Mavericks,10000,81,2012.0,Adventure/Drama,1:55,-38,15.588457268119896
52,49,CJ7,10000,81,2008.0,Kids and family/Comedy,1:28,-3,15.588457268119896
57,81,Europa Report,10000,80,2013.0,Sci fi/Mystery and thriller,1:29,24,15.467895945971296
77,81,Kon-Tiki,10000,80,2012.0,Drama/Adventure,1:58,4,15.467895945971296
81,93,Caramel,10000,80,2007.0,Drama,1:36,12,15.467895945971296
89,90,The Edge of Heaven,10000,80,2007.0,Drama,2:02,1,15.467895945971296
77,73,African Cats,10000,79,2011.0,Documentary,1:30,-4,15.34676814846713
69,80,Man Up,10000,79,2015.0,Romance,1:28,11,15.34676814846713
66,68,Heartbreaker,10000,79,2010.0,Romance,1:45,2,15.34676814846713
75,70,Disconnect,10000,79,2012.0,Drama,1:55,-5,15.34676814846713
87,76,Samsara,10000,79,2011.0,Documentary/Music,1:42,-11,15.34676814846713
44,19,Gentlemen Broncos,10000,79,2009.0,Comedy,1:29,-25,15.34676814846713
40,26,"As Above, So Below",10000,78,2014.0,Horror/Mystery and thriller,1:33,-14,15.225063992104127
87,95,Being Elmo: A Puppeteer's Journey,10000,78,2011.0,Documentary,1:25,8,15.225063992104127
61,55,Hesher,10000,78,2010.0,Drama,1:40,-6,15.225063992104127
32,4,Flatliners,10000,77,2017.0,Sci fi/Mystery and thriller,1:48,-28,15.102773291691431
68,82,Conan O'Brien Can't Stop,10000,77,2011.0,Documentary,1:29,14,15.102773291691431
84,93,First Position,10000,76,2011.0,Documentary,1:30,9,14.979885547093689
50,70,The Private Lives of Pippa Lee,10000,76,2009.0,Comedy/Drama,1:33,20,14.979885547093689
78,54,Flipped,10000,76,2010.0,Romance,1:30,-24,14.979885547093689
78,77,Valentino: The Last Emperor,10000,75,2008.0,Documentary,1:36,-1,14.856389929209026
54,37,The Lucky Ones,10000,75,2008.0,Drama,1:55,-17,14.856389929209026
44,53,Maniac,10000,74,2012.0,Horror,1:29,9,14.732275265126917
41,14,Nine Lives,10000,72,2016.0,Fantasy/Comedy,1:29,-27,14.482142292408389
85,96,Chasing Ice,10000,72,2012.0,Biography/Documentary,1:14,11,14.482142292408389
77,21,The Shack,10000,72,2017.0,Drama,2:12,-56,14.482142292408389
50,68,My One and Only,10000,72,2009.0,Drama/Comedy,1:48,18,14.482142292408389
27,33,The Ward,10000,72,2010.0,Horror/Mystery and thriller,1:28,6,14.482142292408389
84,99,The Invisible War,10000,72,2011.0,Drama/Crime,1:35,15,14.482142292408389
47,79,Grand Piano,10000,72,2013.0,Music/Drama,1:30,32,14.482142292408389
26,15,The Last Exorcism Part II,10000,72,2013.0,Horror/Mystery and thriller,1:29,-11,14.482142292408389
60,68,Rec 2,10000,72,2009.0,Action/Horror,1:25,8,14.482142292408389
72,20,When the Game Stands Tall,10000,71,2014.0,Drama,1:55,-52,14.356099772615265
66,66,Paris,10000,71,2008.0,Comedy/Romance,2:08,0,14.356099772615265
61,41,The Longshots,10000,71,2008.0,Comedy/Drama,1:34,-20,14.356099772615265
52,41,December Boys,10000,70,2007.0,Drama,1:45,-11,14.229389747854103
84,80,Fed Up,10000,70,2014.0,Documentary,1:32,-4,14.229389747854103
0,1,Left Behind,10000,70,2014.0,Sci fi/Action,1:51,1,14.229389747854103
53,49,Ong Bak 2: The Beginning,10000,70,2008.0,Action/Sports and fitness,1:37,-4,14.229389747854103
50,71,Man of Tai Chi,10000,68,2013.0,Action/Sports and fitness,1:45,21,13.973914138485368
23,37,The ABCs of Death,10000,68,2012.0,Horror,2:03,14,13.973914138485368
44,34,Butter,10000,68,2011.0,Comedy,1:30,-10,13.973914138485368
46,53,Last Night,10000,68,2010.0,Drama/Romance,1:32,7,13.973914138485368
73,79,Metallica: Through the Never,10000,68,2013.0,Adventure/Musical,1:32,6,13.973914138485368
31,37,Alien Trespass,10000,68,2009.0,Comedy/Sci fi,1:30,6,13.973914138485368
76,93,Dogtooth,10000,67,2009.0,Drama,1:34,17,13.8451208742507
31,6,The Hottie & the Nottie,10000,67,2008.0,Romance,1:31,-25,13.8451208742507
64,63,King of California,10000,67,2007.0,Drama,1:33,-1,13.8451208742507
83,82,"The Good, the Bad, the Weird",10000,66,2008.0,Action/Western,2:07,-1,13.715604699135167
49,71,Black Death,10000,66,2010.0,Horror/Mystery and thriller,1:42,22,13.715604699135167
78,61,The Concert,10000,66,2009.0,Comedy/Music,1:47,-17,13.715604699135167
72,76,Tokyo!,10000,66,2008.0,Drama,1:52,4,13.715604699135167
81,44,Bella,10000,66,2006.0,Drama,1:31,-37,13.715604699135167
65,79,Trust,10000,66,2010.0,Mystery and thriller,1:46,14,13.715604699135167
30,46,The Lords of Salem,10000,65,2012.0,Horror,1:40,16,13.58535050847747
51,71,VHS 2,10000,65,2013.0,Horror/Mystery and thriller,1:36,20,13.58535050847747
48,68,Leaving,10000,65,2009.0,Romance/Drama,1:25,20,13.58535050847747
85,83,Black Dynamite,10000,64,2009.0,Action/Comedy,1:30,-2,13.454342644059432
72,73,Hallam Foe,10000,64,2007.0,Romance/Drama,1:35,1,13.454342644059432
49,38,Peeples,10000,63,2013.0,Romance,1:35,-11,13.322564864824612
38,29,The Boy,10000,63,2016.0,Horror/Mystery and thriller,1:37,-9,13.322564864824612
47,32,I Spit on Your Grave,10000,63,2010.0,Horror,1:48,-15,13.322564864824612
25,18,The Last Days on Mars,10000,62,2013.0,Sci fi/Mystery and thriller,1:36,-7,13.190000315557024
52,18,Strange Magic,10000,62,2015.0,Comedy/Musical,1:39,-34,13.190000315557024
68,16,Legends of Oz: Dorothy's Return,10000,62,2014.0,Musical/Adventure,1:31,-52,13.190000315557024
24,3,The Apparition,10000,62,2012.0,Horror,1:22,-21,13.190000315557024
80,90,Winnebago Man,10000,62,2009.0,Comedy/Documentary,1:27,10,13.190000315557024
28,21,Spread,10000,61,2009.0,Drama/Comedy,1:37,-7,13.056631493342596
80,66,Vitus,10000,61,2006.0,Drama,2:00,-14,13.056631493342596
78,90,Bears,10000,60,2014.0,Documentary,1:17,12,12.922440211617326
49,73,Valhalla Rising,10000,60,2009.0,Adventure/Action,1:40,24,12.922440211617326
21,48,Vanishing on 7th Street,10000,60,2010.0,Horror/Mystery and thriller,1:25,27,12.922440211617326
73,82,Nothing but the Truth,10000,60,2008.0,Drama,1:47,9,12.922440211617326
58,30,Chaos Theory,10000,60,2007.0,Comedy/Romance,1:28,-28,12.922440211617326
58,76,Kevin Hart: What Now?,10000,59,2016.0,Documentary/Comedy,1:36,18,12.78740756158519
79,75,American Violet,10000,59,2008.0,Drama,1:42,-4,12.78740756158519
67,73,Julia,10000,59,2008.0,Drama/Mystery and thriller,2:24,6,12.78740756158519
35,32,Burke & Hare,10000,59,2010.0,Comedy/Mystery and thriller,1:31,-3,12.78740756158519
40,60,10 Years,10000,58,2011.0,Comedy,1:40,20,12.651513870765422
50,61,The Frozen Ground,10000,57,2013.0,Mystery and thriller,1:45,11,12.514738658402138
73,98,The Loved Ones,10000,57,2009.0,Horror/Mystery and thriller,1:24,25,12.514738658402138
59,57,Feast,10000,56,2006.0,Horror/Comedy,1:26,-2,12.377060587439436
21,18,Devil's Due,10000,56,2014.0,Horror,1:30,-3,12.377060587439436
76,93,Monkey Kingdom,10000,56,2015.0,Documentary,1:22,17,12.377060587439436
33,25,After.Life,10000,56,2009.0,Drama/Mystery and thriller,1:43,-8,12.377060587439436
29,7,Silk,10000,56,2007.0,Romance/Drama,1:49,-22,12.377060587439436
41,42,Ironclad,10000,55,2011.0,Action/Adventure,2:01,1,12.238457412731087
52,4,A Little Bit of Heaven,10000,55,2011.0,Comedy/Romance,1:46,-48,12.238457412731087
75,96,Somers Town,10000,55,2008.0,Comedy/Drama,1:15,21,12.238457412731087
49,6,Battle of the Year,10000,54,2013.0,Drama,1:49,-43,12.098905925115496
42,28,Upside Down,10000,54,2012.0,Sci fi/Romance,1:47,-14,12.098905925115496
22,13,Piranha 3DD,10000,53,2012.0,Horror,1:23,-9,11.958381890942793
56,40,Middle Men,10000,53,2009.0,Drama/Crime,1:45,-16,11.958381890942793
48,15,Hounddog,10000,53,2007.0,Drama,1:33,-33,11.958381890942793
24,52,Donkey Punch,10000,52,2008.0,Mystery and thriller,1:29,28,11.8168599865911
69,12,Atlas Shrugged: Part 1,10000,52,2011.0,Drama,1:42,-57,11.8168599865911
70,54,The Inbetweeners Movie,10000,52,2011.0,Comedy,1:37,-16,11.8168599865911
60,62,Them,10000,52,2006.0,Horror/Mystery and thriller,1:17,2,11.8168599865911
73,76,Ip Man 3,10000,51,2015.0,Sports and fitness/Action,1:45,3,11.674313727451958
78,82,We Live in Public,10000,51,2009.0,Documentary,1:30,4,11.674313727451958
75,94,Under the Sea,10000,50,2009.0,Documentary,0:35,19,11.530715390799685
84,98,Born to Be Wild,10000,50,2011.0,Documentary,0:40,14,11.530715390799685
49,36,The Collection,10000,50,2012.0,Horror/Mystery and thriller,1:22,-13,11.530715390799685
42,76,Let's Talk About the Rain,10000,50,2007.0,Comedy/Drama,1:50,34,11.530715390799685
31,29,The Virginity Hit,10000,49,2010.0,Comedy,1:27,-2,11.3860359318845
83,96,Particle Fever,10000,49,2013.0,Documentary,1:37,13,11.3860359318845
47,12,An American Carol,10000,49,2008.0,Comedy,1:24,-35,11.3860359318845
45,55,Hatchet,10000,49,2006.0,Horror,1:23,10,11.3860359318845
30,38,London Boulevard,10000,48,2010.0,Romance/Drama,1:43,8,11.240244892502977
65,38,Odd Thomas,10000,47,2013.0,Mystery and thriller/Fantasy,1:36,-27,11.093310301199846
29,4,The Cold Light of Day,10000,47,2012.0,Action/Mystery and thriller,1:33,-25,11.093310301199846
68,11,Expelled: No Intelligence Allowed,10000,47,2008.0,Documentary,1:30,-57,11.093310301199846
58,34,Rails & Ties,10000,47,2007.0,Drama,1:41,-24,11.093310301199846
42,32,The Answer Man,10000,47,2009.0,Romance,1:36,-10,11.093310301199846
67,74,Phantasm,10000,46,1979.0,Horror,1:27,7,10.945198564139895
19,7,Fifty Shades of Black,10000,46,2016.0,Comedy,1:32,-12,10.945198564139895
88,93,The Long Goodbye,10000,46,1973.0,Drama/Crime,1:52,5,10.945198564139895
35,28,The Expatriate,10000,46,2012.0,Action/Mystery and thriller,1:44,-7,10.945198564139895
29,7,Dylan Dog: Dead of Night,10000,45,2011.0,Comedy/Horror,1:47,-22,10.795874345554918
68,58,Stuck in Love,10000,45,2012.0,Drama/Comedy,1:37,-10,10.795874345554918
51,18,The Perfect Guy,10000,45,2015.0,Mystery and thriller,1:40,-33,10.795874345554918
63,64,The Escapist,10000,45,2008.0,Drama,1:43,1,10.795874345554918
66,20,Moms' Night Out,10000,44,2014.0,Comedy,1:39,-46,10.645300436514761
46,41,Detention,10000,44,2011.0,Horror/Comedy,1:29,-5,10.645300436514761
21,14,The Pyramid,10000,44,2014.0,Adventure/Horror,1:28,-7,10.645300436514761
89,80,Perfect Blue,10000,44,1997.0,Anime/Mystery and thriller,1:20,-9,10.645300436514761
60,75,Five Minutes of Heaven,10000,44,2009.0,Drama,1:30,15,10.645300436514761
70,57,The Perfect Game,10000,44,2008.0,Kids and family/Drama,1:58,-13,10.645300436514761
37,40,Iron Sky,10000,43,2012.0,Sci fi/Comedy,1:33,3,10.493437610589469
53,19,Tyler Perry's Boo! A Madea Halloween,10000,43,2016.0,Comedy/Adventure,1:43,-34,10.493437610589469
41,67,The Pact,10000,42,2012.0,Horror/Mystery and thriller,1:29,26,10.34024446475599
37,14,The Loft,10000,42,2014.0,Mystery and thriller,1:43,-23,10.34024446475599
86,88,Hubble,10000,42,2010.0,Documentary,0:43,2,10.34024446475599
40,40,The Wendell Baker Story,10000,42,2005.0,Comedy,1:39,0,10.34024446475599
51,39,Batman: The Killing Joke,10000,41,2016.0,Adventure/Fantasy,1:16,-12,10.185677243651742
63,39,Blue Like Jazz,10000,41,2012.0,Drama,1:46,-24,10.185677243651742
63,56,Cemetery Junction,10000,41,2010.0,Comedy,1:35,-7,10.185677243651742
62,10,God's Not Dead 2,10000,40,2016.0,Drama,2:01,-52,10.029689644980788
47,78,Heartless,10000,40,2009.0,Drama/Horror,1:49,31,10.029689644980788
61,10,The Air I Breathe,10000,40,2007.0,Drama,1:37,-51,10.029689644980788
40,40,Dark Matter,10000,40,2007.0,Drama,1:26,0,10.029689644980788
69,64,Martyrs,10000,39,2008.0,Drama/Horror,1:37,-5,9.872232603526719
49,61,Leaves of Grass,10000,38,2009.0,Drama/Comedy,1:44,12,9.713254050808038
34,55,The Descent: Part 2,10000,38,2009.0,Horror/Mystery and thriller,1:34,21,9.713254050808038
49,74,Splinter,10000,38,2008.0,Horror,1:22,25,9.713254050808038
65,81,Island of Lemurs: Madagascar,10000,37,2014.0,Documentary,0:40,16,9.552698646911638
73,73,Chocolate,10000,37,2008.0,Action,1:50,0,9.552698646911638
30,28,Jessabelle,10000,36,2014.0,Horror/Mystery and thriller,1:30,-2,9.390507480439723
46,81,The Hole,10000,36,2009.0,Horror/Mystery and thriller,1:32,35,9.390507480439723
25,3,Bucky Larson: Born to Be a Star,10000,36,2011.0,Comedy,1:36,-22,9.390507480439723
58,89,Jerichow,10000,36,2008.0,Drama,1:29,31,9.390507480439723
44,67,Smiley Face,10000,36,2007.0,Comedy,1:24,23,9.390507480439723
87,34,War Room,10000,35,2015.0,Drama,2:00,-53,9.22661773178138
87,51,Elite Squad,10000,35,2007.0,Drama/Action,1:54,-36,9.22661773178138
21,14,The Romantics,10000,35,2010.0,Comedy/Drama,1:34,-7,9.22661773178138
92,97,The Hidden Fortress,10000,34,1958.0,Comedy,2:19,5,9.060962294042406
67,91,London River,10000,34,2009.0,Drama,1:27,24,9.060962294042406
59,21,Frankie & Alice,10000,33,2010.0,Drama,1:40,-38,8.893469344897873
60,61,Hours,10000,33,2013.0,Drama,1:37,1,8.893469344897873
46,79,The Machine,10000,33,2013.0,Sci fi/Mystery and thriller,1:31,33,8.893469344897873
31,72,Grace,10000,32,2009.0,Comedy/Horror,1:34,41,8.724061861322062
61,28,Play the Game,10000,32,2008.0,Comedy/Romance,1:45,-33,8.724061861322062
64,84,Beautiful Kate,10000,31,2009.0,Drama,1:36,20,8.552657067536824
87,61,Rosencrantz and Guildenstern Are Dead,10000,31,1990.0,Comedy/Drama,1:58,-26,8.552657067536824
31,16,What Goes Up,10000,31,2009.0,Drama,1:44,-15,8.552657067536824
29,45,Winged Creatures,10000,31,2008.0,Drama,1:35,16,8.552657067536824
57,83,Afflicted,10000,30,2013.0,Horror/Mystery and thriller,1:25,26,8.379165804519056
32,3,Twelve,10000,30,2010.0,Drama,1:34,-29,8.379165804519056
53,72,Kites,10000,29,2010.0,Romance/Action,2:13,19,8.20349180691225
42,45,Take,10000,29,2007.0,Drama,1:39,3,8.20349180691225
80,4,Hillary's America: The Secret History of the Democratic Party,10000,28,2016.0,Documentary,1:47,-76,8.02553087005176
84,64,Hachiko: A Dog's Story,10000,28,2009.0,Drama,1:33,-20,8.02553087005176
66,64,To the Arctic,10000,28,2012.0,Documentary,0:40,-2,8.02553087005176
45,4,6 Souls,10000,28,2010.0,Horror/Mystery and thriller,1:53,-41,8.02553087005176
84,96,Yip Man 2,10000,28,2010.0,History/Drama,1:48,12,8.02553087005176
30,36,Battle for the Planet of the Apes,10000,28,1973.0,Sci fi,1:32,6,8.02553087005176
46,4,Witless Protection,10000,28,2008.0,Comedy,1:37,-42,8.02553087005176
83,85,My Name Is Khan,10000,27,2010.0,Drama,2:45,2,7.845169885845621
65,89,Creep,10000,27,2014.0,Comedy/Horror,1:20,24,7.845169885845621
61,41,Wild Child,10000,27,2008.0,Comedy,1:38,-20,7.845169885845621
62,41,Crooked Arrows,10000,27,2012.0,Drama,1:45,-21,7.845169885845621
23,12,ATM,10000,26,2012.0,Horror/Mystery and thriller,1:30,-11,7.662285721192069
78,92,Matador,10000,26,1986.0,Comedy/Drama,1:42,14,7.662285721192069
71,73,"Angus, Thongs and Perfect Snogging",10000,26,2008.0,Comedy,1:39,2,7.662285721192069
54,19,The Amateurs (The Moguls) (Dirty Movie),10000,26,2005.0,,,-35,7.662285721192069
37,12,Walk of Shame,10000,25,2014.0,Comedy,1:35,-25,7.476743906106103
43,20,The Red Baron,10000,25,2008.0,Drama/Action,1:46,-23,7.476743906106103
48,64,The Cake Eaters,10000,25,2007.0,Drama,1:35,16,7.476743906106103
47,24,Blind Dating,10000,25,2007.0,Romance,1:39,-23,7.476743906106103
84,8,America: Imagine the World Without Her,10000,24,2014.0,Documentary,1:43,-76,7.288397090280924
75,25,Letters to God,10000,24,2010.0,Drama,1:54,-50,7.288397090280924
82,63,Felon,10000,24,2008.0,Drama,1:44,-19,7.288397090280924
82,39,To Save a Life,10000,23,2010.0,Drama,2:00,-43,7.097083215743026
58,74,Defendor,10000,23,2009.0,Comedy/Drama,1:35,16,7.097083215743026
60,4,Atlas Shrugged: Part 2,10000,23,2012.0,Drama,1:52,-56,7.097083215743026
78,57,Trailer Park Boys: The Movie,10000,23,2006.0,Comedy,1:37,-21,7.097083215743026
34,20,Stolen,10000,20,2012.0,Mystery and thriller/Action,1:36,-14,6.503449126242364
32,30,Amityville: The Awakening,10000,20,2017.0,Mystery and thriller/Horror,1:25,-2,6.503449126242364
41,20,From Prada to Nada,10000,20,2011.0,Comedy/Romance,1:47,-21,6.503449126242364
83,25,Do You Believe?,10000,20,2015.0,Drama,1:55,-58,6.503449126242364
38,35,Severed Ways: The Norse Discovery of America,10000,20,2007.0,Drama/Adventure,1:50,-3,6.503449126242364
33,45,Death in Love,10000,20,2008.0,Drama,1:37,12,6.503449126242364
62,80,He Was a Quiet Man,10000,20,2007.0,Drama,1:39,18,6.503449126242364
42,5,Waiting for Forever,10000,19,2010.0,Romance,1:34,-37,6.298266028731006
30,0,Saving Christmas,10000,19,2014.0,Comedy/Other,1:20,-30,6.298266028731006
70,74,Night of the Creeps,10000,19,1986.0,Comedy/Horror,1:25,4,6.298266028731006
22,17,Poltergeist III,10000,18,1988.0,Horror,1:36,-5,6.088990769440213
90,83,The Girl Who Leapt Through Time,10000,18,2006.0,Comedy/Sci fi,1:38,-7,6.088990769440213
25,33,Night of the Demons,10000,18,2009.0,Horror,1:30,8,6.088990769440213
40,22,Make It Happen,10000,18,2008.0,Drama,1:30,-18,6.088990769440213
62,39,Goal! 2: Living the Dream,10000,18,2007.0,Drama,1:55,-23,6.088990769440213
27,22,Shrooms,10000,18,2006.0,Horror,1:24,-5,6.088990769440213
29,29,Bitch Slap,10000,17,2009.0,Action,1:44,0,5.875307153057772
46,6,Standing Ovation,10000,17,2010.0,Musical,1:48,-40,5.875307153057772
92,94,Chak De India,10000,17,2007.0,Drama,2:28,2,5.875307153057772
44,19,The Haunting in Connecticut 2: Ghosts of Georgia,10000,16,2013.0,Horror,1:41,-25,5.656854249492381
78,75,Jodhaa Akbar,10000,16,2008.0,Drama/Romance,3:33,-3,5.656854249492381
60,81,Sex Positive,10000,16,2008.0,Documentary/Gay and lesbian,1:15,21,5.656854249492381
77,53,The Fluffy Movie,10000,15,2014.0,Comedy,1:41,-24,5.433216825139731
59,53,Justin Bieber's Believe,10000,15,2013.0,Documentary/Music,1:31,-6,5.433216825139731
72,80,Jailhouse Rock,10000,15,1957.0,Musical,1:36,8,5.433216825139731
51,7,Addicted,10000,14,2014.0,Mystery and thriller/Drama,1:45,-44,5.203912939677927
90,93,A Better Tomorrow,10000,14,1986.0,Drama/Crime,1:31,3,5.203912939677927
25,38,The Perfect Sleep,10000,13,2008.0,Drama/Mystery and thriller,1:39,13,4.968377601139757
93,100,3 Idiots,10000,13,2009.0,Comedy,2:40,7,4.968377601139757
27,0,House,10000,13,2008.0,Horror/Mystery and thriller,1:28,-27,4.968377601139757
33,17,The Oxford Murders,10000,12,2008.0,Drama/Crime,1:50,-16,4.725940818339814
27,8,The Skeptic,10000,12,2009.0,Horror/Mystery and thriller,1:29,-19,4.725940818339814
34,75,The Burrowers,10000,12,2008.0,Western/Horror,1:36,41,4.725940818339814
40,17,Cleaner,10000,12,2007.0,Drama/Crime,1:32,-23,4.725940818339814
38,33,Wedding Daze,10000,12,2006.0,Romance,1:30,-5,4.725940818339814
96,91,Like Stars on Earth,10000,11,2007.0,Drama,2:45,-5,4.475797488182033
65,60,Demons,10000,10,1985.0,Horror,1:30,-5,4.216965034285822
27,10,Embrace of the Vampire,10000,10,2013.0,Horror,1:30,-17,4.216965034285822
40,50,Return From Witch Mountain,10000,10,1978.0,Kids and family/Sci fi,1:35,10,4.216965034285822
69,20,Woman Thou Art Loosed: On the 7th Day,10000,10,2012.0,Drama,1:41,-49,4.216965034285822
82,80,"Bon Cop, Bad Cop",10000,10,2006.0,Comedy/Action,1:56,-2,4.216965034285822
76,78,Tinker Bell and the Great Fairy Rescue,10000,9,2010.0,Kids and family/Animation,1:13,2,3.9482220388574776
78,67,Welcome to the Land of Ch'tis,10000,9,2008.0,Comedy,1:46,-11,3.9482220388574776
55,63,Camp Rock 2: The Final Jam,10000,8,2010.0,Musical/Comedy,1:30,8,3.668016172818685
34,0,Space Chimps 2: Zartog Strikes Back,10000,8,2010.0,Comedy/Animation,1:15,-34,3.668016172818685
50,75,Alien Autopsy,10000,8,2006.0,Comedy/Sci fi,1:35,25,3.668016172818685
64,63,The Poker House,10000,8,2008.0,Drama,1:33,-1,3.668016172818685
43,75,White Noise 2: The Light,10000,8,2007.0,Mystery and thriller,1:39,32,3.668016172818685
22,13,Day of the Dead,10000,8,2008.0,Horror/Mystery and thriller,1:27,-9,3.668016172818685
92,100,Batman: Under the Red Hood,10000,7,2010.0,Adventure/Action,1:15,8,3.374320069567275
83,14,Rise of the Footsoldier,10000,7,2007.0,Drama/Crime,1:59,-69,3.374320069567275
51,14,LOL,10000,7,2012.0,Comedy/Drama,1:37,-37,3.374320069567275
25,0,Lost Boys: The Tribe,10000,7,2008.0,Horror,1:32,-25,3.374320069567275
28,29,Killshot,10000,7,2009.0,Drama/Mystery and thriller,1:24,1,3.374320069567275
94,86,Rang de Basanti,10000,7,2006.0,Comedy/Drama,2:40,-8,3.374320069567275
25,33,Horsemen,10000,6,2009.0,Horror/Mystery and thriller,1:30,8,3.064393493081416
57,67,Resident Evil: Degeneration,10000,6,2008.0,Action/Horror,1:37,10,3.064393493081416
31,0,Tekken,10000,6,2010.0,Sci fi/Drama,1:32,-31,3.064393493081416
21,20,Gooby,10000,5,2009.0,Comedy/Adventure,1:39,-1,2.734363528521053
53,40,My Dinner With Jimi,10000,5,2003.0,Biography/Drama,1:30,-13,2.734363528521053
66,60,Jackie Chan in Shinjuku Incident,10000,5,2009.0,Drama/Crime,2:00,-6,2.734363528521053
58,60,Center Stage: Turn It Up,10000,5,2008.0,Drama,1:30,2,2.734363528521053
83,80,Death Note 2: The Last Name,10000,5,2007.0,Drama/Horror,2:20,-3,2.734363528521053
85,100,The Man From Earth,10000,5,2007.0,Sci fi,1:23,15,2.734363528521053
90,98,Parasite,5000,458,2019.0,Comedy/Mystery and thriller,2:12,8,46.0299945796095
67,87,First Man,5000,450,2018.0,Drama/Biography,2:21,20,45.52582462974842
61,91,Widows,5000,417,2018.0,Drama/Crime,2:08,30,43.40952506736447
69,93,The Favourite,5000,416,2018.0,Drama/Comedy,2:00,24,43.344433542750146
63,83,Midsommar,5000,396,2019.0,Horror/Mystery and thriller,2:25,20,42.030009793706704
72,95,Roma,5000,396,2018.0,Drama,2:15,23,42.030009793706704
60,65,Vice,5000,366,2018.0,Biography/Comedy,2:12,5,40.01065658976095
87,90,Isle of Dogs,5000,364,2018.0,Adventure/Animation,1:41,3,39.87386781202083
26,42,A Wrinkle in Time,5000,338,2018.0,Adventure/Fantasy,1:49,16,38.06912875070366
88,95,Soul,5000,336,2020.0,Comedy/Animation,1:40,7,37.928183927623856
85,81,Judy,5000,334,2019.0,Music/Drama,1:58,-4,37.78692414196535
95,88,Onward,5000,334,2020.0,Comedy/Animation,1:43,-7,37.78692414196535
84,68,Bombshell,5000,330,2019.0,Drama,1:48,-16,37.50344926092717
53,19,Cats,5000,326,2019.0,Comedy/Drama,1:50,-34,37.2186828871591
82,99,Eighth Grade,5000,316,2018.0,Drama/Comedy,1:33,17,36.50097174890849
83,26,Gemini Man,5000,315,2019.0,Fantasy/Mystery and thriller,1:57,-57,36.42873547273243
78,88,Ready or Not,5000,307,2019.0,Horror/Mystery and thriller,1:35,10,35.847715538579024
70,93,Sorry to Bother You,5000,307,2018.0,Sci fi/Fantasy,1:45,23,35.847715538579024
79,83,Creed II,5000,307,2018.0,Drama,2:10,4,35.847715538579024
42,45,The Meg,5000,305,2018.0,Sci fi/Mystery and thriller,1:53,3,35.701576960735366
23,47,Downsizing,5000,301,2017.0,Drama/Fantasy,2:15,24,35.40821712816412
74,81,Long Shot,5000,301,2019.0,Romance,2:03,7,35.40821712816412
96,77,Richard Jewell,5000,292,2019.0,Drama,2:11,-19,34.74275727052265
69,48,Skyscraper,5000,291,2018.0,Action/Mystery and thriller,1:42,-21,34.66834566630047
65,63,Sicario: Day of the Soldado,5000,288,2018.0,Drama/Crime,2:02,-2,34.44453330922775
64,89,You Were Never Really Here,5000,284,2017.0,Drama/Mystery and thriller,1:30,25,34.144751986566035
65,79,Mamma Mia! Here We Go Again,5000,277,2018.0,Musical/Comedy,1:54,14,33.61629573014229
65,88,Ralph Breaks the Internet,5000,275,2018.0,Comedy/Animation,1:52,23,33.46439159473001
83,72,Christopher Robin,5000,275,2018.0,Comedy/Adventure,1:44,-11,33.46439159473001
84,75,The Gentlemen,5000,273,2020.0,Comedy/Drama,1:53,-9,33.3120726055166
25,28,Suburbicon,5000,259,2017.0,Mystery and thriller/Comedy,1:45,3,32.23386276280209
51,59,The Neon Demon,5000,259,2016.0,Horror/Mystery and thriller,1:57,8,32.23386276280209
77,85,Game Night,5000,256,2018.0,Comedy/Action,1:40,8,32.0
65,79,All the Money in the World,5000,256,2017.0,Drama/Crime,2:12,14,32.0
73,84,A Simple Favor,5000,254,2018.0,Mystery and thriller/Comedy,1:57,11,31.843520294778347
87,92,Searching,5000,253,2018.0,Mystery and thriller,1:42,5,31.765107230441497
73,75,Bad Times at the El Royale,5000,252,2018.0,Drama/Crime,2:21,2,31.686577854669387
78,95,The Death of Stalin,5000,248,2017.0,Comedy,1:47,17,31.371284444297096
87,100,Paddington 2,5000,245,2017.0,Kids and family/Comedy,1:43,13,31.133561386575195
73,93,Toni Erdmann,5000,239,2016.0,Comedy/Drama,2:42,20,30.654814192715765
81,92,Good Time,5000,238,2017.0,Crime/Mystery and thriller,1:41,11,30.574586918379627
52,69,Free Fire,5000,236,2016.0,Comedy/Action,1:26,17,30.41375210935341
88,91,"Love, Simon",5000,235,2018.0,Gay and lesbian/Drama,1:50,3,30.333143098167753
72,78,Scary Stories to Tell in the Dark,5000,232,2019.0,Horror/Mystery and thriller,1:51,6,30.090540621339713
51,84,Blockers,5000,229,2018.0,Comedy,1:42,33,29.846758835604586
79,42,Stuber,5000,227,2019.0,Comedy/Action,1:33,-37,29.683571984087028
75,70,Hostiles,5000,223,2017.0,Western/Drama,2:13,-5,29.355571478323455
63,79,American Honey,5000,215,2016.0,Drama/Comedy,2:42,16,28.69287309120695
40,55,The Commuter,5000,213,2018.0,Mystery and thriller/Action,1:44,15,28.52576185074631
64,56,Ma,5000,208,2019.0,Mystery and thriller/Horror,1:39,-8,28.10538794609019
70,65,Annabelle Comes Home,5000,206,2019.0,Horror/Mystery and thriller,1:46,-5,27.93617951273954
54,53,Demolition,5000,206,2015.0,Comedy/Drama,1:41,-1,27.93617951273954
57,63,Child's Play,5000,205,2019.0,Mystery and thriller/Horror,1:30,6,27.85134436832817
34,24,The Nun,5000,205,2018.0,Horror/Mystery and thriller,1:36,-10,27.85134436832817
46,47,Irrational Man,5000,204,2015.0,Comedy,1:34,1,27.76635389491961
75,84,Crawl,5000,202,2019.0,Horror/Mystery and thriller,1:27,9,27.595902757162747
84,97,Mudbound,5000,199,2017.0,Drama/History,2:14,13,27.33903448190164
68,66,Victoria & Abdul,5000,198,2017.0,Drama/Biography,1:50,-2,27.253089591424086
71,88,Lady Macbeth,5000,197,2016.0,Drama/History,1:29,17,27.166981771469644
71,86,Ingrid Goes West,5000,196,2017.0,Comedy/Drama,1:38,15,27.08070988374737
84,96,The Salesman,5000,196,2016.0,Drama/Mystery and thriller,2:05,12,27.08070988374737
37,11,Fifty Shades Freed,5000,195,2018.0,Drama/Romance,1:45,-26,26.9942727761599
87,88,Upgrade,5000,193,2018.0,Sci fi/Horror,1:35,1,26.820898222527152
72,76,Miss Sloane,5000,193,2016.0,Mystery and thriller/Drama,2:12,4,26.820898222527152
76,92,Raw,5000,193,2016.0,Horror/Mystery and thriller,1:38,16,26.820898222527152
51,92,Certain Women,5000,192,2016.0,Drama,1:47,41,26.733958401075075
45,42,Gold,5000,186,2016.0,Drama/Adventure,2:00,-3,26.20870666631663
72,92,The Meyerowitz Stories (New and Selected),5000,186,2017.0,Comedy,1:50,20,26.20870666631663
52,86,Maggie's Plan,5000,184,2015.0,Romance,1:38,34,26.03221601518546
85,92,"I, Daniel Blake",5000,183,2016.0,Drama,1:40,7,25.943701036580038
37,47,Knight of Cups,5000,182,2015.0,Drama,1:58,10,25.855004487777162
58,89,A Bigger Splash,5000,182,2015.0,Drama/Mystery and thriller,2:05,31,25.855004487777162
62,63,Truth,5000,181,2015.0,Drama,2:01,1,25.766124995595995
77,87,Professor Marston & the Wonder Women,5000,181,2017.0,History/Drama,1:48,10,25.766124995595995
71,63,Goodbye Christopher Robin,5000,180,2017.0,Drama/Biography,1:47,-8,25.677061168818504
57,74,Miles Ahead,5000,180,2016.0,Biography/Music,1:36,17,25.677061168818504
37,47,To the Wonder,5000,177,2012.0,Drama/Romance,1:52,10,25.40874949100198
53,27,My Big Fat Greek Wedding 2,5000,176,2016.0,Romance,1:34,-26,25.31893404088985
83,97,Weiner,5000,176,2016.0,Documentary,1:36,14,25.31893404088985
34,36,Our Brand Is Crisis,5000,174,2015.0,Comedy,1:48,2,25.13872691364861
82,26,Rambo: Last Blood,5000,173,2019.0,Action,1:29,-56,25.048332202229876
62,51,12 Strong,5000,172,2018.0,War/Drama,2:10,-11,24.957741334700298
71,90,Their Finest,5000,170,2016.0,Romance/Drama,1:57,19,24.775964830134004
71,83,Denial,5000,167,2016.0,Drama,1:50,12,24.501788937948916
81,93,The Red Turtle,5000,166,2016.0,Adventure/Animation,1:20,12,24.409987387794924
95,81,Abominable,5000,166,2019.0,Kids and family/Comedy,1:37,-14,24.409987387794924
76,84,A United Kingdom,5000,164,2016.0,History/Drama,1:51,8,24.225759698543914
71,52,The Glass Castle,5000,164,2017.0,Drama/Biography,2:07,-19,24.225759698543914
71,18,Death Wish,5000,163,2018.0,Mystery and thriller/Action,1:47,-53,24.13333007004028
57,63,Bird Box,5000,163,2018.0,Sci fi/Adventure,2:04,6,24.13333007004028
41,44,Billy Lynn's Long Halftime Walk,5000,160,2016.0,Comedy/Drama,1:48,3,23.854756574160536
71,92,Southside With You,5000,160,2016.0,Drama/Romance,1:21,21,23.854756574160536
86,84,Loving Vincent,5000,160,2017.0,Drama/Biography,1:35,-2,23.854756574160536
44,74,The Invisible Woman,5000,159,2013.0,Romance/Drama,1:51,30,23.761464418909437
47,56,Albert Nobbs,5000,159,2011.0,Romance/Drama,1:53,9,23.761464418909437
28,34,By the Sea,5000,158,2015.0,Romance/Drama,2:02,6,23.667951973591787
50,79,An Inconvenient Sequel: Truth to Power,5000,156,2017.0,Documentary,1:40,29,23.480258506151625
45,76,My Cousin Rachel,5000,155,2017.0,Drama/Romance,1:46,31,23.38607355742051
30,37,Morgan,5000,154,2016.0,Horror/Sci fi,1:28,7,23.291660464128444
56,89,The Weekend,5000,154,2013.0,Drama/Comedy,1:33,33,23.291660464128444
57,77,Elvis & Nixon,5000,154,2016.0,Comedy,1:26,20,23.291660464128444
41,58,Absolutely Fabulous: The Movie,5000,154,2016.0,Comedy,1:26,17,23.291660464128444
88,85,Dora and the Lost City of Gold,5000,153,2019.0,Adventure/Mystery and thriller,1:42,-3,23.197017186759677
88,97,Mustang,5000,152,2015.0,Drama,1:37,9,23.102141654099842
88,89,Maudie,5000,151,2016.0,Drama/Biography,1:55,1,23.007031762531238
49,82,Chi-Raq,5000,150,2015.0,Drama/Comedy,2:07,33,22.911685375307673
84,80,Marshall,5000,148,2017.0,Biography/Drama,1:58,-4,22.72027439676837
85,96,Embrace of the Serpent,5000,148,2015.0,Drama/Adventure,2:03,11,22.72027439676837
68,86,The Wolfpack,5000,147,2015.0,Biography/Documentary,1:29,18,22.624205359490148
79,85,Tyson,5000,147,2008.0,Documentary,1:30,6,22.624205359490148
63,22,The Book of Henry,5000,146,2017.0,Drama/Mystery and thriller,1:40,-41,22.52789093302636
70,99,Things to Come,5000,146,2016.0,Drama,1:41,29,22.52789093302636
41,53,Fading Gigolo,5000,146,2013.0,Comedy/Romance,1:38,12,22.52789093302636
69,70,Bleed for This,5000,145,2016.0,Biography/Drama,1:56,1,22.43132880334213
56,85,The Meddler,5000,143,2015.0,Comedy/Drama,1:40,29,22.237451987521194
50,72,Our Kind of Traitor,5000,142,2016.0,Mystery and thriller,1:48,22,22.14013247996374
68,93,"Lo and Behold, Reveries of the Connected World",5000,141,2016.0,Documentary,1:38,25,22.042555624480066
66,58,The Dressmaker,5000,141,2015.0,Drama/Mystery and thriller,1:53,-8,22.042555624480066
90,98,Anvil! The Story of Anvil,5000,140,2008.0,Documentary,1:25,8,21.944718908089367
90,96,The Look of Silence,5000,139,2014.0,Documentary,1:39,6,21.84661977512174
44,32,Home Again,5000,139,2017.0,Romance,1:37,-12,21.84661977512174
44,33,"Men, Women & Children",5000,138,2014.0,Drama,1:59,-11,21.748255626180264
89,99,My Life as a Zucchini,5000,137,2016.0,Drama/Animation,1:06,10,21.649623817070065
77,96,We Are the Best!,5000,137,2013.0,Drama,1:42,19,21.649623817070065
72,72,He Named Me Malala,5000,135,2015.0,Documentary,1:27,0,21.451546410907937
42,39,We Are Your Friends,5000,135,2015.0,Romance/Drama,1:36,-3,21.451546410907937
74,81,Indignation,5000,135,2016.0,Drama,1:50,7,21.451546410907937
70,89,Certified Copy,5000,135,2010.0,Romance/Drama,1:46,19,21.451546410907937
62,88,"Kumiko, the Treasure Hunter",5000,134,2014.0,Adventure/Drama,1:44,26,21.35209529135088
57,87,The Trip to Italy,5000,133,2014.0,Comedy,1:46,30,21.252365464220812
57,63,Sleeping With Other People,5000,133,2015.0,Romance,1:40,6,21.252365464220812
69,88,The Tribe,5000,132,2014.0,Drama/Crime,2:10,19,21.152354044022278
37,44,Song to Song,5000,131,2017.0,Romance/Music,2:09,7,21.05205809326756
53,86,Meek's Cutoff,5000,130,2010.0,Western,1:41,33,20.951474621135226
43,48,The Zero Theorem,5000,130,2013.0,Sci fi/Drama,1:47,5,20.951474621135226
89,88,Mommy,5000,130,2014.0,Drama,2:19,-1,20.951474621135226
67,85,The Girl With All the Gifts,5000,128,2016.0,Horror/Mystery and thriller,1:51,18,20.749432874416154
76,78,Mother and Child,5000,128,2009.0,Drama,2:06,2,20.749432874416154
86,93,The Eagle Huntress,5000,128,2016.0,Documentary,1:27,7,20.749432874416154
49,78,The Little Hours,5000,128,2017.0,Comedy,1:30,29,20.749432874416154
85,98,Kedi,5000,128,2016.0,Documentary,1:20,13,20.749432874416154
38,56,Dom Hemingway,5000,128,2013.0,Comedy/Drama,1:33,18,20.749432874416154
42,65,Tamara Drewe,5000,127,2010.0,Comedy,1:50,23,20.647968338800368
48,80,The Assassin,5000,126,2015.0,Drama/Sports and fitness,1:45,32,20.546203756731995
71,88,Christine,5000,126,2016.0,Drama/Biography,1:59,17,20.546203756731995
78,84,Testament of Youth,5000,126,2014.0,Drama/Biography,2:09,6,20.546203756731995
42,65,The Wall,5000,125,2017.0,War/Mystery and thriller,1:30,23,20.444135848948562
47,50,Parkland,5000,125,2013.0,Drama/History,1:34,3,20.444135848948562
49,75,Good Kill,5000,125,2014.0,War/Drama,1:42,26,20.444135848948562
56,49,Super,5000,124,2010.0,Comedy/Action,1:36,-7,20.341761273786197
92,76,Spies in Disguise,5000,123,2019.0,Kids and family/Comedy,1:42,-16,20.23907662547856
57,64,Before I Fall,5000,123,2017.0,Drama/Mystery and thriller,1:40,7,20.23907662547856
77,98,Timbuktu,5000,123,2014.0,Drama,1:37,21,20.23907662547856
76,82,The Armstrong Lie,5000,122,2013.0,Documentary,2:02,6,20.136078432395202
86,78,In a Better World,5000,122,2010.0,Drama,1:53,-8,20.136078432395202
86,89,Tim's Vermeer,5000,122,2013.0,Documentary,1:20,3,20.136078432395202
61,45,"Everything, Everything",5000,122,2017.0,Drama/Romance,1:36,-16,20.136078432395202
85,93,Best of Enemies,5000,121,2015.0,Documentary/Biography,1:28,8,20.032763155216593
51,72,Ferdinand,5000,120,2017.0,Comedy/Adventure,1:48,21,19.92912718504312
82,95,Pariah,5000,120,2011.0,Gay and lesbian/Drama,1:26,13,19.92912718504312
73,88,Born to Be Blue,5000,119,2015.0,History/Romance,1:37,15,19.82516684143501
33,28,Unforgettable,5000,119,2017.0,Mystery and thriller,1:40,-5,19.82516684143501
55,91,Mississippi Grind,5000,119,2015.0,Drama,1:48,36,19.82516684143501
87,91,A Man Called Ove,5000,119,2015.0,Comedy/Drama,1:56,4,19.82516684143501
41,25,Table 19,5000,118,2017.0,Drama/Comedy,1:27,-16,19.720878370380042
76,96,Hitchcock/Truffaut,5000,118,2015.0,Documentary,1:20,20,19.720878370380042
96,43,The Art of Racing in the Rain,5000,118,2019.0,Comedy/Drama,1:49,-53,19.720878370380042
36,54,Married Life,5000,118,2007.0,Romance/Drama,1:30,18,19.720878370380042
71,88,Venus in Fur,5000,117,2013.0,Drama/Comedy,1:35,17,19.616257942185833
68,71,Miss You Already,5000,117,2015.0,Comedy/Drama,1:52,3,19.616257942185833
55,65,Is Anybody There?,5000,117,2008.0,Drama,1:32,10,19.616257942185833
87,95,West of Memphis,5000,117,2012.0,Documentary/Drama,2:30,8,19.616257942185833
82,72,Sarah's Key,5000,117,2010.0,Drama,1:51,-10,19.616257942185833
50,65,Laggies,5000,117,2014.0,Comedy/Romance,1:40,15,19.616257942185833
76,92,Into the Abyss,5000,116,2011.0,Documentary/Drama,1:47,16,19.511301649293156
72,77,Thank You for Your Service,5000,115,2017.0,Drama/Biography,1:48,5,19.406005504006643
76,94,Lore,5000,115,2012.0,Drama/War,1:49,18,19.406005504006643
60,71,Liberal Arts,5000,115,2012.0,Comedy/Romance,1:37,11,19.406005504006643
59,77,The Hero,5000,115,2017.0,Drama,1:36,18,19.406005504006643
47,68,Wuthering Heights,5000,114,2011.0,Drama/Romance,2:08,21,19.300365436139025
50,78,Ginger & Rosa,5000,114,2012.0,Gay and lesbian/Drama,1:30,28,19.300365436139025
54,32,Austenland,5000,114,2013.0,Romance,1:36,-22,19.300365436139025
71,76,A Late Quartet,5000,113,2012.0,Drama,1:45,5,19.194377290564812
48,12,W.E.,5000,113,2011.0,Drama/Romance,1:59,-36,19.194377290564812
84,95,Snow White,5000,113,2012.0,Drama/Fantasy,1:44,11,19.194377290564812
67,67,Snow Angels,5000,113,2007.0,Drama,1:46,0,19.194377290564812
50,33,Insidious: The Last Key,5000,112,2018.0,Mystery and thriller/Horror,1:43,-17,19.088036824679065
48,38,Restless,5000,112,2011.0,Drama,1:33,-10,19.088036824679065
71,88,White God,5000,112,2014.0,Drama,1:59,17,19.088036824679065
55,65,How I Live Now,5000,110,2013.0,Drama,1:41,10,18.874281508207943
72,90,Lebanon,5000,110,2009.0,Drama/War,1:33,18,18.874281508207943
81,74,The Photograph,5000,109,2020.0,Drama/Romance,1:46,-7,18.76685771072333
52,45,Hands of Stone,5000,109,2016.0,Drama/Biography,1:45,-7,18.76685771072333
65,83,The Wave,5000,109,2015.0,Adventure/Mystery and thriller,1:45,18,18.76685771072333
42,66,2 Days in New York,5000,109,2012.0,Comedy,1:35,24,18.76685771072333
62,85,Sightseers,5000,109,2012.0,Comedy,1:28,23,18.76685771072333
70,89,The Trip,5000,108,2010.0,Comedy,1:49,19,18.659063693305395
25,7,Diana,5000,108,2013.0,Drama/Biography,1:53,-18,18.659063693305395
55,61,Flash of Genius,5000,108,2008.0,Drama/Biography,2:00,6,18.659063693305395
53,72,The Congress,5000,108,2013.0,Sci fi,2:02,19,18.659063693305395
59,75,Love Is All You Need,5000,108,2012.0,Romance,1:56,16,18.659063693305395
34,25,Third Person,5000,107,2013.0,Romance/Drama,2:16,-9,18.55089473417879
71,66,Anthropoid,5000,107,2016.0,Mystery and thriller/War,2:00,-5,18.55089473417879
63,25,The Singer,5000,107,2006.0,Biography/Drama,1:56,-38,18.55089473417879
81,95,Pina,5000,106,2011.0,Documentary,1:44,14,18.442346006574258
40,54,The Belko Experiment,5000,106,2016.0,Mystery and thriller/Action,1:30,14,18.442346006574258
70,82,The Unknown Known,5000,106,2013.0,Documentary,1:42,12,18.442346006574258
91,89,Young at Heart,5000,106,2007.0,Documentary,1:50,-2,18.442346006574258
56,83,Tale of Tales,5000,105,2015.0,Adventure/Fantasy,2:05,27,18.333412575379587
41,60,Kaboom,5000,105,2010.0,Comedy/Sci fi,1:26,19,18.333412575379587
57,60,The Last Five Years,5000,104,2014.0,Musical/Romance,1:34,3,18.22408939365073
61,86,My Friend Dahmer,5000,104,2017.0,Drama/Biography,1:47,25,18.22408939365073
48,68,Life During Wartime,5000,104,2009.0,Drama/Comedy,1:38,20,18.22408939365073
31,51,At Any Price,5000,104,2012.0,Drama,1:45,20,18.22408939365073
89,96,The Beatles: Eight Days a Week -- The Touring Years,5000,103,2016.0,Documentary/Music,1:46,7,18.1143712989759
10,99,Knock Down the House,5000,103,2019.0,Documentary,1:26,89,18.1143712989759
69,97,This Is Not a Film,5000,102,2010.0,Documentary,1:15,28,18.004253009684938
89,87,"Like Father, Like Son",5000,102,2013.0,Drama,2:00,-2,18.004253009684938
89,95,Finding Vivian Maier,5000,102,2013.0,Biography/Mystery and thriller,1:23,6,18.004253009684938
78,89,The Angels' Share,5000,102,2012.0,Comedy/Drama,1:41,11,18.004253009684938
89,96,Undefeated,5000,102,2011.0,Documentary,1:53,7,18.004253009684938
85,95,The Wild Parrots of Telegraph Hill,5000,101,2004.0,Documentary,1:23,10,17.893729120895756
85,92,Red Army,5000,101,2014.0,Documentary,1:25,7,17.893729120895756
39,25,Devil's Knot,5000,100,2013.0,Drama/Crime,1:54,-14,17.78279410038923
82,90,Cartel Land,5000,100,2015.0,Documentary,1:38,8,17.78279410038923
48,74,Margaret,5000,100,2011.0,Drama,2:29,26,17.78279410038923
52,40,Henry Poole Is Here,5000,100,2008.0,Comedy/Drama,1:41,-12,17.78279410038923
78,85,Looking for Eric,5000,99,2009.0,Drama/Comedy,1:56,7,17.67144228430324
80,98,Iris,5000,99,2014.0,Drama/Biography,1:23,18,17.67144228430324
88,91,When Marnie Was There,5000,99,2014.0,Anime/Kids and family,1:43,3,17.67144228430324
69,88,Cheap Thrills,5000,99,2013.0,Comedy/Mystery and thriller,1:25,19,17.67144228430324
61,57,The Reluctant Fundamentalist,5000,99,2012.0,Drama,2:08,-4,17.67144228430324
50,32,Monster Trucks,5000,98,2016.0,Adventure/Fantasy,1:45,-18,17.55966787263607
60,87,Terri,5000,98,2011.0,Comedy/Drama,1:45,27,17.55966787263607
94,96,No End in Sight,5000,98,2007.0,Documentary,1:42,2,17.55966787263607
48,44,Scouts Guide to the Zombie Apocalypse,5000,97,2015.0,Comedy/Horror,1:33,-4,17.447464924548626
63,89,Blood Father,5000,97,2016.0,Action/Mystery and thriller,1:28,26,17.447464924548626
65,94,Stranger by the Lake,5000,97,2013.0,Gay and lesbian/Drama,1:37,29,17.447464924548626
75,99,Le Havre,5000,96,2011.0,Comedy/Drama,1:43,24,17.334827353454408
31,45,Life After Beth,5000,96,2014.0,Comedy/Horror,1:30,14,17.334827353454408
35,44,She's Funny That Way,5000,96,2014.0,Romance,1:33,9,17.334827353454408
43,54,Cuban Fury,5000,96,2014.0,Comedy,1:38,11,17.334827353454408
51,24,The Life Before Her Eyes,5000,96,2007.0,Drama/Mystery and thriller,1:30,-27,17.334827353454408
33,51,Brighton Rock,5000,95,2010.0,Drama/Crime,1:51,18,17.22174892188519
29,27,Bel Ami,5000,95,2012.0,Drama/History,1:42,-2,17.22174892188519
58,78,Kill List,5000,95,2011.0,Horror/Mystery and thriller,1:34,20,17.22174892188519
74,90,Brawl in Cell Block 99,5000,94,2017.0,Mystery and thriller/Action,2:12,16,17.108223236119827
63,73,Bellflower,5000,94,2011.0,Drama/Romance,1:45,10,17.108223236119827
81,97,Kurt Cobain: Montage of Heck,5000,94,2015.0,Documentary,2:12,16,17.108223236119827
34,49,War Machine,5000,94,2017.0,Comedy/War,2:02,15,17.108223236119827
50,83,Crystal Fairy & the Magical Cactus,5000,94,2013.0,Comedy,1:40,33,17.108223236119827
90,95,The Salt of the Earth,5000,94,2014.0,Documentary,1:49,5,17.108223236119827
45,78,Z for Zachariah,5000,93,2015.0,Mystery and thriller/Drama,1:37,33,16.994243740562503
90,95,Going Clear: Scientology & the Prison of Belief,5000,93,2015.0,Documentary,1:59,5,16.994243740562503
40,66,Antiviral,5000,93,2012.0,Sci fi/Horror,1:48,26,16.994243740562503
90,100,Taxi to the Dark Side,5000,93,2007.0,Documentary/Drama,1:46,10,16.994243740562503
82,99,The Interrupters,5000,93,2011.0,Documentary/Drama,2:05,17,16.994243740562503
51,65,The Disappearance of Eleanor Rigby,5000,92,2013.0,Drama/Romance,2:03,14,16.879803711855995
47,22,Snow Flower and the Secret Fan,5000,91,2011.0,Drama/History,1:43,-25,16.764896252714394
20,30,Survival of the Dead,5000,91,2009.0,Horror,1:28,10,16.764896252714394
52,84,Shadow Dancer,5000,91,2012.0,Drama/Mystery and thriller,1:42,32,16.764896252714394
22,19,The Bye Bye Man,5000,90,2017.0,Horror/Mystery and thriller,1:36,-3,16.64951428545866
43,54,White Bird in a Blizzard,5000,90,2014.0,Drama/Mystery and thriller,1:30,11,16.64951428545866
76,99,The Missing Picture,5000,89,2013.0,Documentary,1:30,23,16.533650545237286
53,81,Cop Car,5000,89,2015.0,Mystery and thriller,1:28,28,16.533650545237286
81,88,Coherence,5000,89,2013.0,Sci fi/Mystery and thriller,1:29,7,16.533650545237286
34,78,Big Game,5000,89,2014.0,Action/Adventure,1:30,44,16.533650545237286
34,41,Therese,5000,88,2013.0,Drama/Mystery and thriller,1:42,7,16.417297572912943
84,90,Omar,5000,88,2013.0,Drama/Mystery and thriller,1:38,6,16.417297572912943
68,84,Pontypool,5000,88,2008.0,Horror/Mystery and thriller,1:36,16,16.417297572912943
81,80,I Served the King of England,5000,88,2006.0,Comedy/War,1:58,-1,16.417297572912943
58,67,This Must Be the Place,5000,87,2011.0,Drama,1:58,9,16.300447707594707
89,97,Muscle Shoals,5000,87,2013.0,Documentary,1:51,8,16.300447707594707
61,38,Hector and the Search for Happiness,5000,87,2014.0,Comedy/Adventure,1:54,-23,16.300447707594707
85,83,Tyrannosaur,5000,87,2011.0,Drama,1:31,-2,16.300447707594707
25,57,Escape From Tomorrow,5000,87,2013.0,Horror,1:30,32,16.300447707594707
69,72,Golden Door,5000,87,2006.0,Romance/Drama,1:57,3,16.300447707594707
87,59,The Stoning of Soraya M.,5000,86,2008.0,Drama,1:56,-28,16.183093078793917
81,98,The Selfish Giant,5000,86,2013.0,Drama,1:31,17,16.183093078793917
86,95,Weekend,5000,85,2011.0,Romance/Gay and lesbian,1:36,9,16.06522559818003
51,83,Blue Caprice,5000,84,2013.0,Drama/Crime,1:33,32,15.946836950911226
36,68,Jimi: All Is by My Side,5000,84,2013.0,Drama/Biography,1:56,32,15.946836950911226
78,87,Polisse,5000,84,2011.0,Drama/Crime,2:07,9,15.946836950911226
31,36,Lola Versus,5000,84,2012.0,Romance,1:26,5,15.946836950911226
24,20,Fly Me to the Moon,5000,84,2008.0,Kids and family/Adventure,1:29,-4,15.946836950911226
83,87,Winter Sleep,5000,83,2014.0,Drama,3:16,4,15.827918586512368
75,92,We Steal Secrets: The Story of WikiLeaks,5000,83,2013.0,Documentary,2:10,17,15.827918586512368
87,98,Ai Weiwei: Never Sorry,5000,83,2012.0,Documentary,1:31,11,15.827918586512368
78,94,My Kid Could Paint That,5000,83,2007.0,Documentary/Mystery and thriller,1:22,16,15.827918586512368
82,99,The Wailing,5000,82,2016.0,Horror/Mystery and thriller,2:36,17,15.708461709271033
37,34,Deadfall,5000,82,2012.0,Mystery and thriller/Crime,1:35,-3,15.708461709271033
37,68,Life of Crime,5000,82,2013.0,Drama/Crime,1:39,31,15.708461709271033
33,23,Dark Places,5000,82,2015.0,Mystery and thriller,1:43,-10,15.708461709271033
47,57,In the Land of Blood and Honey,5000,82,2011.0,Romance/War,2:07,10,15.708461709271033
78,74,City of Men,5000,82,2007.0,Drama,1:45,-4,15.708461709271033
42,21,Ratchet & Clank,5000,81,2016.0,Sci fi/Comedy,1:34,-21,15.588457268119896
55,65,We Have a Pope,5000,81,2011.0,Drama/Comedy,1:41,10,15.588457268119896
49,68,Great Expectations,5000,81,2012.0,Drama,2:08,19,15.588457268119896
88,98,Ernest & Célestine,5000,81,2014.0,,,10,15.588457268119896
84,88,Reprise,5000,81,2006.0,Drama,1:45,4,15.588457268119896
62,73,The Salvation,5000,80,2014.0,Western/Drama,1:29,11,15.467895945971296
82,98,How to Survive a Plague,5000,80,2012.0,Drama/Gay and lesbian,1:50,16,15.467895945971296
61,85,Experimenter,5000,80,2015.0,Drama/Biography,1:37,24,15.467895945971296
56,38,The Burning Plain,5000,80,2008.0,Drama,1:46,-18,15.467895945971296
37,76,Happy Christmas,5000,79,2014.0,Other/Drama,1:18,39,15.34676814846713
77,94,Janis: Little Girl Blue,5000,79,2015.0,Documentary,1:43,17,15.34676814846713
39,28,Justice,5000,79,2011.0,Drama/Mystery and thriller,1:45,-11,15.34676814846713
74,92,Once Upon A Time in Anatolia,5000,79,2011.0,Drama,2:37,18,15.34676814846713
57,75,Steve Jobs: The Man in the Machine,5000,79,2015.0,Documentary,2:08,18,15.34676814846713
68,86,Circumstance,5000,79,2011.0,Gay and lesbian/Drama,1:45,18,15.34676814846713
40,22,Jem and the Holograms,5000,79,2015.0,Drama/Musical,1:58,-18,15.34676814846713
32,31,The Oranges,5000,78,2011.0,Comedy/Drama,1:32,-1,15.225063992104127
63,29,Gimme Shelter,5000,77,2014.0,Drama,1:40,-34,15.102773291691431
77,87,X Plus Y,5000,77,2014.0,Drama/Comedy,1:51,10,15.102773291691431
76,56,Mao's Last Dancer,5000,77,2009.0,Biography/Drama,1:57,-20,15.102773291691431
76,86,Farewell,5000,77,2009.0,Drama/Mystery and thriller,1:53,10,15.102773291691431
63,62,Son of a Gun,5000,76,2015.0,Drama/Crime,1:48,-1,14.979885547093689
28,17,Unfriend,5000,76,2016.0,Horror/Mystery and thriller,1:32,-11,14.979885547093689
24,38,Death Note,5000,76,2017.0,Mystery and thriller/Horror,1:41,14,14.979885547093689
22,11,Trespass,5000,76,2011.0,Mystery and thriller,1:30,-11,14.979885547093689
91,89,Meru,5000,76,2015.0,Documentary,1:30,-2,14.979885547093689
47,77,The Void,5000,75,2016.0,Horror,1:30,30,14.856389929209026
41,33,Adore,5000,75,2013.0,Drama,1:51,-8,14.856389929209026
25,33,Passion,5000,75,2012.0,Drama/Mystery and thriller,1:40,8,14.856389929209026
51,62,The Awakening,5000,74,2011.0,Horror,1:47,11,14.732275265126917
70,73,Heartbeats,5000,73,2010.0,Gay and lesbian/Romance,1:37,3,14.607530022406213
60,38,Cesar Chavez,5000,73,2014.0,Drama/Biography,1:41,-22,14.607530022406213
74,86,Shin Godzilla,5000,73,2016.0,Sci fi/Action,2:00,12,14.607530022406213
64,85,Imperium,5000,73,2016.0,Drama/Crime,1:48,21,14.607530022406213
20,37,Knock Knock,5000,73,2015.0,Mystery and thriller,1:39,17,14.607530022406213
66,84,The Snowtown Murders,5000,73,2011.0,Drama/Crime,2:00,18,14.607530022406213
54,70,The Housemaid,5000,73,2010.0,Mystery and thriller,1:46,16,14.607530022406213
84,95,The Wrecking Crew,5000,73,2008.0,Documentary/Music,1:42,11,14.607530022406213
36,10,The Cobbler,5000,72,2014.0,Drama/Fantasy,1:39,-26,14.482142292408389
31,18,Diary of a Wimpy Kid: The Long Haul,5000,72,2017.0,Adventure/Kids and family,1:31,-13,14.482142292408389
94,38,The Dirt,5000,72,2019.0,Music/Drama,1:48,-56,14.482142292408389
74,57,Detachment,5000,72,2011.0,Drama,1:37,-17,14.482142292408389
75,97,Theeb,5000,72,2014.0,Drama/Adventure,1:40,22,14.482142292408389
86,88,Boy,5000,72,2010.0,Comedy/Drama,1:28,2,14.482142292408389
86,100,Poetry,5000,72,2010.0,Drama,2:19,14,14.482142292408389
62,36,The Lady,5000,72,2011.0,Biography/Drama,2:07,-26,14.482142292408389
90,100,Waste Land,5000,71,2010.0,Documentary,1:38,10,14.356099772615265
79,89,Timecrimes,5000,71,2007.0,Drama/Action,1:28,10,14.356099772615265
70,73,The Final Girls,5000,71,2015.0,Comedy/Horror,1:28,3,14.356099772615265
82,97,"Oslo, August 31st",5000,71,2011.0,Drama,1:35,15,14.356099772615265
77,87,Chico & Rita,5000,71,2010.0,Romance/Drama,1:33,10,14.356099772615265
82,96,Tomboy,5000,70,2011.0,Drama,1:24,14,14.229389747854103
84,99,Darbareye Elly,5000,70,2009.0,Drama/Mystery and thriller,1:59,15,14.229389747854103
66,60,The Grand Seduction,5000,70,2013.0,Comedy,1:55,-6,14.229389747854103
22,7,Norm of the North,5000,70,2016.0,Kids and family/Comedy,1:30,-15,14.229389747854103
69,76,Big Bad Wolves,5000,70,2013.0,Drama/Crime,1:50,7,14.229389747854103
53,71,Renoir,5000,70,2012.0,Drama,1:51,18,14.229389747854103
82,86,Flame & Citron,5000,70,2008.0,Mystery and thriller/War,2:12,4,14.229389747854103
62,6,The Identical,5000,69,2014.0,Drama,1:47,-56,14.101999070345963
76,99,56 Up,5000,69,2012.0,Documentary,2:23,23,14.101999070345963
64,49,Almost Christmas,5000,69,2016.0,Other/Drama,1:52,-15,14.101999070345963
90,100,The Square,5000,69,2013.0,Documentary,1:44,10,14.101999070345963
85,93,Carlos,5000,69,2010.0,Drama/Biography,2:30,8,14.101999070345963
42,67,Batched,5000,69,2014.0,Drama,1:47,25,14.101999070345963
52,72,Wakefield,5000,69,2016.0,Drama,1:49,20,14.101999070345963
63,86,Easy Money,5000,69,2010.0,Drama/Crime,1:59,23,14.101999070345963
81,97,Ajami,5000,69,2009.0,Drama,2:00,16,14.101999070345963
83,91,Lemon Tree,5000,68,2008.0,Drama,1:46,8,13.973914138485368
79,100,Seymour: An Introduction,5000,68,2014.0,Documentary,1:21,21,13.973914138485368
75,91,Katyn,5000,68,2007.0,Drama,2:01,16,13.973914138485368
53,72,The Tree,5000,67,2010.0,Drama/Romance,1:40,19,13.8451208742507
76,79,Any Day Now,5000,67,2012.0,Drama/Gay and lesbian,1:40,3,13.8451208742507
49,72,Wish You Were Here,5000,67,2012.0,Drama/Mystery and thriller,1:33,23,13.8451208742507
56,70,Beautiful Boy,5000,67,2010.0,Drama,1:40,14,13.8451208742507
73,91,Cat People,5000,66,1942.0,Horror,1:13,18,13.715604699135167
62,74,Stake Land,5000,66,2010.0,Horror,1:36,12,13.715604699135167
85,94,The House I Live In,5000,66,2012.0,Documentary,1:48,9,13.715604699135167
54,85,The Princess of Montpensier,5000,66,2010.0,Romance/Action,2:19,31,13.715604699135167
49,74,Norwegian Wood,5000,66,2010.0,Romance/Drama,2:13,25,13.715604699135167
81,88,Into Great Silence,5000,66,2005.0,Documentary,2:44,7,13.715604699135167
76,46,My Little Pony: The Movie,5000,65,2017.0,Comedy/Adventure,1:39,-30,13.58535050847747
31,74,The Loneliest Planet,5000,65,2011.0,Drama/Mystery and thriller,1:53,43,13.58535050847747
41,35,A Good Old Fashioned Orgy,5000,65,2011.0,Comedy,1:35,-6,13.58535050847747
44,46,The Sweeney,5000,65,2012.0,Drama/Action,1:52,2,13.58535050847747
54,17,Miral,5000,65,2010.0,Drama/History,1:46,-37,13.58535050847747
30,38,Zombie Strippers,5000,65,2008.0,Comedy/Horror,1:34,8,13.58535050847747
80,80,Exiled,5000,65,2006.0,Mystery and thriller,1:50,0,13.58535050847747
82,92,Still,5000,64,2012.0,Drama,1:43,10,13.454342644059432
51,66,Freakonomics,5000,64,2010.0,Documentary,1:26,15,13.454342644059432
57,83,Delirious,5000,64,2006.0,Comedy/Drama,1:47,26,13.454342644059432
72,83,A Cat in Paris,5000,64,2010.0,Animation/Drama,1:05,11,13.454342644059432
77,97,The Dark Horse,5000,64,2014.0,Biography/Drama,2:04,20,13.454342644059432
87,89,Joe Strummer: The Future Is Unwritten,5000,64,2007.0,Documentary,2:05,2,13.454342644059432
83,95,The Rocket,5000,64,2013.0,Drama,1:36,12,13.454342644059432
60,58,Perfect Sense,5000,64,2011.0,Romance/Drama,1:32,-2,13.454342644059432
44,14,The Nut Job 2: Nutty by Nature,5000,63,2017.0,Comedy/Animation,1:31,-30,13.322564864824612
80,84,Manufactured Landscapes,5000,63,2006.0,Documentary,1:26,4,13.322564864824612
42,66,The Rewrite,5000,62,2014.0,Romance/Comedy,1:47,24,13.190000315557024
62,42,Leap!,5000,62,2016.0,Comedy/Adventure,1:26,-20,13.190000315557024
84,95,Last Days in Vietnam,5000,62,2014.0,Drama/War,1:38,11,13.190000315557024
85,87,Even the Rain,5000,62,2010.0,Drama,1:44,2,13.190000315557024
88,90,Inequality for All,5000,62,2013.0,Documentary,1:26,2,13.190000315557024
77,100,Afghan Star,5000,62,2009.0,Documentary,1:28,23,13.190000315557024
73,90,A Place at the Table,5000,62,2012.0,Documentary,1:24,17,13.190000315557024
65,56,Battle in Seattle,5000,62,2007.0,Drama,1:39,-9,13.190000315557024
43,70,The Hallow,5000,61,2015.0,Horror,1:37,27,13.056631493342596
92,98,Sunrise,5000,61,1927.0,Romance/Drama,1:50,6,13.056631493342596
37,25,Sleepless,5000,61,2017.0,Action/Mystery and thriller,1:35,-12,13.056631493342596
77,87,The Attack,5000,61,2012.0,Drama,1:44,10,13.056631493342596
79,85,My Afternoons with Margueritte,5000,61,2010.0,Drama,1:22,6,13.056631493342596
30,10,Hell Ride,5000,60,2008.0,Action,1:24,-20,12.922440211617326
43,10,Tulip Fever,5000,60,2017.0,Drama/Romance,1:47,-33,12.922440211617326
71,85,Spring,5000,60,2014.0,Mystery and thriller,1:49,14,12.922440211617326
74,73,Soul Kitchen,5000,60,2009.0,Comedy/Drama,1:39,-1,12.922440211617326
76,77,Outrage,5000,60,2009.0,Documentary/Gay and lesbian,1:30,1,12.922440211617326
56,52,Romance & Cigarettes,5000,60,2005.0,Comedy/Musical,1:45,-4,12.922440211617326
63,75,Camp X-Ray,5000,59,2014.0,Drama,1:57,12,12.78740756158519
34,80,Willow Creek,5000,59,2013.0,Horror,1:18,46,12.78740756158519
31,42,Chandni Chowk to China,5000,59,2009.0,Comedy/Action,2:20,11,12.78740756158519
40,34,"A Woman, a Gun and a Noodle Shop",5000,59,2009.0,Comedy/Drama,1:30,-6,12.78740756158519
64,84,These Final Hours,5000,58,2013.0,Sci fi/Mystery and thriller,1:27,20,12.651513870765422
73,41,The Flowers of War,5000,58,2011.0,History/War,2:21,-32,12.651513870765422
28,52,A.C.O.D.,5000,58,2013.0,Comedy,1:27,24,12.651513870765422
49,55,Eliza Graves,5000,58,2014.0,Mystery and thriller,1:52,6,12.651513870765422
41,81,In Fear,5000,58,2013.0,Mystery and thriller,1:25,40,12.651513870765422
38,26,The Divide,5000,58,2011.0,Sci fi/Mystery and thriller,1:50,-12,12.651513870765422
44,76,Honeymoon,5000,58,2014.0,Mystery and thriller,1:28,32,12.651513870765422
29,31,Wild Card,5000,58,2015.0,Drama/Action,1:32,2,12.651513870765422
53,53,The Greatest,5000,58,2009.0,Drama,1:40,0,12.651513870765422
45,0,Gotti,5000,58,2018.0,Drama/Biography,1:45,-45,12.651513870765422
54,69,Right at Your Door,5000,58,2006.0,Mystery and thriller,1:36,15,12.651513870765422
63,32,"Love, Rosie",5000,57,2014.0,Romance,1:42,-31,12.514738658402138
78,61,Love Songs,5000,57,2007.0,Gay and lesbian/Romance,1:35,-17,12.514738658402138
24,39,Aftershock,5000,56,2012.0,Horror/Mystery and thriller,1:29,15,12.377060587439436
33,25,Phantom,5000,56,2013.0,Mystery and thriller,1:38,-8,12.377060587439436
36,48,Welcome to the Punch,5000,56,2013.0,Drama/Action,1:39,12,12.377060587439436
68,82,Get the Gringo,5000,56,2012.0,Action/Mystery and thriller,1:36,14,12.377060587439436
79,82,Comic-Con Episode IV: A Fan's Hope,5000,56,2011.0,Documentary,1:26,3,12.377060587439436
46,60,The Eye of the Storm,5000,55,2011.0,Drama,1:59,14,12.238457412731087
25,42,Henry's Crime,5000,55,2010.0,Comedy/Action,1:48,17,12.238457412731087
49,16,September Dawn,5000,55,2006.0,Western/Drama,1:50,-33,12.238457412731087
87,100,Last Train Home,5000,54,2009.0,Documentary,1:25,13,12.098905925115496
39,37,Ishtar,5000,54,1987.0,Comedy,1:47,-2,12.098905925115496
78,24,Little Boy,5000,54,2015.0,War/Drama,1:46,-54,12.098905925115496
56,44,Mr. Right,5000,54,2015.0,Action/Romance,1:33,-12,12.098905925115496
76,93,The Secret of the Grain,5000,54,2007.0,Drama,2:31,17,12.098905925115496
40,22,A Long Way Down,5000,54,2014.0,Comedy/Drama,1:36,-18,12.098905925115496
48,28,High School,5000,54,2010.0,Comedy,1:39,-20,12.098905925115496
68,23,Birth of the Dragon,5000,53,2016.0,Action/Sports and fitness,1:31,-45,11.958381890942793
61,83,Goodbye First Love,5000,53,2011.0,Romance/Drama,1:48,22,11.958381890942793
60,42,Happythankyoumoreplease,5000,53,2010.0,Comedy/Drama,1:40,-18,11.958381890942793
81,96,Brooklyn Castle,5000,53,2012.0,Documentary,1:41,15,11.958381890942793
28,47,The Girl From Monaco,5000,53,2008.0,Comedy/Drama,1:34,19,11.958381890942793
66,79,Che: Part Two,5000,53,2008.0,Biography/Drama,2:08,13,11.958381890942793
34,56,Universal Soldier: Day of Reckoning,5000,52,2012.0,Sci fi/Action,1:53,22,11.8168599865911
32,8,Survivor,5000,52,2015.0,Mystery and thriller/Action,1:36,-24,11.8168599865911
71,73,What We Did on Our Holiday,5000,52,2014.0,Comedy,1:35,2,11.8168599865911
78,79,The Other Son,5000,52,2012.0,Drama,1:45,1,11.8168599865911
64,92,The Devil's Candy,5000,52,2015.0,Horror/Mystery and thriller,1:20,28,11.8168599865911
86,71,More Than a Game,5000,51,2008.0,Documentary,1:45,-15,11.674313727451958
22,8,Are You Here,5000,51,2013.0,Drama/Comedy,1:53,-14,11.674313727451958
43,25,Solace,5000,51,2015.0,Mystery and thriller,1:41,-18,11.674313727451958
34,76,The Last Winter,5000,51,2006.0,Horror/Mystery and thriller,1:47,42,11.674313727451958
48,45,Cracks,5000,51,2009.0,Gay and lesbian/Drama,1:44,-3,11.674313727451958
43,76,Into the Forest,5000,51,2015.0,Drama/Mystery and thriller,1:41,33,11.674313727451958
96,94,Dear Zachary: A Letter to a Son About His Father,5000,51,2008.0,Documentary,1:35,-2,11.674313727451958
88,94,The Normal Heart,5000,50,2014.0,Drama/Gay and lesbian,2:15,6,11.530715390799685
39,44,The Art of the Steal,5000,50,2013.0,Comedy,1:30,5,11.530715390799685
45,76,Cockneys vs Zombies,5000,50,2012.0,Comedy/Action,1:28,31,11.530715390799685
59,80,It's a Disaster,5000,49,2012.0,Comedy,1:28,21,11.3860359318845
37,18,Chapter 27,5000,49,2007.0,Drama,1:24,-19,11.3860359318845
80,86,XXY,5000,49,2007.0,Gay and lesbian/Drama,1:26,6,11.3860359318845
27,42,Rec 3: Genesis,5000,48,2012.0,Horror/Mystery and thriller,1:19,15,11.240244892502977
77,67,Irina Palm,5000,48,2007.0,Comedy/Drama,1:43,-10,11.240244892502977
67,15,Illegal Tender,5000,48,2007.0,Drama/Action,1:47,-52,11.240244892502977
45,38,Two Night Stand,5000,47,2014.0,Romance/Comedy,1:26,-7,11.093310301199846
68,85,The Time That Remains,5000,47,2009.0,Drama/History,1:49,17,11.093310301199846
83,98,A Summer's Tale,5000,47,1996.0,Romance,1:53,15,11.093310301199846
53,45,What We Do Is Secret,5000,47,2007.0,Biography/Drama,1:32,-8,11.093310301199846
88,96,Nanking,5000,47,2007.0,Documentary,1:28,8,11.093310301199846
91,91,Elite Squad 2,5000,46,2010.0,Drama/Crime,1:56,0,10.945198564139895
47,72,I Sell the Dead,5000,46,2008.0,Comedy/Horror,1:25,25,10.945198564139895
90,100,Sound City,5000,46,2013.0,Documentary/Music,1:48,10,10.945198564139895
27,37,Texas Killing Fields,5000,46,2011.0,Drama/Crime,1:45,10,10.945198564139895
23,13,The Moth Diaries,5000,46,2011.0,Horror,1:23,-10,10.945198564139895
66,96,The Survivalist,5000,45,2015.0,Drama/Mystery and thriller,1:44,30,10.795874345554918
52,78,Sleight,5000,45,2016.0,Drama/Mystery and thriller,1:30,26,10.795874345554918
22,7,Shut In,5000,45,2016.0,Mystery and thriller,1:31,-15,10.795874345554918
55,80,GBF,5000,45,2013.0,Comedy/Gay and lesbian,1:34,25,10.795874345554918
64,40,Dedication,5000,45,2007.0,Romance,1:51,-24,10.795874345554918
58,24,Fierce People,5000,45,2005.0,Drama,1:52,-34,10.795874345554918
85,89,The Magnificent Ambersons,5000,44,1942.0,Drama,1:28,4,10.645300436514761
47,55,Perrier's Bounty,5000,44,2009.0,Comedy/Drama,1:28,8,10.645300436514761
23,18,Gambit,5000,44,2012.0,Comedy,1:29,-5,10.645300436514761
87,86,Crazy Pete,5000,44,1965.0,Drama,1:50,-1,10.645300436514761
73,95,Housebound,5000,43,2014.0,Horror/Comedy,1:49,22,10.493437610589469
53,77,Chalet Girl,5000,43,2011.0,Comedy,1:36,24,10.493437610589469
58,63,Middle School: The Worst Years of My Life,5000,43,2016.0,Kids and family/Comedy,1:32,5,10.493437610589469
47,56,Killing Bono,5000,43,2011.0,Comedy,1:54,9,10.493437610589469
28,12,Tokarev,5000,42,2014.0,Mystery and thriller/Action,1:38,-16,10.34024446475599
37,45,Cooties,5000,42,2014.0,Horror/Comedy,1:36,8,10.34024446475599
91,76,How to Make Money Selling Drugs,5000,42,2012.0,Documentary,1:36,-15,10.34024446475599
73,93,Hush,5000,42,2016.0,Horror/Mystery and thriller,1:27,20,10.34024446475599
89,93,The Way He Looks,5000,42,2014.0,Gay and lesbian/Drama,1:35,4,10.34024446475599
33,31,The Good Night,5000,42,2007.0,Comedy/Romance,1:33,-2,10.34024446475599
63,45,Mammoth,5000,42,2009.0,Drama,2:05,-18,10.34024446475599
51,50,Good Dick,5000,42,2008.0,Romance,1:26,-1,10.34024446475599
21,15,Regression,5000,41,2015.0,Drama/Crime,1:46,-6,10.185677243651742
49,63,MI-5,5000,41,2015.0,Drama/Crime,1:44,14,10.185677243651742
68,78,The Milk of Sorrow,5000,41,2009.0,Drama,1:34,10,10.185677243651742
73,76,Outsourced,5000,41,2006.0,Comedy,1:38,3,10.185677243651742
85,98,GasLand,5000,41,2010.0,Documentary,1:45,13,10.185677243651742
80,73,Gaga: Five Foot Two,5000,40,2017.0,Documentary,1:40,-7,10.029689644980788
53,33,Dirty Girl,5000,40,2010.0,Comedy/Gay and lesbian,1:46,-20,10.029689644980788
68,90,Julia's Eyes,5000,40,2010.0,Horror/Mystery and thriller,1:52,22,10.029689644980788
66,49,The Young Messiah,5000,39,2016.0,History/Drama,1:51,-17,9.872232603526719
22,15,The Son of No One,5000,39,2011.0,Crime/Drama,1:35,-7,9.872232603526719
32,44,Lovely Molly,5000,39,2011.0,Horror/Mystery and thriller,1:40,12,9.872232603526719
48,38,My Name Is Bruce,5000,39,2007.0,Comedy/Horror,1:26,-10,9.872232603526719
80,69,Ben X,5000,39,2007.0,Drama,1:33,-11,9.872232603526719
26,29,Extraterrestrial,5000,38,2014.0,Sci fi/Drama,1:41,3,9.713254050808038
90,70,Adam's Apples,5000,37,2005.0,Comedy,1:33,-20,9.552698646911638
38,56,Adult World,5000,36,2013.0,Comedy,1:37,18,9.390507480439723
42,56,Haunter,5000,36,2013.0,Horror/Mystery and thriller,1:37,14,9.390507480439723
42,19,I Hope They Serve Beer in Hell,5000,36,2009.0,Comedy,1:46,-23,9.390507480439723
53,47,Legend of the Fist: The Return of Chen Zhen,5000,36,2010.0,Action/Drama,1:45,-6,9.390507480439723
33,69,Tormented,5000,36,2009.0,Comedy/Horror,1:31,36,9.390507480439723
70,28,Provoked,5000,36,2007.0,Drama,1:51,-42,9.390507480439723
78,91,Sleep Tight,5000,35,2011.0,Horror/Mystery and thriller,1:42,13,9.22661773178138
40,26,The Samaritan,5000,35,2012.0,Drama/Crime,1:33,-14,9.22661773178138
22,20,The Colony,5000,35,2013.0,Sci fi/Mystery and thriller,1:33,-2,9.22661773178138
73,77,Examined Life,5000,35,2008.0,Documentary,1:27,4,9.22661773178138
64,77,The Last Circus,5000,35,2010.0,Drama/War,1:47,13,9.22661773178138
83,77,The Fundamentals of Caring,5000,35,2016.0,Drama/Mystery and thriller,1:33,-6,9.22661773178138
53,32,Struck by Lightning,5000,34,2012.0,Comedy,1:24,-21,9.060962294042406
77,56,The Best Offer,5000,34,2013.0,Romance/Drama,2:04,-21,9.060962294042406
89,82,The Chaser,5000,34,2008.0,Action/Mystery and thriller,2:05,-7,9.060962294042406
46,65,What Doesn't Kill You,5000,34,2008.0,Drama/Crime,1:40,19,9.060962294042406
71,38,Beyond Rangoon,5000,34,1995.0,Drama,1:40,-33,9.060962294042406
78,68,Peter's Friends,5000,34,1992.0,Comedy/Gay and lesbian,1:40,-10,9.060962294042406
19,3,The Darkness,5000,33,2016.0,Mystery and thriller/Horror,1:33,-16,8.893469344897873
52,64,Ping Pong Playa,5000,33,2007.0,Comedy,1:36,12,8.893469344897873
55,45,The Perfect Host,5000,33,2010.0,Mystery and thriller,1:34,-10,8.893469344897873
91,100,Kes,5000,32,1969.0,Drama,1:49,9,8.724061861322062
43,19,Downloading Nancy,5000,32,2008.0,Drama,1:42,-24,8.724061861322062
27,34,The Resident,5000,32,2011.0,Drama/Mystery and thriller,1:31,7,8.724061861322062
82,56,Spare Parts,5000,32,2015.0,Drama,1:53,-26,8.724061861322062
13,34,VHS: Viral,5000,32,2014.0,Horror,1:22,21,8.724061861322062
26,16,The Lifeguard,5000,32,2013.0,Comedy/Drama,1:38,-10,8.724061861322062
83,84,Enchanted April,5000,32,1991.0,Romance,1:33,1,8.724061861322062
73,91,She's Gotta Have It,5000,32,1986.0,Romance,1:24,18,8.724061861322062
61,39,How to Be a Latin Lover,5000,31,2017.0,Comedy,1:55,-22,8.552657067536824
69,81,Dead Snow: Red vs. Dead,5000,31,2014.0,Comedy/Horror,1:40,12,8.552657067536824
45,48,The Education of Charlie Banks,5000,31,2007.0,Drama,1:40,3,8.552657067536824
56,63,Exam,5000,30,2009.0,Mystery and thriller,1:41,7,8.379165804519056
57,27,Before We Go,5000,30,2014.0,Comedy/Romance,1:35,-30,8.379165804519056
36,47,Skateland,5000,30,2010.0,Drama,1:36,11,8.379165804519056
43,57,Franklyn,5000,30,2008.0,Romance/Mystery and thriller,1:38,14,8.379165804519056
81,87,Kiss of the Spider Woman,5000,30,1985.0,Drama,1:59,6,8.379165804519056
94,100,Temple Grandin,5000,30,2010.0,Biography/Drama,1:50,6,8.379165804519056
72,90,Lion's Den,5000,29,2008.0,Drama,1:53,18,8.20349180691225
66,38,X Games: The Movie,5000,29,2009.0,Documentary,1:32,-28,8.20349180691225
38,41,The Tall Man,5000,29,2012.0,Mystery and thriller,1:46,3,8.20349180691225
22,25,Peep World,5000,28,2010.0,Comedy,1:29,3,8.02553087005176
77,86,Something From Nothing: The Art of Rap,5000,28,2012.0,Documentary/Music,1:50,9,8.02553087005176
87,89,Maurice,5000,27,1987.0,Gay and lesbian/Drama,2:20,2,7.845169885845621
31,30,The Numbers Station,5000,27,2013.0,Action/Mystery and thriller,1:29,-1,7.845169885845621
93,93,The Exterminating Angel,5000,27,1962.0,Drama/Fantasy,1:32,0,7.845169885845621
74,85,Wu Xia,5000,27,2011.0,Drama/Crime,1:55,11,7.845169885845621
71,74,Shaolin,5000,27,2011.0,Drama/Sports and fitness,2:11,3,7.845169885845621
44,67,The Missing Person,5000,27,2009.0,Drama/Mystery and thriller,1:35,23,7.845169885845621
44,85,The Strange Case of Angelica,5000,27,2010.0,Drama/Fantasy,1:37,41,7.845169885845621
85,81,The Business of Being Born,5000,27,2007.0,Documentary,1:27,-4,7.845169885845621
94,100,Hearts of Darkness: A Filmmaker's Apocalypse,5000,27,1991.0,Documentary,1:36,6,7.845169885845621
94,42,Unplanned,5000,26,2019.0,Biography/Drama,1:46,-52,7.662285721192069
82,100,Wild Bill,5000,26,2011.0,Drama,1:38,18,7.662285721192069
70,65,Mumbai Diaries,5000,26,2010.0,Drama,1:40,-5,7.662285721192069
45,58,The Infidel,5000,26,2010.0,Comedy,1:44,13,7.662285721192069
31,23,Vehicle 19,5000,26,2013.0,Action/Mystery and thriller,1:25,-8,7.662285721192069
66,81,Coma,5000,26,1978.0,Sci fi,1:53,15,7.662285721192069
47,35,The Slammin' Salmon,5000,26,2009.0,Comedy,1:38,-12,7.662285721192069
45,12,When the Bough Breaks,5000,25,2016.0,Drama,1:42,-33,7.476743906106103
36,48,Blitz,5000,25,2011.0,Drama/Crime,1:33,12,7.476743906106103
32,28,Lesbian Vampire Killers,5000,25,2009.0,Comedy/Horror,1:26,-4,7.476743906106103
49,44,Kidnapped,5000,25,2010.0,Horror/Mystery and thriller,1:25,-5,7.476743906106103
69,88,Silent Light,5000,25,2007.0,Drama,2:07,19,7.476743906106103
29,24,The Lodger,5000,25,2009.0,Drama/Crime,1:36,-5,7.476743906106103
86,100,Kenny,5000,25,2006.0,Comedy,1:40,14,7.476743906106103
46,38,Inhale,5000,24,2010.0,Drama/Mystery and thriller,1:23,-8,7.288397090280924
95,92,"Sherlock, Jr.",5000,24,1924.0,Comedy/Drama,0:48,-3,7.288397090280924
30,17,Smiley,5000,23,2012.0,Horror/Mystery and thriller,1:35,-13,7.097083215743026
50,26,90 Minutes in Heaven,5000,23,2015.0,Drama,2:01,-24,7.097083215743026
40,4,Tyler Perry's Boo 2! A Madea Halloween,5000,23,2017.0,Comedy/Adventure,1:41,-36,7.097083215743026
65,87,A Monster in Paris,5000,23,2011.0,Kids and family/Comedy,1:29,22,7.097083215743026
41,13,Mannequin: On the Move,5000,23,1991.0,Fantasy,1:35,-28,7.097083215743026
21,5,Get a Job,5000,22,2016.0,Comedy,1:23,-16,6.9026233386080005
77,73,Bent,5000,22,1997.0,Drama/Gay and lesbian,1:57,-4,6.9026233386080005
52,14,Dead Man Running,5000,22,2009.0,Drama/Action,1:32,-38,6.9026233386080005
53,55,Frontier(s),5000,22,2007.0,Horror/Mystery and thriller,1:48,2,6.9026233386080005
36,5,Hick,5000,22,2011.0,Drama/Mystery and thriller,1:42,-31,6.9026233386080005
55,68,"If I Want to Whistle, I Whistle",5000,22,2010.0,Drama,1:34,13,6.9026233386080005
46,38,Saawariya,5000,21,2007.0,Drama/Romance,2:26,-8,6.704819013328363
48,0,Max Steel,5000,21,2016.0,Sci fi/Adventure,1:32,-48,6.704819013328363
34,10,No Holds Barred,5000,21,1989.0,Action,1:31,-24,6.704819013328363
56,76,Curse of Chucky,5000,21,2013.0,Horror,1:35,20,6.704819013328363
75,29,Forever Strong,5000,21,2008.0,Drama,1:52,-46,6.704819013328363
18,14,Stan Helsing,5000,21,2009.0,Comedy,1:30,-4,6.704819013328363
87,67,Johnny Got His Gun,5000,21,1971.0,Drama,1:51,-20,6.704819013328363
73,38,Partition,5000,21,2007.0,Drama,1:56,-35,6.704819013328363
29,10,Killing Season,5000,20,2013.0,Action/Mystery and thriller,1:30,-19,6.503449126242364
64,60,Mystery Team,5000,20,2009.0,Comedy,1:46,-4,6.503449126242364
67,80,24: Redemption,5000,20,2008.0,Drama/Action,1:30,13,6.503449126242364
52,50,Tall Tale: The Unbelievable Adventures of Pecos Bill,5000,20,1995.0,Kids and family/Fantasy,1:36,-2,6.503449126242364
44,20,Meet Bill,5000,20,2007.0,Comedy/Drama,1:32,-24,6.503449126242364
67,40,Flashpoint,5000,20,2007.0,Action/Sports and fitness,1:28,-27,6.503449126242364
33,74,Sharknado,5000,19,2013.0,Sci fi/Comedy,1:30,41,6.298266028731006
41,11,Renegades,5000,19,2017.0,Mystery and thriller/Action,1:46,-30,6.298266028731006
43,53,David & Layla,5000,19,2006.0,Comedy/Romance,1:48,10,6.298266028731006
59,47,Erik the Viking,5000,19,1989.0,Comedy/Fantasy,1:43,-12,6.298266028731006
52,21,Outlaw,5000,19,2007.0,Drama/Action,1:45,-31,6.298266028731006
51,28,Endless Love,5000,18,1981.0,Drama/Romance,1:55,-23,6.088990769440213
84,83,Dragon Ball Z: Resurrection F,5000,18,2015.0,Adventure/Action,1:33,-1,6.088990769440213
67,89,As Long As I Live,5000,18,2012.0,Drama/Romance,2:56,22,6.088990769440213
45,72,The Cottage,5000,18,2008.0,Horror/Comedy,1:32,27,6.088990769440213
62,6,Nitro Circus: The Movie,5000,18,2012.0,Comedy,1:25,-56,6.088990769440213
39,22,Open Grave,5000,18,2013.0,Horror,1:42,-17,6.088990769440213
26,0,"Surfer, Dude",5000,18,2008.0,Comedy,1:25,-26,6.088990769440213
81,44,Goodbye Bafana,5000,18,2007.0,Biography/Drama,1:58,-37,6.088990769440213
82,72,Fuel,5000,18,2008.0,Documentary,1:51,-10,6.088990769440213
33,56,Vamps,5000,18,2012.0,Comedy/Horror,1:33,23,6.088990769440213
98,53,Overcomer,5000,17,2019.0,Drama,1:55,-45,5.875307153057772
75,65,Yentl,5000,17,1983.0,Musical,2:14,-10,5.875307153057772
80,88,Helvetica,5000,17,2007.0,Documentary,1:20,8,5.875307153057772
49,6,So Undercover,5000,16,2012.0,Action/Comedy,1:34,-43,5.656854249492381
71,81,Hitler's Children,5000,16,2012.0,Documentary,1:20,10,5.656854249492381
69,0,Last Ounce of Courage,5000,16,2012.0,Drama,1:41,-69,5.656854249492381
78,81,Generation Iron,5000,16,2013.0,Documentary,1:46,3,5.656854249492381
52,63,We Are the Night,5000,16,2010.0,Horror,1:40,11,5.656854249492381
75,69,9th Company,5000,16,2005.0,War/Drama,2:19,-6,5.656854249492381
44,67,The Philosophers,5000,15,2013.0,Drama/Mystery and thriller,1:47,23,5.433216825139731
81,73,Woodlawn,5000,15,2015.0,Drama/Biography,2:03,-8,5.433216825139731
67,80,Luck by Chance,5000,15,2009.0,Mystery and thriller/Comedy,2:36,13,5.433216825139731
49,27,The Sorcerer and the White Snake,5000,15,2011.0,Action/Fantasy,1:40,-22,5.433216825139731
49,67,Grave Encounters,5000,15,2010.0,Horror/Mystery and thriller,1:32,18,5.433216825139731
72,53,I Do,5000,15,2006.0,Romance,1:26,-19,5.433216825139731
85,80,Father Goose,5000,15,1964.0,Comedy,1:55,-5,5.433216825139731
57,40,Phantasm II,5000,15,1988.0,Horror,1:37,-17,5.433216825139731
61,67,The Girl Next Door,5000,15,2007.0,Drama/Mystery and thriller,1:31,6,5.433216825139731
42,29,How to Rob a Bank,5000,14,2007.0,Comedy/Drama,1:21,-13,5.203912939677927
34,8,13,5000,13,2010.0,Mystery and thriller/Action,1:37,-26,4.968377601139757
82,100,Law of Desire,5000,13,1987.0,Gay and lesbian/Comedy,1:40,18,4.968377601139757
57,23,The Big Shot-Caller,5000,13,2008.0,Drama,1:30,-34,4.968377601139757
63,38,Touchback,5000,13,2011.0,Drama,1:58,-25,4.968377601139757
55,15,What Love Is,5000,13,2006.0,Gay and lesbian/Romance,1:28,-40,4.968377601139757
75,85,Inside,5000,13,2007.0,Horror,1:21,10,4.968377601139757
90,42,Rad,5000,12,1986.0,Adventure,1:31,-48,4.725940818339814
23,17,Bob Funk,5000,12,2009.0,Comedy,1:48,-6,4.725940818339814
81,83,Fullmetal Alchemist: The Sacred Star of Milos,5000,12,2011.0,Sci fi/Adventure,1:50,2,4.725940818339814
72,17,Meet the Blacks,5000,12,2016.0,Comedy,1:33,-55,4.725940818339814
71,50,Ghajini,5000,12,2008.0,Action/Drama,3:04,-21,4.725940818339814
89,18,Meet the Mormons,5000,11,2014.0,Documentary,1:18,-71,4.475797488182033
70,27,Thunderstruck,5000,11,2012.0,Comedy/Fantasy,1:33,-43,4.475797488182033
75,45,The Legend of Billie Jean,5000,11,1985.0,Drama,1:36,-30,4.475797488182033
81,80,Forbidden Zone,5000,10,1980.0,Comedy,1:16,-1,4.216965034285822
67,80,No One Killed Jessica,5000,10,2011.0,Drama/Crime,2:17,13,4.216965034285822
73,90,Tinker Bell,5000,10,2008.0,Kids and family/Animation,1:14,17,4.216965034285822
60,70,Illegal,5000,10,2010.0,Drama,1:30,10,4.216965034285822
79,100,"Run Silent, Run Deep",5000,9,1958.0,War,1:33,21,3.9482220388574776
49,11,Dead Heat,5000,9,1988.0,Horror/Action,1:28,-38,3.9482220388574776
31,22,Meeting Evil,5000,9,2011.0,Drama/Mystery and thriller,1:29,-9,3.9482220388574776
44,11,Big Stan,5000,9,2007.0,Comedy/Action,1:48,-33,3.9482220388574776
36,33,Weather Girl,5000,9,2009.0,Comedy,1:33,-3,3.9482220388574776
38,56,I Want Candy,5000,9,2007.0,Comedy,1:25,18,3.9482220388574776
85,78,Death Note,5000,9,2006.0,Drama/Adventure,2:06,-7,3.9482220388574776
90,100,This Man,5000,8,2010.0,Crime/Action,1:59,10,3.668016172818685
62,0,Beer for My Horses,5000,8,2008.0,Adventure/Action,1:33,-62,3.668016172818685
34,38,Godzilla vs. Megalon,5000,8,1976.0,Sci fi,1:20,4,3.668016172818685
80,88,Dragon Ball Z: Battle of Gods,5000,8,2013.0,Anime/Fantasy,1:25,8,3.668016172818685
51,63,Super High Me,5000,8,2007.0,Documentary,1:34,12,3.668016172818685
23,13,The Alphabet Killer,5000,8,2008.0,Drama/Crime,1:38,-10,3.668016172818685
28,38,Raise the Titanic,5000,8,1980.0,Adventure,1:54,10,3.668016172818685
40,25,Powder Blue,5000,8,2009.0,Drama,1:48,-15,3.668016172818685
31,50,Suburban Girl,5000,8,2007.0,Romance,1:37,19,3.668016172818685
53,50,Sikandar,5000,8,2009.0,Drama/Mystery and thriller,1:50,-3,3.668016172818685
48,25,Almost an Angel,5000,8,1990.0,Fantasy,1:37,-23,3.668016172818685
34,50,Eden Log,5000,8,2007.0,Sci fi/Horror,1:38,16,3.668016172818685
67,100,Hulk Vs.,5000,7,2009.0,Fantasy/Action,1:18,33,3.374320069567275
49,57,Neighbors,5000,7,1981.0,Comedy,1:34,8,3.374320069567275
84,71,Kevin Hart: Laugh at My Pain,5000,7,2011.0,Comedy,1:28,-13,3.374320069567275
32,0,"The Toxic Avenger, Part II",5000,7,1989.0,Horror,1:35,-32,3.374320069567275
34,57,The Deaths of Ian Stone,5000,7,2007.0,Horror/Mystery and thriller,1:27,23,3.374320069567275
66,83,Futurama: The Beast With a Billion Backs,5000,6,2008.0,Comedy/Sci fi,1:30,17,3.064393493081416
56,33,The Little Mermaid: Ariel's Beginning,5000,6,2008.0,Kids and family/Animation,1:17,-23,3.064393493081416
38,33,Puppet Master II,5000,6,1990.0,Horror,1:30,-5,3.064393493081416
81,100,Ink,5000,6,2009.0,Sci fi/Fantasy,1:42,19,3.064393493081416
66,100,Ballet Shoes,5000,6,2007.0,Drama,1:30,34,3.064393493081416
19,50,Starship Troopers 3: Marauder,5000,6,2008.0,Sci fi/Action,1:45,31,3.064393493081416
80,40,The Trouble With Terkel,5000,5,2010.0,Animation/Comedy,1:28,-40,2.734363528521053
17,40,Streets of Blood,5000,5,2009.0,Drama/Crime,1:35,23,2.734363528521053
66,60,Futurama: Bender's Game,5000,5,2008.0,Comedy/Sci fi,1:30,-6,2.734363528521053
52,40,The Island,5000,5,1980.0,Adventure,1:54,-12,2.734363528521053
93,100,Justice League: The Flashpoint Paradox,5000,5,2013.0,Animation/Action,1:15,7,2.734363528521053
39,20,Bad Ass,5000,5,2012.0,Action,1:45,-19,2.734363528521053
30,0,Labor Pains,5000,5,2009.0,Comedy,1:29,-30,2.734363528521053
93,100,"Batman: The Dark Knight Returns, Part 1",5000,5,2012.0,Action/Animation,1:16,7,2.734363528521053
33,20,Thick as Thieves,5000,5,2009.0,Drama/Crime,1:44,-13,2.734363528521053
19,20,Baby on Board,5000,5,2008.0,Comedy/Romance,1:35,1,2.734363528521053
57,20,Love and Other Disasters,5000,5,2006.0,Romance,1:31,-37,2.734363528521053
55,20,The Myth,5000,5,2005.0,Action/Adventure,1:58,-35,2.734363528521053
77,96,Booksmart,2500,372,2019.0,Gay and lesbian/Comedy,1:42,19,40.41935114073477
48,46,Dumbo,2500,367,2019.0,Drama/Fantasy,1:52,-2,40.078945840023664
65,65,Suspiria,2500,328,2018.0,Horror/Mystery and thriller,2:32,0,37.36122886082584
49,45,Red Sparrow,2500,300,2018.0,Mystery and thriller,2:19,-4,35.33464921414029
41,62,Mary Queen of Scots,2500,288,2018.0,Biography/Drama,2:04,21,34.44453330922775
74,87,Tully,2500,282,2018.0,Drama/Comedy,1:34,13,33.994267903729856
33,57,Pet Sematary,2500,278,2019.0,Horror/Mystery and thriller,1:41,24,33.69209351576394
97,95,Raya and the Last Dragon,2500,274,2021.0,Kids and family/Animation,1:48,-2,33.38828421669504
62,93,The Old Man & the Gun,2500,269,2018.0,Drama/Mystery and thriller,1:33,31,33.006173253232014
74,80,Boy Erased,2500,263,2018.0,Gay and lesbian/Drama,1:55,6,32.54410577614366
91,89,Blinded by the Light,2500,258,2019.0,Drama/Comedy,1:54,-2,32.15602193394618
68,82,Bill & Ted Face the Music,2500,257,2020.0,Comedy/Adventure,1:31,14,32.07806788174952
94,97,Won't You Be My Neighbor?,2500,253,2018.0,Documentary,1:34,3,31.765107230441497
40,23,The Happytime Murders,2500,247,2018.0,Comedy/Mystery and thriller,1:31,-17,31.292163863166575
68,93,First Reformed,2500,243,2017.0,Drama/Mystery and thriller,1:53,25,30.97447264187668
86,93,Fighting With My Family,2500,241,2019.0,Comedy/Biography,1:47,7,30.81489211741166
39,49,Coming 2 America,2500,239,2021.0,Comedy,1:49,10,30.654814192715765
81,100,Leave No Trace,2500,238,2018.0,Drama,1:48,19,30.574586918379627
58,80,Unsane,2500,236,2018.0,Horror/Mystery and thriller,1:38,22,30.41375210935341
77,89,The Ballad of Buster Scruggs,2500,232,2018.0,Drama/Western,2:12,12,30.090540621339713
35,35,I Feel Pretty,2500,230,2018.0,Comedy,1:50,0,29.928151766205126
78,52,Charlie's Angels,2500,230,2019.0,Adventure/Action,1:58,-26,29.928151766205126
69,24,The Kitchen,2500,228,2019.0,Crime/Drama,1:42,-45,29.76523250994286
66,81,Overlord,2500,226,2018.0,Horror/Mystery and thriller,1:50,15,29.601776444473394
55,68,Wonderstruck,2500,225,2017.0,Drama/Adventure,1:57,13,29.519845068981457
95,89,Dark Waters,2500,225,2019.0,Drama/Mystery and thriller,2:06,-6,29.519845068981457
81,80,Mid90s,2500,225,2018.0,Comedy/Drama,1:24,-1,29.519845068981457
88,89,The Two Popes,2500,223,2019.0,Drama,2:06,1,29.355571478323455
83,97,The Hate U Give,2500,223,2018.0,Drama/Crime,2:13,14,29.355571478323455
45,65,The House With a Clock in Its Walls,2500,219,2018.0,Adventure/Mystery and thriller,1:45,20,29.025357112775033
48,18,Hellboy,2500,219,2019.0,Adventure/Fantasy,2:00,-30,29.025357112775033
96,94,The Peanut Butter Falcon,2500,218,2019.0,Comedy/Drama,1:36,-2,28.942451120368005
71,77,Last Flag Flying,2500,218,2017.0,Comedy/Drama,2:04,6,28.942451120368005
60,47,Underwater,2500,215,2020.0,Sci fi/Horror,1:35,-13,28.69287309120695
71,85,The Square,2500,215,2017.0,Comedy,2:22,14,28.69287309120695
69,67,Extraction,2500,214,2020.0,Mystery and thriller/Action,1:57,-2,28.609390680053693
81,88,American Animals,2500,214,2018.0,Drama/Crime,1:56,7,28.609390680053693
84,83,The Way Back,2500,212,2020.0,Drama,1:48,-1,28.441985657257728
56,49,The Spy Who Dumped Me,2500,208,2018.0,Action/Comedy,1:56,-7,28.10538794609019
58,71,Happy Death Day 2U,2500,207,2019.0,Horror/Mystery and thriller,1:40,13,28.02086036400211
69,86,The Sisters Brothers,2500,207,2018.0,Comedy/Western,2:00,17,28.02086036400211
35,79,I Care a Lot,2500,207,2020.0,Comedy/Mystery and thriller,1:58,44,28.02086036400211
75,84,Disobedience,2500,205,2017.0,Gay and lesbian/Drama,1:54,9,27.85134436832817
67,58,Brightburn,2500,205,2019.0,Sci fi/Horror,1:31,-9,27.85134436832817
60,51,The Equalizer 2,2500,204,2018.0,Mystery and thriller/Action,2:01,-9,27.76635389491961
56,56,Tag,2500,202,2018.0,Comedy,1:40,0,27.595902757162747
74,83,Julieta,2500,200,2016.0,Drama,1:36,9,27.42481756762073
64,80,Macbeth,2500,197,2015.0,Drama,1:53,16,27.166981771469644
44,23,Mile 22,2500,191,2018.0,Mystery and thriller/Action,1:35,-21,26.646848608438216
66,70,The Mule,2500,189,2018.0,Crime/Drama,1:56,4,26.47211419497369
82,43,The Upside,2500,188,2017.0,Comedy/Drama,2:06,-39,26.384487078239673
61,82,Fahrenheit 11/9,2500,185,2018.0,Documentary,2:08,21,26.120550779067592
49,69,Cold Pursuit,2500,185,2019.0,Mystery and thriller/Action,1:58,20,26.120550779067592
88,97,Three Identical Strangers,2500,183,2018.0,History/Documentary,1:36,9,25.943701036580038
34,55,Rules Don't Apply,2500,181,2016.0,Drama/Romance,2:01,21,25.766124995595995
48,92,A Quiet Passion,2500,178,2016.0,Biography/Drama,2:05,44,25.49837485437685
47,70,Isn't It Romantic,2500,178,2019.0,Romance/Fantasy,1:28,23,25.49837485437685
53,55,"Roman J. Israel, Esq.",2500,176,2017.0,Drama/Crime,1:57,2,25.31893404088985
77,79,The Man Who Invented Christmas,2500,174,2017.0,Other/Drama,1:44,2,25.13872691364861
55,79,Brad's Status,2500,174,2017.0,Drama/Comedy,1:42,24,25.13872691364861
27,56,The First Purge,2500,173,2018.0,Horror/Mystery and thriller,1:37,29,25.048332202229876
43,13,The Hustle,2500,168,2019.0,Comedy,1:34,-30,24.59338457671065
71,68,Breathe,2500,168,2017.0,Drama/Biography,1:57,-3,24.59338457671065
86,82,Brigsby Bear,2500,166,2017.0,Comedy,1:37,-4,24.409987387794924
40,15,Robin Hood,2500,165,2018.0,Adventure/Action,1:58,-25,24.317978218708763
37,23,The 15:17 to Paris,2500,165,2018.0,Drama/Mystery and thriller,1:34,-14,24.317978218708763
68,87,Thoroughbreds,2500,164,2017.0,Mystery and thriller/Comedy,1:30,19,24.225759698543914
22,16,Blumhouse's Truth or Dare,2500,161,2018.0,Horror/Mystery and thriller,1:40,-6,23.947830330270747
36,18,I Saw the Light,2500,158,2015.0,Drama/Biography,2:03,-18,23.667951973591787
51,51,Escape Room,2500,157,2019.0,Horror/Mystery and thriller,1:40,0,23.574217318823912
82,81,Instant Family,2500,155,2018.0,Comedy/Drama,1:59,-1,23.38607355742051
93,97,Free Solo,2500,154,2018.0,Documentary,1:40,4,23.291660464128444
65,21,Like a Boss,2500,153,2020.0,Comedy,1:23,-44,23.197017186759677
70,12,Peppermint,2500,150,2018.0,Mystery and thriller/Action,1:42,-58,22.911685375307673
77,93,Thelma,2500,148,2017.0,Horror/Mystery and thriller,1:56,16,22.72027439676837
56,63,Peter Rabbit,2500,146,2018.0,Kids and family/Comedy,1:35,7,22.52789093302636
72,15,The Darkest Minds,2500,140,2018.0,Mystery and thriller/Sci fi,1:44,-57,21.944718908089367
54,49,Freeheld,2500,139,2015.0,Romance/Biography,1:43,-5,21.84661977512174
84,91,Frantz,2500,138,2016.0,Drama/History,1:53,7,21.748255626180264
62,42,Den of Thieves,2500,137,2018.0,Drama/Crime,2:20,-20,21.649623817070065
83,82,Victoria,2500,136,2015.0,Drama/Crime,2:18,-1,21.550721657693213
57,93,Revenge,2500,134,2017.0,Mystery and thriller,1:48,36,21.35209529135088
23,53,The D Train,2500,134,2015.0,Comedy/Drama,1:40,30,21.35209529135088
71,91,Teen Titans GO! to the Movies,2500,133,2018.0,Kids and family/Comedy,1:27,20,21.252365464220812
54,82,Listen Up Philip,2500,133,2014.0,Comedy/Drama,1:49,28,21.252365464220812
71,80,Alpha,2500,132,2018.0,Adventure/Drama,1:37,9,21.152354044022278
37,49,I'm So Excited!,2500,131,2013.0,Gay and lesbian/Comedy,1:29,12,21.05205809326756
67,92,The Endless,2500,131,2017.0,Sci fi/Horror,1:51,25,21.05205809326756
30,47,Wilson,2500,131,2017.0,Comedy,1:34,17,21.05205809326756
64,75,Landline,2500,130,2017.0,Comedy/Drama,1:33,11,20.951474621135226
32,13,Winchester,2500,130,2018.0,Horror/Mystery and thriller,1:39,-19,20.951474621135226
81,91,El Camino: A Breaking Bad Movie,2500,129,2019.0,Drama/Crime,2:02,10,20.850600582083427
87,98,God's Own Country,2500,129,2017.0,Romance/Gay and lesbian,1:44,11,20.850600582083427
52,73,Back Home,2500,128,2015.0,Drama,1:49,21,20.749432874416154
23,21,The Grudge,2500,126,2020.0,Mystery and thriller/Horror,1:34,-2,20.546203756731995
56,88,Norman: The Moderate Rise and Tragic Fall of a New York Fixer,2500,126,2016.0,Drama/Mystery and thriller,1:58,32,20.546203756731995
82,87,Dheepan,2500,126,2015.0,Drama,1:50,5,20.546203756731995
83,94,Little Sister,2500,123,2015.0,Drama,2:06,11,20.23907662547856
30,23,American Pastoral,2500,123,2016.0,Drama,1:48,-7,20.23907662547856
48,62,Hotel Transylvania 3: Summer Vacation,2500,119,2018.0,Comedy/Adventure,1:37,14,19.82516684143501
81,94,"Life, Animated",2500,118,2016.0,Documentary,1:31,13,19.720878370380042
61,83,Trophy Wife,2500,118,2010.0,Comedy,1:43,22,19.720878370380042
54,49,Churchill,2500,116,2017.0,Drama/Biography,1:45,-5,19.511301649293156
41,74,Wiener-Dog,2500,116,2016.0,Comedy,1:27,33,19.511301649293156
39,47,Paris Can Wait,2500,115,2016.0,Romance,1:32,8,19.406005504006643
50,81,Sunset Song,2500,115,2015.0,Drama/History,2:15,31,19.406005504006643
58,49,Towelhead,2500,114,2007.0,Drama,2:08,-9,19.300365436139025
43,62,The Program,2500,111,2015.0,Drama/Biography,1:43,19,18.981339705756774
46,52,Genius,2500,111,2016.0,,,6,18.981339705756774
54,72,The Future,2500,111,2011.0,Drama,1:31,18,18.981339705756774
48,68,Jack Goes Boating,2500,111,2010.0,Romance,1:30,20,18.981339705756774
84,73,The Angry Birds Movie 2,2500,110,2019.0,Comedy/Adventure,1:36,-11,18.874281508207943
53,61,Mood Indigo,2500,109,2013.0,Drama/Romance,1:34,8,18.76685771072333
78,79,Standard Operating Procedure,2500,109,2008.0,Documentary/Drama,1:56,1,18.76685771072333
48,7,Blumhouse's Fantasy Island,2500,108,2020.0,Horror/Mystery and thriller,1:49,-41,18.659063693305395
52,38,Where in the World Is Osama bin Laden?,2500,108,2008.0,Comedy/Documentary,1:33,-14,18.659063693305395
82,94,Goodbye Solo,2500,108,2008.0,Comedy/Drama,1:31,12,18.659063693305395
57,83,Eden,2500,107,2014.0,Drama,2:11,26,18.55089473417879
88,92,Land of Mine,2500,107,2015.0,Drama/History,1:40,4,18.55089473417879
79,96,Jafar Panahi's Taxi,2500,106,2015.0,,,17,18.442346006574258
89,90,Buck,2500,105,2011.0,Documentary,1:28,1,18.333412575379587
57,85,Beach Rats,2500,105,2017.0,Gay and lesbian/Drama,1:37,28,18.333412575379587
65,94,The Duke of Burgundy,2500,104,2014.0,Gay and lesbian/Drama,1:46,29,18.22408939365073
60,83,Like Someone in Love,2500,102,2012.0,Drama,1:49,23,18.004253009684938
57,78,The Eyes of My Mother,2500,101,2016.0,Drama/Horror,1:16,21,17.893729120895756
52,81,Equity,2500,101,2016.0,Drama/Mystery and thriller,1:40,29,17.893729120895756
69,65,Unfinished Song,2500,100,2012.0,Drama/Comedy,1:33,-4,17.78279410038923
64,35,Super Troopers 2,2500,100,2018.0,Comedy,1:43,-29,17.78279410038923
30,46,The Bad Batch,2500,100,2016.0,Horror/Mystery and thriller,1:58,16,17.78279410038923
70,87,Starting Out in the Evening,2500,100,2007.0,Drama,1:50,17,17.78279410038923
58,66,Learning to Drive,2500,99,2014.0,Drama/Romance,1:30,8,17.67144228430324
89,99,Tower,2500,99,2016.0,Documentary,1:38,10,17.67144228430324
44,36,The Bronze,2500,99,2015.0,Comedy,1:40,-8,17.67144228430324
49,79,Baghead,2500,99,2008.0,Comedy/Mystery and thriller,1:28,30,17.67144228430324
53,85,Berberian Sound Studio,2500,98,2012.0,Horror,1:28,32,17.55966787263607
79,69,Remember,2500,98,2015.0,Drama/Mystery and thriller,1:35,-10,17.55966787263607
37,61,Dirty Cops - War on Everyone,2500,98,2016.0,Comedy,1:38,24,17.55966787263607
59,77,The Last Mistress,2500,98,2007.0,Drama,1:44,18,17.55966787263607
69,85,Lorna's Silence,2500,98,2008.0,Drama,1:35,16,17.55966787263607
36,84,Results,2500,96,2015.0,Romance,1:44,48,17.334827353454408
88,92,Every Little Step,2500,96,2008.0,Music/Documentary,1:36,4,17.334827353454408
15,21,The Canyons,2500,95,2013.0,Drama/Mystery and thriller,1:35,6,17.22174892188519
30,19,Wish Upon,2500,94,2017.0,Mystery and thriller/Horror,1:29,-11,17.108223236119827
50,43,Words and Pictures,2500,94,2013.0,Drama/Romance,1:51,-7,17.108223236119827
60,36,6 Underground,2500,94,2019.0,Action/Mystery and thriller,2:07,-24,17.108223236119827
91,91,Taylor Swift: Miss Americana,2500,93,2020.0,Music/Documentary,1:26,0,16.994243740562503
62,82,Higher Ground,2500,93,2011.0,Drama,1:54,20,16.994243740562503
43,62,My Old Lady,2500,93,2014.0,Comedy/Drama,1:47,19,16.994243740562503
52,63,Trishna,2500,93,2011.0,Romance/Drama,1:57,11,16.994243740562503
38,40,Love,2500,93,2015.0,,,2,16.994243740562503
46,63,Desierto - Border Sniper,2500,92,2015.0,Drama/Mystery and thriller,1:30,17,16.879803711855995
59,47,The Hollars,2500,92,2016.0,Drama/Comedy,1:28,-12,16.879803711855995
49,48,A Little Chaos,2500,92,2014.0,Drama/Romance,1:56,-1,16.879803711855995
60,82,Flight of the Red Balloon,2500,92,2007.0,Drama,1:54,22,16.879803711855995
77,95,My Winnipeg,2500,92,2007.0,Comedy/Documentary,1:20,18,16.879803711855995
60,84,My Mother,2500,91,2015.0,Drama/Comedy,1:46,24,16.764896252714394
73,99,Under the Shadow,2500,91,2016.0,Horror/Mystery and thriller,1:24,26,16.764896252714394
42,69,Not Fade Away,2500,91,2012.0,Drama,1:52,27,16.764896252714394
54,73,Stuck,2500,91,2007.0,Comedy/Mystery and thriller,1:34,19,16.764896252714394
64,96,Heart of a Dog,2500,90,2015.0,Documentary,1:15,32,16.64951428545866
33,52,Holy Rollers,2500,90,2010.0,Drama/Crime,1:29,19,16.64951428545866
78,85,Merchants of Doubt,2500,89,2014.0,Documentary,1:36,7,16.533650545237286
50,60,Vince Vaughn's Wild West Comedy Show: 30 Days & 30 Nights - Hollywood to the Heartland,2500,89,2006.0,Comedy/Documentary,1:40,10,16.533650545237286
74,94,A Touch of Sin,2500,88,2013.0,Drama,2:09,20,16.417297572912943
79,95,"20,000 Days on Earth",2500,88,2014.0,Drama,1:37,16,16.417297572912943
91,93,The Tillman Story,2500,88,2010.0,Documentary,1:34,2,16.417297572912943
37,74,A Girl Cut in Two,2500,88,2007.0,Comedy,1:54,37,16.417297572912943
54,58,LBJ,2500,85,2016.0,Drama/Biography,1:38,4,16.06522559818003
42,36,Equals,2500,84,2015.0,Sci fi/Romance,1:41,-6,15.946836950911226
41,51,Being Flynn,2500,84,2012.0,Comedy/Drama,1:42,10,15.946836950911226
61,74,Young & Beautiful,2500,84,2013.0,Drama,1:35,13,15.946836950911226
91,50,A Dog's Journey,2500,84,2019.0,Comedy/Fantasy,1:48,-41,15.946836950911226
46,54,The Foot Fist Way,2500,84,2006.0,Comedy,1:27,8,15.946836950911226
41,66,Afternoon Delight,2500,83,2013.0,Drama/Comedy,1:39,25,15.827918586512368
57,64,Paris 36,2500,83,2008.0,Drama/History,2:00,7,15.827918586512368
58,93,Queen of Earth,2500,83,2015.0,Comedy/Drama,1:29,35,15.827918586512368
83,96,Revanche,2500,83,2008.0,Drama/Crime,2:01,13,15.827918586512368
47,83,The Family Fang,2500,82,2015.0,Comedy/Drama,1:46,36,15.708461709271033
53,88,Computer Chess,2500,82,2013.0,Comedy,1:31,35,15.708461709271033
73,96,Girlhood,2500,81,2014.0,Drama,1:52,23,15.588457268119896
76,94,Barbara,2500,81,2012.0,Drama,1:45,18,15.588457268119896
41,56,Breathe In,2500,80,2013.0,Drama/Romance,1:37,15,15.467895945971296
81,100,Gett: The Trial of Viviane Amsalem,2500,80,2014.0,Drama,1:55,19,15.467895945971296
62,81,Cairo Time,2500,80,2009.0,Romance/Drama,1:28,19,15.467895945971296
17,8,Slender Man,2500,80,2018.0,Horror/Mystery and thriller,1:33,-9,15.467895945971296
69,68,The 100-Year-Old Man Who Climbed Out the Window and Disappeared,2500,80,2013.0,Comedy/Adventure,1:54,-1,15.467895945971296
72,93,Ballast,2500,80,2008.0,Drama,1:36,21,15.467895945971296
25,10,Holmes & Watson,2500,79,2018.0,Mystery and thriller/Comedy,1:30,-15,15.34676814846713
70,91,Gerald's Game,2500,79,2017.0,Horror/Mystery and thriller,1:43,21,15.34676814846713
41,70,Dark Horse,2500,79,2011.0,Drama,1:25,29,15.34676814846713
30,48,Adult Beginners,2500,79,2014.0,Comedy/Drama,1:32,18,15.34676814846713
47,88,Goodbye to Language,2500,78,2014.0,Drama,1:10,41,15.225063992104127
49,65,The Merry Gentleman,2500,78,2009.0,Drama,1:36,16,15.225063992104127
45,79,Goat,2500,77,2016.0,Drama,1:36,34,15.102773291691431
68,82,The Brand New Testament,2500,77,2015.0,Comedy/Fantasy,1:53,14,15.102773291691431
73,53,Where Do We Go Now?,2500,76,2011.0,Musical/Drama,1:40,-20,14.979885547093689
59,67,God Help the Girl,2500,76,2014.0,Musical/Drama,1:51,8,14.979885547093689
84,9,Stonewall,2500,76,2015.0,Gay and lesbian/Drama,2:09,-75,14.979885547093689
79,84,Soul Power,2500,75,2008.0,Music/Documentary,1:33,5,14.856389929209026
80,87,Bullhead,2500,75,2011.0,Drama/Crime,2:08,7,14.856389929209026
32,20,360,2500,75,2011.0,Drama,1:53,-12,14.856389929209026
75,95,Cutie and the Boxer,2500,75,2013.0,Documentary/Biography,1:22,20,14.856389929209026
70,92,James White,2500,75,2015.0,Drama,1:26,22,14.856389929209026
76,87,Roman de Gare,2500,75,2007.0,Drama,1:43,11,14.856389929209026
55,75,District 13: Ultimatum,2500,75,2009.0,Action,1:40,20,14.856389929209026
85,81,A Town Called Panic,2500,75,2009.0,Comedy/Animation,1:15,-4,14.856389929209026
79,84,I Am Big Bird: The Caroll Spinney Story,2500,74,2014.0,Drama/Biography,1:30,5,14.732275265126917
34,54,The Look of Love,2500,74,2013.0,Drama/Biography,1:41,20,14.732275265126917
92,99,Bill Cunningham New York,2500,74,2010.0,Drama/Biography,1:24,7,14.732275265126917
65,86,The Wedding Plan,2500,74,2016.0,Romance,1:50,21,14.732275265126917
69,89,Fill the Void,2500,74,2012.0,Drama,1:30,20,14.732275265126917
47,36,Tim and Eric's Billion Dollar Movie,2500,74,2012.0,Comedy,1:32,-11,14.732275265126917
77,84,Dior and I,2500,73,2014.0,Documentary,1:30,7,14.607530022406213
38,32,Lost River,2500,73,2014.0,Mystery and thriller/Fantasy,1:45,-6,14.607530022406213
85,93,The Hunting Ground,2500,73,2015.0,Documentary,1:42,8,14.607530022406213
57,47,Mister Lonely,2500,73,2007.0,Drama/Comedy,1:52,-10,14.607530022406213
85,97,The Overnighters,2500,73,2014.0,Drama/Documentary,1:41,12,14.607530022406213
73,88,Band Aid,2500,73,2017.0,Drama/Comedy,1:34,15,14.607530022406213
30,52,Boulevard,2500,73,2014.0,Gay and lesbian/Drama,1:28,22,14.607530022406213
56,74,A Royal Night Out,2500,73,2015.0,Comedy/Drama,1:37,18,14.607530022406213
27,48,Mother of Tears,2500,73,2007.0,Drama/Fantasy,1:38,21,14.607530022406213
75,88,Hannah Arendt,2500,73,2012.0,Drama,1:53,13,14.607530022406213
74,83,Dirty Wars,2500,72,2013.0,Documentary,1:26,9,14.482142292408389
58,86,A Field in England,2500,72,2013.0,Mystery and thriller/Drama,1:30,28,14.482142292408389
70,69,Oranges and Sunshine,2500,72,2010.0,Drama/History,1:45,-1,14.482142292408389
37,42,The Extra Man,2500,72,2010.0,Comedy,1:48,5,14.482142292408389
45,76,Last Days in the Desert,2500,71,2015.0,Drama,1:39,31,14.356099772615265
80,65,Starbuck,2500,71,2011.0,Drama/Romance,1:48,-15,14.356099772615265
64,42,Little White Lies,2500,71,2010.0,Drama/Comedy,2:34,-22,14.356099772615265
75,92,Zero Days,2500,71,2016.0,Documentary,1:56,17,14.356099772615265
47,63,The Sacrament,2500,71,2013.0,Mystery and thriller,1:39,16,14.356099772615265
50,73,The Blackcoat's Daughter,2500,71,2015.0,Horror/Mystery and thriller,1:33,23,14.356099772615265
76,87,Amreeka,2500,71,2009.0,Comedy/Drama,1:36,11,14.356099772615265
75,96,Sister,2500,70,2012.0,Drama,1:37,21,14.229389747854103
90,96,Gleason,2500,69,2016.0,Documentary,1:51,6,14.101999070345963
88,88,The Boy and the Beast,2500,69,2015.0,Animation/Action,1:59,0,14.101999070345963
85,96,To All the Boys I've Loved Before,2500,69,2018.0,Drama/Romance,1:39,11,14.101999070345963
51,77,In a Valley of Violence,2500,69,2016.0,Western,1:44,26,14.101999070345963
26,43,Madame Bovary,2500,69,2014.0,Drama/Romance,1:58,17,14.101999070345963
84,94,Best Worst Movie,2500,69,2009.0,Documentary,1:31,10,14.101999070345963
57,79,Red Hill,2500,68,2010.0,Mystery and thriller/Action,1:35,22,13.973914138485368
63,90,Keep the Lights On,2500,67,2012.0,Drama/Gay and lesbian,1:43,27,13.8451208742507
83,91,The Punk Singer,2500,67,2013.0,Documentary/Biography,1:20,8,13.8451208742507
79,99,Elaine Stritch: Shoot Me,2500,67,2013.0,Documentary,1:26,20,13.8451208742507
70,88,Pranzo di Ferragosto,2500,67,2008.0,Comedy/Drama,1:15,18,13.8451208742507
77,74,Winter in Wartime,2500,66,2008.0,Drama/War,1:43,-3,13.715604699135167
49,77,Teenage,2500,66,2013.0,Documentary,1:20,28,13.715604699135167
64,70,To the Bone,2500,66,2017.0,Drama/Comedy,1:47,6,13.715604699135167
44,26,Nobel Son,2500,66,2007.0,Comedy/Mystery and thriller,1:50,-18,13.715604699135167
67,79,Chinese Puzzle,2500,66,2013.0,Comedy/Romance,1:57,12,13.715604699135167
89,88,Tangerines,2500,66,2013.0,War/Drama,1:23,-1,13.715604699135167
49,27,The Necessary Death of Charlie Countryman,2500,66,2013.0,Drama/Romance,1:48,-22,13.715604699135167
65,89,Better Watch Out,2500,65,2016.0,Other/Horror,1:29,24,13.58535050847747
76,77,A Street Cat Named Bob,2500,65,2016.0,Drama/Biography,1:43,1,13.58535050847747
76,89,I Don't Feel at Home in This World Anymore,2500,65,2017.0,Drama/Crime,1:36,13,13.58535050847747
73,94,Elena,2500,65,2011.0,Drama,1:49,21,13.58535050847747
44,83,Evolution,2500,64,2015.0,Mystery and thriller/Horror,1:21,39,13.454342644059432
20,70,XX,2500,63,2017.0,Horror,1:21,50,13.322564864824612
76,89,The Turin Horse,2500,63,2011.0,Drama,2:26,13,13.322564864824612
63,75,The German Doctor,2500,63,2013.0,Drama/Mystery and thriller,1:33,12,13.322564864824612
43,46,5 Flights Up,2500,63,2014.0,Comedy/Drama,1:32,3,13.322564864824612
61,63,For No Good Reason,2500,62,2012.0,Documentary,1:29,2,13.190000315557024
79,84,Laurence Anyways,2500,62,2012.0,Drama/Romance,2:39,5,13.190000315557024
26,23,Elles,2500,62,2011.0,Drama,1:39,-3,13.190000315557024
69,87,Borgman,2500,62,2013.0,Drama/Mystery and thriller,1:53,18,13.190000315557024
80,90,City of Gold,2500,62,2015.0,Documentary/Biography,1:29,10,13.190000315557024
41,42,Goon: Last of the Enforcers,2500,62,2017.0,Comedy,1:41,1,13.190000315557024
52,56,Bran Nue Dae,2500,62,2009.0,Comedy/Musical,1:28,4,13.190000315557024
76,95,Nobody Knows About the Persian Cats,2500,62,2009.0,Drama,1:46,19,13.190000315557024
43,67,The Nightmare,2500,61,2015.0,Documentary/Horror,1:30,24,13.056631493342596
62,72,Magic Trip: Ken Kesey's Search for a Kool Place,2500,61,2011.0,Documentary,1:30,10,13.056631493342596
85,84,American: The Bill Hicks Story,2500,61,2010.0,Documentary,1:46,-1,13.056631493342596
51,69,Thin Ice,2500,61,2011.0,Comedy/Drama,1:34,18,13.056631493342596
35,23,Yoga Hosers,2500,60,2016.0,Horror/Comedy,1:28,-12,12.922440211617326
91,93,The Internet's Own Boy: The Story of Aaron Swartz,2500,60,2014.0,Documentary,1:45,2,12.922440211617326
83,82,Batkid Begins: The Wish Heard Around the World,2500,60,2015.0,Documentary,1:29,-1,12.922440211617326
67,73,The Exception,2500,60,2016.0,Romance/War,1:47,6,12.922440211617326
90,90,"Beats, Rhymes & Life: The Travels of A Tribe Called Quest",2500,60,2011.0,Documentary/Music,1:37,0,12.922440211617326
69,90,My Dog Tulip,2500,60,2009.0,Drama/Animation,1:21,21,12.922440211617326
28,17,The Wild Life,2500,59,2016.0,Comedy/Animation,1:30,-11,12.78740756158519
79,93,Wings,2500,59,1927.0,Drama/History,2:19,14,12.78740756158519
24,53,Black Rock,2500,59,2012.0,Mystery and thriller,1:20,29,12.78740756158519
44,66,Unexpected,2500,58,2015.0,Drama/Comedy,1:25,22,12.651513870765422
29,29,Everly,2500,58,2014.0,Mystery and thriller/Action,1:32,0,12.651513870765422
77,97,April and the Extraordinary World,2500,58,2015.0,Sci fi/Adventure,1:45,20,12.651513870765422
82,84,North Face,2500,58,2008.0,Romance/Adventure,2:06,2,12.651513870765422
47,47,Rock Dog,2500,57,2016.0,Comedy/Adventure,1:30,0,12.514738658402138
61,93,I Am Not a Serial Killer,2500,57,2016.0,Mystery and thriller,1:44,32,12.514738658402138
69,53,South of the Border,2500,57,2009.0,Documentary,1:18,-16,12.514738658402138
39,52,Blood Ties,2500,56,2013.0,Drama/Crime,2:08,13,12.377060587439436
73,63,Broken,2500,56,2012.0,Drama,1:30,-10,12.377060587439436
30,16,Kill Me Three Times,2500,56,2014.0,Mystery and thriller/Action,1:30,-14,12.377060587439436
83,96,Outback,2500,56,1971.0,Drama/Mystery and thriller,1:39,13,12.377060587439436
31,29,The Love Punch,2500,56,2013.0,Comedy,1:34,-2,12.377060587439436
92,82,Dragon Ball Super: Broly,2500,56,2018.0,Action/Adventure,1:41,-10,12.377060587439436
72,77,"People, Places, Things",2500,56,2015.0,Comedy,1:26,5,12.377060587439436
26,16,A Glimpse Inside the Mind of Charles Swan III,2500,56,2012.0,Comedy/Drama,1:25,-10,12.377060587439436
72,73,Pieta,2500,56,2012.0,Drama/Mystery and thriller,1:43,1,12.377060587439436
38,39,The City of Your Final Destination,2500,56,2007.0,Drama,1:54,1,12.377060587439436
58,16,Man Down,2500,55,2015.0,Drama/Mystery and thriller,1:30,-42,12.238457412731087
25,42,Aftermath,2500,55,2017.0,Drama/Mystery and thriller,1:32,17,12.238457412731087
76,64,Café de Flore,2500,55,2011.0,Drama,2:00,-12,12.238457412731087
62,80,Detective Dee and the Mystery of the Phantom Flame,2500,55,2010.0,History/Action,2:03,18,12.238457412731087
87,96,Deep Water,2500,55,2006.0,Documentary,1:33,9,12.238457412731087
17,11,Cell,2500,54,2016.0,Mystery and thriller/Horror,1:38,-6,12.098905925115496
83,96,I Am Divine,2500,54,2012.0,Documentary,1:30,13,12.098905925115496
81,89,Armadillo,2500,54,2010.0,War/Documentary,1:40,8,12.098905925115496
69,85,Tallulah,2500,54,2016.0,Drama,1:51,16,12.098905925115496
77,94,Drug War,2500,54,2012.0,Drama/Action,1:45,17,12.098905925115496
76,87,Meet the Patels,2500,54,2014.0,Comedy/Documentary,1:28,11,12.098905925115496
59,61,Jungle,2500,54,2017.0,Action/Mystery and thriller,1:55,2,12.098905925115496
86,93,City of Life and Death,2500,54,2009.0,War/Drama,2:13,7,12.098905925115496
91,94,Lake of Fire,2500,54,2006.0,Documentary,2:32,3,12.098905925115496
90,96,The Devil Came on Horseback,2500,54,2007.0,Documentary,1:28,6,12.098905925115496
85,80,Pierrepoint: The Last Hangman,2500,54,2005.0,Drama,1:34,-5,12.098905925115496
51,81,Southbound,2500,53,2015.0,Horror/Mystery and thriller,1:29,30,11.958381890942793
87,98,Beware of Mr. Baker,2500,53,2012.0,Documentary,1:32,11,11.958381890942793
52,32,The Hottest State,2500,53,2006.0,Romance/Drama,1:56,-20,11.958381890942793
55,75,Hello I Must Be Going,2500,52,2012.0,Drama/Comedy,1:34,20,11.8168599865911
29,33,Song One,2500,52,2014.0,Musical/Romance,1:28,4,11.8168599865911
43,27,Captive,2500,52,2015.0,Drama/Crime,1:37,-16,11.8168599865911
70,90,My Brother the Devil,2500,52,2012.0,Drama/Crime,1:51,20,11.8168599865911
68,83,Fifty Dead Men Walking,2500,52,2008.0,Mystery and thriller/Action,1:57,15,11.8168599865911
70,42,The Star,2500,52,2017.0,Comedy/Adventure,1:26,-28,11.8168599865911
46,77,Essential Killing,2500,52,2010.0,War/Mystery and thriller,1:24,31,11.8168599865911
89,67,Touched With Fire,2500,52,2015.0,Romance/Drama,1:46,-22,11.8168599865911
39,50,Wolf Creek 2,2500,52,2013.0,Horror/Mystery and thriller,1:46,11,11.8168599865911
63,75,OSS 117: Lost in Rio,2500,52,2009.0,Comedy/Action,1:41,12,11.8168599865911
84,87,Imitation of Life,2500,52,1934.0,Drama,1:46,3,11.8168599865911
64,88,Middle of Nowhere,2500,51,2012.0,Drama/Romance,1:41,24,11.674313727451958
52,61,American Mary,2500,51,2012.0,Horror/Mystery and thriller,1:43,9,11.674313727451958
80,71,Waking Sleeping Beauty,2500,51,2009.0,Documentary,1:26,-9,11.674313727451958
66,73,Sex & Drugs & Rock & Roll,2500,51,2010.0,Drama/Biography,1:54,7,11.674313727451958
34,22,Violet & Daisy,2500,51,2011.0,Drama/Crime,1:28,-12,11.674313727451958
90,98,For the Bible Tells Me So,2500,51,2007.0,Documentary/Gay and lesbian,1:35,8,11.674313727451958
64,47,The Mighty Macs,2500,51,2009.0,Drama,1:38,-17,11.674313727451958
16,20,Motherhood,2500,51,2009.0,Comedy,1:29,4,11.674313727451958
55,73,The Woman,2500,51,2011.0,Horror,1:42,18,11.674313727451958
22,8,The Babymakers,2500,51,2012.0,Comedy,1:38,-14,11.674313727451958
53,92,Backcountry,2500,51,2014.0,Adventure/Drama,1:32,39,11.674313727451958
67,25,The Final Season,2500,51,2007.0,Drama,1:53,-42,11.674313727451958
80,92,Il Divo,2500,51,2008.0,Biography/Drama,1:50,12,11.674313727451958
80,94,Diplomacy,2500,50,2014.0,Drama/History,1:28,14,11.530715390799685
46,60,Hellion,2500,50,2014.0,Drama,1:38,14,11.530715390799685
40,80,The Monster,2500,50,2016.0,Horror/Mystery and thriller,1:31,40,11.530715390799685
74,92,Caesar Must Die,2500,50,2012.0,Drama,1:16,18,11.530715390799685
82,86,Gypsy Caravan,2500,50,2006.0,Documentary,1:51,4,11.530715390799685
86,80,Send a Bullet,2500,50,2007.0,Documentary,1:25,-6,11.530715390799685
80,69,Shot Caller,2500,49,2017.0,Drama/Crime,2:00,-11,11.3860359318845
81,67,The Music Never Stopped,2500,49,2011.0,Drama,1:45,-14,11.3860359318845
47,76,The Ones Below,2500,49,2015.0,Mystery and thriller,1:27,29,11.3860359318845
77,98,The Island President,2500,49,2011.0,Documentary,1:41,21,11.3860359318845
88,94,King of Devil's Island,2500,49,2010.0,Drama/History,1:52,6,11.3860359318845
75,90,To Be Takei,2500,49,2014.0,Documentary/Gay and lesbian,1:33,15,11.3860359318845
31,49,A Single Shot,2500,49,2013.0,Mystery and thriller,1:56,18,11.3860359318845
61,29,Colonia,2500,49,2015.0,Romance/History,1:50,-32,11.3860359318845
34,47,Pusher,2500,49,2012.0,Drama/Crime,1:29,13,11.3860359318845
80,90,Shotgun Stories,2500,49,2007.0,Drama/Mystery and thriller,1:32,10,11.3860359318845
47,81,Do I Sound Gay?,2500,48,2014.0,Gay and lesbian/Documentary,1:17,34,11.240244892502977
84,100,Nostalgia for the Light,2500,48,2010.0,Documentary,1:30,16,11.240244892502977
24,17,Father Figures,2500,48,2017.0,Comedy,1:53,-7,11.240244892502977
78,85,Roman Polanski: Wanted and Desired,2500,48,2008.0,Drama/Crime,1:40,7,11.240244892502977
39,35,Dragon Blade,2500,48,2015.0,Action/Drama,1:43,-4,11.240244892502977
94,92,Icarus,2500,48,2017.0,Documentary,1:50,-2,11.240244892502977
72,90,Super Dark Times,2500,48,2017.0,Drama/Mystery and thriller,1:42,18,11.240244892502977
60,48,The Bang Bang Club,2500,48,2010.0,Drama,1:49,-12,11.240244892502977
88,96,Marina Abramovic: The Artist Is Present,2500,47,2012.0,Drama/Biography,1:46,8,11.093310301199846
70,19,Polar,2500,47,2019.0,Mystery and thriller/Action,1:58,-51,11.093310301199846
83,64,Rudderless,2500,47,2014.0,Drama,1:45,-19,11.093310301199846
73,45,Nicotina,2500,47,2003.0,Comedy/Drama,1:30,-28,11.093310301199846
35,48,31,2500,46,2016.0,Other/Horror,1:42,13,10.945198564139895
29,63,The Trust,2500,46,2016.0,Drama/Crime,1:33,34,10.945198564139895
83,87,All the Way,2500,46,2016.0,Drama/Biography,2:12,4,10.945198564139895
86,100,We Were Here,2500,46,2011.0,History/Gay and lesbian,1:30,14,10.945198564139895
85,93,Johnny Guitar,2500,46,1954.0,Western,1:50,8,10.945198564139895
60,39,You Instead,2500,46,2011.0,Romance,1:20,-21,10.945198564139895
82,78,The End of the Line,2500,46,2009.0,Documentary,1:22,-4,10.945198564139895
10,17,The Human Centipede III (Final Sequence),2500,46,2015.0,Horror,1:43,7,10.945198564139895
44,54,Mr. Nice,2500,46,2010.0,Biography/Drama,2:01,10,10.945198564139895
45,59,Hannah Takes the Stairs,2500,46,2007.0,Comedy/Romance,1:24,14,10.945198564139895
78,100,Ilo Ilo,2500,45,2013.0,Drama,1:39,22,10.795874345554918
42,7,CBGB,2500,45,2013.0,Drama,1:41,-35,10.795874345554918
32,56,Citadel,2500,45,2012.0,Horror,1:25,24,10.795874345554918
87,42,Forsaken,2500,45,2015.0,Western/Drama,1:30,-45,10.795874345554918
59,20,The Vatican Tapes,2500,45,2015.0,Horror/Mystery and thriller,1:29,-39,10.795874345554918
61,91,Cropsey,2500,45,2009.0,Drama/Documentary,1:24,30,10.795874345554918
68,87,Starlet,2500,45,2012.0,Drama,1:47,19,10.795874345554918
60,58,Noise,2500,45,2008.0,Comedy,1:27,-2,10.795874345554918
63,80,A Secret,2500,45,2007.0,Drama/History,1:45,17,10.795874345554918
47,95,We Are Still Here,2500,44,2015.0,Horror,1:24,48,10.645300436514761
24,30,Leatherface,2500,44,2017.0,Horror,1:30,6,10.645300436514761
30,41,A Little Help,2500,44,2010.0,Comedy/Drama,1:49,11,10.645300436514761
44,32,About Ray,2500,44,2015.0,Comedy/Gay and lesbian,1:34,-12,10.645300436514761
70,66,Trash,2500,44,2014.0,Comedy/Drama,1:53,-4,10.645300436514761
67,93,Knuckle,2500,44,2011.0,Documentary/Biography,1:33,26,10.645300436514761
31,18,Absolutely Anything,2500,44,2015.0,Comedy/Sci fi,1:25,-13,10.645300436514761
59,18,Legendary,2500,44,2010.0,Drama,1:47,-41,10.645300436514761
62,68,Ira and Abby,2500,44,2006.0,Romance,1:41,6,10.645300436514761
54,65,Wrong,2500,43,2012.0,Drama/Comedy,1:34,11,10.493437610589469
45,65,13 Sins,2500,43,2014.0,Horror/Mystery and thriller,1:32,20,10.493437610589469
43,40,The Grand,2500,43,2008.0,Comedy,1:44,-3,10.493437610589469
34,48,All Cheerleaders Die,2500,42,2013.0,Horror/Mystery and thriller,1:30,14,10.34024446475599
80,88,Code Black,2500,42,2013.0,Drama/Documentary,1:22,8,10.34024446475599
57,81,Rob the Mob,2500,42,2014.0,Drama/Crime,1:44,24,10.34024446475599
43,45,About Alex,2500,42,2014.0,Comedy/Drama,1:38,2,10.34024446475599
83,83,Collapse,2500,42,2009.0,Documentary,1:20,0,10.34024446475599
75,76,Hara-Kiri: Death of a Samurai,2500,42,2011.0,Drama/History,2:06,1,10.34024446475599
54,52,Puncture,2500,42,2011.0,Drama/History,1:40,-2,10.34024446475599
78,74,Kurt Cobain About a Son,2500,42,2006.0,Documentary,1:37,-4,10.34024446475599
78,33,Music Within,2500,42,2007.0,Drama,1:35,-45,10.34024446475599
84,55,The Bubble,2500,42,2006.0,Gay and lesbian/Drama,1:58,-29,10.34024446475599
80,80,Why Don't You Play in Hell?,2500,41,2013.0,Action/Comedy,2:09,0,10.185677243651742
30,68,Magic Magic,2500,41,2013.0,Mystery and thriller,1:37,38,10.185677243651742
74,88,The Well Digger's Daughter,2500,41,2011.0,Romance,1:47,14,10.185677243651742
35,24,Collide,2500,41,2016.0,Mystery and thriller/Action,1:34,-11,10.185677243651742
44,49,"My Son, My Son, What Have Ye Done",2500,41,2009.0,Drama/Horror,1:33,5,10.185677243651742
84,85,The Black Balloon,2500,41,2008.0,Drama,1:37,1,10.185677243651742
23,41,Nobody Walks,2500,41,2012.0,Drama,1:23,18,10.185677243651742
57,66,(Untitled),2500,41,2009.0,Romance,1:36,9,10.185677243651742
42,27,Sex and Death 101,2500,41,2007.0,Comedy/Gay and lesbian,1:40,-15,10.185677243651742
56,90,The Fairy,2500,40,2011.0,Drama/Romance,1:34,34,10.029689644980788
84,100,The Decline of Western Civilization,2500,40,1981.0,Documentary,1:40,16,10.029689644980788
32,40,Brief Interviews With Hideous Men,2500,40,2009.0,Drama,1:20,8,10.029689644980788
29,25,Slipstream,2500,40,2007.0,Comedy/Sci fi,1:37,-4,10.029689644980788
42,48,No One Lives,2500,40,2012.0,Horror/Mystery and thriller,1:26,6,10.029689644980788
90,80,The Hammer,2500,40,2007.0,Comedy/Romance,1:33,-10,10.029689644980788
28,54,Little Accidents,2500,39,2014.0,Drama,1:45,26,9.872232603526719
55,64,True Legend,2500,39,2010.0,Drama/History,1:55,9,9.872232603526719
27,31,Hell Baby,2500,39,2013.0,Comedy/Horror,1:33,4,9.872232603526719
67,59,The Hip Hop Project,2500,39,2006.0,Documentary,1:28,-8,9.872232603526719
88,79,Sharkwater,2500,39,2006.0,Documentary,1:29,-9,9.872232603526719
18,15,The Other Man,2500,39,2008.0,Drama/Mystery and thriller,1:30,-3,9.872232603526719
25,49,The Broken,2500,39,2008.0,Horror/Mystery and thriller,1:28,24,9.872232603526719
68,92,Is the Man Who Is Tall Happy? An Animated Conversation With Noam Chomsky,2500,38,2013.0,Biography/Animation,1:29,24,9.713254050808038
60,95,The Mermaid,2500,38,2016.0,Fantasy/Comedy,1:33,35,9.713254050808038
68,18,After,2500,38,2019.0,Drama/Romance,1:46,-50,9.713254050808038
32,32,Every Secret Thing,2500,38,2014.0,Drama/Crime,1:33,0,9.713254050808038
29,37,The Other Side of the Door,2500,38,2016.0,Horror/Mystery and thriller,1:36,8,9.713254050808038
33,63,Sunlight Jr.,2500,38,2013.0,Drama,1:30,30,9.713254050808038
66,29,The Letters,2500,38,2014.0,Biography/Drama,1:59,-37,9.713254050808038
26,42,Death Defying Acts,2500,38,2007.0,Romance/Drama,1:37,16,9.713254050808038
88,84,The Inevitable Defeat of Mister & Pete,2500,38,2013.0,Drama,1:48,-4,9.713254050808038
25,22,Serious Moonlight,2500,37,2009.0,Drama/Comedy,1:24,-3,9.552698646911638
69,89,You Will Be My Son,2500,37,2011.0,Drama,1:41,20,9.552698646911638
31,70,Zombeavers,2500,37,2014.0,Horror/Comedy,1:17,39,9.552698646911638
30,41,The English Teacher,2500,37,2013.0,Drama/Comedy,1:31,11,9.552698646911638
67,59,What Happened to Monday,2500,37,2017.0,Sci fi/Action,2:03,-8,9.552698646911638
80,73,Surviving Progress,2500,37,2011.0,Documentary,1:26,-7,9.552698646911638
56,19,Winnie,2500,37,2011.0,Biography/Drama,1:44,-37,9.552698646911638
79,59,Forks Over Knives,2500,37,2011.0,Documentary,1:36,-20,9.552698646911638
35,73,The Falling,2500,37,2014.0,Drama/Mystery and thriller,1:42,38,9.552698646911638
65,84,Kabluey,2500,37,2007.0,Comedy,1:26,19,9.552698646911638
80,83,Red Dog,2500,36,2011.0,Comedy/Drama,1:32,3,9.390507480439723
37,64,I Am Michael,2500,36,2015.0,Drama/Gay and lesbian,1:42,27,9.390507480439723
33,19,Very Good Girls,2500,36,2013.0,Drama,1:31,-14,9.390507480439723
46,67,Life Partners,2500,36,2014.0,Gay and lesbian/Romance,1:33,21,9.390507480439723
24,14,Return to Sender,2500,36,2015.0,Drama/Mystery and thriller,1:35,-10,9.390507480439723
64,92,Mystery Road,2500,36,2013.0,Drama/Crime,2:02,28,9.390507480439723
35,69,C.O.G.,2500,36,2013.0,Comedy/Gay and lesbian,1:28,34,9.390507480439723
74,92,Kids for Cash,2500,36,2013.0,Documentary/Drama,1:42,18,9.390507480439723
55,92,Girl Model,2500,36,2011.0,Documentary/Mystery and thriller,1:17,37,9.390507480439723
35,42,Hatchet II,2500,36,2010.0,Horror,1:29,7,9.390507480439723
38,60,Kiss of the Damned,2500,35,2012.0,Horror,1:36,22,9.22661773178138
24,17,Incarnate,2500,35,2016.0,Horror/Mystery and thriller,1:26,-7,9.22661773178138
36,31,Dad's Army,2500,35,2016.0,Comedy,1:40,-5,9.22661773178138
68,91,Faults,2500,35,2014.0,Drama/Mystery and thriller,1:29,23,9.22661773178138
69,94,Journey to the West: Conquering the Demons,2500,35,2013.0,Adventure/Fantasy,1:50,25,9.22661773178138
36,34,5 Days of War,2500,35,2011.0,Drama/War,1:52,-2,9.22661773178138
30,31,Automata,2500,35,2014.0,Sci fi/Mystery and thriller,1:49,1,9.22661773178138
82,94,All Things Must Pass,2500,35,2015.0,Documentary,1:40,12,9.22661773178138
73,86,Romantics Anonymous,2500,35,2010.0,Romance,1:20,13,9.22661773178138
21,40,Storage 24,2500,35,2012.0,Sci fi/Horror,1:27,19,9.22661773178138
16,17,Monsters: Dark Continent,2500,35,2014.0,Sci fi/Mystery and thriller,1:59,1,9.22661773178138
69,60,Lazer Team,2500,35,2015.0,Comedy/Sci fi,1:42,-9,9.22661773178138
93,97,Safety Last,2500,35,1923.0,Comedy,1:14,4,9.22661773178138
47,34,Finishing the Game,2500,35,2007.0,Comedy,1:28,-13,9.22661773178138
45,50,The Pretty One,2500,34,2013.0,Drama/Comedy,1:30,5,9.060962294042406
61,88,Post Mortem,2500,34,2010.0,Drama,1:36,27,9.060962294042406
52,59,Beyond the Black Rainbow,2500,34,2011.0,Sci fi,1:49,7,9.060962294042406
36,50,The Perfect Family,2500,34,2011.0,Drama/Gay and lesbian,1:24,14,9.060962294042406
55,47,The Comedy,2500,34,2012.0,Drama,1:30,-8,9.060962294042406
71,47,White Irish Drinkers,2500,34,2010.0,Drama,1:49,-24,9.060962294042406
83,79,Max Manus,2500,34,2008.0,War/Drama,1:58,-4,9.060962294042406
71,94,Neds,2500,34,2010.0,Drama,2:04,23,9.060962294042406
62,29,The Magic of Belle Isle,2500,34,2012.0,Comedy/Drama,1:49,-33,9.060962294042406
33,35,Descent,2500,34,2007.0,Drama/Mystery and thriller,1:40,2,9.060962294042406
17,3,Passion Play,2500,33,2010.0,Drama/Mystery and thriller,1:34,-14,8.893469344897873
22,12,Good People,2500,33,2014.0,Mystery and thriller,1:31,-10,8.893469344897873
80,24,Mr. Church,2500,33,2016.0,Drama,1:44,-56,8.893469344897873
70,85,The Flat,2500,33,2011.0,Documentary,1:37,15,8.893469344897873
88,100,Glen Campbell... I'll Be Me,2500,33,2014.0,Documentary/Biography,1:45,12,8.893469344897873
19,24,Elektra Luxx,2500,33,2010.0,Comedy,1:38,5,8.893469344897873
51,61,Jack Brooks: Monster Slayer,2500,33,2007.0,Comedy/Action,1:25,10,8.893469344897873
72,76,Let the Bullets Fly,2500,33,2010.0,Comedy/Western,2:12,4,8.893469344897873
46,70,Felony,2500,33,2013.0,Drama/Crime,1:45,24,8.893469344897873
65,67,Bunny and the Bull,2500,33,2009.0,Comedy,1:41,2,8.893469344897873
51,70,Grabbers,2500,33,2012.0,Comedy/Sci fi,1:34,19,8.893469344897873
60,58,Weirdsville,2500,33,2007.0,Comedy/Drama,1:30,-2,8.893469344897873
81,79,Recount,2500,33,2008.0,Drama,1:57,-2,8.893469344897873
85,100,Sita Sings the Blues,2500,32,2008.0,Fantasy/Animation,1:22,15,8.724061861322062
50,75,A Lonely Place to Die,2500,32,2011.0,Mystery and thriller/Action,1:38,25,8.724061861322062
27,38,Skiptrace,2500,32,2016.0,Action/Comedy,1:47,11,8.724061861322062
35,34,A Fantastic Fear of Everything,2500,32,2012.0,Comedy,1:39,-1,8.724061861322062
72,69,Battle for Haditha,2500,32,2007.0,War/Drama,1:33,-3,8.724061861322062
92,63,I Can Only Imagine,2500,32,2018.0,Biography/Music,1:50,-29,8.724061861322062
30,9,The Angriest Man in Brooklyn,2500,32,2014.0,Comedy/Drama,1:24,-21,8.724061861322062
78,88,Grey Gardens,2500,32,2009.0,Drama,1:44,10,8.724061861322062
51,31,The Brass Teapot,2500,32,2012.0,Comedy/Fantasy,1:41,-20,8.724061861322062
46,16,Last Knights,2500,31,2015.0,Adventure/Action,1:55,-30,8.552657067536824
91,94,Indie Game: The Movie,2500,31,2011.0,Drama/Documentary,1:34,3,8.552657067536824
48,32,Paper Man,2500,31,2009.0,Drama/Comedy,1:50,-16,8.552657067536824
52,42,Comet,2500,31,2014.0,Comedy/Drama,1:30,-10,8.552657067536824
80,90,House,2500,31,1977.0,Comedy/Mystery and thriller,1:27,10,8.552657067536824
79,94,Secret Sunshine,2500,31,2007.0,Drama,2:22,15,8.552657067536824
69,100,Hell and Back Again,2500,31,2011.0,Documentary,1:28,31,8.552657067536824
54,73,The House of Magic,2500,30,2013.0,Adventure/Animation,1:25,19,8.379165804519056
52,60,Tai Chi Zero,2500,30,2012.0,Sports and fitness/Action,1:40,8,8.379165804519056
72,83,Terms and Conditions May Apply,2500,30,2013.0,Documentary,1:19,11,8.379165804519056
81,87,Antarctica: A Year on Ice,2500,30,2013.0,Documentary,1:31,6,8.379165804519056
34,37,The Truth About Emanuel,2500,30,2013.0,Drama,1:36,3,8.379165804519056
33,20,Tarzan,2500,30,2013.0,Adventure/Animation,1:34,-13,8.379165804519056
42,37,4.3.2.1.,2500,30,2010.0,Drama/Crime,1:57,-5,8.379165804519056
65,77,Dreams of a Life,2500,30,2011.0,Drama,1:35,12,8.379165804519056
36,47,Save the Date,2500,30,2012.0,Drama/Romance,1:38,11,8.379165804519056
35,67,Good Neighbours,2500,30,2010.0,Drama/Crime,1:38,32,8.379165804519056
63,50,The Fox and the Child,2500,30,2007.0,Kids and family/Drama,1:36,-13,8.379165804519056
77,100,God Loves Uganda,2500,29,2013.0,Gay and lesbian/Documentary,1:30,23,8.20349180691225
36,38,As I Lay Dying,2500,29,2013.0,Drama,1:50,2,8.20349180691225
34,48,Synchronicity,2500,29,2015.0,Sci fi/Mystery and thriller,1:41,14,8.20349180691225
48,14,The Ledge,2500,29,2011.0,Drama/Mystery and thriller,1:41,-34,8.20349180691225
71,59,Bra Boys,2500,29,2007.0,Documentary,1:30,-12,8.20349180691225
31,66,The Good Doctor,2500,29,2011.0,Comedy/Drama,1:33,35,8.20349180691225
73,66,To Rob a Thief,2500,29,2007.0,Comedy/Action,1:38,-7,8.20349180691225
40,66,The Town That Dreaded Sundown,2500,29,2014.0,Horror/Mystery and thriller,1:25,26,8.20349180691225
79,93,The Pervert's Guide to Ideology,2500,29,2012.0,Documentary,2:14,14,8.20349180691225
91,97,Le Doulos,2500,29,1961.0,Drama,1:48,6,8.20349180691225
80,93,Wrinkles,2500,28,2014.0,,,13,8.02553087005176
48,68,Flying Swords of Dragon Gate,2500,28,2011.0,Action/Adventure,2:02,20,8.02553087005176
65,93,Last Ride,2500,28,2009.0,Drama,1:40,28,8.02553087005176
81,36,The Grace Card,2500,28,2010.0,Drama,1:41,-45,8.02553087005176
72,86,Peepli Live,2500,28,2010.0,Comedy,1:45,14,8.02553087005176
89,68,Pearl Jam Twenty,2500,28,2011.0,Documentary/Music,1:59,-21,8.02553087005176
54,86,The Turning,2500,28,2013.0,Drama,3:00,32,8.02553087005176
49,41,The Taqwacores,2500,27,2010.0,Drama,1:23,-8,7.845169885845621
54,22,The Baytown Outlaws,2500,27,2012.0,Action/Comedy,1:38,-32,7.845169885845621
24,48,Wrecked,2500,27,2011.0,Mystery and thriller,1:31,24,7.845169885845621
56,93,Leap Year,2500,27,2010.0,Drama,1:34,37,7.845169885845621
68,70,Red,2500,27,2008.0,Drama,1:35,2,7.845169885845621
60,81,The Missouri Breaks,2500,27,1976.0,Western/Drama,2:05,21,7.845169885845621
37,41,StreetDance 2,2500,27,2012.0,Romance/Drama,1:25,4,7.845169885845621
53,41,Beauty and the Beast,2500,27,2014.0,Romance/Adventure,1:52,-12,7.845169885845621
64,56,Now Is Good,2500,27,2012.0,Romance/Drama,1:43,-8,7.845169885845621
30,33,The Babysitters,2500,27,2007.0,Drama,1:30,3,7.845169885845621
31,46,Here Comes the Devil,2500,26,2012.0,Horror/Mystery and thriller,1:37,15,7.662285721192069
30,35,The Good Guy,2500,26,2009.0,Drama/Romance,1:30,5,7.662285721192069
64,77,Burning Man,2500,26,2011.0,Drama,1:49,13,7.662285721192069
20,12,Jack and Diane,2500,26,2012.0,Gay and lesbian/Drama,1:33,-8,7.662285721192069
24,27,Anamorph,2500,26,2007.0,Drama/Crime,1:44,3,7.662285721192069
85,77,Four Minutes,2500,26,2006.0,Drama,1:52,-8,7.662285721192069
17,0,The Disappointments Room,2500,26,2016.0,Horror/Mystery and thriller,1:32,-17,7.662285721192069
82,92,The Incredible Shrinking Man,2500,26,1957.0,Sci fi,1:21,10,7.662285721192069
74,92,Stations of the Cross,2500,26,2014.0,Drama,1:47,18,7.662285721192069
32,27,Goodbye World,2500,26,2013.0,Comedy/Drama,1:40,-5,7.662285721192069
34,12,Lake City,2500,26,2008.0,Drama,1:32,-22,7.662285721192069
78,96,King Corn,2500,26,2007.0,Documentary,1:30,18,7.662285721192069
79,88,The Pope's Toilet,2500,26,2005.0,Drama,1:37,9,7.662285721192069
46,28,The Cup,2500,25,2011.0,Drama,1:36,-18,7.476743906106103
62,80,Tales of the Night,2500,25,2011.0,Fantasy/Animation,1:24,18,7.476743906106103
37,44,Clown,2500,25,2014.0,Horror,1:40,7,7.476743906106103
41,56,Frankenstein's Army,2500,25,2013.0,Action/Horror,1:24,15,7.476743906106103
30,68,Space Station 76,2500,25,2014.0,Comedy/Sci fi,1:33,38,7.476743906106103
84,92,Requiem for the American Dream,2500,25,2015.0,Biography,1:13,8,7.476743906106103
61,84,Fat Kid Rules the World,2500,25,2012.0,Comedy,1:34,23,7.476743906106103
64,64,Poultrygeist: Night of the Chicken Dead,2500,25,2006.0,Comedy/Musical,1:43,0,7.476743906106103
58,44,The Stone Angel,2500,25,2007.0,Drama,1:55,-14,7.476743906106103
34,20,Incendiary,2500,25,2008.0,Romance/Drama,1:36,-14,7.476743906106103
61,17,Careful What You Wish For,2500,24,2015.0,Mystery and thriller,1:31,-44,7.288397090280924
79,83,Cul-de-Sac,2500,24,1966.0,Comedy,1:50,4,7.288397090280924
74,21,The Christmas Candle,2500,24,2013.0,Other/Drama,1:40,-53,7.288397090280924
83,83,You Don't Know Jack,2500,24,2010.0,Drama/Biography,2:10,0,7.288397090280924
78,88,Anti Matter,2500,24,2016.0,Sci fi,1:49,10,7.288397090280924
59,58,Ironweed,2500,24,1987.0,Drama,2:21,-1,7.288397090280924
36,4,Shanghai,2500,24,2010.0,Drama/Mystery and thriller,1:45,-32,7.288397090280924
86,100,Letter From an Unknown Woman,2500,24,1948.0,Romance,1:30,14,7.288397090280924
49,50,American Swing,2500,24,2008.0,Documentary,1:21,1,7.288397090280924
61,42,The Go-Getter,2500,24,2007.0,Comedy/Drama,1:33,-19,7.288397090280924
72,71,Were the World Mine,2500,24,2008.0,Comedy/Musical,1:36,-1,7.288397090280924
35,9,Chatroom,2500,23,2010.0,Drama/Mystery and thriller,1:37,-26,7.097083215743026
38,57,Willard,2500,23,1971.0,Horror,1:35,19,7.097083215743026
81,83,I Killed My Mother,2500,23,2009.0,Biography/Drama,1:36,2,7.097083215743026
88,78,Summer Wars,2500,23,2009.0,Sci fi/Adventure,1:54,-10,7.097083215743026
63,30,The Oogieloves in the Big Balloon Adventure,2500,23,2012.0,Kids and family/Adventure,1:28,-33,7.097083215743026
47,22,Jesus Henry Christ,2500,23,2011.0,Comedy,1:32,-25,7.097083215743026
45,17,Barefoot,2500,23,2014.0,Comedy/Romance,1:29,-28,7.097083215743026
32,17,The Protector 2,2500,23,2013.0,Action/Sports and fitness,1:44,-15,7.097083215743026
46,48,Doghouse,2500,23,2009.0,Comedy/Horror,1:29,2,7.097083215743026
49,17,Bunraku,2500,23,2010.0,Action/Fantasy,2:01,-32,7.097083215743026
80,86,The Last Metro,2500,22,1980.0,Drama,2:10,6,6.9026233386080005
30,64,Price Check,2500,22,2012.0,Drama/Comedy,1:33,34,6.9026233386080005
83,100,Jour de Fete,2500,22,1949.0,Comedy,1:20,17,6.9026233386080005
76,50,Road Hard,2500,22,2015.0,Comedy,1:38,-26,6.9026233386080005
39,9,Horrid Henry: The Movie,2500,22,2011.0,Comedy/Kids and family,1:33,-30,6.9026233386080005
39,68,17 Girls,2500,22,2011.0,Drama,1:30,29,6.9026233386080005
70,86,Red Obsession,2500,22,2013.0,Documentary,1:15,16,6.9026233386080005
36,59,Would You Rather,2500,22,2012.0,Horror/Mystery and thriller,1:33,23,6.9026233386080005
45,23,The Secret of Moonacre,2500,22,2009.0,Romance/Adventure,1:43,-22,6.9026233386080005
50,68,Daydream Nation,2500,22,2010.0,Comedy/Drama,1:38,18,6.9026233386080005
70,81,The Pirate Fairy,2500,21,2014.0,Adventure/Animation,1:19,11,6.704819013328363
16,14,Cherry,2500,21,2012.0,Drama,1:42,-2,6.704819013328363
21,14,A Merry Friggin' Christmas,2500,21,2014.0,Other/Comedy,1:28,-7,6.704819013328363
53,33,Tennessee,2500,21,2008.0,Drama,1:39,-20,6.704819013328363
44,24,Day Zero,2500,21,2007.0,Drama,1:32,-20,6.704819013328363
62,95,Lake Mungo,2500,21,2008.0,Horror/Mystery and thriller,1:29,33,6.704819013328363
53,10,Honey 2,2500,21,2011.0,Drama,1:51,-43,6.704819013328363
87,90,The Boys: The Sherman Brothers' Story,2500,21,2009.0,Documentary,1:41,3,6.704819013328363
50,67,Scenic Route,2500,21,2013.0,Drama/Mystery and thriller,1:25,17,6.704819013328363
26,5,Home Sweet Hell,2500,21,2015.0,Comedy/Mystery and thriller,1:38,-21,6.704819013328363
81,81,Quill: The Life of a Guide Dog,2500,21,2004.0,Drama,1:40,0,6.704819013328363
51,38,Flashbacks of a Fool,2500,21,2008.0,Drama,1:53,-13,6.704819013328363
43,48,Jolene,2500,21,2008.0,Drama,1:50,5,6.704819013328363
58,86,Last Passenger,2500,21,2013.0,Action/Mystery and thriller,1:32,28,6.704819013328363
85,81,Mad Detective,2500,21,2007.0,Drama/Crime,1:29,-4,6.704819013328363
21,10,The Longest Week,2500,20,2014.0,Romance,1:26,-11,6.503449126242364
67,45,Cantinflas,2500,20,2014.0,Drama/Biography,1:43,-22,6.503449126242364
55,90,Gayby,2500,20,2012.0,Drama/Gay and lesbian,1:29,35,6.503449126242364
28,25,Why Stop Now?,2500,20,2012.0,Comedy/Drama,1:27,-3,6.503449126242364
41,45,The Horde,2500,20,2009.0,Action/Horror,1:30,4,6.503449126242364
32,10,Revolution,2500,20,1985.0,War/Drama,2:03,-22,6.503449126242364
30,70,Coffin Rock,2500,20,2009.0,Mystery and thriller,1:32,40,6.503449126242364
28,0,"Love, Wedding, Marriage",2500,19,2011.0,Comedy,1:30,-28,6.298266028731006
70,89,Everybody Loves Somebody,2500,19,2017.0,Romance,1:41,19,6.298266028731006
63,11,I'm in Love With a Church Girl,2500,19,2013.0,Romance/Drama,1:58,-52,6.298266028731006
92,95,The Wolf Children Ame and Yuki,2500,19,2012.0,Animation/Fantasy,1:57,3,6.298266028731006
73,95,All Saints,2500,19,2017.0,Drama,1:48,22,6.298266028731006
42,16,Flypaper,2500,19,2011.0,Comedy/Drama,1:24,-26,6.298266028731006
58,32,Closing the Ring,2500,19,2007.0,Romance/Drama,1:59,-26,6.298266028731006
49,53,Largo Winch,2500,19,2008.0,Adventure/Mystery and thriller,1:48,4,6.298266028731006
82,89,Delhi Belly,2500,19,2011.0,Comedy/Action,1:43,7,6.298266028731006
49,32,Fat Girls,2500,19,2006.0,Comedy/Gay and lesbian,1:28,-17,6.298266028731006
88,89,King of Hearts,2500,18,1966.0,Comedy,1:42,1,6.088990769440213
48,44,A Turtle's Tale: Sammy's Adventures,2500,18,2010.0,Adventure/Animation,1:28,-4,6.088990769440213
44,22,The Perfect Match,2500,18,2016.0,Romance,1:36,-22,6.088990769440213
64,78,Time Lapse,2500,18,2014.0,Sci fi/Mystery and thriller,1:44,14,6.088990769440213
79,72,The Hornet's Nest,2500,18,2014.0,Documentary/Action,1:35,-7,6.088990769440213
67,28,We the Party,2500,18,2012.0,Comedy/Drama,1:44,-39,6.088990769440213
55,67,Ip Man: The Final Fight,2500,18,2013.0,Biography/Action,1:40,12,6.088990769440213
30,44,Bereavement,2500,18,2010.0,Drama/Crime,1:43,14,6.088990769440213
50,76,The Children,2500,17,2008.0,Horror,1:24,26,5.875307153057772
29,0,Behaving Badly,2500,17,2014.0,Romance,1:38,-29,5.875307153057772
68,12,Kingsglaive: Final Fantasy XV,2500,17,2016.0,Adventure/Fantasy,1:50,-56,5.875307153057772
36,18,Video Games: The Movie,2500,17,2014.0,Documentary,1:40,-18,5.875307153057772
31,0,Kalamity,2500,17,2010.0,Drama/Mystery and thriller,1:40,-31,5.875307153057772
85,94,Long Day's Journey Into Night,2500,17,1962.0,Drama,2:54,9,5.875307153057772
59,65,The Road,2500,17,2011.0,Horror,1:50,6,5.875307153057772
43,29,The Chaperone,2500,17,2011.0,Comedy/Drama,1:44,-14,5.875307153057772
40,29,Deadgirl,2500,17,2008.0,Horror,1:41,-11,5.875307153057772
73,88,Quo Vadis?,2500,17,1951.0,Drama/History,2:51,15,5.875307153057772
71,47,"Gandhi, My Father",2500,17,2007.0,Drama,2:29,-24,5.875307153057772
63,88,Stretch,2500,16,2014.0,Action/Comedy,1:42,25,5.656854249492381
80,100,The Return of Martin Guerre,2500,16,1982.0,Drama/History,2:02,20,5.656854249492381
37,63,Knights of Badassdom,2500,16,2014.0,Comedy/Adventure,1:25,26,5.656854249492381
40,0,Hot to Trot,2500,16,1988.0,Comedy,1:24,-40,5.656854249492381
84,94,Toy Story of Terror!,2500,16,2013.0,,,10,5.656854249492381
82,63,La Grande Bouffe,2500,16,1973.0,Comedy,2:10,-19,5.656854249492381
81,50,When Night Is Falling,2500,16,1995.0,Gay and lesbian/Drama,1:34,-31,5.656854249492381
85,67,Greater,2500,15,2016.0,Drama/Biography,2:10,-18,5.433216825139731
39,13,Love and Honor,2500,15,2012.0,Drama,1:36,-26,5.433216825139731
46,33,Chain Letter,2500,15,2010.0,Horror/Mystery and thriller,1:27,-13,5.433216825139731
83,100,Monika,2500,15,1952.0,Drama,1:36,17,5.433216825139731
57,40,Passchendaele,2500,15,2008.0,War/Drama,,-17,5.433216825139731
84,87,Punching the Clown,2500,15,2009.0,Comedy,1:31,3,5.433216825139731
68,87,Dostana,2500,15,2008.0,Romance,2:25,19,5.433216825139731
67,80,Milton Glaser: To Inform & Delight,2500,15,2008.0,Documentary,1:13,13,5.433216825139731
35,40,Rosencrantz and Guildenstern Are Undead,2500,15,2009.0,Comedy,1:25,5,5.433216825139731
53,7,Battlefield America,2500,14,2012.0,Drama,1:46,-46,5.203912939677927
50,71,Here,2500,14,2011.0,Romance/Drama,2:06,21,5.203912939677927
55,57,Tough Guys,2500,14,1986.0,Comedy,1:43,2,5.203912939677927
72,71,Don 2,2500,14,2011.0,Drama/Action,2:25,-1,5.203912939677927
86,86,Barfi!,2500,14,2012.0,Comedy/Adventure,2:30,0,5.203912939677927
69,79,Little Big Soldier,2500,14,2010.0,Comedy/Action,1:36,10,5.203912939677927
17,7,11-11-11,2500,14,2011.0,Horror/Mystery and thriller,1:22,-10,5.203912939677927
56,15,The Kissing Booth,2500,13,2018.0,Romance,1:45,-41,4.968377601139757
41,62,Retreat,2500,13,2011.0,Sci fi/Mystery and thriller,1:30,21,4.968377601139757
86,92,Zindagi Na Milegi Dobara,2500,13,2011.0,Drama/Adventure,2:35,6,4.968377601139757
38,0,Fred: The Movie,2500,13,2010.0,Kids and family/Comedy,1:30,-38,4.968377601139757
25,38,Agent Vinod,2500,13,2012.0,Action/Adventure,2:37,13,4.968377601139757
81,77,Inside Hana's Suitcase,2500,13,2009.0,Documentary,1:28,-4,4.968377601139757
17,15,Not Forgotten,2500,13,2009.0,Mystery and thriller,1:37,-2,4.968377601139757
57,46,The Sasquatch Gang,2500,13,2007.0,Comedy/Adventure,1:26,-11,4.968377601139757
71,58,Pulling Strings,2500,12,2013.0,Romance,1:52,-13,4.725940818339814
83,50,Made in Heaven,2500,12,1987.0,Romance,1:42,-33,4.725940818339814
87,75,Unconditional,2500,12,2012.0,Drama,1:32,-12,4.725940818339814
28,8,Crazy on the Outside,2500,12,2010.0,Comedy,1:36,-20,4.725940818339814
26,8,Mama's Boy,2500,12,2007.0,Comedy/Drama,1:29,-18,4.725940818339814
72,42,Filly Brown,2500,12,2012.0,Drama,1:39,-30,4.725940818339814
81,50,Home Run,2500,12,2013.0,Drama,1:53,-31,4.725940818339814
32,33,The Objective,2500,12,2008.0,Sci fi/War,1:30,1,4.725940818339814
21,8,Sex and Breakfast,2500,12,2007.0,Comedy/Romance,1:21,-13,4.725940818339814
93,100,Mind Game,2500,11,2004.0,Adventure/Mystery and thriller,1:43,7,4.475797488182033
24,9,Branded,2500,11,2012.0,Sci fi/Mystery and thriller,1:46,-15,4.475797488182033
61,82,Tokyo Gore Police,2500,11,2008.0,Horror/Action,1:49,21,4.475797488182033
72,64,Son of Batman,2500,11,2014.0,Adventure/Action,1:14,-8,4.475797488182033
32,9,Shank,2500,11,2010.0,Action,1:30,-23,4.475797488182033
88,91,Aftershocks (Tangshan dadizhen),2500,11,2010.0,,,3,4.475797488182033
65,55,"Romulus, My Father",2500,11,2007.0,Drama,1:43,-10,4.475797488182033
73,100,Confessions of a Superhero,2500,11,2007.0,Documentary,1:32,27,4.475797488182033
37,73,Mulberry Street,2500,11,2006.0,Horror/Mystery and thriller,1:25,36,4.475797488182033
23,0,The Prince,2500,10,2014.0,Drama/Crime,1:31,-23,4.216965034285822
54,70,Visioneers,2500,10,2008.0,Drama/Comedy,1:34,16,4.216965034285822
78,60,Hillsong: Let Hope Rise,2500,10,2016.0,Music/Documentary,1:43,-18,4.216965034285822
82,20,I'm Not Ashamed,2500,10,2016.0,Drama/Biography,1:52,-62,4.216965034285822
86,40,Same Kind of Different as Me,2500,10,2017.0,Drama,1:59,-46,4.216965034285822
27,20,Grave Encounters 2,2500,10,2012.0,Horror/Mystery and thriller,1:39,-7,4.216965034285822
21,10,Joe Dirt 2: Beautiful Loser,2500,10,2015.0,Comedy,1:47,-11,4.216965034285822
38,60,The Remaining,2500,10,2014.0,Horror/Mystery and thriller,1:23,22,4.216965034285822
18,20,The Broken Tower,2500,10,2011.0,Biography/Drama,1:48,2,4.216965034285822
25,50,Helena From the Wedding,2500,10,2010.0,Drama/Other,1:39,25,4.216965034285822
74,30,Let There Be Light,2500,10,2017.0,Drama,1:41,-44,4.216965034285822
40,0,Atlas Shrugged: Who Is John Galt?,2500,10,2014.0,Drama,1:39,-40,4.216965034285822
77,90,The Decline of Western Civilization Part II: The Metal Years,2500,10,1988.0,Documentary,1:33,13,4.216965034285822
35,10,Knucklehead,2500,10,2010.0,Comedy,1:40,-25,4.216965034285822
96,90,Heima,2500,10,2007.0,Documentary/Music,1:37,-6,4.216965034285822
29,10,Moving McAllister,2500,10,2007.0,Romance,1:29,-19,4.216965034285822
21,0,The Starving Games,2500,9,2013.0,Comedy,1:23,-21,3.9482220388574776
45,56,The Outskirts,2500,9,2017.0,Comedy,1:35,11,3.9482220388574776
35,44,Bad Kids Go to Hell,2500,9,2012.0,Comedy/Mystery and thriller,1:31,9,3.9482220388574776
71,78,Female Agents,2500,9,2008.0,Action/Mystery and thriller,2:00,7,3.9482220388574776
22,44,Smokin' Aces 2: Assassins' Ball,2500,9,2010.0,Action,1:26,22,3.9482220388574776
71,78,A Match Made in Heaven,2500,9,1997.0,Drama,1:36,7,3.9482220388574776
24,33,The New Daughter,2500,9,2009.0,Horror/Mystery and thriller,1:48,9,3.9482220388574776
73,50,One Week,2500,8,2008.0,Drama,1:34,-23,3.668016172818685
36,50,Ong Bak 3,2500,8,2010.0,Sports and fitness/Action,1:34,14,3.668016172818685
39,50,Provinces of Night,2500,8,2010.0,Drama,1:45,11,3.668016172818685
64,88,The Grass Is Greener,2500,8,1960.0,Comedy,1:45,24,3.668016172818685
34,75,Quarantine 2: Terminal,2500,8,2011.0,Sci fi/Horror,1:26,41,3.668016172818685
72,13,"No manches, Frida",2500,8,2016.0,Comedy,1:40,-59,3.668016172818685
78,50,Grace Unplugged,2500,8,2013.0,Drama,1:42,-28,3.668016172818685
85,75,Batman: Assault on Arkham,2500,8,2014.0,Action/Adventure,1:15,-10,3.668016172818685
92,88,Welcome to Dongmakgol,2500,8,2005.0,Comedy/War,2:13,-4,3.668016172818685
79,88,Batman Year One,2500,8,2011.0,Action/Adventure,1:04,9,3.668016172818685
53,25,Student Bodies,2500,8,1981.0,Horror,1:25,-28,3.668016172818685
27,25,Animals United,2500,8,2010.0,Kids and family/Comedy,1:33,-2,3.668016172818685
20,38,Smother,2500,8,2007.0,Comedy/Drama,1:32,18,3.668016172818685
56,63,Bachna Ae Haseeno,2500,8,2008.0,Romance,2:32,7,3.668016172818685
62,63,The Machine Girl,2500,8,2008.0,Action/Horror,1:36,1,3.668016172818685
56,38,Itty Bitty T...y Committee,2500,8,2007.0,Comedy,1:27,-18,3.668016172818685
43,100,Borderland,2500,8,2007.0,Drama/Crime,1:44,57,3.668016172818685
51,71,Bol Bachchan,2500,7,2012.0,Drama/Action,2:30,20,3.374320069567275
90,100,Mickey's Christmas Carol,2500,7,1983.0,Other/Animation,0:25,10,3.374320069567275
80,71,The Secret Life of Walter Mitty,2500,7,1947.0,Comedy,1:48,-9,3.374320069567275
71,57,Bodyguards and Assassins,2500,7,2009.0,Drama/Sports and fitness,2:19,-14,3.374320069567275
66,57,New York,2500,7,2009.0,Action/Drama,2:34,-9,3.374320069567275
64,57,Yeh Jawaani Hai Deewani,2500,7,2013.0,Romance,2:40,-7,3.374320069567275
9,14,Soldiers of Fortune,2500,7,2012.0,Action/Mystery and thriller,1:34,5,3.374320069567275
83,57,Taking Chance,2500,7,2009.0,War/Drama,1:18,-26,3.374320069567275
16,14,And Soon the Darkness,2500,7,2010.0,Horror/Mystery and thriller,1:31,-2,3.374320069567275
85,71,Meeting People Is Easy,2500,7,1999.0,Documentary,1:38,-14,3.374320069567275
72,86,Teen Beach Movie,2500,7,2013.0,Comedy/Romance,1:30,14,3.374320069567275
41,57,Trauma,2500,7,1993.0,Horror/Mystery and thriller,1:45,16,3.374320069567275
22,14,Blonde Ambition,2500,7,2007.0,Romance,1:33,-8,3.374320069567275
20,50,Tashan,2500,6,2008.0,Romance/Action,2:20,30,3.064393493081416
56,50,Metropia,2500,6,2009.0,Sci fi/Animation,1:26,-6,3.064393493081416
31,17,Jeepers Creepers 3,2500,6,2017.0,Horror/Mystery and thriller,1:40,-14,3.064393493081416
34,67,ZMD: Zombies of Mass Destruction,2500,6,2009.0,Gay and lesbian/Horror,1:32,33,3.064393493081416
41,50,Billion Dollar Brain,2500,6,1967.0,Drama,1:51,9,3.064393493081416
60,0,The Lion of Judah,2500,6,2011.0,Other/Drama,1:27,-60,3.064393493081416
64,33,Craigslist Joe,2500,6,2012.0,Adventure/Documentary,1:30,-31,3.064393493081416
22,17,Apartment 143,2500,6,2011.0,Horror,1:20,-5,3.064393493081416
58,50,Laaga Chunari Mein Daag,2500,6,2007.0,Drama,2:18,-8,3.064393493081416
79,50,Justice League: War,2500,6,2014.0,Action/Animation,1:19,-29,3.064393493081416
14,17,30 Days of Night: Dark Days,2500,6,2010.0,Horror,1:32,3,3.064393493081416
45,67,Cocktail,2500,6,2012.0,Drama/Romance,2:26,22,3.064393493081416
70,50,Green Lantern: First Flight,2500,6,2009.0,Kids and family/Action,1:17,-20,3.064393493081416
37,17,Death Race 2,2500,6,2010.0,Action/Mystery and thriller,1:36,-20,3.064393493081416
72,67,Aaja Nachle,2500,6,2007.0,Drama/Musical,2:27,-5,3.064393493081416
49,50,Scenes of a Sexual Nature,2500,6,2006.0,Comedy/Drama,1:31,1,3.064393493081416
83,80,English Vinglish,2500,5,2012.0,Drama,2:13,-3,2.734363528521053
75,100,Superman: Unbound,2500,5,2013.0,Adventure/Action,1:15,25,2.734363528521053
81,80,"Come Back to the 5 & Dime Jimmy Dean, Jimmy Dean",2500,5,1982.0,Drama/Comedy,1:50,-1,2.734363528521053
47,40,River Queen,2500,5,2005.0,Drama/History,1:53,-7,2.734363528521053
61,60,Family Guy Presents: It's a Trap,2500,5,2010.0,,,-1,2.734363528521053
77,40,Priceless,2500,5,2016.0,Drama/Mystery and thriller,1:38,-37,2.734363528521053
45,60,The Lazarus Project,2500,5,2008.0,Drama/Mystery and thriller,1:40,15,2.734363528521053
42,20,Repentance,2500,5,2013.0,Mystery and thriller,1:33,-22,2.734363528521053
22,0,InAPPropriate Comedy,2500,5,2013.0,Comedy,1:24,-22,2.734363528521053
33,0,Slaughter High,2500,5,1985.0,Horror,1:30,-33,2.734363528521053
28,0,Polaroid,2500,5,2019.0,Horror/Mystery and thriller,1:28,-28,2.734363528521053
73,100,Tinker Bell and the Lost Treasure,2500,5,2009.0,Kids and family/Animation,1:16,27,2.734363528521053
68,100,The Beast Stalker,2500,5,2008.0,Action/Mystery and thriller,1:49,32,2.734363528521053
88,80,Waterloo Bridge,2500,5,1940.0,Romance,1:43,-8,2.734363528521053
56,60,Greta,2500,5,2009.0,Drama,1:32,4,2.734363528521053
51,80,Dance of the Dead,2500,5,2008.0,Comedy/Adventure,1:35,29,2.734363528521053
72,20,Bhool Bhulaiyaa,2500,5,2007.0,Comedy/Horror,2:35,-52,2.734363528521053
65,60,Vexille,2500,5,2007.0,Sci fi/Action,1:49,-5,2.734363528521053
44,60,Billu Barber,2500,5,2009.0,Comedy/Drama,2:17,16,2.734363528521053
73,60,Electroma,2500,5,2006.0,Sci fi/Drama,1:14,-13,2.734363528521053
86,95,The Irishman,1000,451,2019.0,Drama/Crime,3:29,9,45.58902862256936
72,90,The Lighthouse,1000,382,2019.0,Drama/Mystery and thriller,1:50,18,41.09505838693994
87,97,The Farewell,1000,341,2019.0,Comedy/Drama,1:40,10,38.27996102016362
38,54,The Dead Don't Die,1000,306,2019.0,Comedy/Horror,1:43,16,35.77469102259483
83,75,The King of Staten Island,1000,280,2020.0,Comedy/Drama,2:17,-8,33.84338306058975
50,74,Destroyer,1000,268,2018.0,Drama/Crime,2:03,24,32.929432503463254
76,72,On the Basis of Sex,1000,264,2018.0,Drama/Biography,2:00,-4,32.62138938955259
72,87,EMMA.,1000,254,2020.0,Comedy/Drama,2:05,15,31.843520294778347
38,62,Vox Lux,1000,250,2018.0,Music/Drama,1:50,24,31.529167622359036
36,39,The Girl in the Spider's Web,1000,237,2018.0,Action/Mystery and thriller,1:57,3,30.494233135441753
42,82,High Life,1000,234,2018.0,Sci fi/Mystery and thriller,1:53,40,30.252405352433488
91,99,Shoplifters,1000,226,2018.0,Drama/Adventure,2:01,8,29.601776444473394
77,86,The Wife,1000,224,2017.0,Drama,1:40,9,29.43777702680547
78,94,A Fantastic Woman,1000,222,2017.0,Gay and lesbian/Drama,1:43,16,29.273227574963673
69,81,Ben Is Back,1000,220,2018.0,Drama/Mystery and thriller,1:43,12,29.108121263755205
69,87,Colette,1000,217,2018.0,Drama/Biography,1:51,18,28.8594023911159
73,93,Wildlife,1000,215,2018.0,Drama,1:44,20,28.69287309120695
86,76,Hotel Mumbai,1000,215,2018.0,Mystery and thriller/Drama,2:05,-10,28.69287309120695
34,32,The Nutcracker and the Four Realms,1000,202,2018.0,Kids and family/Adventure,1:39,-2,27.595902757162747
42,31,Wonder Wheel,1000,201,2017.0,Drama,1:41,-11,27.510439959956123
66,69,Adrift,1000,200,2018.0,Romance/Drama,2:00,3,27.42481756762073
71,50,Tolkien,1000,197,2019.0,Drama/Biography,1:52,-21,27.166981771469644
30,20,Serenity,1000,196,2019.0,Drama/Mystery and thriller,1:43,-10,27.08070988374737
80,95,Burning,1000,194,2018.0,Drama/Mystery and thriller,2:28,15,26.907669282564235
75,77,"Don't Worry, He Won't Get Far on Foot",1000,190,2018.0,Drama/Biography,1:53,2,26.559567619788876
35,61,Velvet Buzzsaw,1000,190,2019.0,,,26,26.559567619788876
55,89,The Kid Who Would Be King,1000,189,2019.0,Adventure/Fantasy,2:00,34,26.47211419497369
74,49,"Where'd You Go, Bernadette",1000,188,2019.0,Comedy,1:44,-25,26.384487078239673
74,90,Lean on Pete,1000,188,2017.0,Drama,2:02,16,26.384487078239673
64,79,At Eternity's Gate,1000,187,2018.0,Drama/Biography,1:50,15,26.296684997953903
51,54,Book Club,1000,186,2018.0,Romance,1:44,3,26.20870666631663
90,99,Apollo 11,1000,186,2019.0,Drama/History,1:33,9,26.20870666631663
76,86,The Miseducation of Cameron Post,1000,186,2018.0,Drama/Gay and lesbian,1:31,10,26.20870666631663
36,28,The Curse of La Llorona,1000,186,2019.0,Horror/Mystery and thriller,1:33,-8,26.20870666631663
84,95,Loveless,1000,185,2017.0,Drama,2:07,11,26.120550779067592
82,97,The Rider,1000,183,2017.0,Drama/Western,1:44,15,25.943701036580038
57,54,"Extremely Wicked, Shockingly Evil and Vile",1000,182,2019.0,Crime/Drama,1:50,-3,25.855004487777162
44,28,The Rhythm Section,1000,180,2020.0,Mystery and thriller/Action,1:49,-16,25.677061168818504
35,58,Hotel Artemis,1000,179,2018.0,Mystery and thriller/Action,1:33,23,25.587811597850912
79,93,RBG,1000,178,2018.0,Documentary,1:37,14,25.49837485437685
93,90,Capernaum,1000,176,2018.0,Drama,2:10,-3,25.31893404088985
49,81,Early Man,1000,175,2018.0,Kids and family/Comedy,1:29,32,25.228927017388646
87,94,Blindspotting,1000,173,2018.0,Drama/Comedy,1:35,7,25.048332202229876
67,80,Film Stars Don't Die in Liverpool,1000,169,2017.0,Romance/Biography,1:46,13,24.684775987507244
74,83,"Juliet, Naked",1000,167,2018.0,Music/Romance,1:45,9,24.501788937948916
48,34,Welcome to Marwen,1000,167,2018.0,Fantasy/Comedy,1:56,-14,24.501788937948916
78,30,Bloodshot,1000,161,2020.0,Action/Adventure,1:49,-48,23.947830330270747
61,82,The Party,1000,160,2017.0,Comedy/Drama,1:11,21,23.854756574160536
58,71,Trolls World Tour,1000,160,2020.0,Comedy/Fantasy,1:31,13,23.854756574160536
59,46,Little,1000,158,2019.0,Fantasy/Comedy,1:49,-13,23.667951973591787
73,92,Hearts Beat Loud,1000,157,2018.0,Comedy/Music,1:37,19,23.574217318823912
50,57,White Boy Rick,1000,155,2018.0,Drama/Crime,1:51,7,23.38607355742051
40,38,Life of the Party,1000,154,2018.0,Comedy,1:45,-2,23.291660464128444
78,90,Arctic,1000,150,2018.0,Adventure/Drama,1:37,12,22.911685375307673
67,62,Outlaw King,1000,149,2018.0,Drama/Biography,2:17,-5,22.816100321808104
54,47,SCOOB!,1000,148,2020.0,Kids and family/Animation,1:34,-7,22.72027439676837
39,72,Vivarium,1000,147,2020.0,Mystery and thriller/Sci fi,1:37,33,22.624205359490148
33,42,What Men Want,1000,146,2019.0,Romance/Fantasy,1:57,9,22.52789093302636
74,84,Borg vs. McEnroe,1000,145,2017.0,Drama,1:48,10,22.43132880334213
63,88,A Private War,1000,144,2018.0,War/Drama,1:50,25,22.33451661845039
38,26,Night School,1000,143,2018.0,Comedy,1:51,-12,22.237451987521194
83,71,The King,1000,142,2019.0,History/Drama,2:20,-12,22.14013247996374
16,46,The Dinner,1000,142,2017.0,Drama/Mystery and thriller,2:00,30,22.14013247996374
89,99,Faces Places,1000,141,2017.0,Documentary,1:29,10,22.042555624480066
73,58,The Highwaymen,1000,139,2019.0,Drama/Crime,2:12,-15,21.84661977512174
80,96,After the Storm,1000,138,2016.0,Drama,1:57,16,21.748255626180264
39,75,Mom and Dad,1000,137,2017.0,Horror/Comedy,2:03,36,21.649623817070065
55,74,Assassination Nation,1000,136,2018.0,Comedy/Action,1:50,19,21.550721657693213
55,71,Triple Frontier,1000,135,2019.0,Adventure/Mystery and thriller,2:05,16,21.451546410907937
74,89,Run,1000,134,2020.0,Mystery and thriller,1:30,15,21.35209529135088
64,60,Operation Finale,1000,134,2018.0,History/Mystery and thriller,2:02,-4,21.35209529135088
38,40,Gringo,1000,133,2018.0,Action/Comedy,1:50,2,21.252365464220812
64,59,The House That Jack Built,1000,133,2018.0,Drama/Crime,2:31,-5,21.252365464220812
56,82,Beirut,1000,132,2018.0,Drama/Mystery and thriller,1:49,26,21.152354044022278
76,97,Border,1000,128,2018.0,Mystery and thriller/Romance,1:48,21,20.749432874416154
62,76,Smallfoot,1000,127,2018.0,Comedy/Animation,1:36,14,20.647968338800368
35,39,The Strangers: Prey at Night,1000,125,2018.0,Horror/Mystery and thriller,1:25,4,20.444135848948562
62,77,Anna and the Apocalypse,1000,122,2017.0,Comedy/Horror,1:32,15,20.136078432395202
51,75,The Sense of an Ending,1000,120,2017.0,Drama,1:48,24,19.92912718504312
39,60,Unfriended: Dark Web,1000,119,2018.0,Horror/Mystery and thriller,1:28,21,19.82516684143501
65,96,Menashe,1000,118,2017.0,Drama/Comedy,1:22,31,19.720878370380042
81,91,Human Flow,1000,118,2017.0,Documentary,2:20,10,19.720878370380042
87,97,The Guilty,1000,118,2018.0,Drama/Crime,1:25,10,19.720878370380042
89,86,The Insult,1000,116,2017.0,Drama,1:53,-3,19.511301649293156
39,36,Mark Felt: The Man Who Brought Down the White House,1000,115,2017.0,Drama/Biography,1:43,-3,19.406005504006643
28,24,The Comedian,1000,114,2016.0,Drama/Comedy,2:00,-4,19.300365436139025
43,43,Second Act,1000,113,2018.0,Romance,1:44,0,19.194377290564812
60,96,The Love Witch,1000,112,2016.0,Drama/Horror,2:00,36,19.088036824679065
75,79,Page One: Inside The New York Times,1000,112,2011.0,Documentary,1:28,4,19.088036824679065
68,37,Hunter Killer,1000,112,2018.0,Action/Mystery and thriller,2:01,-31,19.088036824679065
70,95,Gimme Danger,1000,111,2016.0,Music/Documentary,1:48,25,18.981339705756774
65,51,Papillon,1000,111,2017.0,Drama/Biography,2:13,-14,18.981339705756774
31,38,Black Christmas,1000,110,2019.0,Other/Horror,1:32,7,18.874281508207943
49,76,Una,1000,110,2016.0,Drama,1:36,27,18.874281508207943
50,37,Johnny English Strikes Again,1000,109,2018.0,Adventure/Comedy,1:28,-13,18.76685771072333
54,96,The Fits,1000,109,2015.0,Drama,1:12,42,18.76685771072333
32,27,Breaking In,1000,107,2018.0,Drama/Mystery and thriller,1:28,-5,18.55089473417879
81,91,Beyond the Hills,1000,107,2012.0,Drama,2:30,10,18.55089473417879
64,83,The Trip to Spain,1000,107,2017.0,Comedy,1:50,19,18.55089473417879
79,93,Private Life,1000,106,2018.0,Drama/Comedy,2:04,14,18.442346006574258
51,52,Mowgli: Legend of the Jungle,1000,105,2018.0,Adventure/Fantasy,1:45,1,18.333412575379587
87,95,The Breadwinner,1000,105,2017.0,Drama/Animation,1:34,8,18.333412575379587
48,63,Adoration,1000,104,2008.0,Drama,1:40,15,18.22408939365073
79,61,The Current War: Director's Cut,1000,104,2019.0,History/Drama,1:41,-18,18.22408939365073
72,91,Journey's End,1000,102,2017.0,War/Drama,1:47,19,18.004253009684938
70,86,Novitiate,1000,101,2017.0,Drama,2:03,16,17.893729120895756
68,33,The Intruder,1000,101,2019.0,Drama/Mystery and thriller,1:42,-35,17.893729120895756
69,88,Hounds of Love,1000,100,2016.0,Drama/Crime,1:48,19,17.78279410038923
54,93,Cam,1000,99,2018.0,Mystery and thriller/Horror,1:34,39,17.67144228430324
48,61,Uncle Drew,1000,99,2018.0,Comedy,1:44,13,17.67144228430324
32,36,God's Pocket,1000,99,2014.0,Comedy/Drama,1:28,4,17.67144228430324
80,90,Always Be My Maybe,1000,96,2019.0,Romance,1:42,10,17.334827353454408
64,40,The Last Word,1000,95,2017.0,Drama/Comedy,1:48,-24,17.22174892188519
37,47,Goosebumps 2: Haunted Halloween,1000,95,2018.0,Comedy/Adventure,1:30,10,17.22174892188519
79,90,A War,1000,94,2015.0,Drama/War,1:55,11,17.108223236119827
66,95,Fire at Sea,1000,94,2016.0,Documentary,1:48,29,17.108223236119827
60,73,The Ritual,1000,94,2017.0,Horror,1:34,13,17.108223236119827
69,87,Blade of the Immortal,1000,94,2017.0,Action/Adventure,2:31,18,17.108223236119827
85,96,Bombshell: The Hedy Lamarr Story,1000,93,2017.0,Documentary,1:30,11,16.994243740562503
72,80,The Platform,1000,93,2019.0,Mystery and thriller/Sci fi,1:34,8,16.994243740562503
79,42,Don't Let Go,1000,92,2019.0,Drama/Mystery and thriller,1:43,-37,16.879803711855995
37,68,Wild Grass,1000,91,2009.0,Drama,1:44,31,16.764896252714394
62,90,Marjorie Prime,1000,91,2017.0,Comedy/Sci fi,1:39,28,16.764896252714394
54,82,Land Ho!,1000,91,2014.0,Comedy/Adventure,1:34,28,16.764896252714394
46,23,Romeo & Juliet,1000,90,2013.0,Drama/Romance,1:58,-23,16.64951428545866
71,89,Mary and The Witch's Flower,1000,90,2017.0,Adventure/Anime,1:43,18,16.64951428545866
90,97,The Second Mother,1000,90,2015.0,Drama,1:52,7,16.64951428545866
68,45,47 Meters Down: Uncaged,1000,89,2019.0,Adventure/Horror,1:29,-23,16.533650545237286
42,80,Time Out of Mind,1000,88,2014.0,Drama,2:00,38,16.417297572912943
72,79,Countdown to Zero,1000,87,2010.0,Documentary,1:30,7,16.300447707594707
79,88,78/52,1000,86,2017.0,Documentary,1:31,9,16.183093078793917
41,64,The Unicorn Store,1000,86,2017.0,,,23,16.183093078793917
54,27,UglyDolls,1000,86,2019.0,Comedy/Musical,1:27,-27,16.183093078793917
24,50,Manglehorn,1000,86,2014.0,Drama,1:37,26,16.183093078793917
40,60,Saint Laurent,1000,86,2014.0,Biography/Drama,2:31,20,16.183093078793917
46,21,Mute,1000,86,2017.0,Sci fi/Mystery and thriller,2:06,-25,16.183093078793917
76,92,Child's Pose,1000,85,2013.0,Drama,1:52,16,16.06522559818003
54,75,Manifesto,1000,85,2015.0,Comedy/Drama,1:35,21,16.06522559818003
61,80,The New Girlfriend,1000,84,2014.0,Drama/Mystery and thriller,1:47,19,15.946836950911226
52,37,Spenser Confidential,1000,84,2020.0,Action,1:51,-15,15.946836950911226
32,70,Hold the Dark,1000,84,2018.0,Adventure/Mystery and thriller,2:05,38,15.946836950911226
48,75,The Eclipse,1000,84,2009.0,Drama/Mystery and thriller,1:28,27,15.946836950911226
68,67,Tommy's Honour,1000,83,2016.0,Drama/Biography,1:52,-1,15.827918586512368
66,72,Viceroy's House,1000,81,2017.0,Drama/History,1:45,6,15.588457268119896
47,64,Love Crime,1000,81,2010.0,Mystery and thriller,1:46,17,15.588457268119896
83,79,Supermensch: The Legend of Shep Gordon,1000,80,2013.0,Documentary,1:24,-4,15.467895945971296
34,18,Queen of the Desert,1000,79,2015.0,Drama/Biography,2:08,-16,15.34676814846713
51,72,Disorder,1000,79,2015.0,Drama/Mystery and thriller,1:41,21,15.34676814846713
71,59,A Dog's Way Home,1000,79,2019.0,Adventure/Drama,1:36,-12,15.34676814846713
69,80,Reality,1000,79,2012.0,Comedy/Drama,1:55,11,15.34676814846713
51,90,The Blue Room,1000,78,2014.0,Mystery and thriller,1:15,39,15.225063992104127
55,74,The Limehouse Golem,1000,78,2016.0,Mystery and thriller,1:49,19,15.225063992104127
76,62,The First Grader,1000,78,2010.0,Biography/Drama,1:39,-14,15.225063992104127
50,90,My Golden Days,1000,77,2015.0,Drama/Romance,2:03,40,15.102773291691431
53,43,Brimstone,1000,77,2016.0,Western/Mystery and thriller,2:28,-10,15.102773291691431
84,94,I Wish,1000,77,2011.0,Comedy/Drama,2:08,10,15.102773291691431
65,93,Daughters of the Dust,1000,76,1991.0,Drama,1:54,28,14.979885547093689
96,59,The Last Full Measure,1000,76,2019.0,War/Drama,1:56,-37,14.979885547093689
60,79,"Police, Adjective",1000,76,2009.0,Drama,1:50,19,14.979885547093689
86,96,Trouble the Water,1000,76,2008.0,Documentary,1:33,10,14.979885547093689
66,88,Cargo,1000,76,2018.0,,,22,14.979885547093689
46,25,Proud Mary,1000,75,2018.0,Mystery and thriller/Action,1:28,-21,14.856389929209026
46,87,Francofonia,1000,75,2015.0,Documentary/Drama,1:27,41,14.856389929209026
73,92,Eat That Question: Frank Zappa in His Own Words,1000,75,2016.0,Documentary/Music,1:30,19,14.856389929209026
47,81,Something in the Air,1000,75,2012.0,Romance/Drama,2:02,34,14.856389929209026
61,75,Blackthorn,1000,75,2011.0,Western/Action,1:38,14,14.856389929209026
82,82,"Life, Above All",1000,74,2010.0,Drama,1:42,0,14.732275265126917
60,95,Museum Hours,1000,74,2012.0,Drama,1:47,35,14.732275265126917
75,91,I Am Mother,1000,74,2019.0,Sci fi/Mystery and thriller,1:55,16,14.732275265126917
31,43,The Face of Love,1000,74,2013.0,Romance/Drama,1:32,12,14.732275265126917
71,77,The Connection,1000,74,2014.0,Drama/Action,2:15,6,14.732275265126917
62,78,Shall We Kiss?,1000,74,2007.0,Comedy/Romance,1:42,16,14.732275265126917
55,92,Demon,1000,72,2015.0,Horror/Mystery and thriller,1:34,37,14.482142292408389
97,63,Brian Banks,1000,72,2018.0,Drama/Biography,1:39,-34,14.482142292408389
25,56,Trespass Against Us,1000,72,2016.0,Drama/Crime,1:40,31,14.482142292408389
81,81,The Guernsey Literary and Potato Peel Pie Society,1000,72,2018.0,Romance/Drama,2:04,0,14.482142292408389
89,96,The Beaches of Agnès,1000,72,2008.0,Documentary/Biography,1:50,7,14.482142292408389
79,94,Diana Vreeland: The Eye Has to Travel,1000,71,2011.0,Biography/Documentary,1:17,15,14.356099772615265
43,49,I Smile Back,1000,71,2015.0,Drama,1:25,6,14.356099772615265
80,87,First They Killed My Father,1000,71,2017.0,Biography/Drama,2:16,7,14.356099772615265
57,62,Delicacy,1000,71,2011.0,Romance,1:49,5,14.356099772615265
81,33,Anna,1000,70,2019.0,Mystery and thriller/Action,1:59,-48,14.229389747854103
41,64,Digging for Fire,1000,70,2015.0,Drama/Mystery and thriller,1:23,23,14.229389747854103
72,84,The Forgiveness of Blood,1000,70,2011.0,Drama,1:49,12,14.229389747854103
72,26,Countdown,1000,70,2019.0,Comedy/Horror,1:30,-46,14.229389747854103
54,79,Apostle,1000,70,2018.0,Horror/Mystery and thriller,2:09,25,14.229389747854103
83,90,Client 9: The Rise and Fall of Eliot Spitzer,1000,70,2010.0,Documentary,1:57,7,14.229389747854103
65,91,Gimme the Loot,1000,69,2012.0,Drama/Crime,1:21,26,14.101999070345963
50,96,The Forbidden Room,1000,69,2015.0,Drama/Mystery and thriller,2:10,46,14.101999070345963
96,94,Klaus,1000,69,2019.0,Comedy/Adventure,1:38,-2,14.101999070345963
71,74,Chicken With Plums,1000,69,2011.0,Drama/Comedy,1:31,3,14.101999070345963
50,49,Before the Rains,1000,69,2007.0,Drama,1:38,-1,14.101999070345963
50,88,Jauja,1000,68,2014.0,Drama,1:48,38,13.973914138485368
42,44,Murder Mystery,1000,68,2019.0,Action/Comedy,1:37,2,13.973914138485368
54,62,Samba,1000,68,2014.0,Drama/Comedy,1:59,8,13.973914138485368
67,67,Service Entrance,1000,67,2010.0,Comedy,1:44,0,13.8451208742507
50,72,A Tale of Love and Darkness,1000,67,2015.0,History/Drama,1:38,22,13.8451208742507
37,39,The 9th Life of Louis Drax,1000,67,2016.0,Mystery and thriller,1:48,2,13.8451208742507
68,82,The Double Hour,1000,67,2009.0,Drama/Mystery and thriller,1:35,14,13.8451208742507
36,27,Sherlock Gnomes,1000,67,2018.0,Comedy/Animation,1:26,-9,13.8451208742507
34,58,Red Hook Summer,1000,66,2012.0,Drama,2:01,24,13.715604699135167
80,95,"Not Quite Hollywood: The Wild, Untold Story of Ozploitation!",1000,66,2008.0,Documentary,1:43,15,13.715604699135167
54,89,The Childhood of a Leader,1000,66,2015.0,History/Drama,1:55,35,13.715604699135167
23,27,The Last of Robin Hood,1000,66,2013.0,Romance/Biography,1:32,4,13.715604699135167
85,95,Crude,1000,66,2009.0,Documentary,1:44,10,13.715604699135167
69,88,Drunk Stoned Brilliant Dead: The Story of the National Lampoon,1000,65,2015.0,Documentary,1:34,19,13.58535050847747
72,92,The Black Panthers: Vanguard of the Revolution,1000,65,2015.0,Drama/History,1:54,20,13.58535050847747
86,97,A Film Unfinished,1000,65,2009.0,Documentary,1:29,11,13.58535050847747
25,17,Aloft,1000,65,2014.0,Drama,1:56,-8,13.58535050847747
22,42,Touchy Feely,1000,65,2013.0,Comedy/Drama,1:29,20,13.58535050847747
86,88,I.O.U.S.A.,1000,65,2008.0,Documentary,1:27,2,13.58535050847747
73,86,Dumplin',1000,64,2018.0,Drama/Comedy,1:50,13,13.454342644059432
79,63,Breakthrough,1000,64,2019.0,Drama,1:56,-16,13.454342644059432
28,53,The Humbling,1000,64,2014.0,Comedy/Gay and lesbian,1:53,25,13.454342644059432
60,88,Neil Young Journeys,1000,64,2011.0,Documentary,1:27,28,13.454342644059432
72,86,Treeless Mountain,1000,64,2008.0,Drama,1:29,14,13.454342644059432
39,41,Midnight's Children,1000,63,2012.0,Drama,2:28,2,13.322564864824612
55,21,Midnight Sun,1000,63,2018.0,Romance/Drama,1:31,-34,13.322564864824612
54,62,Every Day,1000,63,2018.0,Fantasy/Drama,1:35,8,13.322564864824612
52,78,Cold Weather,1000,63,2010.0,Mystery and thriller/Comedy,1:37,26,13.322564864824612
87,98,Marwencol,1000,63,2010.0,Documentary,1:23,11,13.322564864824612
54,73,Mozart's Sister,1000,63,2010.0,Drama,2:00,19,13.322564864824612
74,78,I Kill Giants,1000,63,2017.0,Adventure/Fantasy,1:46,4,13.322564864824612
42,25,Filth and Wisdom,1000,63,2008.0,Comedy/Romance,1:21,-17,13.322564864824612
74,92,A Prayer Before Dawn,1000,62,2017.0,Mystery and thriller/Action,1:57,18,13.190000315557024
75,84,The Patience Stone,1000,62,2012.0,Drama,1:38,9,13.190000315557024
44,45,The Discovery,1000,62,2017.0,Sci fi/Romance,1:50,1,13.190000315557024
91,97,Burma VJ: Reporting From a Closed Country,1000,62,2008.0,Documentary,1:24,6,13.190000315557024
53,69,Operation Avalanche,1000,62,2016.0,Drama/Mystery and thriller,1:34,16,13.190000315557024
65,84,Mayhem,1000,61,2017.0,Horror/Action,1:26,19,13.056631493342596
80,93,Endless Poetry,1000,61,2016.0,Biography,2:08,13,13.056631493342596
33,23,Kill Your Friends,1000,61,2015.0,Mystery and thriller/Comedy,1:43,-10,13.056631493342596
50,77,Simon Killer,1000,61,2012.0,Drama,1:45,27,13.056631493342596
55,56,Once Upon a Deadpool,1000,61,2018.0,Comedy/Action,1:58,1,13.056631493342596
67,15,Bitter Harvest,1000,61,2017.0,Romance/War,1:43,-52,13.056631493342596
37,52,Thérèse,1000,60,2012.0,Drama,1:50,15,12.922440211617326
68,92,Set It Up,1000,60,2018.0,Romance,1:45,24,12.922440211617326
67,87,Lost in Paris,1000,60,2016.0,Comedy,1:25,20,12.922440211617326
67,92,Sunshine Superman,1000,60,2014.0,Documentary,1:40,25,12.922440211617326
43,73,Catfight,1000,60,2016.0,Comedy,1:36,30,12.922440211617326
87,85,The Art of the Steal,1000,60,2009.0,Documentary,1:41,-2,12.922440211617326
75,90,The Grocer's Son,1000,60,2007.0,Drama,1:36,15,12.922440211617326
69,76,The First Monday in May,1000,59,2016.0,Documentary,1:31,7,12.78740756158519
84,85,The Music of Strangers: Yo-Yo Ma & the Silk Road Ensemble,1000,59,2015.0,Music/Documentary,1:36,1,12.78740756158519
49,54,Post Tenebras Lux,1000,59,2012.0,Drama,2:00,5,12.78740756158519
65,95,Appropriate Behavior,1000,59,2014.0,Comedy/Gay and lesbian,1:26,30,12.78740756158519
73,73,Darfur Now,1000,59,2007.0,Documentary,1:39,0,12.78740756158519
67,93,Of Time and the City,1000,59,2008.0,Documentary/Biography,1:12,26,12.78740756158519
69,88,Aleksandra,1000,59,2007.0,Drama,1:35,19,12.78740756158519
75,67,The Christmas Chronicles,1000,58,2018.0,Comedy/Adventure,1:44,-8,12.651513870765422
77,93,Boy and the World,1000,58,2013.0,Adventure/Animation,1:20,16,12.651513870765422
61,90,The Father of My Children,1000,58,2009.0,Drama,1:50,29,12.651513870765422
50,33,The Wrong Missy,1000,58,2020.0,Comedy,1:29,-17,12.651513870765422
56,71,A Perfect Day,1000,58,2015.0,Comedy/Drama,1:46,15,12.651513870765422
59,79,Sweet Virginia,1000,57,2017.0,Drama/Mystery and thriller,1:35,20,12.514738658402138
43,26,Unlocked,1000,57,2017.0,Action/Mystery and thriller,1:38,-17,12.514738658402138
71,86,Mysteries of Lisbon,1000,57,2010.0,Drama/History,4:26,15,12.514738658402138
78,75,The Yes Men Fix the World,1000,57,2009.0,Documentary,1:30,-3,12.514738658402138
64,61,The Little Death,1000,57,2014.0,Romance,1:36,-3,12.514738658402138
70,84,Bamako,1000,57,2006.0,Drama,1:58,14,12.514738658402138
66,81,Night Catches Us,1000,57,2010.0,Drama,1:30,15,12.514738658402138
32,11,Replicas,1000,56,2018.0,Sci fi/Mystery and thriller,1:47,-21,12.377060587439436
31,29,All I See Is You,1000,56,2016.0,Drama,1:50,-2,12.377060587439436
24,25,Woodshock,1000,56,2017.0,Drama,1:41,1,12.377060587439436
70,70,5 to 7,1000,56,2014.0,Romance,1:38,0,12.377060587439436
67,21,Seven Days in Utopia,1000,56,2011.0,Drama,1:36,-46,12.377060587439436
87,84,Supersonic,1000,56,2016.0,Documentary/Music,1:57,-3,12.377060587439436
80,84,Lilting,1000,55,2014.0,Drama/Gay and lesbian,1:31,4,12.238457412731087
66,71,A Thousand Times Goodnight,1000,55,2013.0,Drama/War,1:57,5,12.238457412731087
87,98,Homecoming: A Film by Beyoncé,1000,55,2019.0,,,11,12.238457412731087
45,82,Entertainment,1000,55,2015.0,Comedy,1:42,37,12.238457412731087
23,25,The Benefactor,1000,55,2015.0,Drama,1:32,2,12.238457412731087
50,69,Visitors,1000,55,2013.0,Documentary,1:27,19,12.238457412731087
55,44,Mental,1000,55,2012.0,Comedy/Drama,1:56,-11,12.238457412731087
79,24,Forever My Girl,1000,54,2018.0,Music/Drama,1:48,-55,12.098905925115496
61,96,Manakamana,1000,54,2013.0,Documentary,1:58,35,12.098905925115496
84,94,Gook,1000,54,2017.0,Drama/Comedy,1:35,10,12.098905925115496
76,98,Long Way North,1000,54,2015.0,Adventure/Drama,1:21,22,12.098905925115496
56,76,The Headless Woman,1000,54,2008.0,Drama/Mystery and thriller,1:29,20,12.098905925115496
36,50,Hateship Loveship,1000,54,2013.0,Comedy/Drama,1:42,14,12.098905925115496
68,74,Clown,1000,54,2010.0,Comedy,1:31,6,12.098905925115496
75,93,The Four Times,1000,54,2010.0,Drama,1:28,18,12.098905925115496
36,51,Half of a Yellow Sun,1000,53,2013.0,Drama,1:53,15,11.958381890942793
63,83,The Galapagos Affair: Satan Came to Eden,1000,53,2014.0,Crime/Drama,2:00,20,11.958381890942793
80,92,Güeros,1000,53,2014.0,Comedy,1:48,12,11.958381890942793
86,92,The Black Power Mixtape 1967-1975,1000,53,2011.0,Drama/History,1:40,6,11.958381890942793
68,83,Mademoiselle Chambon,1000,53,2009.0,Drama,1:41,15,11.958381890942793
78,72,The Names of Love,1000,53,2010.0,Romance,1:24,-6,11.958381890942793
27,25,Saint John of Las Vegas,1000,53,2009.0,Comedy/Drama,1:25,-2,11.958381890942793
83,96,Up the Yangtze,1000,53,2007.0,Documentary,1:33,13,11.958381890942793
28,13,Love Ranch,1000,52,2010.0,Drama,1:58,-15,11.8168599865911
63,73,The Wizard of Lies,1000,52,2017.0,Crime/Drama,2:13,10,11.8168599865911
74,77,A Coffee in Berlin,1000,52,2012.0,Drama/Comedy,1:28,3,11.8168599865911
78,83,Ivory Tower,1000,52,2014.0,Drama/History,1:30,5,11.8168599865911
83,77,The Green Prince,1000,52,2014.0,Documentary/Biography,1:35,-6,11.8168599865911
42,17,The Sea of Trees,1000,52,2015.0,Drama,1:50,-25,11.8168599865911
57,69,The Dead Lands,1000,52,2014.0,Action/Drama,1:48,12,11.8168599865911
25,20,Arthur Newman,1000,51,2012.0,Drama/Romance,1:41,-5,11.674313727451958
45,84,The Salt of Life,1000,51,2011.0,Comedy,1:30,39,11.674313727451958
44,84,Glassland,1000,51,2014.0,Drama,1:29,40,11.674313727451958
49,78,The Intervention,1000,51,2016.0,Drama/Comedy,1:30,29,11.674313727451958
10,37,The Face of an Angel,1000,51,2014.0,Drama,1:41,27,11.674313727451958
19,18,Lay the Favorite,1000,51,2012.0,Drama/Comedy,1:34,-1,11.674313727451958
76,90,In Bloom,1000,51,2013.0,Drama,1:42,14,11.674313727451958
86,88,Bobby Fischer Against the World,1000,51,2011.0,Documentary,1:32,2,11.674313727451958
81,84,Rich Hill,1000,51,2014.0,Documentary,1:31,3,11.674313727451958
84,92,Corman's World: Exploits of a Hollywood Rebel,1000,51,2011.0,Documentary,1:35,8,11.674313727451958
85,98,Chimes at Midnight,1000,50,1965.0,Drama/History,1:55,13,11.530715390799685
56,70,Buster's Mal Heart,1000,50,2016.0,Drama/Mystery and thriller,1:38,14,11.530715390799685
70,88,Prospect,1000,50,2018.0,Sci fi/Adventure,1:38,18,11.530715390799685
90,98,Mea Maxima Culpa: Silence in the House of God,1000,50,2012.0,Documentary,1:47,8,11.530715390799685
59,28,Fathers and Daughters,1000,50,2015.0,Drama,1:56,-31,11.530715390799685
65,92,12 O'Clock Boys,1000,50,2013.0,Documentary,1:14,27,11.530715390799685
26,42,Child of God,1000,50,2013.0,Drama,1:44,16,11.530715390799685
84,84,Black Gold,1000,50,2006.0,Documentary,1:17,0,11.530715390799685
77,88,Zero Motivation,1000,50,2014.0,Comedy/Drama,1:40,11,11.530715390799685
65,86,The Witnesses,1000,50,2007.0,Drama,1:54,21,11.530715390799685
83,98,Blindsight,1000,50,2006.0,Documentary/Adventure,1:44,15,11.530715390799685
85,88,"What Happened, Miss Simone?",1000,49,2015.0,Music/Biography,1:41,3,11.3860359318845
41,49,Hemingway & Gellhorn,1000,49,2012.0,Drama/Biography,2:30,8,11.3860359318845
57,73,Headshot,1000,49,2016.0,Sports and fitness/Action,1:58,16,11.3860359318845
71,82,Amanda Knox,1000,49,2016.0,Drama/Crime,1:32,11,11.3860359318845
77,88,Happy People: A Year in the Taiga,1000,49,2010.0,Documentary,1:34,11,11.3860359318845
73,92,Into the Inferno,1000,49,2016.0,Documentary,1:44,19,11.3860359318845
76,73,Dinosaur 13,1000,49,2014.0,Documentary,1:46,-3,11.3860359318845
26,100,Hannah Gadsby: Nanette,1000,49,2018.0,Comedy/Stand up,1:09,74,11.3860359318845
88,96,5 Broken Cameras,1000,48,2011.0,Documentary/War,1:30,8,11.240244892502977
38,58,Partisan,1000,48,2015.0,Drama/Mystery and thriller,1:38,20,11.240244892502977
73,88,Terribly Happy,1000,48,2008.0,Drama/Mystery and thriller,1:40,15,11.240244892502977
51,81,The Myth of the American Sleepover,1000,48,2010.0,Comedy/Drama,1:33,30,11.240244892502977
63,83,No Impact Man,1000,48,2009.0,Documentary,1:32,20,11.240244892502977
77,81,Flow: For Love of Water,1000,48,2008.0,Documentary,1:33,4,11.240244892502977
77,96,The Women's Balcony,1000,47,2016.0,Drama/Comedy,1:36,19,11.093310301199846
85,100,Everyday Sunshine: The Story of Fishbone,1000,47,2010.0,Music/Documentary,1:47,15,11.093310301199846
95,45,Cirque du Soleil: Worlds Away,1000,47,2012.0,Adventure/Drama,1:27,-50,11.093310301199846
50,74,Alps,1000,47,2011.0,Drama,1:33,24,11.093310301199846
73,98,Finders Keepers,1000,47,2015.0,Documentary,1:24,25,11.093310301199846
60,91,What Richard Did,1000,47,2012.0,Drama,1:27,31,11.093310301199846
20,32,Boarding Gate,1000,47,2007.0,Mystery and thriller,1:33,12,11.093310301199846
84,91,Alamar,1000,47,2009.0,Drama,1:13,7,11.093310301199846
43,74,Beeswax,1000,47,2009.0,Comedy/Drama,1:40,31,11.093310301199846
74,91,Art and Craft,1000,46,2014.0,Documentary,1:30,17,10.945198564139895
98,52,I Still Believe,1000,46,2020.0,Romance/Biography,1:55,-46,10.945198564139895
50,91,Momma's Man,1000,46,2008.0,Drama,1:39,41,10.945198564139895
53,78,Attenberg,1000,46,2010.0,Drama,1:35,25,10.945198564139895
74,96,The Arbor,1000,46,2010.0,Drama,1:34,22,10.945198564139895
94,96,The Crash Reel,1000,46,2013.0,Documentary,1:49,2,10.945198564139895
22,11,The Bag Man,1000,46,2014.0,Drama/Crime,1:48,-11,10.945198564139895
83,74,Just Another Love Story,1000,46,2007.0,Drama/Mystery and thriller,1:40,-9,10.945198564139895
66,87,Terror's Advocate,1000,46,2007.0,Documentary,2:18,21,10.945198564139895
53,11,Papa: Hemingway in Cuba,1000,45,2015.0,Drama/Biography,1:49,-42,10.795874345554918
85,96,Los Angeles Plays Itself,1000,45,2003.0,Documentary,2:49,11,10.795874345554918
43,16,I Melt With You,1000,45,2011.0,Mystery and thriller,2:09,-27,10.795874345554918
62,78,Felix and Meira,1000,45,2014.0,Drama/Romance,1:46,16,10.795874345554918
62,87,Ballet 422,1000,45,2014.0,Documentary/Music,1:12,25,10.795874345554918
92,82,The Rape of Europa,1000,45,2006.0,Documentary,1:57,-10,10.795874345554918
57,91,1922,1000,44,2017.0,Horror,1:42,34,10.645300436514761
69,93,Our Children,1000,44,2012.0,Drama,1:51,24,10.645300436514761
75,89,Our Souls at Night,1000,44,2017.0,Drama,1:43,14,10.645300436514761
74,52,Cool It,1000,44,2010.0,Documentary,1:29,-22,10.645300436514761
62,32,Desert Dancer,1000,44,2015.0,Drama,1:44,-30,10.645300436514761
46,80,Baskin,1000,44,2015.0,Horror/Fantasy,1:37,34,10.645300436514761
77,89,Narco cultura,1000,44,2012.0,Documentary,1:43,12,10.645300436514761
27,11,Delgo,1000,44,2008.0,Comedy/Fantasy,1:30,-16,10.645300436514761
41,77,Genova,1000,44,2008.0,Drama,1:34,36,10.645300436514761
48,80,Afterschool,1000,44,2008.0,Drama,2:01,32,10.645300436514761
71,89,24 City,1000,44,2008.0,Documentary/Drama,1:52,18,10.645300436514761
84,100,Fireworks Wednesday,1000,44,2006.0,Drama,1:44,16,10.645300436514761
30,21,Paradise,1000,43,2013.0,Comedy,1:26,-9,10.493437610589469
70,86,Declaration of War,1000,43,2011.0,Drama,1:40,16,10.493437610589469
66,95,Hard to Be a God,1000,43,2013.0,Sci fi/Drama,2:57,29,10.493437610589469
20,42,Open Windows,1000,43,2014.0,Mystery and thriller,1:40,22,10.493437610589469
63,86,The Big Picture,1000,43,2010.0,Drama,1:54,23,10.493437610589469
28,30,Summer in February,1000,43,2013.0,Drama/Romance,1:41,2,10.493437610589469
29,44,Cold Comes the Night,1000,43,2013.0,Drama/Crime,1:30,15,10.493437610589469
48,70,The We and the I,1000,43,2012.0,Drama,1:43,22,10.493437610589469
43,70,The Motel Life,1000,43,2012.0,Drama,1:25,27,10.493437610589469
88,98,Keep on Keepin' On,1000,43,2014.0,Documentary,1:26,10,10.493437610589469
74,91,Our Nixon,1000,43,2013.0,Documentary,1:24,17,10.493437610589469
28,40,Finding Amanda,1000,43,2008.0,Comedy/Drama,1:40,12,10.493437610589469
72,81,Great World of Sound,1000,43,2006.0,Comedy,1:46,9,10.493437610589469
70,69,Revenge of the Electric Car,1000,42,2011.0,Documentary,1:30,-1,10.34024446475599
63,86,Detropia,1000,42,2012.0,Documentary,1:30,23,10.34024446475599
42,69,Frank & Lola,1000,42,2016.0,Drama/Romance,1:28,27,10.34024446475599
76,67,Game Change,1000,42,2012.0,Drama,1:58,-9,10.34024446475599
87,98,The Song of Sparrows,1000,42,2008.0,Drama,1:36,11,10.34024446475599
78,88,The Real Dirt on Farmer John,1000,42,2005.0,Documentary,1:22,10,10.34024446475599
53,71,I Declare War,1000,42,2012.0,Drama,1:30,18,10.34024446475599
51,80,We Gotta Get Out of This Place,1000,41,2013.0,Drama/Crime,1:31,29,10.185677243651742
79,100,More Than Honey,1000,41,2012.0,Documentary,1:35,21,10.185677243651742
81,98,Sherpa,1000,41,2015.0,Documentary,1:36,17,10.185677243651742
54,76,The Do-Deca-Pentathlon,1000,41,2012.0,Comedy,1:16,22,10.185677243651742
61,34,Luv,1000,41,2012.0,Drama,1:34,-27,10.185677243651742
58,78,Lucky Them,1000,41,2013.0,Comedy/Drama,1:36,20,10.185677243651742
71,71,Queen to Play,1000,41,2009.0,Drama,1:37,0,10.185677243651742
83,98,Time Is Illmatic,1000,41,2014.0,Documentary/Biography,1:13,15,10.185677243651742
42,83,Return,1000,41,2011.0,Drama,1:41,41,10.185677243651742
38,37,In the Blood,1000,41,2014.0,Action/Mystery and thriller,1:48,-1,10.185677243651742
91,83,Planet B-Boy,1000,41,2007.0,Documentary,1:41,-8,10.185677243651742
54,12,There Be Dragons,1000,41,2011.0,Drama,2:00,-42,10.185677243651742
69,95,Notes on Blindness,1000,40,2016.0,Documentary,1:30,26,10.029689644980788
79,93,"Norte, the End of History",1000,40,2013.0,Drama,4:10,14,10.029689644980788
61,93,A Dark Song,1000,40,2016.0,Drama/Horror,1:40,32,10.029689644980788
44,60,Trash Humpers,1000,40,2009.0,Horror,1:18,16,10.029689644980788
71,78,The Wall,1000,40,2012.0,Sci fi/Drama,1:48,7,10.029689644980788
75,68,Bride Flight,1000,40,2008.0,Drama,2:10,-7,10.029689644980788
79,95,Sing Your Song,1000,40,2011.0,Documentary/Biography,1:43,16,10.029689644980788
61,75,Bettie Page Reveals All,1000,40,2011.0,Documentary/Biography,1:30,14,10.029689644980788
80,93,"Moscow, Belgium",1000,40,2008.0,Comedy/Romance,1:42,13,10.029689644980788
41,40,Lila & Eve,1000,40,2015.0,Drama/Crime,1:34,-1,10.029689644980788
36,18,A Few Best Men,1000,39,2011.0,Drama/Comedy,1:37,-18,9.872232603526719
47,77,100 Bloody Acres,1000,39,2012.0,Horror/Comedy,1:31,30,9.872232603526719
80,46,"Paul, Apostle of Christ",1000,39,2018.0,Drama,1:48,-34,9.872232603526719
73,87,Kicks,1000,39,2016.0,Comedy/Drama,1:24,14,9.872232603526719
74,97,Ixcanul,1000,39,2015.0,Drama,1:33,23,9.872232603526719
35,41,A Hundred Streets,1000,39,2016.0,Drama,1:33,6,9.872232603526719
23,29,Don Verdean,1000,38,2015.0,Comedy,1:36,6,9.713254050808038
74,68,That Sugar Film,1000,38,2014.0,Documentary,1:34,-6,9.713254050808038
30,61,Sierra Burgess Is a Loser,1000,38,2018.0,Romance,1:45,31,9.713254050808038
59,45,Walking With the Enemy,1000,38,2013.0,Drama/History,2:06,-14,9.713254050808038
55,63,Hungry Hearts,1000,38,2014.0,Drama/Mystery and thriller,1:52,8,9.713254050808038
29,37,Cut Bank,1000,38,2014.0,Mystery and thriller,1:29,8,9.713254050808038
56,76,Northern Soul,1000,38,2014.0,Drama/Comedy,1:42,20,9.713254050808038
66,82,Deli Man,1000,38,2014.0,Documentary,1:31,16,9.713254050808038
89,87,The Last Lions,1000,38,2011.0,Documentary,1:28,-2,9.713254050808038
67,76,Match,1000,38,2014.0,Comedy/Drama,1:32,9,9.713254050808038
45,61,At Middleton,1000,38,2013.0,Romance,1:40,16,9.713254050808038
22,24,The Runner,1000,38,2015.0,Drama,1:30,2,9.713254050808038
45,18,Princess Kaiulani,1000,38,2009.0,Biography/Drama,2:10,-27,9.713254050808038
83,92,Big Star: Nothing Can Hurt Me,1000,38,2012.0,Documentary,1:53,9,9.713254050808038
54,76,The Exploding Girl,1000,38,2009.0,Romance/Drama,1:20,22,9.713254050808038
71,65,Pandora's Promise,1000,37,2013.0,Documentary,1:30,-6,9.552698646911638
58,30,The Good Heart,1000,37,2009.0,Drama,1:38,-28,9.552698646911638
40,35,Jayne Mansfield's Car,1000,37,2012.0,Drama,2:02,-5,9.552698646911638
56,70,Bart Got a Room,1000,37,2008.0,Comedy,1:20,14,9.552698646911638
93,86,George Harrison: Living in the Material World,1000,37,2011.0,Documentary/Biography,3:28,-7,9.552698646911638
77,89,"Pink Ribbons, Inc.",1000,37,2011.0,Documentary,1:37,12,9.552698646911638
73,68,"Bless Me, Ultima",1000,37,2012.0,War/Drama,1:46,-5,9.552698646911638
63,65,The Summit,1000,37,2012.0,Documentary,1:42,2,9.552698646911638
86,84,Let Him Have It,1000,37,1991.0,Drama/Crime,1:59,-2,9.552698646911638
41,16,An American Affair,1000,37,2009.0,Drama/History,1:33,-25,9.552698646911638
58,59,Trucker,1000,37,2008.0,Drama,1:33,1,9.552698646911638
65,84,Medicine for Melancholy,1000,37,2008.0,Romance/Drama,1:28,19,9.552698646911638
75,95,My Father My Lord,1000,37,2007.0,Drama,1:14,20,9.552698646911638
37,67,For Ellen,1000,36,2012.0,Drama,1:33,30,9.390507480439723
34,47,Young Ones,1000,36,2014.0,Drama/Sci fi,1:39,13,9.390507480439723
77,92,Marshland,1000,36,2014.0,Mystery and thriller,1:45,15,9.390507480439723
83,100,A New Leaf,1000,36,1971.0,Comedy,1:42,17,9.390507480439723
38,22,Better Living Through Chemistry,1000,36,2014.0,Drama/Comedy,1:31,-16,9.390507480439723
86,89,The Golden Dream,1000,36,2013.0,Drama,1:42,3,9.390507480439723
54,89,Run & Jump,1000,36,2013.0,Drama,1:42,35,9.390507480439723
23,25,Mansome,1000,36,2012.0,Documentary,1:24,2,9.390507480439723
41,58,Milo,1000,36,2013.0,Comedy/Horror,1:23,17,9.390507480439723
56,81,My Blind Brother,1000,36,2016.0,Romance,1:23,25,9.390507480439723
82,78,The Other F Word,1000,36,2011.0,Documentary,1:38,-4,9.390507480439723
54,61,Quid Pro Quo,1000,36,2008.0,Comedy/Drama,1:21,7,9.390507480439723
88,81,Unmistaken Child,1000,36,2008.0,Documentary,1:44,-7,9.390507480439723
31,39,Ceremony,1000,36,2010.0,Comedy,1:30,8,9.390507480439723
86,100,Pray the Devil Back to Hell,1000,36,2008.0,Documentary,1:12,14,9.390507480439723
69,86,Kings of Pastry,1000,35,2009.0,Documentary,1:24,17,9.22661773178138
68,74,Natural Selection,1000,35,2011.0,Comedy,1:30,6,9.22661773178138
44,46,Another Happy Day,1000,35,2011.0,Drama/Comedy,1:55,2,9.22661773178138
23,23,Salvation Boulevard,1000,35,2011.0,Drama/Comedy,1:36,0,9.22661773178138
40,89,Emelie,1000,35,2015.0,Mystery and thriller,1:26,49,9.22661773178138
62,86,Down Terrace,1000,35,2009.0,Comedy/Drama,1:33,24,9.22661773178138
77,86,Eyes Wide Open,1000,35,2009.0,Drama,1:31,9,9.22661773178138
70,77,The Wildest Dream: Conquest of Everest,1000,35,2010.0,Documentary,1:33,7,9.22661773178138
70,89,Happy Valley,1000,35,2014.0,Documentary/Drama,1:38,19,9.22661773178138
32,49,King Cobra,1000,35,2016.0,Drama/Crime,1:32,17,9.22661773178138
56,60,Vidal Sassoon: The Movie,1000,35,2010.0,Documentary,1:30,4,9.22661773178138
84,94,Our Daily Bread,1000,35,2005.0,Documentary,1:32,10,9.22661773178138
35,77,Unforgivable,1000,35,2011.0,Drama,1:52,42,9.22661773178138
62,89,Woman on the Beach,1000,35,2006.0,Drama,1:40,27,9.22661773178138
71,91,Your Mommy Kills Animals,1000,35,2007.0,Documentary,1:46,20,9.22661773178138
72,94,The Farewell Party,1000,34,2014.0,Drama/Comedy,1:30,22,9.060962294042406
43,41,Kickboxer: Vengeance,1000,34,2016.0,Sports and fitness/Action,1:30,-2,9.060962294042406
72,82,Noble,1000,34,2014.0,Drama/Biography,1:40,10,9.060962294042406
30,6,Some Kind of Beautiful,1000,34,2014.0,Romance,1:39,-24,9.060962294042406
72,85,You've Been Trumped,1000,34,2011.0,Documentary,1:35,13,9.060962294042406
91,97,The Earrings of Madame De ...,1000,34,1953.0,Drama,1:45,6,9.060962294042406
51,62,Dear Mr. Watterson,1000,34,2013.0,Documentary,1:29,11,9.060962294042406
78,91,Tales From the Golden Age,1000,34,2009.0,Comedy,2:35,13,9.060962294042406
71,91,And Everything Is Going Fine,1000,34,2010.0,Documentary,1:29,20,9.060962294042406
28,47,Bait,1000,34,2012.0,Action/Horror,1:30,19,9.060962294042406
52,62,Toast,1000,34,2010.0,Comedy/Drama,1:36,10,9.060962294042406
22,27,Happy Tears,1000,33,2009.0,Drama,1:36,5,8.893469344897873
52,73,Personal Best,1000,33,1982.0,Drama/Gay and lesbian,2:04,21,8.893469344897873
38,52,Trust Me,1000,33,2013.0,Comedy,1:30,14,8.893469344897873
66,88,Deathgasm,1000,33,2015.0,Horror/Comedy,1:30,22,8.893469344897873
28,36,Sharknado 3: Oh Hell No!,1000,33,2015.0,Sci fi/Comedy,1:28,8,8.893469344897873
75,88,If a Tree Falls: A Story of the Earth Liberation Front,1000,33,2011.0,Drama/Documentary,1:25,13,8.893469344897873
38,73,ABCs of Death 2,1000,33,2014.0,Horror,2:03,35,8.893469344897873
68,88,The Army of Crime,1000,33,2009.0,War/Drama,2:19,20,8.893469344897873
80,64,Husbands,1000,33,1970.0,Comedy/Drama,2:18,-16,8.893469344897873
83,91,Score: A Film Music Documentary,1000,33,2016.0,Documentary/Music,1:34,8,8.893469344897873
78,97,Phil Ochs: There But for Fortune,1000,33,2010.0,Documentary/Biography,1:36,19,8.893469344897873
59,82,Earth Days,1000,33,2009.0,Documentary,1:42,23,8.893469344897873
75,100,Live-In Maid,1000,33,2004.0,Drama,1:27,25,8.893469344897873
46,72,Greetings From Tim Buckley,1000,32,2012.0,Drama,1:39,26,8.724061861322062
73,84,Far From Men,1000,32,2014.0,Drama,1:42,11,8.724061861322062
71,19,Jexi,1000,32,2019.0,Comedy,1:24,-52,8.724061861322062
72,97,Sleepless Night,1000,32,2011.0,Drama/Crime,1:42,25,8.724061861322062
77,91,Blue Jay,1000,32,2016.0,Drama,1:25,14,8.724061861322062
52,56,Janie Jones,1000,32,2010.0,Drama,1:54,4,8.724061861322062
88,88,The Other Dream Team,1000,32,2012.0,Documentary,1:28,0,8.724061861322062
69,75,Venus and Serena,1000,32,2012.0,Biography/Documentary,1:40,6,8.724061861322062
72,81,Closet Monster,1000,32,2015.0,Gay and lesbian/Drama,1:30,9,8.724061861322062
90,100,Long Strange Trip,1000,32,2017.0,Documentary/Music,3:58,10,8.724061861322062
43,74,Alex of Venice,1000,31,2014.0,Drama,1:26,31,8.552657067536824
74,77,Braven,1000,31,2018.0,Mystery and thriller/Action,1:34,3,8.552657067536824
76,81,A Letter to Momo,1000,31,2011.0,Drama/Anime,2:00,5,8.552657067536824
19,45,4:44 Last Day on Earth,1000,31,2011.0,Drama/Fantasy,1:24,26,8.552657067536824
60,87,In the Fog,1000,31,2012.0,Drama/War,2:07,27,8.552657067536824
31,61,Sharknado 2: The Second One,1000,31,2014.0,Comedy/Action,1:30,30,8.552657067536824
77,71,I Am Chris Farley,1000,31,2015.0,Documentary,1:35,-6,8.552657067536824
30,26,Life Happens,1000,31,2011.0,Comedy,1:40,-4,8.552657067536824
82,100,For the Love of Spock,1000,31,2016.0,Documentary,1:40,18,8.552657067536824
86,94,A Simple Life,1000,31,2011.0,Drama,1:57,8,8.552657067536824
72,81,Today's Special,1000,31,2009.0,Comedy,1:39,9,8.552657067536824
33,42,Wonderful World,1000,31,2009.0,Romance/Drama,1:35,9,8.552657067536824
66,68,Save Me,1000,31,2007.0,Drama,1:36,2,8.552657067536824
80,87,Scott Walker: 30 Century Man,1000,31,2006.0,Documentary/Biography,1:36,7,8.552657067536824
45,17,Mine,1000,30,2016.0,War/Mystery and thriller,1:47,-28,8.379165804519056
86,100,Odd Man Out,1000,30,1947.0,Mystery and thriller,1:55,14,8.379165804519056
63,83,The Special Relationship,1000,30,2010.0,Drama,1:32,20,8.379165804519056
76,77,Too Big to Fail,1000,30,2011.0,Drama,1:38,1,8.379165804519056
67,37,Before I Disappear,1000,30,2014.0,Drama,1:39,-30,8.379165804519056
59,83,Witching & Bitching,1000,30,2013.0,Drama/Horror,1:54,24,8.379165804519056
15,33,Cymbeline,1000,30,2014.0,Drama,1:25,18,8.379165804519056
68,33,Pelé,1000,30,2016.0,Biography/History,1:47,-35,8.379165804519056
58,60,The Horseman,1000,30,2008.0,Mystery and thriller,1:50,2,8.379165804519056
33,17,Plastic,1000,30,2014.0,Comedy/Action,1:42,-16,8.379165804519056
44,50,Grassroots,1000,30,2012.0,Comedy/Drama,1:40,6,8.379165804519056
69,90,Colma: The Musical,1000,30,2006.0,Comedy/Gay and lesbian,1:53,21,8.379165804519056
83,79,Out in the Dark,1000,29,2012.0,Gay and lesbian/Drama,1:36,-4,8.20349180691225
61,72,The Babysitter,1000,29,2017.0,Horror/Comedy,1:25,11,8.20349180691225
75,97,In the Family,1000,29,2011.0,Drama,2:49,22,8.20349180691225
17,10,Creature,1000,29,2011.0,Horror,1:35,-7,8.20349180691225
54,79,Amer,1000,29,2009.0,Horror/Mystery and thriller,1:30,25,8.20349180691225
68,62,Beautiful Losers,1000,29,2008.0,Music/Documentary,1:30,-6,8.20349180691225
66,48,Nativity!,1000,29,2009.0,Other/Comedy,1:45,-18,8.20349180691225
71,97,Seasons,1000,29,2015.0,Documentary,1:37,26,8.20349180691225
84,83,The Seven Five,1000,29,2014.0,Documentary/Biography,1:42,-1,8.20349180691225
53,79,Get Santa,1000,29,2014.0,Kids and family/Comedy,1:42,26,8.20349180691225
68,38,Hollywood Dreams,1000,29,2006.0,Comedy/Drama,1:41,-30,8.20349180691225
73,100,Planet of Snail,1000,29,2011.0,Documentary/Drama,1:27,27,8.20349180691225
63,83,House of Tolerance,1000,29,2011.0,Drama,2:02,20,8.20349180691225
71,83,North Sea Texas,1000,29,2011.0,Gay and lesbian/Drama,1:34,12,8.20349180691225
55,86,In Between Days,1000,29,2006.0,Romance/Drama,1:22,31,8.20349180691225
22,7,Misconduct,1000,28,2016.0,Drama/Mystery and thriller,1:46,-15,8.02553087005176
41,29,Heist,1000,28,2015.0,Mystery and thriller/Action,1:30,-12,8.02553087005176
80,68,The Sunset Limited,1000,28,2011.0,Drama,1:31,-12,8.02553087005176
64,54,Breakfast With Scot,1000,28,2007.0,Drama/Gay and lesbian,1:33,-10,8.02553087005176
49,68,Somebody Up There Likes Me,1000,28,2012.0,Comedy,1:15,19,8.02553087005176
47,43,Postman Pat: The Movie - You Know You're the One,1000,28,2013.0,Adventure/Animation,1:28,-4,8.02553087005176
31,57,The Freebie,1000,28,2010.0,Comedy,1:18,26,8.02553087005176
33,14,Playing It Cool,1000,28,2014.0,Comedy/Drama,1:34,-19,8.02553087005176
54,61,Clear History,1000,28,2013.0,Comedy,1:40,7,8.02553087005176
40,44,Brake,1000,27,2012.0,Mystery and thriller/Action,1:32,4,7.845169885845621
58,85,Downhill Racer,1000,27,1969.0,Drama,1:42,27,7.845169885845621
39,70,My Amityville Horror,1000,27,2012.0,Horror/Documentary,1:29,31,7.845169885845621
72,81,The Country Teacher,1000,27,2008.0,Drama/Gay and lesbian,1:55,9,7.845169885845621
86,89,The Soft Skin,1000,27,1964.0,Romance,1:50,3,7.845169885845621
69,63,Dog Pound,1000,27,2010.0,Drama/Mystery and thriller,1:28,-6,7.845169885845621
44,78,Big Ass Spider!,1000,27,2013.0,Sci fi/Comedy,1:20,34,7.845169885845621
39,33,Sympathy for Delicious,1000,27,2010.0,Drama/Comedy,1:36,-6,7.845169885845621
95,67,Champs,1000,27,2015.0,Documentary/Biography,1:25,-28,7.845169885845621
63,85,Paper Planes,1000,27,2014.0,Kids and family/Adventure,1:36,22,7.845169885845621
51,11,Black Gold,1000,27,2011.0,Drama,2:10,-40,7.845169885845621
67,70,The Keeper of Lost Causes,1000,27,2013.0,Drama/Crime,1:37,3,7.845169885845621
61,78,Band of Robbers,1000,27,2015.0,Comedy,1:35,17,7.845169885845621
83,96,"Jeanne Dielman, 23 Commerce Quay, 1080 Brussels",1000,27,1975.0,Drama,3:21,13,7.845169885845621
39,19,Goats,1000,27,2012.0,Comedy,1:34,-20,7.845169885845621
52,56,White Wedding,1000,27,2009.0,Romance,1:33,4,7.845169885845621
87,100,The Friends of Eddie Coyle,1000,27,1973.0,Drama/Crime,1:40,13,7.845169885845621
93,100,Racing Dreams,1000,27,2009.0,Documentary,1:37,7,7.845169885845621
40,30,Marigold,1000,27,2007.0,Romance/Musical,1:52,-10,7.845169885845621
84,85,Vanaja,1000,27,2006.0,Drama,1:51,1,7.845169885845621
78,92,My Perestroika,1000,26,2010.0,Documentary,1:27,14,7.662285721192069
81,100,Louder Than a Bomb,1000,26,2010.0,Documentary,1:40,19,7.662285721192069
54,54,Brotherhood,1000,26,2010.0,Drama/Crime,1:16,0,7.662285721192069
81,96,Fados,1000,26,2007.0,Musical,1:30,15,7.662285721192069
76,35,Impractical Jokers: The Movie,1000,26,2020.0,Comedy,1:33,-41,7.662285721192069
51,65,Marie Curie,1000,26,2016.0,Drama/Biography,1:40,14,7.662285721192069
73,62,Carrie Pilby,1000,26,2016.0,Comedy/Drama,1:38,-11,7.662285721192069
65,38,The Liberator,1000,26,2013.0,Biography/Drama,1:59,-27,7.662285721192069
66,81,Red White & Blue,1000,26,2010.0,Drama/Mystery and thriller,1:43,15,7.662285721192069
61,73,Collaborator,1000,26,2011.0,Comedy/Drama,1:27,12,7.662285721192069
31,15,Revenge of the Green Dragons,1000,26,2014.0,Drama/Action,1:34,-16,7.662285721192069
55,77,Zero Charisma,1000,26,2013.0,Comedy,1:28,22,7.662285721192069
42,31,Walking on Sunshine,1000,26,2014.0,Romance/Musical,1:37,-11,7.662285721192069
33,19,Innocence,1000,26,2013.0,Horror/Mystery and thriller,1:36,-14,7.662285721192069
33,50,Uncertainty,1000,26,2008.0,Drama,1:44,17,7.662285721192069
39,54,Albatross,1000,26,2011.0,Drama,1:30,15,7.662285721192069
69,27,The World Unseen,1000,26,2007.0,Romance/Gay and lesbian,1:44,-42,7.662285721192069
15,8,Exposed,1000,25,2016.0,Mystery and thriller,1:42,-7,7.476743906106103
69,72,The People vs. George Lucas,1000,25,2010.0,Comedy/Documentary,1:33,3,7.476743906106103
43,84,It Felt Like Love,1000,25,2013.0,Drama,1:22,41,7.476743906106103
61,84,Excision,1000,25,2012.0,Horror,1:21,23,7.476743906106103
27,48,Monogamy,1000,25,2010.0,Drama,1:36,21,7.476743906106103
82,92,Pressure Cooker,1000,25,2008.0,Documentary,1:39,10,7.476743906106103
42,44,Glorious 39,1000,25,2009.0,War/History,2:09,2,7.476743906106103
53,64,How About You,1000,25,2007.0,Comedy/Drama,1:30,11,7.476743906106103
47,32,Extinction,1000,25,2018.0,Sci fi/Mystery and thriller,,-15,7.476743906106103
82,60,Kumaré,1000,25,2011.0,Documentary,1:24,-22,7.476743906106103
37,44,Big Sur,1000,25,2013.0,Drama,1:40,7,7.476743906106103
87,92,The Way We Get By,1000,25,2009.0,Documentary,1:24,5,7.476743906106103
87,92,The Kingdom of Dreams and Madness,1000,25,2013.0,Documentary,1:58,5,7.476743906106103
73,96,Year of the Living Dead,1000,25,2013.0,Documentary,1:16,23,7.476743906106103
39,80,Wake Wood,1000,25,2011.0,Drama/Horror,1:30,41,7.476743906106103
78,88,The Yellow Sea,1000,25,2010.0,Drama/Crime,2:19,10,7.476743906106103
67,72,Exporting Raymond,1000,25,2010.0,Documentary,1:26,5,7.476743906106103
42,25,War of the Buttons,1000,24,2011.0,Adventure/History,1:39,-17,7.288397090280924
29,33,Exists,1000,24,2014.0,Horror,1:26,4,7.288397090280924
74,83,Youssou N'Dour: I Bring What I Love,1000,24,2008.0,Music/Documentary,1:42,9,7.288397090280924
28,46,Killing Gunther,1000,24,2017.0,Action/Comedy,1:32,18,7.288397090280924
46,79,Cult of Chucky,1000,24,2017.0,Horror,1:30,33,7.288397090280924
22,33,Boogie Woogie,1000,24,2009.0,Drama/Comedy,1:30,11,7.288397090280924
30,8,1911,1000,24,2011.0,Drama/War,2:05,-22,7.288397090280924
59,54,Frontera,1000,24,2013.0,Drama,1:43,-5,7.288397090280924
59,96,Archipelago,1000,24,2010.0,Drama,1:54,37,7.288397090280924
40,42,Stitches,1000,24,2012.0,Comedy/Horror,1:26,2,7.288397090280924
72,100,Creep 2,1000,24,2017.0,Horror/Mystery and thriller,1:18,28,7.288397090280924
49,71,The Canal,1000,24,2014.0,Horror/Mystery and thriller,1:32,22,7.288397090280924
64,71,Guest of Cindy Sherman,1000,24,2008.0,Documentary,1:28,7,7.288397090280924
15,4,Beneath the Darkness,1000,24,2011.0,Mystery and thriller,1:37,-11,7.288397090280924
68,17,Twice Born,1000,24,2012.0,Drama,2:07,-51,7.288397090280924
89,92,Daybreak,1000,24,1939.0,Romance/Drama,1:33,3,7.288397090280924
57,75,Kung Fu Jungle,1000,24,2014.0,Mystery and thriller/Action,1:40,18,7.288397090280924
22,4,Outcast,1000,23,2014.0,Drama/Sports and fitness,1:38,-18,7.097083215743026
84,83,The Whale,1000,23,2011.0,Documentary,1:25,-1,7.097083215743026
75,74,Cold Fish,1000,23,2010.0,Drama/Mystery and thriller,2:24,-1,7.097083215743026
58,96,Midnight Son,1000,23,2011.0,Horror,1:28,38,7.097083215743026
70,48,You're Not You,1000,23,2014.0,Drama,1:42,-22,7.097083215743026
42,74,The Banshee Chapter,1000,23,2013.0,Horror/Mystery and thriller,1:27,32,7.097083215743026
21,43,At the Devil's Door,1000,23,2013.0,Horror,1:33,22,7.097083215743026
65,70,The Magic Flute,1000,23,2006.0,Music/Romance,2:15,5,7.097083215743026
39,57,Hatchet III,1000,23,2013.0,Horror,1:21,18,7.097083215743026
46,74,The Dead,1000,23,2010.0,Horror/Mystery and thriller,1:48,28,7.097083215743026
56,74,Starry Eyes,1000,23,2014.0,Horror,1:36,18,7.097083215743026
59,57,Hyena Road,1000,23,2015.0,Drama/War,2:00,-2,7.097083215743026
48,91,Guy and Madeline on a Park Bench,1000,23,2009.0,Musical/Drama,1:22,43,7.097083215743026
67,70,Barrymore,1000,23,2011.0,Drama,1:23,3,7.097083215743026
29,48,Devil's Pass,1000,23,2013.0,Mystery and thriller,1:29,19,7.097083215743026
36,9,Answers to Nothing,1000,23,2011.0,Drama,2:04,-27,7.097083215743026
59,83,Fast Girls,1000,23,2012.0,Drama,1:31,24,7.097083215743026
87,87,Benazir Bhutto,1000,23,2010.0,Documentary,1:55,0,7.097083215743026
41,43,Paris-Manhattan,1000,23,2012.0,Romance,1:17,2,7.097083215743026
28,61,Nurse,1000,23,2014.0,Mystery and thriller,1:24,33,7.097083215743026
65,70,The Giant Mechanical Man,1000,23,2012.0,Romance,1:34,5,7.097083215743026
64,83,Juan of the Dead,1000,23,2011.0,Comedy/Action,1:40,19,7.097083215743026
75,87,Wise Blood,1000,23,1979.0,Drama,1:48,12,7.097083215743026
80,74,A/K/A Tommy Chong,1000,23,2006.0,Documentary,1:18,-6,7.097083215743026
71,87,Magnificent Obsession,1000,23,1954.0,Drama,1:48,16,7.097083215743026
52,91,She Done Him Wrong,1000,23,1933.0,Comedy,1:06,39,7.097083215743026
66,17,Freebie and the Bean,1000,23,1974.0,Action,1:52,-49,7.097083215743026
76,83,Amu,1000,23,2005.0,Drama,1:42,7,7.097083215743026
34,22,Another Gay Sequel: Gays Gone Wild,1000,23,2008.0,Comedy,1:38,-12,7.097083215743026
24,9,Multiple Sarcasms,1000,22,2010.0,Drama,1:37,-15,6.9026233386080005
49,36,Nativity 2: Danger in the Manger!,1000,22,2012.0,Other/Comedy,1:45,-13,6.9026233386080005
15,5,30 Beats,1000,22,2012.0,Romance,1:28,-10,6.9026233386080005
21,32,A Good Marriage,1000,22,2014.0,Mystery and thriller,1:43,11,6.9026233386080005
41,45,"3, 2, 1... Frankie Go Boom",1000,22,2012.0,Comedy,1:29,4,6.9026233386080005
17,5,Nature Calls,1000,22,2012.0,Comedy,1:20,-12,6.9026233386080005
34,68,Rec 4: Apocalypse,1000,22,2014.0,Horror/Mystery and thriller,1:32,34,6.9026233386080005
29,73,Patrick,1000,22,2013.0,Horror,1:35,44,6.9026233386080005
54,36,Big Stone Gap,1000,22,2014.0,Romance,1:36,-18,6.9026233386080005
52,77,The Den,1000,22,2014.0,Horror/Mystery and thriller,1:17,25,6.9026233386080005
55,50,The Winning Season,1000,22,2009.0,Comedy/Drama,1:46,-5,6.9026233386080005
42,59,Little Birds,1000,22,2011.0,Drama,1:36,17,6.9026233386080005
84,18,Old Fashioned,1000,22,2014.0,Romance,1:55,-66,6.9026233386080005
67,86,A Birder's Guide to Everything,1000,22,2013.0,Comedy/Drama,1:28,19,6.9026233386080005
51,23,The Decoy Bride,1000,22,2011.0,Comedy/Drama,1:29,-28,6.9026233386080005
60,82,China Heavyweight,1000,22,2012.0,Documentary,1:34,22,6.9026233386080005
36,50,Shuttle,1000,22,2008.0,Drama/Mystery and thriller,1:46,14,6.9026233386080005
21,0,Transylmania,1000,22,2009.0,Comedy,1:35,-21,6.9026233386080005
36,73,Jug Face,1000,22,2013.0,Horror,1:21,37,6.9026233386080005
75,73,"Lovely, Still",1000,22,2008.0,Drama/Other,1:30,-2,6.9026233386080005
91,95,An Autumn Afternoon,1000,22,1962.0,Drama,1:55,4,6.9026233386080005
60,36,95 Miles to Go,1000,22,2004.0,Comedy/Documentary,1:17,-24,6.9026233386080005
56,86,Orgasm Inc.,1000,22,2009.0,Documentary,1:13,30,6.9026233386080005
62,14,Vibes,1000,22,1988.0,Romance,1:39,-48,6.9026233386080005
67,90,Topkapi,1000,21,1964.0,Mystery and thriller/Comedy,2:00,23,6.704819013328363
20,5,The Color of Time,1000,21,2012.0,Drama/Biography,1:12,-15,6.704819013328363
76,90,The Iran Job,1000,21,2012.0,Documentary,1:30,14,6.704819013328363
48,52,Ashby,1000,21,2015.0,Drama/Comedy,1:42,4,6.704819013328363
15,43,Approaching the Unknown,1000,21,2016.0,Sci fi/Mystery and thriller,1:30,28,6.704819013328363
46,62,The Osiris Child,1000,21,2016.0,Sci fi/Mystery and thriller,1:35,16,6.704819013328363
67,86,The Windmill Movie,1000,21,2008.0,Documentary,1:22,19,6.704819013328363
29,24,Rapture-Palooza,1000,21,2013.0,Comedy/Fantasy,1:24,-5,6.704819013328363
19,24,Marauders,1000,21,2016.0,Drama/Crime,1:47,5,6.704819013328363
52,71,Break Point,1000,21,2014.0,Comedy,1:30,19,6.704819013328363
64,81,Talaash: The Answer Lies Within,1000,21,2012.0,Mystery and thriller,2:19,17,6.704819013328363
62,33,The Brooklyn Brothers Beat the Best,1000,21,2011.0,Comedy,1:37,-29,6.704819013328363
73,100,Multiple Maniacs,1000,21,1970.0,Comedy/Drama,1:30,27,6.704819013328363
77,71,The Misfortunates,1000,21,2009.0,Drama,1:48,-6,6.704819013328363
78,62,Secret of the Wings,1000,21,2012.0,,,-16,6.704819013328363
60,76,Dream Home,1000,21,2010.0,Horror,1:36,16,6.704819013328363
73,76,Crips and Bloods: Made in America,1000,21,2008.0,Documentary,1:45,3,6.704819013328363
82,86,El Norte,1000,21,1983.0,Drama,2:19,4,6.704819013328363
87,95,This Sporting Life,1000,21,1963.0,Drama,2:14,8,6.704819013328363
85,90,Crossing the Line,1000,21,2006.0,Documentary,1:31,5,6.704819013328363
76,75,TinkerBell and the Legend of the NeverBeast,1000,20,2014.0,,,-1,6.503449126242364
88,50,Occupation,1000,20,2018.0,Sci fi/Action,2:00,-38,6.503449126242364
41,80,The Reef,1000,20,2010.0,Horror,1:24,39,6.503449126242364
40,45,Phoenix Forgotten,1000,20,2017.0,Sci fi/Horror,1:27,5,6.503449126242364
21,25,Crazy Eyes,1000,20,2012.0,Comedy,1:35,4,6.503449126242364
68,70,Brothers at War,1000,20,2009.0,Documentary/War,1:52,2,6.503449126242364
57,60,Breaking Upwards,1000,20,2009.0,Romance,1:28,3,6.503449126242364
31,10,Search Party,1000,20,2014.0,Comedy/Action,1:33,-21,6.503449126242364
53,10,God's Not Dead: A Light in Darkness,1000,20,2018.0,Drama,1:46,-43,6.503449126242364
74,85,Make Believe,1000,20,2010.0,Documentary,1:29,11,6.503449126242364
68,60,That's What I Am,1000,20,2011.0,Comedy/Drama,1:41,-8,6.503449126242364
35,25,Miss Meadows,1000,20,2014.0,Comedy,1:28,-10,6.503449126242364
59,60,Humboldt County,1000,20,2008.0,Comedy/Drama,1:36,1,6.503449126242364
24,15,Irvine Welsh's Ecstasy,1000,20,2011.0,Romance/Drama,1:39,-9,6.503449126242364
16,0,Dark Tide,1000,20,2012.0,Drama/Mystery and thriller,1:54,-16,6.503449126242364
94,100,A Brighter Summer Day,1000,20,1991.0,Drama,4:00,6,6.503449126242364
50,35,The Other End of the Line,1000,20,2008.0,Romance,1:46,-15,6.503449126242364
45,50,Otto; or Up With Dead People,1000,20,2008.0,Comedy/Gay and lesbian,1:35,5,6.503449126242364
25,15,Garden Party,1000,20,2008.0,Drama,1:30,-10,6.503449126242364
61,75,Love for Sale,1000,20,2006.0,Drama,1:28,14,6.503449126242364
30,26,The Duel,1000,19,2016.0,Western/Drama,1:56,-4,6.298266028731006
55,79,Summer '04,1000,19,2006.0,Drama,1:37,24,6.298266028731006
18,26,Twixt,1000,19,2011.0,Horror/Mystery and thriller,1:28,8,6.298266028731006
65,79,Twins of Evil,1000,19,1971.0,Horror,1:25,14,6.298266028731006
56,32,Drift,1000,19,2013.0,Drama,1:53,-24,6.298266028731006
49,32,Adventures of Power,1000,19,2008.0,Adventure/Comedy,1:36,-17,6.298266028731006
65,74,The Last Rites of Joe May,1000,19,2011.0,Drama,1:42,9,6.298266028731006
52,47,The Last Ride,1000,19,2012.0,Drama/Biography,1:42,-5,6.298266028731006
52,89,Bedlam,1000,19,1946.0,Horror,1:19,37,6.298266028731006
37,16,The Right Kind of Wrong,1000,19,2013.0,Romance,1:37,-21,6.298266028731006
30,26,The Best and the Brightest,1000,19,2010.0,Comedy,1:33,-4,6.298266028731006
53,68,Chained,1000,19,2012.0,Mystery and thriller,1:34,15,6.298266028731006
25,32,The Victim,1000,19,2011.0,Mystery and thriller,1:23,7,6.298266028731006
24,58,I Am the Pretty Thing That Lives in the House,1000,19,2016.0,Horror,1:27,34,6.298266028731006
55,53,Phase IV,1000,19,1974.0,Sci fi,1:26,-2,6.298266028731006
26,47,A Case of You,1000,19,2013.0,Romance,1:32,21,6.298266028731006
26,16,Tanner Hall,1000,19,2009.0,Drama,1:35,-10,6.298266028731006
55,89,Beyond Hatred,1000,19,2005.0,Documentary,1:30,34,6.298266028731006
18,21,The Black Waters of Echo's Pond,1000,19,2009.0,Horror/Mystery and thriller,1:32,3,6.298266028731006
32,53,Vinyan,1000,19,2008.0,Drama/Horror,1:36,21,6.298266028731006
81,95,A Brief History of Time,1000,19,1992.0,Documentary,1:24,14,6.298266028731006
48,79,Small Town Murder Songs,1000,19,2010.0,Drama/Crime,1:16,31,6.298266028731006
65,89,Darkon,1000,19,2006.0,Documentary/Fantasy,1:33,24,6.298266028731006
81,63,The Island,1000,19,2006.0,Drama,1:52,-18,6.298266028731006
63,16,Nina's Heavenly Delights,1000,19,2006.0,Gay and lesbian/Romance,1:36,-47,6.298266028731006
36,67,The Wedding Video,1000,18,2012.0,Drama/Comedy,1:34,31,6.088990769440213
32,56,Pet,1000,18,2016.0,Mystery and thriller,1:30,24,6.088990769440213
69,61,In Your Eyes,1000,18,2014.0,Drama/Romance,1:46,-8,6.088990769440213
17,17,How It Ends,1000,18,2018.0,Sci fi/Mystery and thriller,1:53,0,6.088990769440213
30,50,YellowBrickRoad,1000,18,2010.0,Horror/Mystery and thriller,1:38,20,6.088990769440213
21,0,The Layover,1000,18,2016.0,Comedy/Romance,1:35,-21,6.088990769440213
29,56,Atrocious,1000,18,2010.0,Horror/Mystery and thriller,1:15,27,6.088990769440213
28,33,The Trouble With Bliss,1000,18,2011.0,Drama/Romance,1:37,5,6.088990769440213
83,72,Bhaag Milkha Bhaag,1000,18,2013.0,Biography/Drama,3:08,-11,6.088990769440213
73,72,Loose Cannons,1000,18,2010.0,Comedy/Romance,1:50,-1,6.088990769440213
45,50,Duck,1000,18,2005.0,Drama,1:38,5,6.088990769440213
82,89,California Dreamin' (Nesfarsit),1000,18,2007.0,Comedy/Drama,2:35,7,6.088990769440213
71,44,Ex Drummer,1000,18,2007.0,Comedy/Drama,1:44,-27,6.088990769440213
44,83,Corpo Celeste,1000,18,2011.0,Drama,1:40,39,6.088990769440213
14,6,Super Capers,1000,18,2009.0,Comedy/Fantasy,1:38,-8,6.088990769440213
34,6,The Tortured,1000,18,2010.0,Mystery and thriller,1:19,-28,6.088990769440213
40,72,American Zombie,1000,18,2007.0,Comedy/Horror,1:30,32,6.088990769440213
55,33,The Guitar,1000,18,2008.0,Romance/Drama,1:35,-22,6.088990769440213
46,22,Flakes,1000,18,2007.0,Comedy,1:24,-24,6.088990769440213
46,18,"Game Over, Man!",1000,17,2018.0,Action/Comedy,1:41,-28,5.875307153057772
89,94,On the Job,1000,17,2013.0,Drama/Crime,2:01,5,5.875307153057772
79,88,Springsteen & I,1000,17,2013.0,Documentary,2:04,9,5.875307153057772
89,100,Love Streams,1000,17,1984.0,Drama,2:16,11,5.875307153057772
48,29,Irene in Time,1000,17,2009.0,Drama/Romance,1:35,-19,5.875307153057772
29,53,Contracted,1000,17,2013.0,Horror/Mystery and thriller,1:24,24,5.875307153057772
62,47,Mr. Pip,1000,17,2012.0,Drama/War,1:55,-15,5.875307153057772
91,100,Burn,1000,17,2012.0,Documentary,1:26,9,5.875307153057772
93,100,Paradise Lost 3: Purgatory,1000,17,2011.0,Documentary,2:01,7,5.875307153057772
77,71,Turtle: The Incredible Journey,1000,17,2009.0,Documentary,1:21,-6,5.875307153057772
24,0,The Anomaly,1000,17,2014.0,Sci fi/Mystery and thriller,1:37,-24,5.875307153057772
67,94,Meet the Fokkens,1000,17,2011.0,Biography/Documentary,1:20,27,5.875307153057772
61,82,Batman Ninja,1000,17,2018.0,Action/Adventure,1:25,21,5.875307153057772
74,76,Chevolution,1000,17,2008.0,Documentary,1:39,2,5.875307153057772
65,53,Cleanskin,1000,17,2012.0,Mystery and thriller,1:48,-12,5.875307153057772
30,76,3 Backyards,1000,17,2010.0,Drama,1:27,46,5.875307153057772
76,82,Like Dandelion Dust,1000,17,2009.0,Drama,1:44,6,5.875307153057772
49,18,Mighty Fine,1000,17,2012.0,Comedy/Drama,1:20,-31,5.875307153057772
71,41,Footprints,1000,17,2009.0,Drama/Mystery and thriller,1:20,-30,5.875307153057772
85,88,Reel Injun,1000,17,2009.0,Documentary,1:26,3,5.875307153057772
17,35,While She Was Out,1000,17,2008.0,Mystery and thriller,1:28,18,5.875307153057772
58,53,Stone of Destiny,1000,17,2008.0,Comedy/Adventure,1:36,-5,5.875307153057772
76,81,Objectified,1000,16,2009.0,Documentary,1:15,5,5.656854249492381
51,38,Compadres,1000,16,2016.0,Action/Comedy,1:42,-13,5.656854249492381
18,13,American Heist,1000,16,2014.0,Drama/Crime,1:30,-5,5.656854249492381
53,50,Chennai Express,1000,16,2013.0,Action/Comedy,2:21,-3,5.656854249492381
79,94,Casting By,1000,16,2012.0,Documentary,1:29,15,5.656854249492381
27,50,Americano,1000,16,2011.0,Drama,1:45,23,5.656854249492381
25,19,The Big Bang,1000,16,2010.0,Mystery and thriller,1:41,-6,5.656854249492381
34,25,Jenny's Wedding,1000,16,2015.0,Gay and lesbian/Romance,1:34,-9,5.656854249492381
77,88,Barking Dogs Never Bite,1000,16,2000.0,Comedy,1:48,11,5.656854249492381
68,81,7 Days,1000,16,2010.0,Drama/Crime,1:45,13,5.656854249492381
75,94,The Rabbi's Cat,1000,16,2011.0,Adventure/Animation,1:40,19,5.656854249492381
80,94,Teddy Bear,1000,16,2012.0,Drama,1:32,14,5.656854249492381
48,38,Make Your Move,1000,16,2013.0,Musical,1:50,-10,5.656854249492381
36,75,Fear and Desire,1000,16,1953.0,War/Drama,1:08,39,5.656854249492381
27,0,Father of Invention,1000,16,2010.0,Comedy,1:34,-27,5.656854249492381
36,63,Ricky,1000,16,2009.0,Comedy/Drama,1:29,27,5.656854249492381
86,63,New World,1000,16,2013.0,Mystery and thriller,2:14,-23,5.656854249492381
64,38,Mia and the Migoo,1000,16,2008.0,Kids and family/Animation,1:32,-26,5.656854249492381
88,100,The Ballad of Narayama,1000,16,1983.0,Drama,2:10,12,5.656854249492381
87,69,Some Mother's Son,1000,16,1996.0,Drama,1:52,-18,5.656854249492381
33,50,Change of Plans,1000,16,2009.0,Comedy/Drama,1:40,17,5.656854249492381
36,7,Fire With Fire,1000,15,2012.0,Drama/Crime,1:37,-29,5.433216825139731
64,93,Page Eight,1000,15,2011.0,Drama,1:40,29,5.433216825139731
65,73,Killers,1000,15,2014.0,Drama/Crime,2:17,8,5.433216825139731
22,40,Tenderness,1000,15,2008.0,Drama/Crime,1:41,18,5.433216825139731
90,100,The Phantom Carriage,1000,15,1921.0,Horror,1:33,10,5.433216825139731
38,47,28 Hotel Rooms,1000,15,2012.0,Drama,1:22,9,5.433216825139731
33,20,Cat Run,1000,15,2011.0,Action/Comedy,1:42,-13,5.433216825139731
95,100,Investigation of a Citizen Above Suspicion,1000,15,1970.0,Drama/Crime,1:55,5,5.433216825139731
44,20,K-11,1000,15,2012.0,Drama/Gay and lesbian,1:28,-24,5.433216825139731
36,47,Barry Munday,1000,15,2010.0,Drama/Comedy,1:38,11,5.433216825139731
9,0,Stranded,1000,15,2013.0,Sci fi/Horror,1:25,-9,5.433216825139731
75,47,The Beautiful Truth,1000,15,2008.0,Documentary,1:32,-28,5.433216825139731
18,0,Kite,1000,15,2014.0,Action/Mystery and thriller,1:30,-18,5.433216825139731
8,13,The Open House,1000,15,2018.0,Mystery and thriller,1:34,5,5.433216825139731
38,0,The Undefeated,1000,15,2011.0,Documentary,1:50,-38,5.433216825139731
61,80,Mothra,1000,15,1961.0,Sci fi,1:41,19,5.433216825139731
75,87,The Hit,1000,15,1984.0,Drama/Crime,1:38,12,5.433216825139731
65,80,Resolution,1000,15,2012.0,Horror/Mystery and thriller,1:33,15,5.433216825139731
86,73,Prayers for Bobby,1000,15,2009.0,Drama,1:30,-13,5.433216825139731
10,27,The Wicker Tree,1000,15,2010.0,Horror/Mystery and thriller,1:36,17,5.433216825139731
68,73,The Age of Stupid,1000,15,2009.0,Documentary/Drama,1:29,5,5.433216825139731
85,80,Shadow Company,1000,15,2006.0,Documentary,1:26,-5,5.433216825139731
49,87,Absentia,1000,15,2011.0,Horror,1:31,38,5.433216825139731
43,53,Triangle,1000,15,2007.0,Action,1:41,10,5.433216825139731
33,0,An Invisible Sign,1000,15,2010.0,Drama,1:36,-33,5.433216825139731
75,50,Where Hope Grows,1000,14,2014.0,Drama,1:36,-25,5.203912939677927
58,14,Cavemen,1000,14,2013.0,Romance,1:27,-44,5.203912939677927
29,79,Enemies Closer,1000,14,2013.0,Mystery and thriller/Action,1:25,50,5.203912939677927
66,7,Fallen,1000,14,2016.0,Drama/Romance,1:27,-59,5.203912939677927
85,93,Lonely Are the Brave,1000,14,1962.0,Western,1:47,8,5.203912939677927
58,0,Persecuted,1000,14,2014.0,Drama/Mystery and thriller,1:31,-58,5.203912939677927
75,71,What's in a Name,1000,14,2012.0,Comedy,1:49,-4,5.203912939677927
85,100,Urbanized,1000,14,2011.0,Documentary,1:22,15,5.203912939677927
53,86,Caterpillar,1000,14,2010.0,War/Drama,1:25,33,5.203912939677927
45,29,Bobby Deerfield,1000,14,1977.0,Romance,2:04,-16,5.203912939677927
89,100,The Gunfighter,1000,14,1950.0,Western,1:24,11,5.203912939677927
70,79,The Trotsky,1000,14,2009.0,Comedy,1:57,9,5.203912939677927
66,57,Gardens of the Night,1000,14,2007.0,Drama,1:50,-9,5.203912939677927
54,36,Firstborn,1000,14,1984.0,Drama,1:43,-18,5.203912939677927
62,86,Dr. Bronner's Magic Soapbox,1000,14,2006.0,Documentary,1:28,24,5.203912939677927
65,57,Intimate Enemies,1000,14,2007.0,War/Drama,1:48,-8,5.203912939677927
79,86,The Naked Prey,1000,14,1966.0,Adventure,1:36,7,5.203912939677927
89,64,Arranged,1000,14,2007.0,Comedy/Romance,1:30,-25,5.203912939677927
85,69,"Fat, Sick & Nearly Dead",1000,13,2010.0,Documentary,1:37,-16,4.968377601139757
19,8,The Lovers,1000,13,2014.0,Adventure/Romance,1:45,-11,4.968377601139757
52,69,14 Blades,1000,13,2010.0,Drama/Mystery and thriller,1:56,17,4.968377601139757
84,38,Vaxxed: From Cover-Up to Catastrophe,1000,13,2016.0,Documentary,1:31,-46,4.968377601139757
52,15,Special Forces,1000,13,2011.0,Adventure/Drama,1:49,-37,4.968377601139757
75,92,The Revisionaries,1000,13,2012.0,Documentary,1:24,17,4.968377601139757
55,46,22 Bullets,1000,13,2010.0,Drama/Crime,1:55,-9,4.968377601139757
53,85,Tracker,1000,13,2010.0,Action/Adventure,1:42,32,4.968377601139757
75,69,Wolf Warrior II,1000,13,2017.0,Action/Adventure,2:01,-6,4.968377601139757
63,54,Salt of This Sea,1000,13,2008.0,Romance/Drama,1:49,-9,4.968377601139757
29,31,Lookin' to Get Out,1000,13,1982.0,Comedy,1:45,2,4.968377601139757
29,31,Galaxy of Terror,1000,13,1981.0,Sci fi,1:20,2,4.968377601139757
36,8,A Dark Truth,1000,13,2012.0,Mystery and thriller,1:46,-28,4.968377601139757
62,46,No Smoking,1000,13,2007.0,Comedy,2:08,-16,4.968377601139757
73,92,White Dog,1000,13,1982.0,Drama/Horror,1:30,19,4.968377601139757
58,31,Black Irish,1000,13,2006.0,Drama,1:34,-27,4.968377601139757
47,92,Little Evil,1000,12,2017.0,Horror/Comedy,1:34,45,4.725940818339814
45,75,Kill Command,1000,12,2016.0,Sci fi/Mystery and thriller,1:39,30,4.725940818339814
71,67,The Thieves,1000,12,2012.0,Drama/Crime,2:16,-4,4.725940818339814
84,50,The Resurrection of Gavin Stone,1000,12,2017.0,Comedy/Drama,1:32,-34,4.725940818339814
78,75,I Am Bruce Lee,1000,12,2012.0,Documentary/Biography,1:30,-3,4.725940818339814
80,50,From a House on Willow Street,1000,12,2016.0,Horror,1:30,-30,4.725940818339814
65,25,Manny,1000,12,2014.0,Documentary,1:28,-40,4.725940818339814
30,17,USS Indianapolis: Men of Courage,1000,12,2016.0,Action/War,2:15,-13,4.725940818339814
34,25,Tortilla Heaven,1000,12,2007.0,Comedy,1:37,-9,4.725940818339814
17,17,The Trouble With Romance,1000,12,2007.0,Comedy/Romance,1:28,0,4.725940818339814
54,17,A Warrior's Heart,1000,12,2011.0,Romance/Drama,1:38,-37,4.725940818339814
27,67,Alexander the Last,1000,12,2009.0,Drama,1:12,40,4.725940818339814
74,92,Red Riding: 1980,1000,12,2009.0,Drama/Crime,1:33,18,4.725940818339814
28,50,Spring Breakdown,1000,12,2009.0,Comedy,1:24,22,4.725940818339814
49,42,Cut Sleeve Boys,1000,12,2006.0,Gay and lesbian/Romance,1:26,-7,4.725940818339814
78,0,Cover,1000,12,2007.0,Gay and lesbian/Drama,1:38,-78,4.725940818339814
22,42,Guy X,1000,12,2005.0,Comedy/Drama,1:38,20,4.725940818339814
76,91,Red Riding: 1983,1000,11,2009.0,Drama/Crime,1:43,15,4.475797488182033
91,91,Winning: The Racing Life of Paul Newman,1000,11,2015.0,Biography/Documentary,1:23,0,4.475797488182033
56,9,Faith of Our Fathers,1000,11,2015.0,Drama,1:36,-47,4.475797488182033
56,18,The Ultimate Life,1000,11,2013.0,Drama,1:44,-38,4.475797488182033
74,64,The Siege of Jadotville,1000,11,2016.0,Drama/Mystery and thriller,1:48,-10,4.475797488182033
37,27,The People I've Slept With,1000,11,2012.0,Comedy,1:29,-10,4.475797488182033
33,55,Thale,1000,11,2012.0,Horror/Fantasy,1:17,22,4.475797488182033
84,27,Supremacy,1000,11,2014.0,Drama/Mystery and thriller,1:46,-57,4.475797488182033
59,9,Just Before I Go,1000,11,2014.0,Comedy/Drama,1:30,-50,4.475797488182033
99,55,Pali Road,1000,11,2015.0,Romance/Drama,1:32,-44,4.475797488182033
8,9,Age of the Dragons,1000,11,2011.0,Adventure/Fantasy,1:31,1,4.475797488182033
32,64,Silent Night,1000,11,2012.0,Horror/Mystery and thriller,1:34,32,4.475797488182033
64,64,You Won't Miss Me,1000,11,2009.0,Comedy/Drama,1:21,0,4.475797488182033
52,45,White on Rice,1000,11,2009.0,Comedy,1:30,-7,4.475797488182033
67,45,Into the White,1000,11,2012.0,Action/Drama,1:40,-22,4.475797488182033
80,64,Noriko's Dinner Table,1000,11,2005.0,Drama/Mystery and thriller,2:33,-16,4.475797488182033
22,55,A Burning Hot Summer,1000,11,2011.0,Drama,1:35,33,4.475797488182033
48,91,The Taking of Deborah Logan,1000,11,2014.0,Mystery and thriller,1:30,43,4.475797488182033
39,82,+1,1000,11,2013.0,,,43,4.475797488182033
50,55,Baarìa,1000,11,2009.0,Comedy/Drama,2:30,5,4.475797488182033
85,100,The Magician,1000,11,1958.0,Comedy/Drama,1:42,15,4.475797488182033
14,18,The Marc Pease Experience,1000,11,2009.0,Comedy/Drama,1:20,4,4.475797488182033
65,64,"Ladies and Gentlemen, the Fabulous Stains",1000,11,1982.0,Musical,1:27,-1,4.475797488182033
90,82,The Fire Within,1000,11,1963.0,Drama,1:48,-8,4.475797488182033
70,70,The Vicious Kind,1000,10,2009.0,Drama/Comedy,1:32,0,4.216965034285822
73,70,Reign of Assassins,1000,10,2010.0,Sports and fitness/Action,2:00,-3,4.216965034285822
53,50,Suck,1000,10,2009.0,Horror/Comedy,1:31,-3,4.216965034285822
47,30,Ready,1000,10,2011.0,Drama/Action,2:25,-17,4.216965034285822
87,80,Love With the Proper Stranger,1000,10,1963.0,Drama/Comedy,1:42,-7,4.216965034285822
65,60,The Wild and Wonderful Whites of West Virginia,1000,10,2009.0,Documentary,1:24,-5,4.216965034285822
76,30,Soaked in Bleach,1000,10,2015.0,Documentary/Drama,1:40,-46,4.216965034285822
82,80,Girl Rising,1000,10,2013.0,Documentary,1:42,-2,4.216965034285822
41,20,Spring Break,1000,10,1983.0,Comedy,1:40,-21,4.216965034285822
62,90,Funeral Kings,1000,10,2012.0,Comedy/Drama,1:25,28,4.216965034285822
51,80,Nate & Margaret,1000,10,2012.0,Comedy/Gay and lesbian,1:19,29,4.216965034285822
58,80,The Sky Crawlers,1000,10,2008.0,Adventure/Anime,2:01,22,4.216965034285822
24,50,Dying Breed,1000,10,2008.0,Horror,1:32,26,4.216965034285822
81,89,Jerusalem,1000,9,2013.0,Documentary,0:42,8,3.9482220388574776
53,44,Buffalo Girls,1000,9,2012.0,Documentary,1:06,-9,3.9482220388574776
39,67,Ek Main Aur Ekk Tu,1000,9,2012.0,Romance,1:50,28,3.9482220388574776
18,11,Tees Maar Khan,1000,9,2010.0,Comedy,2:15,-7,3.9482220388574776
83,89,Stella Dallas,1000,9,1937.0,Drama,1:51,6,3.9482220388574776
20,22,Welcome to the Jungle,1000,9,2013.0,Comedy,1:35,2,3.9482220388574776
0,22,400 Days,1000,9,2015.0,Sci fi/Mystery and thriller,1:31,22,3.9482220388574776
69,78,Justice League Dark,1000,9,2017.0,Sci fi/Action,1:16,9,3.9482220388574776
83,67,Sidewalls,1000,9,2011.0,Drama,1:35,-16,3.9482220388574776
72,67,Guzaarish,1000,9,2010.0,Drama,2:15,-5,3.9482220388574776
36,33,Just Buried,1000,9,2007.0,Comedy/Drama,1:34,-3,3.9482220388574776
30,0,I Spit on Your Grave 2,1000,9,2013.0,Horror,1:40,-30,3.9482220388574776
89,100,Masquerade,1000,9,2012.0,Drama/History,2:11,11,3.9482220388574776
68,78,Busco novio para mi mujer,1000,9,2016.0,Romance,1:32,10,3.9482220388574776
90,78,Murph: The Protector,1000,9,2013.0,Documentary,1:19,-12,3.9482220388574776
31,22,Reasonable Doubt,1000,9,2014.0,Drama/Crime,1:32,-9,3.9482220388574776
12,22,Spiderhole,1000,9,2009.0,Horror,1:22,10,3.9482220388574776
38,22,6 Month Rule,1000,9,2011.0,Romance,1:39,-16,3.9482220388574776
27,67,"Leslie, My Name Is Evil",1000,9,2009.0,Comedy/Drama,1:25,40,3.9482220388574776
56,56,A Complete History of My Sexual Failures,1000,9,2008.0,Comedy/Documentary,1:30,0,3.9482220388574776
33,11,I Am Wrath,1000,9,2016.0,Drama/Action,1:32,-22,3.9482220388574776
34,44,Damnation Alley,1000,9,1977.0,Sci fi,1:31,10,3.9482220388574776
65,22,Raajneeti,1000,9,2010.0,Drama,2:43,-43,3.9482220388574776
18,56,Nightmare Man,1000,9,2006.0,Horror,1:34,38,3.9482220388574776
60,67,Four Flies on Grey Velvet,1000,9,1971.0,Mystery and thriller,1:44,7,3.9482220388574776
27,67,The Backwoods,1000,9,2006.0,Drama/Horror,1:38,40,3.9482220388574776
84,100,Sawdust and Tinsel,1000,9,1953.0,Drama,1:32,16,3.9482220388574776
36,50,Attack on Titan: End of the World,1000,8,2015.0,Adventure/Fantasy,1:30,14,3.668016172818685
67,88,Rocket Singh: Salesman of the Year,1000,8,2009.0,Comedy,2:36,21,3.668016172818685
99,88,The Power of Nightmares,1000,8,2004.0,Documentary,2:37,-11,3.668016172818685
28,25,Staten Island,1000,8,2009.0,Drama/Crime,1:36,-3,3.668016172818685
59,63,Samson and Delilah,1000,8,1949.0,Drama,2:08,4,3.668016172818685
45,63,Track 29,1000,8,1988.0,Comedy,1:26,18,3.668016172818685
36,38,The Theatre Bizarre,1000,8,2011.0,Horror,1:54,2,3.668016172818685
62,88,The Conspiracy,1000,8,2012.0,Mystery and thriller,1:25,26,3.668016172818685
41,13,When Harry Tries to Marry,1000,8,2011.0,Romance,1:33,-28,3.668016172818685
26,38,Eichmann,1000,8,2007.0,Drama/History,1:40,12,3.668016172818685
70,88,The Enforcer,1000,8,1951.0,Drama/Crime,1:27,18,3.668016172818685
30,25,Jack and Jill vs. the World,1000,8,2007.0,Romance,1:29,-5,3.668016172818685
51,100,Last Shift,1000,8,2014.0,Horror/Mystery and thriller,1:30,49,3.668016172818685
68,13,I Want Your Money,1000,8,2010.0,Documentary,1:32,-55,3.668016172818685
45,25,CZ12,1000,8,2012.0,Comedy/Action,1:49,-20,3.668016172818685
56,63,Dil Bole Hadippa!,1000,8,2009.0,Romance,2:28,7,3.668016172818685
11,13,Main Street,1000,8,2010.0,Drama,1:32,2,3.668016172818685
33,13,The Final,1000,8,2010.0,Drama/Horror,,-20,3.668016172818685
80,50,Over the GW,1000,8,2007.0,Drama,1:15,-30,3.668016172818685
71,88,Justice League: Gods and Monsters,1000,8,2015.0,Action/Animation,1:12,17,3.668016172818685
83,88,Islander,1000,8,2006.0,Drama,1:40,5,3.668016172818685
52,88,Thoda Pyaar Thoda Magic,1000,8,2008.0,Comedy/Drama,2:25,36,3.668016172818685
70,38,Amazing Grace and Chuck,1000,8,1987.0,Drama,1:56,-32,3.668016172818685
42,25,Assault on Wall Street,1000,8,2012.0,Action/Mystery and thriller,1:37,-17,3.668016172818685
28,38,Timber Falls,1000,8,2007.0,Horror/Mystery and thriller,1:40,10,3.668016172818685
35,38,Burning Palms,1000,8,2010.0,Comedy/Drama,1:52,3,3.668016172818685
44,25,Botched,1000,8,2007.0,Comedy/Mystery and thriller,1:40,-19,3.668016172818685
35,25,Syrup,1000,8,2013.0,Comedy/Drama,1:30,-10,3.668016172818685
38,38,"Naked Ambition, an R-Rated Look at an X-Rated Industry",1000,8,2009.0,Documentary,1:21,0,3.668016172818685
68,50,Jimmy and Judy,1000,8,2006.0,Romance/Drama,1:40,-18,3.668016172818685
77,71,Blood Into Wine,1000,7,2010.0,Documentary,1:40,-6,3.374320069567275
95,86,A Very Sordid Wedding,1000,7,2017.0,Gay and lesbian/Comedy,1:49,-9,3.374320069567275
92,29,The Red Pill,1000,7,2016.0,Documentary,1:57,-63,3.374320069567275
41,14,Bloody Mama,1000,7,1970.0,Drama/Crime,1:30,-27,3.374320069567275
94,100,Never Sleep Again: The Elm Street Legacy,1000,7,2010.0,,,6,3.374320069567275
24,57,Sharktopus,1000,7,2010.0,Sci fi/Horror,1:29,33,3.374320069567275
78,100,"Nightmares in Red, White and Blue",1000,7,2009.0,Documentary,1:26,22,3.374320069567275
62,57,Boy Wonder,1000,7,2010.0,Drama/Crime,1:33,-5,3.374320069567275
61,86,White Lightning,1000,7,1973.0,Action,1:41,25,3.374320069567275
71,14,Not Cool,1000,7,2014.0,Comedy,1:33,-57,3.374320069567275
96,86,Bill Burr: Paper Tiger,1000,7,2019.0,Comedy/Stand up,1:07,-10,3.374320069567275
18,0,World of the Dead: The Zombie Diaries 2,1000,7,2011.0,Horror,1:28,-18,3.374320069567275
33,0,Lost Boys: The Thirst,1000,7,2010.0,Horror,1:22,-33,3.374320069567275
63,57,Preacher's Kid,1000,7,2009.0,Drama,1:41,-6,3.374320069567275
75,43,Falling for Mala,1000,7,2015.0,Romance,1:46,-32,3.374320069567275
22,29,The Incubus,1000,7,1982.0,Horror,1:32,7,3.374320069567275
66,57,The Half Life of Timofey Berezin,1000,7,2006.0,Drama,1:47,-9,3.374320069567275
32,71,Hansel & Gretel Get Baked,1000,7,2013.0,Comedy/Horror,1:27,39,3.374320069567275
33,57,The Hills Run Red,1000,7,2009.0,Horror/Mystery and thriller,1:21,24,3.374320069567275
44,29,Kaavalan,1000,7,2011.0,Romance,2:40,-15,3.374320069567275
63,57,Justice League: Throne of Atlantis,1000,7,2015.0,Action/Adventure,1:12,-6,3.374320069567275
49,0,For the Love of Money,1000,7,2012.0,Drama/Crime,1:33,-49,3.374320069567275
70,29,50 to 1,1000,7,2014.0,Drama,1:50,-41,3.374320069567275
32,0,Term Life,1000,7,2016.0,Action/Mystery and thriller,1:34,-32,3.374320069567275
64,71,Kid Cannabis,1000,7,2014.0,Comedy/Drama,1:50,7,3.374320069567275
24,14,Stay Cool,1000,7,2009.0,Comedy,1:34,-10,3.374320069567275
62,57,The 5th Quarter,1000,7,2010.0,Drama,1:38,-5,3.374320069567275
49,29,The Last International Playboy,1000,7,2008.0,Comedy/Romance,1:35,-20,3.374320069567275
84,100,Steve Jobs: The Lost Interview,1000,7,2011.0,Documentary,1:10,16,3.374320069567275
58,57,The Beautiful Person,1000,7,2008.0,Drama,1:35,-1,3.374320069567275
30,43,Town Creek,1000,7,2009.0,Horror/Mystery and thriller,1:30,13,3.374320069567275
61,57,The Living End,1000,7,1992.0,Gay and lesbian/Drama,1:32,-4,3.374320069567275
58,17,Swiped,1000,6,2018.0,Comedy,1:33,-41,3.064393493081416
56,50,Sex and the Single Girl,1000,6,1964.0,Comedy,1:54,-6,3.064393493081416
66,83,Rockstar,1000,6,2011.0,Drama/Romance,2:40,17,3.064393493081416
49,50,Student of the Year,1000,6,2012.0,Romance,2:27,1,3.064393493081416
42,50,Circle,1000,6,2015.0,Mystery and thriller/Drama,1:27,8,3.064393493081416
40,17,Three and Out,1000,6,2008.0,Comedy,1:46,-23,3.064393493081416
34,17,Khatta Meetha,1000,6,2010.0,Drama/Comedy,2:37,-17,3.064393493081416
44,0,Gator,1000,6,1976.0,Action,1:55,-44,3.064393493081416
34,67,The Shrine,1000,6,2010.0,Horror,1:25,33,3.064393493081416
88,100,Kahaani,1000,6,2012.0,Mystery and thriller,2:02,12,3.064393493081416
27,33,Freezer,1000,6,2014.0,Action/Mystery and thriller,1:31,6,3.064393493081416
56,67,The Heroes of Telemark,1000,6,1965.0,War/Drama,2:11,11,3.064393493081416
78,33,Celine: Through the Eyes of the World,1000,6,2010.0,Documentary,2:00,-45,3.064393493081416
76,0,Playback,1000,6,2011.0,Horror,1:38,-76,3.064393493081416
33,17,After the Break,1000,6,2010.0,Drama/Romance,1:53,-16,3.064393493081416
42,33,Don't Look Back,1000,6,2009.0,Drama/Mystery and thriller,1:50,-9,3.064393493081416
33,0,Golmaal Returns,1000,6,2008.0,Comedy,2:15,-33,3.064393493081416
44,0,Gottfried Helnwein & the Dreaming Child,1000,6,2011.0,Documentary,1:10,-44,3.064393493081416
70,67,Beer Wars,1000,6,2009.0,Documentary,1:25,-3,3.064393493081416
84,83,All This and Heaven Too,1000,6,1940.0,Drama,2:23,-1,3.064393493081416
69,67,The Belles of St. Trinian's,1000,6,1954.0,Comedy,1:31,-2,3.064393493081416
92,100,Shoeshine,1000,6,1946.0,Drama,1:33,8,3.064393493081416
49,67,Class of 1999,1000,6,1990.0,Sci fi/Action,1:38,18,3.064393493081416
20,67,Hostel Part III,1000,6,2011.0,Horror,1:28,47,3.064393493081416
34,100,Alien Raiders,1000,6,2008.0,Mystery and thriller,1:25,66,3.064393493081416
45,67,Stupidity,1000,6,2003.0,Documentary,1:02,22,3.064393493081416
63,0,Graduation,1000,6,2007.0,Drama/Crime,1:29,-63,3.064393493081416
54,50,Life Is Hot in Cracktown,1000,6,2009.0,Drama,1:39,-4,3.064393493081416
47,0,Remember the Daze,1000,6,2007.0,Comedy/Drama,1:41,-47,3.064393493081416
25,40,Operation: Endgame,1000,5,2010.0,Action/Comedy,1:22,15,2.734363528521053
78,100,Batman vs. Robin,1000,5,2015.0,Adventure/Action,1:19,22,2.734363528521053
70,100,Resident Evil: Damnation,1000,5,2012.0,Sci fi/Action,1:40,30,2.734363528521053
31,40,The Horror of H.P. Lovecraft (LovecraCked! The Movie),1000,5,2006.0,,,9,2.734363528521053
49,80,Karthik Calling Karthik,1000,5,2010.0,Mystery and thriller/Comedy,2:15,31,2.734363528521053
99,100,Mosul,1000,5,2019.0,Documentary,1:26,1,2.734363528521053
64,100,Batman: Bad Blood,1000,5,2016.0,Action/Animation,1:12,36,2.734363528521053
64,60,"Lila, Lila",1000,5,2009.0,Comedy,1:47,-4,2.734363528521053
64,80,Vampire Circus,1000,5,1972.0,Horror,1:27,16,2.734363528521053
57,60,Jackass 3.5,1000,5,2011.0,Comedy,1:25,3,2.734363528521053
76,40,A Question of Faith,1000,5,2017.0,Drama,1:31,-36,2.734363528521053
36,100,Sex Addict,1000,5,2008.0,,,64,2.734363528521053
72,100,The Dark Command,1000,5,1940.0,Western,1:34,28,2.734363528521053
79,100,Phineas and Ferb: The Movie: Across the 2nd Dimension,1000,5,2011.0,Comedy/Adventure,1:30,21,2.734363528521053
55,80,35 & Ticking,1000,5,2011.0,Romance,1:30,25,2.734363528521053
67,80,Mummies: Secrets of the Pharaohs,1000,5,2007.0,Documentary,0:40,13,2.734363528521053
79,80,Mr. Warmth: The Don Rickles Project,1000,5,2007.0,Comedy/Documentary,1:29,1,2.734363528521053
59,80,Sinbad the Sailor,1000,5,1947.0,Adventure,1:57,21,2.734363528521053
65,80,Justice League vs. Teen Titans,1000,5,2016.0,Animation/Action,1:18,15,2.734363528521053
60,60,Dabangg,1000,5,2010.0,Action,2:06,0,2.734363528521053
64,40,Gunless,1000,5,2010.0,Comedy/Western,1:29,-24,2.734363528521053
92,100,Runnin' Down a Dream: Tom Petty and the Heartbreakers,1000,5,2007.0,Documentary,3:58,8,2.734363528521053
34,0,Hell & Back,1000,5,2015.0,,,-34,2.734363528521053
34,60,Megan Is Missing,1000,5,2011.0,Drama,1:26,26,2.734363528521053
60,60,Big Shots,1000,5,1987.0,Adventure,1:28,0,2.734363528521053
65,100,Mischief Night,1000,5,2006.0,Comedy/Drama,1:33,35,2.734363528521053
82,100,Empties,1000,5,2007.0,Comedy/Drama,1:40,18,2.734363528521053
23,40,Age of Heroes,1000,5,2011.0,War/Drama,1:30,17,2.734363528521053
50,60,Love Is the Drug,1000,5,2006.0,Drama,1:36,10,2.734363528521053
75,80,Superman vs. the Elite,1000,5,2012.0,Action/Animation,1:14,5,2.734363528521053
43,60,Sharpay's Fabulous Adventure,1000,5,2011.0,Comedy/Drama,1:29,17,2.734363528521053
53,20,The Good Life,1000,5,2007.0,Drama,1:30,-33,2.734363528521053
34,0,Faces in the Crowd,1000,5,2011.0,Horror/Mystery and thriller,1:42,-34,2.734363528521053
87,60,The Trap,1000,5,2007.0,Drama,1:46,-27,2.734363528521053
48,40,The Haunted World of El Superbeasto,1000,5,2009.0,Comedy/Adventure,1:17,-8,2.734363528521053
38,40,They Wait,1000,5,2007.0,Horror/Mystery and thriller,1:29,2,2.734363528521053
47,40,Veer,1000,5,2010.0,Romance/Drama,2:36,-7,2.734363528521053
69,0,Fetching Cody,1000,5,2005.0,Comedy/Drama,1:27,-69,2.734363528521053
62,60,Will Ferrell: You're Welcome America - A Final Night with George W Bush,1000,5,2009.0,,,-2,2.734363528521053
36,100,Storm Warning,1000,5,2007.0,Horror,1:22,64,2.734363528521053
45,40,Strays,1000,5,1997.0,Drama,1:45,-5,2.734363528521053
34,40,Blue State,1000,5,2007.0,Comedy,1:30,6,2.734363528521053
82,94,Nomadland,500,406,2020.0,Drama,1:48,12,42.690257164532525
88,90,Promising Young Woman,500,386,2020.0,Mystery and thriller/Comedy,1:53,2,41.36347958594597
42,60,Greta,500,276,2018.0,Drama/Mystery and thriller,1:38,18,33.54039526043435
39,59,The Front Runner,500,229,2018.0,Drama/Biography,1:53,20,29.846758835604586
49,92,Relic,500,228,2020.0,Drama/Horror,1:29,43,29.76523250994286
48,99,Never Rarely Sometimes Always,500,226,2020.0,Drama,1:41,51,29.601776444473394
63,40,Irresistible,500,224,2020.0,Comedy,1:41,-23,29.43777702680547
84,92,The Last Black Man in San Francisco,500,206,2019.0,Drama,2:01,8,27.93617951273954
46,91,Gloria Bell,500,205,2018.0,Romance,1:42,45,27.85134436832817
52,29,Antebellum,500,194,2020.0,Mystery and thriller,1:46,-23,26.907669282564235
44,75,The Rental,500,193,2020.0,Horror/Mystery and thriller,1:28,31,26.820898222527152
60,78,Everybody Knows,500,177,2018.0,Drama/Crime,2:13,18,25.40874949100198
36,89,The Souvenir,500,174,2019.0,Drama/Romance,1:59,53,25.13872691364861
67,88,Missing Link,500,171,2019.0,Comedy/Adventure,1:34,21,24.86695274122312
40,41,The Laundromat,500,170,2019.0,Comedy,1:36,1,24.775964830134004
61,68,On Chesil Beach,500,169,2017.0,Drama/Romance,1:50,7,24.684775987507244
38,26,The Woman in the Window,500,168,2021.0,Mystery and thriller,1:40,-12,24.59338457671065
63,84,The Art of Self-Defense,500,165,2019.0,Comedy,1:44,21,24.317978218708763
75,88,Whitney,500,162,2018.0,Music/Documentary,2:00,13,24.0406875503036
56,59,Under the Silver Lake,500,153,2018.0,Mystery and thriller/Comedy,2:19,3,23.197017186759677
71,77,In the Fade,500,150,2017.0,Drama/Crime,1:45,6,22.911685375307673
48,66,Lizzie,500,149,2018.0,Drama/History,1:45,18,22.816100321808104
84,94,Bad Education,500,148,2019.0,Drama/Comedy,1:43,10,22.72027439676837
69,76,Dragged Across Concrete,500,146,2018.0,Drama/Crime,2:39,7,22.52789093302636
35,65,The Little Stranger,500,141,2018.0,Horror/Mystery and thriller,1:51,30,22.042555624480066
32,86,Let the Sunshine In,500,140,2017.0,Romance,1:35,54,21.944718908089367
72,87,Swallow,500,130,2019.0,Mystery and thriller,1:35,15,20.951474621135226
49,73,Final Portrait,500,129,2017.0,Comedy/Drama,1:30,24,20.850600582083427
69,80,22 July,500,128,2018.0,Drama,2:23,11,20.749432874416154
79,52,Five Feet Apart,500,126,2019.0,Drama/Romance,1:56,-27,20.546203756731995
48,39,Mary Shelley,500,126,2017.0,Drama/Biography,2:00,-9,20.546203756731995
30,56,The Beach Bum,500,124,2019.0,Comedy,1:35,26,20.341761273786197
79,99,McQueen,500,124,2018.0,Documentary,1:51,20,20.341761273786197
66,93,"Yes, God, Yes",500,123,2019.0,Comedy,1:18,27,20.23907662547856
37,24,7 Days in Entebbe,500,118,2018.0,Drama/History,1:47,-13,19.720878370380042
33,78,Shadow in the Cloud,500,118,2020.0,War/Horror,1:23,45,19.720878370380042
82,86,What They Had,500,116,2018.0,Drama,1:40,4,19.511301649293156
54,68,Damsel,500,114,2018.0,Western/Comedy,1:53,14,19.300365436139025
54,21,Miss Bala,500,112,2019.0,Mystery and thriller/Action,1:44,-33,19.088036824679065
64,74,The Children Act,500,112,2017.0,Drama,1:45,10,19.088036824679065
56,38,The Leisure Seeker,500,109,2017.0,Drama/Adventure,1:52,-18,18.76685771072333
44,34,Wonder Park,500,108,2019.0,Comedy/Kids and family,1:25,-10,18.659063693305395
70,70,Moxie,500,106,2021.0,Drama/Comedy,1:51,0,18.442346006574258
68,99,Cameraperson,500,106,2016.0,Documentary,1:42,31,18.442346006574258
45,51,Superfly,500,102,2018.0,Mystery and thriller/Drama,1:56,6,18.004253009684938
61,52,The Sun Is Also a Star,500,102,2019.0,Drama/Romance,1:40,-9,18.004253009684938
74,92,We the Animals,500,100,2018.0,Drama/Gay and lesbian,1:34,18,17.78279410038923
70,81,Over the Moon,500,99,2020.0,Comedy/Musical,1:35,11,17.67144228430324
81,97,The Half of It,500,99,2020.0,Gay and lesbian/Romance,1:45,16,17.67144228430324
57,72,The Perfection,500,96,2018.0,Horror/Mystery and thriller,1:30,15,17.334827353454408
83,93,The Outpost,500,96,2020.0,War/Drama,2:03,10,17.334827353454408
38,48,How to Talk to Girls at Parties,500,94,2017.0,Romance/Sci fi,1:42,10,17.108223236119827
59,71,The Commune,500,94,2016.0,Drama,1:52,12,17.108223236119827
44,56,Sparkle,500,94,2012.0,Musical/Drama,1:52,12,17.108223236119827
99,89,Linda Ronstadt: The Sound of My Voice,500,94,2019.0,Music/Documentary,1:35,-10,17.108223236119827
51,74,The Man Who Killed Hitler and Then the Bigfoot,500,94,2018.0,Adventure/Drama,1:38,23,17.108223236119827
54,34,Kin,500,94,2018.0,Sci fi/Action,1:42,-20,17.108223236119827
68,95,Blaze,500,91,2018.0,Music/Drama,2:07,27,16.764896252714394
46,77,Queen and Country,500,91,2014.0,Romance/Drama,1:55,31,16.764896252714394
47,71,The Unknown Girl,500,91,2016.0,Drama/Crime,1:53,24,16.764896252714394
65,68,The Journey,500,90,2016.0,Drama,1:34,3,16.64951428545866
80,96,American Factory,500,90,2019.0,Documentary,1:49,16,16.64951428545866
43,54,Gemma Bovery,500,90,2014.0,Comedy/Drama,1:39,11,16.64951428545866
63,29,Rebel in the Rye,500,89,2017.0,Drama/Biography,1:46,-34,16.533650545237286
77,98,Nothing Like a Dame,500,88,2018.0,Documentary,1:23,21,16.417297572912943
55,70,Finding Your Feet,500,88,2017.0,Comedy/Romance,1:51,15,16.417297572912943
72,100,Host,500,87,2020.0,Horror/Mystery and thriller,0:57,28,16.300447707594707
30,66,Wine Country,500,86,2019.0,Comedy,1:43,36,16.183093078793917
73,36,Poms,500,86,2019.0,Comedy,1:31,-37,16.183093078793917
66,85,The Villainess,500,86,2017.0,Action,2:09,19,16.183093078793917
58,51,Destination Wedding,500,86,2018.0,Romance,1:26,-7,16.183093078793917
97,87,Pavarotti,500,86,2019.0,Documentary/Music,1:54,-10,16.183093078793917
76,79,Jimmy Carter: Man From Plains,500,86,2007.0,Documentary,2:06,3,16.183093078793917
80,90,Mirai,500,84,2018.0,Fantasy/Anime,1:38,10,15.946836950911226
77,77,Crown Heights,500,84,2017.0,Drama/Biography,1:36,0,15.946836950911226
68,90,Mountains May Depart,500,84,2015.0,Drama,2:12,22,15.946836950911226
83,96,I Lost My Body,500,82,2019.0,Drama/Fantasy,1:21,13,15.708461709271033
86,89,Bodied,500,82,2017.0,Comedy,2:01,3,15.708461709271033
74,62,Willy's Wonderland,500,81,2021.0,Horror/Action,1:28,-12,15.588457268119896
36,42,The Prodigy,500,81,2019.0,Horror/Mystery and thriller,1:32,6,15.588457268119896
70,84,Monsters and Men,500,79,2018.0,Drama,1:35,14,15.34676814846713
76,54,The Best of Enemies,500,78,2019.0,Drama/History,2:13,-22,15.225063992104127
41,72,Gemini,500,78,2017.0,Mystery and thriller,1:33,31,15.225063992104127
37,44,Captive State,500,78,2019.0,Sci fi/Mystery and thriller,1:49,7,15.225063992104127
66,53,Bad Samaritan,500,77,2018.0,Mystery and thriller,1:47,-13,15.102773291691431
24,51,Complete Unknown,500,76,2016.0,Drama/Mystery and thriller,1:31,27,14.979885547093689
62,72,Lords of Chaos,500,76,2018.0,Drama/Music,1:52,10,14.979885547093689
57,49,Marrowbone,500,75,2017.0,Horror/Mystery and thriller,1:50,-8,14.856389929209026
50,32,The Catcher Was a Spy,500,75,2018.0,Drama/Biography,1:34,-18,14.856389929209026
52,89,Lambert & Stamp,500,74,2014.0,Documentary,1:57,37,14.732275265126917
39,75,To All the Boys: P.S. I Still Love You,500,73,2020.0,Romance/Comedy,1:41,36,14.607530022406213
33,36,In the Tall Grass,500,73,2019.0,Drama/Horror,1:30,3,14.607530022406213
74,96,Western,500,72,2017.0,Drama,2:00,22,14.482142292408389
55,85,My Entire High School Sinking Into the Sea,500,72,2016.0,Comedy/Adventure,1:12,30,14.482142292408389
82,61,The Doors: When You're Strange,500,71,2009.0,Documentary,1:30,-21,14.356099772615265
45,74,Killing Ground,500,70,2016.0,Horror/Mystery and thriller,1:28,29,14.229389747854103
19,50,Dog Eat Dog,500,70,2016.0,Drama/Crime,1:33,31,14.229389747854103
51,67,The SpongeBob Movie: Sponge on the Run,500,69,2020.0,Comedy/Animation,1:31,16,14.101999070345963
70,84,Tom of Finland,500,69,2017.0,Gay and lesbian/Drama,1:56,14,14.101999070345963
24,41,Strangerland,500,68,2015.0,Drama/Mystery and thriller,1:51,17,13.973914138485368
76,62,Dog Days,500,68,2018.0,Romance,1:53,-14,13.973914138485368
20,37,Beyond the Reach,500,68,2014.0,Action/Mystery and thriller,1:31,17,13.973914138485368
91,97,Pick of the Litter,500,67,2018.0,Documentary,1:21,6,13.8451208742507
36,21,Terminal,500,67,2018.0,Drama/Crime,1:36,-15,13.8451208742507
46,70,The Cured,500,66,2017.0,Drama/Horror,1:35,24,13.715604699135167
41,39,Hell Fest,500,66,2018.0,Mystery and thriller/Horror,1:29,-2,13.715604699135167
80,82,Casino Jack and the United States of Money,500,66,2010.0,Documentary,2:00,2,13.715604699135167
52,70,The Duchess of Langeais,500,66,2007.0,Romance/Drama,2:17,18,13.715604699135167
64,91,The Willoughbys,500,65,2020.0,Kids and family/Comedy,1:32,27,13.58535050847747
24,19,Kidnapping Mr. Heineken,500,64,2015.0,Drama/Crime,1:35,-5,13.454342644059432
25,16,Show Dogs,500,63,2018.0,Kids and family/Comedy,1:32,-9,13.322564864824612
85,92,After Tiller,500,62,2013.0,Drama/Biography,1:28,7,13.190000315557024
65,89,The Incredible Jessica James,500,61,2017.0,Comedy,1:25,24,13.056631493342596
21,34,The Assignment,500,61,2016.0,Mystery and thriller/Action,1:36,13,13.056631493342596
79,98,Court,500,61,2014.0,Drama,1:55,19,13.056631493342596
57,77,Chronic,500,60,2015.0,Drama,1:33,20,12.922440211617326
51,87,Viva Riva!,500,60,2010.0,Drama,1:36,36,12.922440211617326
23,47,The Hurricane Heist,500,59,2018.0,Mystery and thriller/Action,1:43,24,12.78740756158519
62,80,Dark River,500,59,2017.0,Drama/Mystery and thriller,1:29,18,12.78740756158519
68,91,The Dog,500,58,2013.0,Documentary/Gay and lesbian,1:41,23,12.651513870765422
67,95,Citizen Jane: Battle for the City,500,57,2016.0,Documentary,1:32,28,12.514738658402138
86,100,Bright Lights: Starring Carrie Fisher and Debbie Reynolds,500,57,2016.0,Documentary,1:35,14,12.514738658402138
40,68,Nasty Baby,500,56,2015.0,Drama/Gay and lesbian,1:41,28,12.377060587439436
52,85,Crazy Horse,500,55,2011.0,Documentary,2:14,33,12.238457412731087
38,60,Creative Control,500,55,2015.0,Drama/Comedy,1:37,22,12.238457412731087
37,67,Bastards,500,55,2013.0,Drama,1:40,30,12.238457412731087
42,76,Welcome to New York,500,55,2014.0,Drama,2:05,34,12.238457412731087
77,78,Black '47,500,55,2018.0,Drama/History,1:40,1,12.238457412731087
78,91,Raiders!,500,54,2015.0,Documentary,1:35,13,12.098905925115496
51,57,Alone in Berlin,500,54,2016.0,Drama/History,1:43,6,12.098905925115496
25,52,Miss Julie,500,54,2014.0,Drama,2:09,27,12.098905925115496
71,72,Point and Shoot,500,54,2014.0,Documentary,0:55,1,12.098905925115496
53,80,Yella,500,54,2007.0,Romance/Drama,1:29,27,12.098905925115496
83,83,The Captain,500,53,2017.0,War/Drama,1:58,0,11.958381890942793
27,36,Stage Fright,500,53,2014.0,Comedy/Musical,1:30,9,11.958381890942793
43,83,What Keeps You Alive,500,52,2018.0,Horror/Mystery and thriller,1:39,40,11.8168599865911
65,83,Someone Great,500,52,2019.0,Romance,1:32,18,11.8168599865911
51,90,Always Shine,500,51,2016.0,Drama/Mystery and thriller,1:27,39,11.674313727451958
89,98,Call Me Kuchu,500,51,2012.0,Drama/Documentary,1:27,9,11.674313727451958
49,88,Amour fou,500,51,2014.0,Drama/History,1:36,39,11.674313727451958
71,71,Kodachrome,500,51,2017.0,Comedy/Drama,1:40,0,11.674313727451958
56,90,Walking Out,500,50,2017.0,Drama/Adventure,1:35,34,11.530715390799685
70,80,Whitey: United States of America v. James J. Bulger,500,50,2014.0,Documentary,1:47,10,11.530715390799685
56,62,"Yves Saint Laurent 5, Avenue Marceau 75116 Paris",500,50,2002.0,Documentary,1:25,6,11.530715390799685
80,96,Mafioso,500,50,1962.0,Comedy/Drama,1:45,16,11.530715390799685
88,92,"Jim & Andy: The Great Beyond - Featuring a Very Special, Contractually Obligated Mention of Tony Clifton",500,49,2017.0,Documentary,1:34,4,11.3860359318845
35,37,Anon,500,49,2018.0,Sci fi/Mystery and thriller,1:40,2,11.3860359318845
33,8,The Last Face,500,49,2016.0,Drama,2:11,-25,11.3860359318845
43,45,The Better Angels,500,49,2014.0,Biography/Drama,1:35,2,11.3860359318845
50,49,Low Down,500,49,2014.0,Drama,1:58,-1,11.3860359318845
36,48,Mascots,500,48,2016.0,Comedy,1:35,12,11.240244892502977
26,15,Action Point,500,48,2018.0,Comedy,1:25,-11,11.240244892502977
59,85,"Happy, Happy",500,48,2010.0,Drama/Comedy,1:28,26,11.240244892502977
72,79,Bethlehem,500,48,2013.0,Drama/Mystery and thriller,1:39,7,11.240244892502977
57,100,Strong Island,500,48,2017.0,Documentary,1:47,43,11.240244892502977
82,92,"Electric Boogaloo: The Wild, Untold Story of Cannon Films",500,48,2014.0,Documentary,1:46,10,11.240244892502977
35,31,Loving Pablo,500,48,2017.0,Crime/Biography,2:08,-4,11.240244892502977
78,96,The Last of the Unjust,500,48,2013.0,Documentary/Biography,3:38,18,11.240244892502977
70,54,Steep,500,48,2007.0,Documentary,1:30,-16,11.240244892502977
49,60,El Bulli: Cooking in Progress,500,47,2010.0,Documentary,1:48,11,11.093310301199846
40,70,Wildling,500,47,2018.0,Fantasy/Mystery and thriller,1:33,30,11.093310301199846
73,96,The Pool,500,47,2007.0,Drama,1:44,23,11.093310301199846
38,79,The Phenom,500,47,2016.0,Drama,1:30,41,11.093310301199846
42,49,Scatter My Ashes at Bergdorf's,500,47,2013.0,Documentary,1:33,7,11.093310301199846
76,96,Silent Souls,500,47,2010.0,Drama,1:15,20,11.093310301199846
48,54,Hunky Dory,500,46,2011.0,Musical,1:50,6,10.945198564139895
56,78,Mean Dreams,500,46,2016.0,Mystery and thriller,1:45,22,10.945198564139895
48,93,Most Beautiful Island,500,46,2017.0,Drama/Mystery and thriller,1:20,45,10.945198564139895
48,80,"Camille Claudel, 1915",500,46,2013.0,Biography/Drama,1:35,32,10.945198564139895
92,89,Sgt. Stubby: An American Hero,500,46,2018.0,Kids and family/War,1:24,-3,10.945198564139895
51,80,Barry,500,46,2016.0,Biography/Drama,1:44,29,10.945198564139895
90,98,Let the Fire Burn,500,46,2012.0,Drama/Mystery and thriller,1:28,8,10.945198564139895
68,78,Paradise: Love,500,46,2012.0,Drama,2:00,10,10.945198564139895
65,91,Mother of George,500,45,2013.0,Drama,1:47,26,10.795874345554918
45,56,Beloved,500,45,2011.0,Musical/Drama,2:13,11,10.795874345554918
68,27,Jiu Jitsu,500,45,2020.0,Sci fi/Fantasy,1:42,-41,10.795874345554918
83,51,The Miracle Season,500,45,2018.0,Drama,1:39,-32,10.795874345554918
70,89,Yossi,500,45,2012.0,Gay and lesbian/Drama,1:23,19,10.795874345554918
72,64,Don't Stop Believin': Everyman's Journey,500,45,2013.0,Documentary,1:45,-8,10.795874345554918
91,75,Alive Inside,500,44,2014.0,Documentary,1:17,-16,10.645300436514761
55,70,The Artist and the Model,500,44,2013.0,Drama/Comedy,1:44,15,10.645300436514761
31,9,The Forger,500,44,2014.0,Drama/Mystery and thriller,1:35,-22,10.645300436514761
62,59,Heli,500,44,2013.0,Drama,1:45,-3,10.645300436514761
50,25,Anesthesia,500,44,2015.0,Drama,1:29,-25,10.645300436514761
87,89,Paddleton,500,44,2019.0,Comedy/Drama,1:29,2,10.645300436514761
62,84,Rust Creek,500,44,2018.0,Mystery and thriller,1:48,22,10.645300436514761
33,55,Blood,500,44,2012.0,Drama/Crime,1:35,22,10.645300436514761
73,82,Blank City,500,44,2009.0,Documentary,1:39,9,10.645300436514761
25,9,I.T.,500,43,2016.0,Mystery and thriller,1:35,-16,10.493437610589469
35,26,Nobody's Fool,500,43,2018.0,Romance,1:50,-9,10.493437610589469
71,67,A Futile and Stupid Gesture,500,43,2018.0,Biography/Comedy,1:41,-4,10.493437610589469
59,79,Moebius,500,43,2013.0,Drama/Mystery and thriller,1:29,20,10.493437610589469
75,74,Chasing Trane: The John Coltrane Documentary,500,43,2016.0,Documentary/Music,1:39,-1,10.493437610589469
68,100,Sholem Aleichem: Laughing in the Darkness,500,43,2011.0,Documentary,1:33,32,10.493437610589469
74,79,I See You,500,42,2019.0,Mystery and thriller,1:36,5,10.34024446475599
65,76,Outside the Law,500,42,2010.0,Drama/History,2:18,11,10.34024446475599
71,93,Deceptive Practice: The Mysteries and Mentors of Ricky Jay,500,42,2012.0,Documentary,1:28,22,10.34024446475599
62,88,Everyone Else,500,42,2009.0,Drama/Romance,1:59,26,10.34024446475599
69,90,The Unforeseen,500,42,2007.0,Documentary,1:34,21,10.34024446475599
64,79,The Mill and the Cross,500,42,2011.0,Drama/History,1:35,15,10.34024446475599
83,81,The Last Mountain,500,42,2011.0,Documentary,1:35,-2,10.34024446475599
52,67,The Romance of Astrea and Celadon,500,42,2007.0,Romance/Drama,1:49,15,10.34024446475599
72,80,No Place on Earth,500,41,2012.0,Documentary,1:24,8,10.185677243651742
75,95,Being 17,500,41,2016.0,Drama/Gay and lesbian,1:54,20,10.185677243651742
53,73,Paradise: Faith,500,41,2012.0,Drama,1:59,20,10.185677243651742
78,29,The Red Sea Diving Resort,500,41,2018.0,,,-49,10.185677243651742
25,27,The Rocky Horror Picture Show: Let's Do the Time Warp Again,500,41,2016.0,,,2,10.185677243651742
61,88,A Screaming Man,500,41,2010.0,Drama,1:32,27,10.185677243651742
71,63,Jig,500,41,2011.0,Documentary,1:33,-8,10.185677243651742
76,93,Neighboring Sounds,500,41,2012.0,Drama/Mystery and thriller,2:11,17,10.185677243651742
46,46,Like Father,500,41,2018.0,Comedy/Drama,1:43,0,10.185677243651742
60,61,Cinema Verite,500,41,2011.0,Drama,1:30,1,10.185677243651742
23,49,All Is Bright,500,41,2013.0,Comedy/Other,1:47,26,10.185677243651742
82,80,Body of War,500,41,2007.0,Documentary,1:27,-2,10.185677243651742
24,28,Every Thing Will Be Fine,500,40,2015.0,Drama,1:58,4,10.029689644980788
93,65,Jay and Silent Bob Reboot,500,40,2019.0,Comedy,1:35,-28,10.029689644980788
57,43,Hot Summer Nights,500,40,2017.0,Drama/Romance,1:47,-14,10.029689644980788
55,85,Win It All,500,40,2017.0,Comedy,1:30,30,10.029689644980788
32,50,Phil Spector,500,40,2013.0,Biography/Drama,1:33,18,10.029689644980788
28,21,Once Upon a Time in Venice,500,39,2017.0,Action/Comedy,1:34,-7,9.872232603526719
69,56,Please Stand By,500,39,2017.0,Drama/Comedy,1:33,-13,9.872232603526719
49,85,The Vanishing,500,39,2018.0,Mystery and thriller/Action,1:47,36,9.872232603526719
54,79,A Thousand Years of Good Prayers,500,39,2007.0,Drama/Romance,1:23,25,9.872232603526719
65,90,52 Tuesdays,500,39,2013.0,Drama/Gay and lesbian,1:49,25,9.872232603526719
83,97,Being Evel,500,39,2015.0,Documentary/Biography,1:42,14,9.872232603526719
77,92,Tanna,500,39,2015.0,Drama/Adventure,1:44,15,9.872232603526719
29,28,Burying the Ex,500,39,2014.0,Romance/Horror,1:25,-1,9.872232603526719
75,67,Patti Smith: Dream of Life,500,39,2008.0,Documentary/Music,1:49,-8,9.872232603526719
42,42,Moonwalkers,500,38,2015.0,Action/Comedy,1:47,0,9.713254050808038
60,82,An Oversimplification of Her Beauty,500,38,2012.0,Drama/Romance,1:24,22,9.713254050808038
64,84,Letters From Baghdad,500,38,2016.0,Documentary,1:35,20,9.713254050808038
58,58,3 From Hell,500,38,2019.0,Horror,2:02,0,9.713254050808038
51,37,Self-Medicated,500,38,2005.0,Drama,1:48,-14,9.713254050808038
50,68,What Alice Found,500,38,2003.0,Drama,1:36,18,9.713254050808038
74,71,The Ambassador,500,38,2011.0,Documentary,1:33,-3,9.713254050808038
64,87,Korengal,500,38,2014.0,Documentary/Drama,1:30,23,9.713254050808038
76,82,That Evening Sun,500,38,2009.0,Drama,1:49,6,9.713254050808038
75,79,Sangre de Mi Sangre,500,38,2007.0,Drama/Mystery and thriller,1:51,4,9.713254050808038
51,74,Augustine,500,38,2012.0,Drama,1:41,23,9.713254050808038
73,79,Bustin' Down the Door,500,38,2008.0,Documentary,1:35,6,9.713254050808038
76,92,Harvard Beats Yale 29-29,500,38,2008.0,Documentary,1:45,16,9.713254050808038
30,0,True Crimes,500,37,2016.0,Drama/Crime,1:32,-30,9.552698646911638
67,78,Small Town Crime,500,37,2017.0,Drama/Crime,1:31,11,9.552698646911638
69,65,Reaching for the Moon,500,37,2013.0,Romance/Gay and lesbian,1:58,-4,9.552698646911638
15,11,Dying of the Light,500,37,2014.0,Mystery and thriller/Action,1:35,-4,9.552698646911638
55,59,Jackpot,500,37,2011.0,Drama/Crime,1:22,4,9.552698646911638
44,35,Adam Resurrected,500,37,2008.0,War/Drama,1:46,-9,9.552698646911638
77,89,Eastern Boys,500,37,2013.0,Gay and lesbian/Drama,2:08,12,9.552698646911638
54,68,Greedy Lying Bastards,500,37,2012.0,Documentary,1:30,14,9.552698646911638
41,95,The Treasure,500,37,2015.0,Comedy,1:29,54,9.552698646911638
76,83,Mifune: The Last Samurai,500,36,2015.0,Documentary,1:20,7,9.390507480439723
51,19,The Ottoman Lieutenant,500,36,2017.0,Drama/War,1:50,-32,9.390507480439723
87,86,Jean-Michel Basquiat: The Radiant Child,500,36,2010.0,Documentary,1:33,-1,9.390507480439723
67,67,The Notebook,500,36,2013.0,Drama/War,1:50,0,9.390507480439723
29,17,Special Correspondents,500,36,2016.0,Comedy,1:41,-12,9.390507480439723
68,97,The Edge of Democracy,500,36,2019.0,Drama/History,1:53,29,9.390507480439723
67,78,The Clovehitch Killer,500,36,2018.0,Mystery and thriller,1:50,11,9.390507480439723
90,97,Mugabe and the White African,500,36,2009.0,Documentary,1:30,7,9.390507480439723
36,58,Ten Thousand Saints,500,36,2015.0,Comedy/Drama,1:46,22,9.390507480439723
65,64,Goethe!,500,36,2010.0,Drama,1:40,-1,9.390507480439723
72,64,8: The Mormon Proposition,500,36,2010.0,Documentary,1:20,-8,9.390507480439723
93,92,Stranded: I've Come From a Plane That Crashed on the Mountains,500,36,2007.0,Documentary,1:53,-1,9.390507480439723
68,50,Man in the Chair,500,36,2007.0,Comedy/Drama,1:49,-18,9.390507480439723
55,94,Little Sister,500,35,2016.0,Drama/Comedy,1:31,39,9.22661773178138
30,11,Tyler Perry's A Madea Family Funeral,500,35,2019.0,Comedy,1:49,-19,9.22661773178138
58,77,Watermark,500,35,2013.0,Documentary,1:32,19,9.22661773178138
66,91,Lowlife,500,35,2017.0,Drama/Comedy,1:36,25,9.22661773178138
79,83,Aftermath,500,35,2013.0,Mystery and thriller/Comedy,1:24,4,9.22661773178138
27,23,The Adderall Diaries,500,35,2015.0,Drama,1:27,-4,9.22661773178138
78,86,Good Ol' Freda,500,35,2013.0,Documentary,1:26,8,9.22661773178138
79,80,Captain Abu Raed,500,35,2007.0,Drama,1:50,1,9.22661773178138
84,86,Spinning Plates,500,35,2012.0,Documentary,1:35,2,9.22661773178138
66,97,Rapt,500,35,2009.0,Drama,2:05,31,9.22661773178138
77,83,A Hard Day,500,35,2014.0,Action/Mystery and thriller,1:50,6,9.22661773178138
72,94,King Jack,500,35,2015.0,Drama,1:21,22,9.22661773178138
56,60,Look,500,35,2007.0,Drama,1:38,4,9.22661773178138
54,43,Lagerfeld Confidential,500,35,2007.0,Documentary,1:28,-11,9.22661773178138
46,59,Capital,500,34,2012.0,Drama,1:54,13,9.060962294042406
76,100,Rebels of the Neon God,500,34,1993.0,Drama,1:46,24,9.060962294042406
55,88,Stand Clear of the Closing Doors,500,34,2013.0,Drama,1:34,33,9.060962294042406
54,82,Lamb,500,34,2015.0,Drama,1:37,28,9.060962294042406
32,59,Ping Pong Summer,500,34,2014.0,Comedy,1:32,27,9.060962294042406
82,91,Crime After Crime,500,34,2011.0,Crime/Drama,1:35,9,9.060962294042406
66,79,Fighters,500,34,2014.0,Romance,1:38,13,9.060962294042406
65,76,Free Men,500,34,2011.0,War/Drama,1:39,11,9.060962294042406
16,18,Rupture,500,34,2016.0,Sci fi/Mystery and thriller,1:42,2,9.060962294042406
38,50,Choking Man,500,34,2006.0,Drama,1:24,12,9.060962294042406
75,76,Over the Hills and Far Away,500,34,2009.0,Documentary,1:34,1,9.060962294042406
70,88,Easier With Practice,500,34,2009.0,Drama,1:40,18,9.060962294042406
82,88,Get Me Roger Stone,500,33,2017.0,Biography/Documentary,1:40,6,8.893469344897873
83,94,Queen of the Sun: What Are the Bees Telling Us?,500,33,2010.0,Drama/Documentary,1:22,11,8.893469344897873
48,64,I Travel Alone,500,33,2013.0,Drama,1:25,16,8.893469344897873
84,91,Évocateur: The Morton Downey Jr. Movie,500,33,2012.0,Documentary,1:31,7,8.893469344897873
45,27,Traffik,500,33,2018.0,Action/Mystery and thriller,1:36,-18,8.893469344897873
30,45,Raze,500,33,2013.0,Action/Mystery and thriller,1:27,15,8.893469344897873
45,85,Exhibition,500,33,2013.0,Drama,1:44,40,8.893469344897873
85,100,Enemies of the People,500,33,2009.0,Documentary,1:33,15,8.893469344897873
66,79,The Robber,500,33,2010.0,Drama/Biography,1:30,13,8.893469344897873
86,82,Billy the Kid,500,33,2007.0,Documentary,1:25,-4,8.893469344897873
69,94,Under the Sun,500,32,2015.0,Documentary,1:46,25,8.724061861322062
80,97,No No: A Dockumentary,500,32,2014.0,Documentary,1:40,17,8.724061861322062
57,91,The Confirmation,500,32,2016.0,Drama/Comedy,1:41,34,8.724061861322062
95,38,Echo Boomers,500,32,2020.0,Drama/Crime,1:34,-57,8.724061861322062
83,91,The Night Comes for Us,500,32,2018.0,Mystery and thriller/Action,2:01,8,8.724061861322062
61,53,The Sicilian Girl,500,32,2009.0,Drama,1:55,-8,8.724061861322062
89,91,Beauty Is Embarrassing,500,32,2012.0,Comedy/Documentary,1:28,2,8.724061861322062
95,84,Ip Man 4: The Finale,500,32,2019.0,Action/Sports and fitness,1:45,-11,8.724061861322062
80,41,The Professor and the Madman,500,32,2019.0,Drama/Biography,2:05,-39,8.724061861322062
70,100,The Order of Myths,500,32,2008.0,Documentary,1:37,30,8.724061861322062
50,78,The Conquest,500,32,2011.0,Biography,1:50,28,8.724061861322062
77,97,Paul Williams Still Alive,500,32,2011.0,Comedy/Documentary,1:24,20,8.724061861322062
55,47,3,500,32,2010.0,Comedy/Gay and lesbian,1:44,-8,8.724061861322062
22,34,A Teacher,500,32,2013.0,Drama,1:15,12,8.724061861322062
62,81,Days and Clouds,500,32,2007.0,Drama,1:59,19,8.724061861322062
82,100,Henri-George Clouzot's Inferno,500,32,2009.0,Documentary,1:42,18,8.724061861322062
88,81,Under Our Skin,500,32,2008.0,Documentary,1:44,-7,8.724061861322062
66,72,America the Beautiful,500,32,2007.0,Documentary,1:45,6,8.724061861322062
51,78,Daddy Longlegs,500,32,2010.0,,,27,8.724061861322062
85,78,Berlin,500,32,2007.0,Documentary/Music,1:21,-7,8.724061861322062
28,26,Momentum,500,31,2015.0,Mystery and thriller/Action,1:36,-2,8.552657067536824
15,55,Some Girl(s),500,31,2013.0,Drama/Comedy,1:30,40,8.552657067536824
76,100,Anita O'Day: The Life of a Jazz Singer,500,31,2007.0,Music/Documentary,1:33,24,8.552657067536824
89,100,Chasing Coral,500,31,2017.0,Documentary,1:33,11,8.552657067536824
34,32,The Whole Truth,500,31,2016.0,Drama/Crime,1:33,-2,8.552657067536824
67,84,Nobody Else but You,500,31,2011.0,Drama/Crime,1:43,17,8.552657067536824
68,65,Gun Hill Road,500,31,2011.0,Drama,1:28,-3,8.552657067536824
62,68,Shut Up Little Man! An Audio Misadventure,500,31,2011.0,Comedy/Drama,1:25,6,8.552657067536824
69,77,Amira & Sam,500,31,2014.0,Comedy/Romance,1:28,8,8.552657067536824
68,77,Pledge,500,31,2018.0,Horror/Mystery and thriller,1:18,9,8.552657067536824
82,97,7 Boxes,500,31,2012.0,Action/Mystery and thriller,1:40,15,8.552657067536824
79,84,Glass: A Portrait of Philip in Twelve Parts,500,31,2007.0,Documentary/Music,1:55,5,8.552657067536824
77,87,Constantine's Sword,500,31,2007.0,Documentary,1:35,10,8.552657067536824
89,100,Next Goal Wins,500,30,2014.0,Documentary,1:36,11,8.379165804519056
57,77,Aurora,500,30,2010.0,Drama,3:01,20,8.379165804519056
56,57,Crooked House,500,30,2017.0,Mystery and thriller/Drama,1:55,1,8.379165804519056
84,83,Gore Vidal: The United States of Amnesia,500,30,2013.0,Documentary,1:29,-1,8.379165804519056
86,100,Matt Shepard Is a Friend of Mine,500,30,2012.0,Documentary/Biography,1:29,14,8.379165804519056
70,93,This Is Martin Bonner,500,30,2013.0,Drama,1:23,23,8.379165804519056
53,63,Tiger Eyes,500,30,2012.0,Drama,1:32,10,8.379165804519056
55,30,Lullaby,500,30,2014.0,Drama,1:57,-25,8.379165804519056
26,27,The Vault,500,30,2017.0,Horror/Mystery and thriller,1:31,1,8.379165804519056
51,80,Serbis,500,30,2008.0,Drama,1:31,29,8.379165804519056
49,59,Fractured,500,29,2019.0,Mystery and thriller,1:40,10,8.20349180691225
76,76,The Stone Roses: Made of Stone,500,29,2013.0,Documentary,1:37,0,8.20349180691225
81,100,Jazz on a Summer's Day,500,29,1959.0,Music/Documentary,1:25,19,8.20349180691225
15,17,The Titan,500,29,2017.0,Sci fi/Romance,1:37,2,8.20349180691225
61,41,Night Train to Lisbon,500,29,2013.0,Romance/Mystery and thriller,1:51,-20,8.20349180691225
84,86,I Am Heath Ledger,500,29,2017.0,Documentary,1:30,2,8.20349180691225
83,100,La Belle Noiseuse,500,29,1991.0,Drama,3:58,17,8.20349180691225
34,48,Meet Monica Velour,500,29,2010.0,Comedy,1:37,14,8.20349180691225
85,100,Thunder Soul,500,29,2010.0,Documentary,1:28,15,8.20349180691225
24,52,Holidays,500,29,2016.0,Horror,1:44,28,8.20349180691225
50,66,Monster Hunt,500,29,2015.0,Fantasy/Action,1:56,16,8.20349180691225
54,79,The Ballad of Lefty Brown,500,29,2017.0,Western,1:51,25,8.20349180691225
69,76,Unmade Beds,500,29,2009.0,Comedy/Drama,1:32,7,8.20349180691225
71,90,Khodorkovsky,500,29,2011.0,Documentary/Biography,1:51,19,8.20349180691225
91,97,Cameraman: The Life & Work of Jack Cardiff,500,29,2010.0,Documentary,1:26,6,8.20349180691225
67,59,Skills Like This,500,29,2007.0,Comedy,1:26,-8,8.20349180691225
26,62,Cherry Tree Lane,500,29,2010.0,Drama/Crime,1:17,36,8.20349180691225
54,83,Steel City,500,29,2006.0,Drama/Crime,1:36,29,8.20349180691225
55,57,Ghostland,500,28,2018.0,Horror,1:31,2,8.02553087005176
69,79,Telstar,500,28,2008.0,Music/Drama,1:59,10,8.02553087005176
31,68,Roadie,500,28,2011.0,Drama,1:35,37,8.02553087005176
44,71,Chelsea on the Rocks,500,28,2008.0,Documentary,1:28,27,8.02553087005176
50,32,Elsa & Fred,500,28,2014.0,Romance,1:44,-18,8.02553087005176
39,71,Dig Two Graves,500,28,2014.0,Horror/Mystery and thriller,1:25,32,8.02553087005176
42,43,Spike Island,500,28,2012.0,Drama,1:36,1,8.02553087005176
49,71,R100,500,28,2013.0,Comedy/Drama,1:40,22,8.02553087005176
73,93,The Retrieval,500,28,2013.0,Drama/History,1:34,20,8.02553087005176
71,82,Littlerock,500,28,2010.0,Drama,1:23,11,8.02553087005176
70,86,Animals,500,28,2014.0,Drama,1:26,16,8.02553087005176
12,0,Cabin Fever,500,28,2016.0,Horror,1:39,-12,8.02553087005176
65,57,Art & Copy,500,28,2009.0,Documentary,1:28,-8,8.02553087005176
82,96,Herb and Dorothy,500,28,2008.0,Documentary,1:31,14,8.02553087005176
84,85,Shut Up and Play the Hits,500,27,2012.0,Music/Documentary,1:45,1,7.845169885845621
62,93,Munyurangabo,500,27,2007.0,Drama,1:37,31,7.845169885845621
53,67,The Ballad of Genesis and Lady Jaye,500,27,2011.0,Documentary,1:12,14,7.845169885845621
76,89,Gabrielle,500,27,2013.0,Drama/Romance,1:44,13,7.845169885845621
45,59,Bounty Killer,500,27,2013.0,Sci fi/Action,1:33,14,7.845169885845621
73,96,One Lucky Elephant,500,27,2009.0,Documentary,1:24,23,7.845169885845621
55,63,Private Peaceful,500,27,2012.0,War/Drama,1:40,8,7.845169885845621
73,96,These Birds Walk,500,27,2013.0,Drama,1:11,23,7.845169885845621
67,96,Shifty,500,27,2008.0,Mystery and thriller,1:26,29,7.845169885845621
60,41,"Milarepa: Magician, Murderer, Saint",500,27,2006.0,Drama/Biography,1:30,-19,7.845169885845621
62,78,Canvas,500,27,2006.0,Drama,1:41,16,7.845169885845621
71,85,Graceland,500,26,2012.0,Drama/Crime,1:24,14,7.662285721192069
81,81,Holding the Man,500,26,2015.0,Gay and lesbian/Drama,2:07,0,7.662285721192069
14,8,Escape Plan 2: Hades,500,26,2018.0,Mystery and thriller/Action,1:34,-6,7.662285721192069
79,73,Harmontown,500,26,2014.0,Documentary,1:41,-6,7.662285721192069
80,92,Circo,500,26,2010.0,Documentary,1:15,12,7.662285721192069
21,23,Don't Knock Twice,500,26,2016.0,Horror/Mystery and thriller,1:33,2,7.662285721192069
38,65,Proxy,500,26,2013.0,Drama/Horror,2:00,27,7.662285721192069
34,38,Voice From the Stone,500,26,2017.0,Horror/Mystery and thriller,1:34,4,7.662285721192069
82,85,Breathless,500,26,2009.0,Drama/Crime,2:10,3,7.662285721192069
34,27,The Week Of,500,26,2018.0,Comedy,1:56,-7,7.662285721192069
39,73,Road to Nowhere,500,26,2010.0,Romance/Mystery and thriller,2:01,34,7.662285721192069
78,65,Linsanity,500,26,2013.0,Documentary,1:28,-13,7.662285721192069
54,73,Mr. Untouchable,500,26,2007.0,Documentary,1:32,19,7.662285721192069
59,85,Bonsai,500,26,2011.0,Drama,1:35,26,7.662285721192069
80,85,Call Me Lucky,500,26,2015.0,Documentary,1:46,5,7.662285721192069
54,81,Joshy,500,26,2016.0,Comedy/Drama,1:33,27,7.662285721192069
63,92,The Cool School,500,26,2008.0,Documentary,1:26,29,7.662285721192069
87,85,Unconscious,500,26,2006.0,Comedy/Drama,1:48,-2,7.662285721192069
23,38,Don McKay,500,26,2009.0,Mystery and thriller,1:27,15,7.662285721192069
69,80,Alex Strangelove,500,25,2018.0,Gay and lesbian/Comedy,1:39,11,7.476743906106103
46,72,How to Cook Your Life,500,25,2007.0,Documentary,1:40,26,7.476743906106103
69,84,The President,500,25,2014.0,Comedy/Drama,1:58,15,7.476743906106103
38,48,Eli,500,25,2019.0,Horror/Mystery and thriller,1:38,10,7.476743906106103
42,72,The Harvest,500,25,2013.0,Mystery and thriller,1:44,30,7.476743906106103
63,60,Wasteland,500,25,2012.0,Drama/Crime,1:49,-3,7.476743906106103
18,32,We'll Never Have Paris,500,25,2014.0,Romance,1:35,14,7.476743906106103
84,96,Dealt,500,25,2017.0,Documentary,1:25,12,7.476743906106103
64,72,Addiction Incorporated,500,25,2011.0,Documentary,1:40,8,7.476743906106103
82,88,Eames: The Architect & the Painter,500,25,2011.0,Biography/Documentary,1:23,6,7.476743906106103
67,96,The Russian Woodpecker,500,25,2015.0,War/Documentary,1:21,29,7.476743906106103
57,92,Slash,500,25,2016.0,Drama/Comedy,1:40,35,7.476743906106103
86,80,M.F.A.,500,25,2017.0,Mystery and thriller,1:35,-6,7.476743906106103
42,56,Decoding Annie Parker,500,25,2013.0,Drama,1:31,14,7.476743906106103
66,88,Wheelman,500,25,2017.0,Action/Mystery and thriller,1:22,22,7.476743906106103
59,64,I Am Ali,500,25,2014.0,Documentary/Biography,1:54,5,7.476743906106103
36,76,The Monitor,500,25,2011.0,Mystery and thriller,1:36,40,7.476743906106103
49,64,The Fitzgerald Family Christmas,500,25,2012.0,Comedy/Drama,1:42,15,7.476743906106103
56,88,The Dark,500,25,2018.0,Horror,1:35,32,7.476743906106103
89,100,Passing Strange The Movie,500,25,2009.0,Musical,2:16,11,7.476743906106103
34,36,The Hot Flashes,500,25,2013.0,Comedy,1:39,2,7.476743906106103
84,84,A Wolf at the Door,500,25,2013.0,Drama/Crime,1:40,0,7.476743906106103
90,80,Hipsters,500,25,2011.0,,,-10,7.476743906106103
73,72,American Promise,500,25,2013.0,Documentary,2:20,-1,7.476743906106103
84,83,The King's Choice,500,24,2016.0,Drama/History,2:13,-1,7.288397090280924
54,50,The FP,500,24,2011.0,Comedy,1:22,-4,7.288397090280924
67,88,For Those in Peril,500,24,2013.0,Drama,1:32,21,7.288397090280924
57,46,Until the Light Takes Us,500,24,2008.0,Music/Documentary,1:33,-11,7.288397090280924
39,67,Ibiza,500,24,2018.0,Adventure/Romance,1:34,28,7.288397090280924
29,25,Girls Against Boys,500,24,2012.0,Mystery and thriller,1:33,-4,7.288397090280924
93,100,Night Will Fall,500,24,2014.0,Documentary/War,1:15,7,7.288397090280924
74,88,Whores' Glory,500,24,2011.0,Documentary,1:50,14,7.288397090280924
48,4,Reach Me,500,24,2014.0,Drama,1:35,-44,7.288397090280924
88,88,The Thief,500,24,1997.0,Drama,1:37,0,7.288397090280924
86,83,Heavy Metal in Baghdad,500,24,2007.0,Documentary,1:32,-3,7.288397090280924
28,83,Beyond the Gates,500,23,2016.0,Horror/Mystery and thriller,1:24,55,7.097083215743026
55,70,68 Kill,500,23,2017.0,Crime/Comedy,1:33,15,7.097083215743026
53,78,Summercamp!,500,23,2006.0,Documentary,1:24,25,7.097083215743026
67,91,Miss Stevens,500,23,2016.0,Drama/Comedy,1:25,24,7.097083215743026
79,83,Maidentrip,500,23,2013.0,Documentary,1:22,4,7.097083215743026
70,83,Una noche,500,23,2012.0,Drama,1:30,13,7.097083215743026
39,52,Flowers in the Attic,500,23,2014.0,Drama/Mystery and thriller,1:30,13,7.097083215743026
75,61,This Beautiful Fantastic,500,23,2016.0,Drama/Comedy,1:32,-14,7.097083215743026
58,43,When We First Met,500,23,2018.0,Romance,1:37,-15,7.097083215743026
68,74,"Tuesday, After Christmas",500,23,2010.0,Drama,1:40,6,7.097083215743026
18,4,Hemingway's Garden of Eden,500,23,2008.0,Drama/Romance,1:51,-14,7.097083215743026
11,4,Just Getting Started,500,23,2017.0,Other/Comedy,1:31,-7,7.097083215743026
37,83,The Cleanse,500,23,2016.0,Horror/Comedy,1:21,46,7.097083215743026
80,83,My Dinner With Hervé,500,23,2018.0,Drama/Biography,1:46,3,7.097083215743026
63,43,All Stars,500,23,2013.0,Comedy,1:47,-20,7.097083215743026
31,48,Shut In,500,23,2015.0,Horror/Mystery and thriller,1:30,17,7.097083215743026
34,13,Spark: A Space Tail,500,23,2016.0,Comedy/Animation,1:30,-21,7.097083215743026
87,91,Fire in Babylon,500,23,2010.0,Documentary,1:23,4,7.097083215743026
62,87,Oddball,500,23,2015.0,Kids and family/Adventure,1:36,25,7.097083215743026
72,61,Love the Beast,500,23,2009.0,Documentary,1:32,-11,7.097083215743026
52,35,Manhattan Night,500,23,2016.0,Drama/Crime,1:53,-17,7.097083215743026
38,22,Angels Crest,500,23,2011.0,Drama,1:33,-16,7.097083215743026
92,78,Escape Fire: The Fight to Rescue American Healthcare,500,23,2012.0,Documentary,1:39,-14,7.097083215743026
84,83,The Elephant in the Living Room,500,23,2010.0,Documentary,1:36,-1,7.097083215743026
74,83,Absurdistan,500,23,2008.0,Comedy,1:28,9,7.097083215743026
91,100,Jalsaghar,500,23,1960.0,Drama,1:40,9,7.097083215743026
82,32,Between Worlds,500,22,2018.0,Mystery and thriller,1:30,-50,6.9026233386080005
22,45,Almost Human,500,22,2013.0,Sci fi/Horror,1:20,23,6.9026233386080005
45,59,Expired,500,22,2007.0,Drama/Romance,1:44,14,6.9026233386080005
39,27,Sandy Wexler,500,22,2017.0,Comedy,2:10,-12,6.9026233386080005
63,100,SPL 2: A Time for Consequences,500,22,2015.0,Sports and fitness/Mystery and thriller,2:00,37,6.9026233386080005
66,82,Storm,500,22,2009.0,Drama,1:45,16,6.9026233386080005
51,36,Family Weekend,500,22,2012.0,Comedy,1:36,-15,6.9026233386080005
68,95,Tramps,500,22,2016.0,Romance,1:22,27,6.9026233386080005
23,0,Precious Cargo,500,22,2016.0,Mystery and thriller/Action,1:35,-23,6.9026233386080005
20,9,Kill Switch,500,22,2017.0,Sci fi/Action,1:31,-11,6.9026233386080005
59,27,A-X-L,500,22,2018.0,Sci fi/Adventure,1:40,-32,6.9026233386080005
58,68,Rigor Mortis,500,22,2013.0,Horror/Mystery and thriller,1:41,10,6.9026233386080005
78,77,Jerusalema,500,22,2008.0,Drama/Action,1:58,-1,6.9026233386080005
69,95,I Married a Witch,500,22,1942.0,Fantasy,1:16,26,6.9026233386080005
37,32,Home of Phobia,500,22,2004.0,Comedy/Gay and lesbian,1:32,-5,6.9026233386080005
85,100,Dreams With Sharp Teeth,500,22,2007.0,Documentary,1:36,15,6.9026233386080005
49,55,Yonkers Joe,500,22,2008.0,Drama,1:41,6,6.9026233386080005
60,91,Strange Culture,500,22,2007.0,Documentary,1:15,31,6.9026233386080005
80,95,Steal a Pencil for Me,500,22,2007.0,Romance,1:34,15,6.9026233386080005
35,52,Dark Was the Night,500,21,2014.0,Drama/Horror,1:38,17,6.704819013328363
38,67,Beyond Skyline,500,21,2017.0,Sci fi/Action,1:46,29,6.704819013328363
28,81,Await Further Instructions,500,21,2018.0,Horror/Mystery and thriller,1:31,53,6.704819013328363
23,48,Come Out and Play,500,21,2012.0,Horror,1:26,25,6.704819013328363
44,62,Late Phases,500,21,2014.0,Horror/Mystery and thriller,1:35,18,6.704819013328363
70,86,Storm Surfers,500,21,2012.0,Documentary,1:35,16,6.704819013328363
81,95,A Winter's Tale,500,21,1992.0,Romance,1:53,14,6.704819013328363
24,10,The Family Tree,500,21,2010.0,Drama/Comedy,1:35,-14,6.704819013328363
48,95,The Heart Machine,500,21,2014.0,Drama/Mystery and thriller,1:25,47,6.704819013328363
42,48,Criminal Activities,500,21,2015.0,Drama/Crime,1:34,6,6.704819013328363
76,86,Watchers of the Sky,500,21,2014.0,Documentary,2:00,10,6.704819013328363
22,24,Out of the Dark,500,21,2014.0,Horror/Mystery and thriller,1:32,2,6.704819013328363
27,19,Diablo,500,21,2015.0,Western/Action,1:23,-8,6.704819013328363
37,43,And While We Were Here,500,21,2012.0,Drama/Romance,1:23,6,6.704819013328363
77,90,Punk's Not Dead,500,21,2007.0,Documentary/Music,1:33,13,6.704819013328363
62,0,Hard Kill,500,21,2020.0,Mystery and thriller/Action,1:35,-62,6.704819013328363
14,24,Cabin Fever: Patient Zero,500,21,2014.0,Horror/Mystery and thriller,1:34,10,6.704819013328363
81,86,The 12th Man,500,21,2017.0,Drama/Adventure,2:11,5,6.704819013328363
24,43,Bokeh,500,21,2017.0,Sci fi/Drama,1:32,19,6.704819013328363
34,33,Blind Date,500,21,2008.0,Drama,1:20,-1,6.704819013328363
45,62,Turn the River,500,21,2007.0,Drama,1:32,17,6.704819013328363
31,14,The Tiger's Tail,500,21,2006.0,Drama,1:46,-17,6.704819013328363
25,15,First Kill,500,20,2017.0,Drama/Crime,1:37,-10,6.503449126242364
92,95,Pete Seeger: The Power of Song,500,20,2007.0,Documentary,1:33,3,6.503449126242364
77,10,The Professor,500,20,2018.0,Drama/Comedy,1:30,-67,6.503449126242364
42,25,Rememory,500,20,2017.0,Mystery and thriller/Sci fi,1:51,-17,6.503449126242364
41,40,Black Butterfly,500,20,2017.0,Mystery and thriller,1:33,-1,6.503449126242364
75,95,Calibre,500,20,2018.0,Mystery and thriller,1:41,20,6.503449126242364
62,80,Code 8,500,20,2019.0,Sci fi,1:38,18,6.503449126242364
83,95,East Side Sushi,500,20,2014.0,Drama/Comedy,1:30,12,6.503449126242364
65,80,The Sisterhood of Night,500,20,2014.0,Drama,1:22,15,6.503449126242364
46,65,WolfCop,500,20,2014.0,Horror/Comedy,1:19,19,6.503449126242364
71,80,Never Forever,500,20,2007.0,Drama,1:30,9,6.503449126242364
81,65,Resurrect Dead: The Mystery of the Toynbee Tiles,500,20,2011.0,Documentary,1:26,-16,6.503449126242364
79,90,Fastball,500,20,2015.0,Documentary,1:27,11,6.503449126242364
86,95,Hail the Conquering Hero,500,20,1944.0,Comedy,1:41,9,6.503449126242364
40,65,SiREN,500,20,2016.0,Horror/Mystery and thriller,1:22,25,6.503449126242364
42,60,Digging Up the Marrow,500,20,2014.0,Horror/Mystery and thriller,1:28,18,6.503449126242364
91,90,Adam Sandler: 100% Fresh,500,20,2018.0,,,-1,6.503449126242364
48,60,Wasted on the Young,500,20,2010.0,Drama/Mystery and thriller,1:37,12,6.503449126242364
66,90,My Joy,500,20,2010.0,Drama,2:07,24,6.503449126242364
56,65,Peter and Vandy,500,20,2009.0,Romance,1:18,9,6.503449126242364
51,40,Operation Chromite,500,20,2016.0,War/Drama,1:55,-11,6.503449126242364
61,70,The Land,500,20,2016.0,Drama/Crime,1:41,9,6.503449126242364
69,45,The Road Within,500,20,2014.0,Comedy/Drama,1:41,-24,6.503449126242364
65,75,Zarafa,500,20,2012.0,Animation/Drama,1:18,10,6.503449126242364
38,60,The Veteran,500,20,2011.0,Action/Mystery and thriller,1:38,22,6.503449126242364
65,30,Mandingo,500,20,1975.0,Drama,2:07,-35,6.503449126242364
83,85,A Married Woman,500,20,1965.0,Drama,1:34,2,6.503449126242364
51,85,Nights and Weekends,500,20,2008.0,Drama,1:20,34,6.503449126242364
30,30,Finding Bliss,500,20,2009.0,Comedy,1:38,0,6.503449126242364
71,75,Tales From the Script,500,20,2009.0,Documentary,1:56,4,6.503449126242364
50,58,Extraordinary Tales,500,19,2013.0,Horror/Mystery and thriller,1:10,8,6.298266028731006
48,74,The Lie,500,19,2011.0,Drama/Comedy,1:22,26,6.298266028731006
39,32,The Possession of Michael King,500,19,2014.0,Horror,1:23,-7,6.298266028731006
77,21,My Way,500,19,2011.0,Drama/War,2:22,-56,6.298266028731006
36,58,The Returned,500,19,2013.0,Mystery and thriller/Horror,1:38,22,6.298266028731006
80,79,The American Side,500,19,2014.0,Drama/Mystery and thriller,1:30,-1,6.298266028731006
85,100,The Loving Story,500,19,2011.0,Documentary,1:17,15,6.298266028731006
74,84,Divines,500,19,2016.0,Drama,1:45,10,6.298266028731006
40,32,My Last Five Girlfriends,500,19,2009.0,Romance,1:27,-8,6.298266028731006
64,68,Miami Connection,500,19,1988.0,Drama/Sports and fitness,1:30,4,6.298266028731006
95,37,American Skin,500,19,2019.0,Drama,1:29,-58,6.298266028731006
44,21,Copperhead,500,19,2013.0,Drama/History,1:58,-23,6.298266028731006
57,26,Jamesy Boy,500,19,2014.0,Drama,1:49,-31,6.298266028731006
78,95,Making the Boys,500,19,2009.0,Documentary/Gay and lesbian,1:30,17,6.298266028731006
84,84,Klitschko,500,19,2011.0,Documentary/Biography,1:56,0,6.298266028731006
54,68,Dangerous Liaisons,500,19,2012.0,Romance/Drama,1:45,14,6.298266028731006
20,0,Swinging With the Finkels,500,19,2010.0,Comedy/Romance,1:25,-20,6.298266028731006
82,79,The Innocent,500,19,1976.0,Romance/Drama,2:05,-3,6.298266028731006
67,95,The Unloved,500,19,2009.0,Drama,1:46,28,6.298266028731006
63,84,Lake Tahoe,500,19,2008.0,Drama,1:25,21,6.298266028731006
63,58,Vanishing of the Bees,500,19,2009.0,Documentary,1:27,-5,6.298266028731006
89,100,Shadows of Our Forgotten Ancestors,500,19,1964.0,Drama,1:37,11,6.298266028731006
73,95,The Chinese Girl,500,19,1967.0,Comedy/Drama,1:30,22,6.298266028731006
71,47,The Man of My Life,500,19,2006.0,Drama,1:54,-24,6.298266028731006
80,94,Gregory Crewdson: Brief Encounters,500,18,2012.0,Documentary,1:17,14,6.088990769440213
65,50,"Like Sunday, Like Rain",500,18,2014.0,Drama,1:44,-15,6.088990769440213
22,28,Alien Abduction,500,18,2014.0,Mystery and thriller/Sci fi,1:26,6,6.088990769440213
24,61,Robot Overlords,500,18,2014.0,Sci fi/Action,1:29,37,6.088990769440213
58,50,Outrage: Beyond,500,18,2012.0,Drama/Crime,1:52,-8,6.088990769440213
37,67,The Perfect Date,500,18,2019.0,Romance,1:30,30,6.088990769440213
79,78,The Tiger Hunter,500,18,2016.0,Comedy/Drama,1:34,-1,6.088990769440213
56,72,Beyond a Reasonable Doubt,500,18,1956.0,Mystery and thriller,1:20,16,6.088990769440213
90,100,Justice League Dark: Apokolips War,500,18,2020.0,Action/Adventure,1:30,10,6.088990769440213
44,44,Khumba,500,18,2013.0,Kids and family/Adventure,1:25,0,6.088990769440213
22,28,Bad Johnson,500,18,2014.0,Comedy/Fantasy,1:28,6,6.088990769440213
44,72,Windfall,500,18,2010.0,Documentary/Drama,1:21,28,6.088990769440213
26,44,Jackboots on Whitehall,500,18,2010.0,Comedy/War,,18,6.088990769440213
34,22,Loosies,500,18,2011.0,Comedy/Drama,1:29,-12,6.088990769440213
60,94,Passenger Side,500,18,2009.0,Drama,,34,6.088990769440213
34,44,5 Star Day,500,18,2010.0,Drama,1:37,10,6.088990769440213
58,39,Local Color,500,18,2006.0,Drama,1:39,-19,6.088990769440213
51,61,Newcastle,500,18,2008.0,Drama,1:47,10,6.088990769440213
74,94,The Case of the Grinning Cat,500,18,2004.0,Documentary,0:58,20,6.088990769440213
54,33,Free Style,500,18,2009.0,Drama,1:34,-21,6.088990769440213
22,28,Chatham,500,18,2009.0,Romance,1:37,6,6.088990769440213
62,53,Inch'Allah,500,17,2012.0,Drama,1:40,-9,5.875307153057772
71,47,The Living Wake,500,17,2007.0,Comedy,1:31,-24,5.875307153057772
14,35,A Kind of Murder,500,17,2016.0,Drama/Crime,1:38,21,5.875307153057772
47,59,The End of Love,500,17,2012.0,Drama,1:30,12,5.875307153057772
80,88,Boy Meets Girl,500,17,2014.0,Comedy/Romance,1:35,8,5.875307153057772
28,18,Love's Kitchen,500,17,2011.0,Romance,1:30,-10,5.875307153057772
66,100,You're Sleeping Nicole,500,17,2014.0,Drama,1:33,34,5.875307153057772
44,47,Sand Castle,500,17,2017.0,War/Drama,1:53,3,5.875307153057772
31,29,Don't Hang Up,500,17,2016.0,Horror/Mystery and thriller,1:23,-2,5.875307153057772
28,6,Evidence,500,17,2013.0,Mystery and thriller,1:33,-22,5.875307153057772
62,100,Strongman,500,17,2009.0,Documentary,1:53,38,5.875307153057772
70,82,The First Beautiful Thing,500,17,2010.0,Drama,2:02,12,5.875307153057772
84,94,Knuckleball!,500,17,2012.0,Documentary,1:34,10,5.875307153057772
66,71,The Taking of Tiger Mountain,500,17,2014.0,Action/Adventure,2:21,5,5.875307153057772
71,82,Skeletons,500,17,2010.0,Comedy,1:33,11,5.875307153057772
52,29,Sugarhouse,500,17,2007.0,Drama/Crime,1:30,-23,5.875307153057772
40,53,A Four Letter Word,500,17,2007.0,Comedy/Romance,1:27,13,5.875307153057772
77,88,William S. Burroughs: A Man Within,500,17,2010.0,Documentary,1:27,11,5.875307153057772
34,31,Infini,500,16,2015.0,Sci fi/Mystery and thriller,1:50,-3,5.656854249492381
50,25,Samson,500,16,2018.0,Adventure/Action,1:50,-25,5.656854249492381
46,81,The Borderlands,500,16,2013.0,Horror/Mystery and thriller,1:29,35,5.656854249492381
67,13,Brain on Fire,500,16,2016.0,Drama/Biography,1:35,-54,5.656854249492381
69,75,Fort Bliss,500,16,2014.0,Drama,1:49,6,5.656854249492381
73,81,Audrie & Daisy,500,16,2016.0,Documentary,1:30,8,5.656854249492381
44,56,Standoff,500,16,2016.0,Mystery and thriller,1:25,12,5.656854249492381
37,63,Howl,500,16,2015.0,Horror,1:29,26,5.656854249492381
79,100,Betting on Zero,500,16,2016.0,Documentary,1:39,21,5.656854249492381
31,25,Skin Trade,500,16,2014.0,Drama/Action,1:36,-6,5.656854249492381
54,56,The Viral Factor,500,16,2012.0,Action/Adventure,2:00,2,5.656854249492381
61,94,Gigante,500,16,2009.0,Drama,1:24,33,5.656854249492381
41,31,Harold,500,16,2008.0,Comedy,1:34,-10,5.656854249492381
85,81,Active Measures,500,16,2018.0,Documentary,1:52,-4,5.656854249492381
77,94,Living Is Easy With Eyes Closed,500,16,2013.0,Drama,1:48,17,5.656854249492381
16,6,Freakdog,500,16,2008.0,Horror/Mystery and thriller,1:25,-10,5.656854249492381
52,75,The Waiting City,500,16,2009.0,Drama,1:49,23,5.656854249492381
57,56,GMO OMG,500,16,2013.0,Documentary,1:30,-1,5.656854249492381
92,94,The Story of the Last Chrysanthemums,500,16,1939.0,Drama,2:28,2,5.656854249492381
41,75,American Fable,500,16,2016.0,Drama/Mystery and thriller,1:36,34,5.656854249492381
72,81,White Lightnin',500,16,2009.0,Drama,1:24,9,5.656854249492381
70,75,Six in Paris,500,16,1965.0,Drama,1:35,5,5.656854249492381
73,44,The Butcher's Son,500,16,2009.0,Drama/Action,1:42,-29,5.656854249492381
80,88,War Made Easy,500,16,2007.0,,,8,5.656854249492381
30,60,The Houses October Built,500,15,2014.0,Horror,1:31,30,5.433216825139731
80,100,Dance Academy: The Movie,500,15,2017.0,Drama,1:41,20,5.433216825139731
37,0,Best Night Ever,500,15,2013.0,Comedy,1:22,-37,5.433216825139731
28,53,Viral,500,15,2016.0,Horror/Mystery and thriller,1:29,25,5.433216825139731
22,0,Generation Um...,500,15,2012.0,Drama,1:36,-22,5.433216825139731
80,73,Toys in the Attic,500,15,2009.0,Fantasy/Animation,1:16,-7,5.433216825139731
92,100,The Two of Us,500,15,1968.0,Drama,1:26,8,5.433216825139731
54,60,Terrifier,500,15,2017.0,Other/Horror,1:22,6,5.433216825139731
65,60,Cold Turkey,500,15,1971.0,Comedy,1:39,-5,5.433216825139731
36,13,Justin and the Knights of Valor,500,15,2013.0,Adventure/Animation,1:30,-23,5.433216825139731
46,33,The Waiting,500,15,2016.0,Drama/Mystery and thriller,1:37,-13,5.433216825139731
64,20,Breach,500,15,2020.0,Sci fi/Action,1:29,-44,5.433216825139731
74,93,Champion,500,15,1949.0,Drama/Romance,1:39,19,5.433216825139731
45,40,A Wink and a Smile,500,15,2008.0,Documentary,1:31,-5,5.433216825139731
32,20,Alien Outpost,500,15,2014.0,Sci fi/Action,1:30,-12,5.433216825139731
79,73,Patema Inverted,500,15,2013.0,Adventure/Animation,1:39,-6,5.433216825139731
61,93,Radius,500,15,2017.0,Sci fi/Mystery and thriller,1:27,32,5.433216825139731
32,27,The Canyon,500,15,2009.0,Mystery and thriller,1:42,-5,5.433216825139731
42,7,All's Faire in Love,500,15,2009.0,Romance,1:55,-35,5.433216825139731
33,13,Just Like a Woman,500,15,2012.0,Drama,1:30,-20,5.433216825139731
76,93,Idiots and Angels,500,15,2008.0,Comedy/Drama,1:18,17,5.433216825139731
51,13,If I Were You,500,15,2012.0,Comedy/Drama,1:55,-38,5.433216825139731
67,20,The Adventurer: The Curse of the Midas Box,500,15,2013.0,Action/Adventure,1:38,-47,5.433216825139731
76,87,Ain't in It for My Health: A Film About Levon Helm,500,15,2010.0,Documentary,1:23,11,5.433216825139731
77,93,Abel,500,15,2010.0,Comedy/Drama,1:24,16,5.433216825139731
51,33,Inside Daisy Clover,500,15,1965.0,Drama,2:08,-18,5.433216825139731
58,67,Norman,500,15,2010.0,Comedy/Drama,1:37,9,5.433216825139731
88,73,Saint Misbehavin': The Wavy Gravy Movie,500,15,2009.0,Documentary,1:27,-15,5.433216825139731
57,53,The High Cost of Living,500,15,2010.0,Drama,1:32,-4,5.433216825139731
62,67,On the Ice,500,15,2011.0,Drama/Mystery and thriller,1:36,5,5.433216825139731
84,67,The Secrets,500,15,2007.0,Drama,2:07,-17,5.433216825139731
80,87,Kabei: Our Mother,500,15,2008.0,Drama,2:13,7,5.433216825139731
76,40,Carbon Nation,500,15,2010.0,Documentary,1:22,-36,5.433216825139731
27,57,Phantasm: Ravager,500,14,2016.0,Horror,1:27,30,5.203912939677927
66,43,Life of a King,500,14,2013.0,Drama,1:41,-23,5.203912939677927
55,57,Road to Paloma,500,14,2014.0,Drama,1:31,2,5.203912939677927
76,100,Sometimes a Great Notion,500,14,1970.0,Drama,1:54,24,5.203912939677927
74,43,Highwater,500,14,2008.0,Adventure/Documentary,1:30,-31,5.203912939677927
49,64,General Orders No. 9,500,14,2009.0,Documentary,1:12,15,5.203912939677927
43,64,The Disappeared,500,14,2008.0,Horror,1:37,21,5.203912939677927
28,7,Java Heat,500,14,2013.0,Mystery and thriller/Action,1:44,-21,5.203912939677927
56,79,Heat and Dust,500,14,1983.0,Drama,2:13,23,5.203912939677927
78,100,Kinyarwanda,500,14,2011.0,Drama/Romance,1:40,22,5.203912939677927
50,0,The Perfect Age of Rock 'n' Roll,500,14,2009.0,Drama,1:32,-50,5.203912939677927
33,64,Come and Find Me,500,14,2016.0,Mystery and thriller,1:52,31,5.203912939677927
72,79,Deep Web,500,14,2015.0,Documentary,1:30,7,5.203912939677927
60,79,Children of Invention,500,14,2009.0,Drama,1:26,19,5.203912939677927
63,36,Queen of the Lot,500,14,2010.0,Comedy/Romance,2:00,-27,5.203912939677927
15,7,Authors Anonymous,500,14,2014.0,Comedy,1:35,-8,5.203912939677927
55,93,The Girl in the Book,500,14,2015.0,Drama,1:28,38,5.203912939677927
41,21,The Seasoning House,500,14,2012.0,Horror/Mystery and thriller,1:30,-20,5.203912939677927
87,86,Who Is Harry Nilsson (And Why Is Everybody Talkin' About Him)?,500,14,2010.0,Documentary,1:56,-1,5.203912939677927
20,29,The Dinosaur Project,500,14,2012.0,Sci fi/Adventure,1:23,9,5.203912939677927
25,14,Sharknado: The 4th Awakens,500,14,2016.0,Comedy/Action,1:30,-11,5.203912939677927
18,50,The New Twenty,500,14,2009.0,Gay and lesbian/Drama,1:32,32,5.203912939677927
22,7,Waiting for Dublin,500,14,2007.0,Romance,1:23,-15,5.203912939677927
72,93,The Apprenticeship of Duddy Kravitz,500,14,1974.0,Comedy/Drama,2:01,21,5.203912939677927
51,64,Monster Camp,500,14,2007.0,Documentary/Fantasy,1:21,13,5.203912939677927
66,77,The Boy With the Cuckoo-Clock Heart,500,13,2013.0,Animation/Musical,1:34,11,4.968377601139757
43,69,Ragnarok,500,13,2013.0,Adventure/Action,1:40,26,4.968377601139757
23,31,Final Girl,500,13,2015.0,Action/Mystery and thriller,1:30,8,4.968377601139757
77,100,Horses of God,500,13,2012.0,Drama,1:55,23,4.968377601139757
40,46,"The Butcher, the Chef, and the Swordsman",500,13,2010.0,Sports and fitness/Action,1:35,6,4.968377601139757
86,54,On Any Sunday: The Next Chapter,500,13,2014.0,Adventure/Action,1:34,-32,4.968377601139757
39,69,iBoy,500,13,2017.0,Sci fi/Action,1:31,30,4.968377601139757
44,77,Zero Bridge,500,13,2008.0,Drama,1:36,33,4.968377601139757
78,85,As If I Am Not There,500,13,2009.0,Drama,1:40,7,4.968377601139757
61,31,Inconceivable,500,13,2017.0,Drama/Mystery and thriller,1:45,-30,4.968377601139757
34,69,6 Years,500,13,2015.0,Drama/Romance,1:25,35,4.968377601139757
35,77,Slumlord,500,13,2015.0,Horror/Mystery and thriller,1:27,42,4.968377601139757
50,69,The Princess Switch,500,13,2018.0,Other/Romance,1:41,19,4.968377601139757
87,85,Bridegroom,500,13,2012.0,Documentary/Gay and lesbian,1:19,-2,4.968377601139757
91,77,Bones Brigade: An Autobiography,500,13,2012.0,Documentary,1:51,-14,4.968377601139757
56,69,Forget Me Not,500,13,2010.0,Romance,1:32,13,4.968377601139757
84,92,Kickboxer: Retaliation,500,13,2018.0,Action/Drama,1:50,8,4.968377601139757
33,31,Aroused,500,13,2013.0,Documentary,1:13,-2,4.968377601139757
76,77,Some Came Running,500,13,1958.0,Drama,2:17,1,4.968377601139757
68,46,The Abandoned,500,13,2015.0,Horror/Mystery and thriller,1:28,-22,4.968377601139757
62,69,Black Butterflies,500,13,2011.0,Drama,1:40,7,4.968377601139757
71,77,The Life and Times of Allen Ginsberg,500,13,1993.0,Documentary,1:22,6,4.968377601139757
60,62,A Film With Me in It,500,13,2008.0,Comedy/Mystery and thriller,1:29,2,4.968377601139757
30,23,Lucky,500,13,2011.0,Drama,1:40,-7,4.968377601139757
44,0,Nola,500,13,2003.0,Romance,1:37,-44,4.968377601139757
38,15,Fireball,500,13,2009.0,Action/Sports and fitness,1:37,-23,4.968377601139757
58,85,Houdini,500,13,1953.0,Biography/Drama,1:46,27,4.968377601139757
16,8,Mega Piranha,500,13,2010.0,Sci fi/Horror,1:30,-8,4.968377601139757
28,62,Cthulhu,500,13,2008.0,Gay and lesbian/Horror,1:49,34,4.968377601139757
76,77,La Notte di San Lorenzo (Night of the Shooting Stars) (The Night of San Lorenzo),500,13,1982.0,,,1,4.968377601139757
48,85,The Take,500,13,2007.0,Drama/Crime,1:36,37,4.968377601139757
75,85,Shoot the Moon,500,13,1982.0,Drama,2:05,10,4.968377601139757
53,67,Geography Club,500,12,2013.0,Drama/Gay and lesbian,1:23,14,4.725940818339814
66,75,Batman: Gotham by Gaslight,500,12,2018.0,Adventure/Mystery and thriller,1:18,9,4.725940818339814
16,17,Wild Horses,500,12,2015.0,Mystery and thriller,1:42,1,4.725940818339814
83,75,Bomb City,500,12,2017.0,Drama/Crime,1:35,-8,4.725940818339814
59,75,Free the Mind,500,12,2012.0,Adventure/Documentary,1:20,16,4.725940818339814
24,17,Air,500,12,2015.0,Sci fi/Mystery and thriller,1:35,-7,4.725940818339814
71,92,Some Freaks,500,12,2016.0,Drama/Romance,1:37,21,4.725940818339814
39,25,Perfect Sisters,500,12,2014.0,Mystery and thriller,1:40,-14,4.725940818339814
63,8,The Book of Love,500,12,2016.0,Drama/Comedy,1:44,-55,4.725940818339814
83,92,Imperial Dreams,500,12,2014.0,Drama,1:27,9,4.725940818339814
48,25,Tau,500,12,2018.0,Sci fi/Mystery and thriller,1:37,-23,4.725940818339814
44,83,Let Us Prey,500,12,2014.0,Horror,1:28,39,4.725940818339814
87,100,Marketa Lazarová,500,12,1968.0,Drama,3:00,13,4.725940818339814
64,75,Dear Lemon Lima,500,12,2009.0,Comedy,1:28,11,4.725940818339814
87,75,The Attorney,500,12,2013.0,Drama,2:07,-12,4.725940818339814
75,92,Man Hunt,500,12,1941.0,Mystery and thriller,1:40,17,4.725940818339814
64,58,Time Trap,500,12,2017.0,Sci fi/Adventure,1:27,-6,4.725940818339814
41,75,Errors of the Human Body,500,12,2012.0,Drama/Mystery and thriller,1:41,34,4.725940818339814
68,50,Dirty Laundry,500,12,2006.0,Comedy/Gay and lesbian,1:47,-18,4.725940818339814
23,58,Preservation,500,12,2014.0,Horror/Mystery and thriller,1:30,35,4.725940818339814
28,67,My Worst Nightmare,500,12,2011.0,Romance,1:39,39,4.725940818339814
33,8,The Reunion,500,12,2011.0,Comedy/Action,1:36,-25,4.725940818339814
83,100,Wild River,500,12,1960.0,Drama,1:50,17,4.725940818339814
85,75,These Amazing Shadows,500,12,2011.0,Documentary,1:26,-10,4.725940818339814
49,58,Journey to the West: The Demons Strike Back,500,12,2017.0,Comedy/Action,1:49,9,4.725940818339814
56,75,Square Grouper: The Godfathers of Ganja,500,12,2011.0,Documentary,1:40,19,4.725940818339814
91,100,The Big Parade,500,12,1925.0,War,2:06,9,4.725940818339814
25,25,Army of One,500,12,2016.0,Comedy,1:33,0,4.725940818339814
69,83,The Boy Friend,500,12,1971.0,Comedy/Musical,2:16,14,4.725940818339814
95,75,Workingman's Death,500,12,2005.0,Documentary,2:02,-20,4.725940818339814
14,33,Trapped Ashes,500,12,2006.0,Horror,1:45,19,4.725940818339814
74,42,Noah's Arc: Jumping the Broom,500,12,2008.0,Drama/Romance,1:41,-32,4.725940818339814
58,42,The Human Race,500,12,2012.0,Sci fi/Mystery and thriller,1:30,-16,4.725940818339814
63,58,Plastic Planet,500,12,2009.0,Documentary,1:35,-5,4.725940818339814
26,0,Sarah Landon and the Paranormal Hour,500,12,2007.0,Mystery and thriller,1:21,-26,4.725940818339814
62,83,The Rain People,500,12,1969.0,Drama,1:42,21,4.725940818339814
49,67,Naked Boys Singing,500,12,2007.0,Comedy/Musical,1:35,18,4.725940818339814
68,36,Ghost Team One,500,11,2013.0,Horror/Comedy,1:23,-32,4.475797488182033
65,55,Private Romeo,500,11,2011.0,Drama/Gay and lesbian,1:38,-10,4.475797488182033
80,82,Splinters,500,11,2011.0,Documentary,1:34,2,4.475797488182033
52,73,Slow Learners,500,11,2015.0,Comedy,1:36,21,4.475797488182033
81,18,Distorted,500,11,2018.0,Mystery and thriller,1:27,-63,4.475797488182033
73,100,Boy Meets Girl,500,11,1984.0,Drama,1:40,27,4.475797488182033
94,100,How to Die in Oregon,500,11,2011.0,Documentary,1:47,6,4.475797488182033
48,45,Tai Chi Hero,500,11,2012.0,Adventure/Sports and fitness,1:43,-3,4.475797488182033
50,27,Splinterheads,500,11,2009.0,Comedy,1:34,-23,4.475797488182033
63,91,Daylight,500,11,2010.0,Mystery and thriller,1:15,28,4.475797488182033
42,55,Wrong Cops,500,11,2013.0,Drama/Crime,1:23,13,4.475797488182033
82,91,Toy Story That Time Forgot,500,11,2014.0,,,9,4.475797488182033
53,73,Newlyweds,500,11,2011.0,Drama/Comedy,1:35,20,4.475797488182033
28,64,Dark Touch,500,11,2013.0,Horror,1:32,36,4.475797488182033
24,0,November Criminals,500,11,2017.0,Drama/Crime,1:25,-24,4.475797488182033
62,36,Back to 1942,500,11,2012.0,Drama/History,2:26,-26,4.475797488182033
90,91,The White Stripes Under Great White Northern Lights,500,11,2009.0,Documentary,1:33,1,4.475797488182033
70,64,Awake: The Life of Yogananda,500,11,2014.0,Documentary,1:27,-6,4.475797488182033
90,100,What Lies Upstream,500,11,2017.0,Documentary,1:29,10,4.475797488182033
66,73,Harvest,500,11,2010.0,Drama,1:43,7,4.475797488182033
68,82,Kundo: Age of the Rampant,500,11,2014.0,Action,2:17,14,4.475797488182033
41,45,All In: The Poker Movie,500,11,2012.0,Documentary,1:40,4,4.475797488182033
63,91,My Little Chickadee,500,11,1940.0,Comedy/Western,1:23,28,4.475797488182033
97,100,The Stranger,500,11,1991.0,Drama,2:00,3,4.475797488182033
16,9,Nothing Left to Fear,500,11,2013.0,Horror,1:40,-7,4.475797488182033
38,45,Batman and Harley Quinn,500,11,2017.0,Action/Adventure,1:16,7,4.475797488182033
74,82,The Wild Hunt,500,11,2009.0,Drama/Mystery and thriller,1:36,8,4.475797488182033
16,45,In Their Skin,500,11,2012.0,Horror/Mystery and thriller,1:36,29,4.475797488182033
80,73,The Meerkats,500,11,2008.0,Documentary,1:23,-7,4.475797488182033
39,55,Zenith,500,11,2010.0,Sci fi/Mystery and thriller,1:33,16,4.475797488182033
65,82,Trouble in Mind,500,11,1985.0,Drama/Crime,1:51,17,4.475797488182033
72,55,Spork,500,11,2010.0,Comedy/Musical,1:26,-17,4.475797488182033
48,36,Park,500,11,2006.0,Comedy,1:26,-12,4.475797488182033
76,100,Gate of Hell,500,10,1953.0,Drama/Romance,1:30,24,4.216965034285822
14,40,Under the Bed,500,10,2012.0,Horror,1:28,26,4.216965034285822
90,10,All Relative,500,10,2014.0,Drama/Romance,1:25,-80,4.216965034285822
59,30,The Brothers Karamazov,500,10,1958.0,Drama,2:26,-29,4.216965034285822
35,60,A Horrible Way to Die,500,10,2010.0,Horror/Mystery and thriller,1:25,25,4.216965034285822
66,80,The Battery,500,10,2012.0,Horror,1:41,14,4.216965034285822
53,0,Christmas Eve,500,10,2015.0,Other/Drama,1:36,-53,4.216965034285822
38,30,Date and Switch,500,10,2014.0,Gay and lesbian/Romance,1:31,-8,4.216965034285822
27,0,Reclaim,500,10,2014.0,Mystery and thriller,1:36,-27,4.216965034285822
41,30,Small Apartments,500,10,2012.0,Drama/Crime,1:37,-11,4.216965034285822
96,30,VooDoo,500,10,2017.0,Horror,1:24,-66,4.216965034285822
61,40,Flu,500,10,2013.0,Drama/Mystery and thriller,2:02,-21,4.216965034285822
49,80,Phase 7,500,10,2011.0,Horror/Comedy,1:35,31,4.216965034285822
58,60,Shimmer Lake,500,10,2017.0,Comedy/Drama,1:27,2,4.216965034285822
50,70,Against the Sun,500,10,2014.0,Drama/History,1:40,20,4.216965034285822
56,60,Cold War 2,500,10,2016.0,Drama/Action,1:54,4,4.216965034285822
93,80,Deathstroke: Knights & Dragons,500,10,2020.0,Action/Adventure,1:27,-13,4.216965034285822
43,60,Accidents Happen,500,10,2009.0,Comedy/Drama,1:35,17,4.216965034285822
70,50,A Shine of Rainbows,500,10,2009.0,Kids and family/Drama,1:41,-20,4.216965034285822
59,80,Some Guy Who Kills People,500,10,2011.0,Comedy/Mystery and thriller,1:37,21,4.216965034285822
61,80,Operation Mekong,500,10,2016.0,Action/Adventure,2:04,19,4.216965034285822
78,90,Veteran,500,10,2015.0,Comedy/Drama,2:04,12,4.216965034285822
68,40,The Stray,500,10,2017.0,Drama,1:32,-28,4.216965034285822
77,60,The Sunshine Boy,500,10,2009.0,Documentary,1:42,-17,4.216965034285822
73,90,Fubar 2,500,10,2010.0,Comedy,1:25,17,4.216965034285822
93,100,Second Breath,500,10,1966.0,Drama,2:24,7,4.216965034285822
76,70,Very Young Girls,500,10,2007.0,Documentary,1:23,-6,4.216965034285822
81,60,The Ritz,500,10,1976.0,Comedy/Gay and lesbian,1:31,-21,4.216965034285822
77,89,The Incredible Journey,500,9,1963.0,Adventure/Kids and family,1:20,12,3.9482220388574776
92,0,Hating Breitbart,500,9,2012.0,Documentary,1:25,-92,3.9482220388574776
78,78,Mooz-lum,500,9,2010.0,Drama,1:36,0,3.9482220388574776
85,67,"America, America",500,9,1963.0,Drama,2:48,-18,3.9482220388574776
83,67,The Isle,500,9,2018.0,Horror/Mystery and thriller,1:36,-16,3.9482220388574776
86,100,The Kid Brother,500,9,1927.0,Comedy,1:23,14,3.9482220388574776
44,11,9/11,500,9,2017.0,Drama,1:30,-33,3.9482220388574776
41,78,The End of Time,500,9,2012.0,Documentary,1:49,37,3.9482220388574776
38,67,Ben,500,9,1972.0,Mystery and thriller,1:33,29,3.9482220388574776
79,78,The Parking Lot Movie,500,9,2010.0,Documentary,1:14,-1,3.9482220388574776
79,78,American Satan,500,9,2017.0,Music/Mystery and thriller,1:51,-1,3.9482220388574776
75,89,Rocky Road to Dublin,500,9,1968.0,Documentary,1:10,14,3.9482220388574776
56,56,The Ghouls,500,9,2015.0,Action/Adventure,2:07,0,3.9482220388574776
26,56,Special ID,500,9,2013.0,Drama/Action,1:39,30,3.9482220388574776
86,89,House of Pleasure,500,9,1952.0,Comedy,1:40,3,3.9482220388574776
43,0,The True Memoirs of an International Assassin,500,9,2016.0,Comedy/Action,1:38,-43,3.9482220388574776
84,89,Between Us,500,9,2009.0,Drama,1:20,5,3.9482220388574776
69,11,"After Fall, Winter",500,9,2011.0,Romance/Drama,2:11,-58,3.9482220388574776
33,0,You May Not Kiss the Bride,500,9,2011.0,Action/Romance,1:40,-33,3.9482220388574776
38,22,2:22,500,9,2017.0,Mystery and thriller,1:39,-16,3.9482220388574776
23,0,Brother's Justice,500,9,2010.0,Comedy,1:26,-23,3.9482220388574776
59,89,Siege of the Dead,500,9,2010.0,Horror,0:59,30,3.9482220388574776
26,44,Gori Tere Pyaar Mein,500,9,2013.0,Romance,2:30,18,3.9482220388574776
85,100,The Heart Is a Lonely Hunter,500,9,1968.0,Drama,2:04,15,3.9482220388574776
77,100,Dry Season,500,9,2006.0,Drama,1:36,23,3.9482220388574776
33,44,Adrift in Manhattan,500,9,2007.0,Drama,1:31,11,3.9482220388574776
82,78,Something Like Happiness,500,9,2005.0,Drama,1:46,-4,3.9482220388574776
73,100,Executive Suite,500,9,1954.0,Drama,1:44,27,3.9482220388574776
80,100,The Amazing Catfish,500,8,2013.0,Drama/Comedy,1:29,20,3.668016172818685
63,75,High Strung,500,8,2016.0,Music/Drama,1:37,12,3.668016172818685
72,25,Blood Honey,500,8,2017.0,Mystery and thriller,1:35,-47,3.668016172818685
52,88,Kink,500,8,2013.0,Documentary,1:20,36,3.668016172818685
38,50,The Power of Few,500,8,2013.0,Drama/Crime,1:35,12,3.668016172818685
86,75,Father Never Bothered,500,8,2016.0,Comedy,1:34,-11,3.668016172818685
92,100,Which Way Home,500,8,2009.0,Documentary,1:23,8,3.668016172818685
78,100,Red Dust,500,8,1932.0,Romance,1:23,22,3.668016172818685
68,75,Freedom,500,8,2009.0,Drama,1:51,7,3.668016172818685
73,88,Machete Maidens Unleashed!,500,8,2010.0,Drama/History,1:25,15,3.668016172818685
33,25,Police Story 2013,500,8,2013.0,Drama/Action,1:50,-8,3.668016172818685
90,88,Spirit of the Marathon,500,8,2007.0,Documentary,1:44,-2,3.668016172818685
31,0,Naked,500,8,2017.0,Comedy,1:36,-31,3.668016172818685
43,25,Zambezia,500,8,2012.0,Kids and family/Comedy,1:23,-18,3.668016172818685
71,75,American Grindhouse,500,8,2010.0,Documentary,1:20,4,3.668016172818685
75,88,One on One,500,8,1977.0,Drama,1:38,13,3.668016172818685
4,50,Amy Schumer: The Leather Special,500,8,2017.0,,,46,3.668016172818685
53,63,Sellebrity,500,8,2012.0,Documentary,1:29,10,3.668016172818685
81,100,The Devil and Miss Jones,500,8,1941.0,Comedy,1:32,19,3.668016172818685
50,38,Golmaal 3,500,8,2010.0,Comedy,2:19,-12,3.668016172818685
36,75,Dinosaurs Alive!,500,8,2007.0,Documentary,0:40,39,3.668016172818685
30,50,Transit,500,8,2012.0,Drama/Crime,1:27,20,3.668016172818685
46,25,Dinotasia,500,8,2012.0,Documentary,1:23,-21,3.668016172818685
50,63,Still of the Night,500,8,1982.0,Drama/Crime,1:31,13,3.668016172818685
64,88,The Sterile Cuckoo,500,8,1969.0,Comedy/Drama,1:48,24,3.668016172818685
42,75,Acolytes,500,8,2008.0,Mystery and thriller,1:31,33,3.668016172818685
63,63,Stuck Between Stations,500,8,2011.0,Romance,1:25,0,3.668016172818685
51,63,The Art of Travel,500,8,2008.0,Adventure,1:41,12,3.668016172818685
25,63,The People That Time Forgot,500,8,1977.0,Fantasy,1:30,38,3.668016172818685
45,38,Kiss the Bride,500,8,2007.0,Gay and lesbian/Romance,1:55,-7,3.668016172818685
41,63,London mon amour,500,8,2008.0,Comedy/Romance,1:39,22,3.668016172818685
67,100,Wagon Master,500,8,1950.0,Western,1:26,33,3.668016172818685
76,50,A Song Is Born,500,8,1948.0,Comedy/Musical,1:53,-26,3.668016172818685
85,75,Black Sun,500,8,2005.0,,,-10,3.668016172818685
65,75,King of the Gypsies,500,8,1978.0,Drama,1:52,10,3.668016172818685
77,50,Everything's Cool,500,8,2007.0,Documentary,1:40,-27,3.668016172818685
63,75,The Divorcee,500,8,1930.0,Drama,1:23,12,3.668016172818685
24,57,Detention of the Dead,500,7,2012.0,Horror/Comedy,1:27,33,3.374320069567275
32,43,Animal,500,7,2014.0,Horror,1:26,11,3.374320069567275
71,71,Disney's Descendants 2,500,7,2017.0,Comedy/Adventure,1:51,0,3.374320069567275
58,71,Don't Be Afraid of the Dark,500,7,1973.0,Horror/Mystery and thriller,1:14,13,3.374320069567275
11,0,Leprechaun: Origins,500,7,2014.0,Horror,1:30,-11,3.374320069567275
25,43,Vikingdom,500,7,2012.0,Action/Adventure,1:50,18,3.374320069567275
47,43,Resident Evil: Vendetta,500,7,2017.0,Action/Animation,1:37,-4,3.374320069567275
50,57,Aarakshan,500,7,2011.0,Drama,2:44,7,3.374320069567275
63,86,Supporting Characters,500,7,2012.0,Comedy,1:27,23,3.374320069567275
40,0,Fading of the Cries,500,7,2011.0,Horror/Fantasy,1:29,-40,3.374320069567275
73,57,Kenny Chesney: Summer In 3d,500,7,2010.0,,,-16,3.374320069567275
28,14,Deadly Blessing,500,7,1981.0,Horror,1:42,-14,3.374320069567275
24,14,Patient Zero,500,7,2018.0,Mystery and thriller/Horror,1:26,-10,3.374320069567275
46,43,ARQ,500,7,2016.0,Sci fi,1:28,-3,3.374320069567275
70,43,House of Dark Shadows,500,7,1970.0,Horror,1:38,-27,3.374320069567275
63,43,Susan Slept Here,500,7,1954.0,Comedy,1:38,-20,3.374320069567275
59,57,"Black, White and Blues",500,7,2010.0,Drama,1:31,-2,3.374320069567275
56,57,Noëlle,500,7,2006.0,Romance/Other,1:41,1,3.374320069567275
94,100,The Easy Life,500,7,2011.0,Comedy,1:42,6,3.374320069567275
36,57,The Lost Bladesman,500,7,2011.0,Biography/Action,1:47,21,3.374320069567275
62,14,The Masked Saint,500,7,2016.0,Comedy/Drama,1:51,-48,3.374320069567275
42,43,Falcon Rising,500,7,2014.0,Action/Adventure,1:43,1,3.374320069567275
39,57,Curtains,500,7,1983.0,Horror,1:29,18,3.374320069567275
67,100,The Big Gay Musical,500,7,2009.0,Gay and lesbian/Musical,1:30,33,3.374320069567275
62,86,Dangerous,500,7,1935.0,Drama,1:18,24,3.374320069567275
85,100,The Island,500,7,1960.0,Drama,1:36,15,3.374320069567275
76,71,Bleach,500,7,2018.0,Action/Adventure,1:48,-5,3.374320069567275
52,71,XOXO,500,7,2016.0,Comedy,1:32,19,3.374320069567275
77,100,Sunday in New York,500,7,1963.0,Romance,1:45,23,3.374320069567275
72,86,Ride Lonesome,500,7,1959.0,Western,1:13,14,3.374320069567275
60,100,Teacher of the Year,500,7,2014.0,Comedy,1:20,40,3.374320069567275
81,100,Lili,500,7,1953.0,Romance/Musical,1:21,19,3.374320069567275
90,100,Amal,500,7,2007.0,Drama,1:41,10,3.374320069567275
53,71,My Awkward Sexual Adventure,500,7,2012.0,Comedy,1:39,18,3.374320069567275
61,86,The Fugitive,500,7,1947.0,Drama,1:44,25,3.374320069567275
25,14,As Cool as I Am,500,7,2013.0,Comedy/Drama,1:32,-11,3.374320069567275
71,71,Race to Nowhere,500,7,2010.0,Documentary,1:25,0,3.374320069567275
60,43,From Time to Time,500,7,2009.0,Comedy/Fantasy,1:35,-17,3.374320069567275
52,100,Dinosaurs: Giants of Patagonia,500,7,2007.0,Documentary,0:40,48,3.374320069567275
47,14,Ronaldo,500,7,2015.0,Documentary/Biography,1:32,-33,3.374320069567275
50,100,The Tunnel,500,7,2011.0,Drama/Horror,1:30,50,3.374320069567275
55,14,Solomon and Sheba,500,7,1959.0,Drama/History,2:19,-41,3.374320069567275
71,71,Cannery Row,500,7,1982.0,Drama,2:00,0,3.374320069567275
64,71,Mr. Bug Goes to Town,500,7,1941.0,Kids and family/Comedy,1:17,7,3.374320069567275
61,100,Four Sheets to the Wind,500,7,2007.0,Drama,1:21,39,3.374320069567275
80,67,The Tall Blond Man With One Black Shoe,500,6,1972.0,Mystery and thriller/Comedy,1:30,-13,3.064393493081416
75,83,Genevieve,500,6,1953.0,Comedy,1:26,8,3.064393493081416
40,17,Walt Before Mickey,500,6,2015.0,Drama/Biography,2:00,-23,3.064393493081416
78,83,Ways to Live Forever,500,6,2010.0,Drama,1:30,5,3.064393493081416
75,83,Sparks,500,6,2013.0,Mystery and thriller/Action,1:30,8,3.064393493081416
25,0,The Horror of Party Beach,500,6,1964.0,Horror,1:12,-25,3.064393493081416
43,50,Dum Maaro Dum,500,6,2011.0,Mystery and thriller,,7,3.064393493081416
27,67,Everything Strange and New,500,6,2009.0,Drama,1:24,40,3.064393493081416
45,67,The Beach Party at the Threshold of Hell,500,6,2006.0,Comedy,1:30,22,3.064393493081416
50,100,The Domestics,500,6,2018.0,Mystery and thriller/Action,1:35,50,3.064393493081416
21,0,Joker,500,6,2012.0,Adventure/Fantasy,1:44,-21,3.064393493081416
84,50,Not Today,500,6,2012.0,Drama,1:58,-34,3.064393493081416
56,83,Painted Skin: The Resurrection,500,6,2012.0,Mystery and thriller,2:11,27,3.064393493081416
68,100,Northwest Passage,500,6,1940.0,Adventure,2:06,32,3.064393493081416
90,100,Speedy,500,6,1928.0,Comedy,1:27,10,3.064393493081416
89,100,Spine Tingler! The William Castle Story,500,6,2007.0,Biography/Documentary,1:22,11,3.064393493081416
16,0,Children of the Corn,500,6,2009.0,Horror,1:32,-16,3.064393493081416
43,83,The Client List,500,6,2010.0,Drama,1:30,40,3.064393493081416
26,50,Penumbra,500,6,2011.0,Horror/Mystery and thriller,1:25,24,3.064393493081416
75,100,The Garden,500,6,1990.0,Gay and lesbian/Drama,1:35,25,3.064393493081416
29,17,Let's Kill Ward's Wife,500,6,2014.0,Comedy,1:32,-12,3.064393493081416
91,100,Hamlet,500,6,2009.0,Drama,3:02,9,3.064393493081416
47,50,Roadside Romeo,500,6,2008.0,Comedy/Animation,1:58,3,3.064393493081416
32,33,Plush,500,6,2013.0,Mystery and thriller,1:39,1,3.064393493081416
90,67,State of Siege,500,6,1972.0,Drama/Mystery and thriller,2:00,-23,3.064393493081416
80,83,Svengali,500,6,1931.0,Drama,1:16,3,3.064393493081416
61,50,Greaser's Palace,500,6,1972.0,Comedy,1:31,-11,3.064393493081416
83,100,The White Helmets,500,6,2016.0,Documentary,0:40,17,3.064393493081416
29,0,Second Sight,500,6,1989.0,Comedy,1:24,-29,3.064393493081416
44,33,Chillerama,500,6,2011.0,Comedy/Fantasy,2:00,-11,3.064393493081416
68,33,Believe,500,6,2016.0,Drama/Other,1:59,-35,3.064393493081416
94,100,Roger Waters: The Wall,500,6,2014.0,Documentary,2:12,6,3.064393493081416
45,50,SEAL Team Six: The Raid on Osama bin Laden,500,6,2012.0,Action/Drama,1:30,5,3.064393493081416
78,83,The Story of Luke,500,6,2012.0,Comedy/Drama,1:35,5,3.064393493081416
15,0,The Long Weekend,500,6,2008.0,Drama/Mystery and thriller,1:28,-15,3.064393493081416
52,50,Carny,500,6,1980.0,Drama,1:47,-2,3.064393493081416
49,33,The Girl on a Motorcycle,500,6,1968.0,Drama,1:31,-16,3.064393493081416
44,50,Sushi Girl,500,6,2012.0,Drama/Crime,1:38,6,3.064393493081416
29,33,Meskada,500,6,2010.0,Drama/Mystery and thriller,1:27,4,3.064393493081416
85,83,Garbage Warrior,500,6,2007.0,Documentary,1:26,-2,3.064393493081416
68,33,What If ...,500,6,2010.0,Drama,1:55,-35,3.064393493081416
36,33,Gospel Hill,500,6,2008.0,Drama,1:39,-3,3.064393493081416
53,17,Eating Out: All You Can Eat,500,6,2009.0,Comedy,1:20,-36,3.064393493081416
73,83,Under the Bombs,500,6,2007.0,Romance/War,1:38,10,3.064393493081416
41,17,Sunchaser,500,6,1996.0,Drama,2:02,-24,3.064393493081416
70,100,Mr. Lucky,500,6,1943.0,Comedy/Drama,1:40,30,3.064393493081416
70,100,School for Scoundrels,500,6,1960.0,Comedy,1:34,30,3.064393493081416
65,67,The Mighty Celt,500,6,2005.0,Drama,1:21,2,3.064393493081416
62,83,The Lost,500,6,2008.0,Drama/Horror,1:59,21,3.064393493081416
47,83,Far North,500,6,2007.0,Romance/Drama,1:29,36,3.064393493081416
42,50,Some Girls,500,6,1988.0,Comedy,1:34,8,3.064393493081416
69,0,Reckless,500,5,1984.0,Drama,1:30,-69,2.734363528521053
85,80,180 Degrees South,500,5,2010.0,Documentary,1:25,-5,2.734363528521053
46,40,Pyaar Impossible,500,5,2010.0,Romance,2:21,-6,2.734363528521053
72,80,The Hidden Face,500,5,2011.0,Mystery and thriller,1:43,8,2.734363528521053
67,80,Next Gen,500,5,2018.0,Sci fi/Comedy,1:44,13,2.734363528521053
51,100,The Monkey King 2,500,5,2016.0,Adventure/Fantasy,1:59,49,2.734363528521053
28,20,Go With Me,500,5,2015.0,Mystery and thriller,1:30,-8,2.734363528521053
48,60,Lost in Hong Kong,500,5,2015.0,Adventure/Comedy,1:54,12,2.734363528521053
65,60,Ratter,500,5,2015.0,Drama/Mystery and thriller,1:20,-5,2.734363528521053
33,60,The Devil's Chair,500,5,2007.0,Horror,1:27,27,2.734363528521053
40,20,Blue Crush 2,500,5,2011.0,Drama/Romance,2:00,-20,2.734363528521053
72,60,The Great Lie,500,5,1941.0,Romance,1:47,-12,2.734363528521053
78,100,"Arrow, the Ultimate Weapon",500,5,2011.0,Drama/History,2:02,22,2.734363528521053
49,40,Madhouse,500,5,1974.0,Horror,1:29,-9,2.734363528521053
80,20,Ode to Billy Joe,500,5,1976.0,Drama/Gay and lesbian,1:46,-60,2.734363528521053
31,60,See No Evil 2,500,5,2014.0,Horror,1:30,29,2.734363528521053
81,20,Blood Ransom,500,5,2014.0,Romance/Mystery and thriller,1:41,-61,2.734363528521053
50,0,Boss,500,5,2013.0,Comedy/Action,2:23,-50,2.734363528521053
31,60,Forbidden World,500,5,1982.0,Sci fi,1:26,29,2.734363528521053
44,100,I Can See You,500,5,2008.0,Horror,1:37,56,2.734363528521053
65,100,Every Man for Himself,500,5,1980.0,Drama,1:29,35,2.734363528521053
32,60,High Lane,500,5,2009.0,Action/Adventure,1:24,28,2.734363528521053
16,20,The Traveler,500,5,2010.0,Horror/Mystery and thriller,1:31,4,2.734363528521053
63,40,Make the Yuletide Gay,500,5,2009.0,Comedy/Other,1:29,-23,2.734363528521053
85,80,I Knew It Was You: Rediscovering John Cazale,500,5,2009.0,Documentary/Biography,0:39,-5,2.734363528521053
79,80,Nurse.Fighter.Boy,500,5,2008.0,Drama,1:33,1,2.734363528521053
51,80,A Good Day to Be Black & Sexy,500,5,2008.0,Romance/Drama,1:32,29,2.734363528521053
37,40,Werewolf: The Beast Among Us,500,5,2012.0,Horror/Mystery and thriller,1:33,3,2.734363528521053
56,100,Black Legion,500,5,1937.0,Drama/Crime,1:23,44,2.734363528521053
75,80,Neo Ned,500,5,2005.0,Drama,1:37,5,2.734363528521053
76,80,Becoming Santa,500,5,2010.0,Documentary/Other,1:37,4,2.734363528521053
71,100,"Goodbye, Mr. Chips",500,5,1969.0,Musical,2:31,29,2.734363528521053
46,40,Idiot's Delight,500,5,1939.0,Comedy,1:45,-6,2.734363528521053
33,20,Mausam,500,5,2011.0,Romance/Drama,2:40,-13,2.734363528521053
85,100,"It's Not Me, I Swear!",500,5,2008.0,Comedy,1:45,15,2.734363528521053
84,100,The Tall T,500,5,1957.0,Western,1:18,16,2.734363528521053
33,20,Open Window,500,5,2006.0,Drama,1:37,-13,2.734363528521053
63,60,I'm Through With White Girls (The Inevitable Undoing of Jay Brooks),500,5,2007.0,Romance,1:33,-3,2.734363528521053
64,80,Watch on the Rhine,500,5,1943.0,Drama,1:54,16,2.734363528521053
80,60,Madame X,500,5,1966.0,Drama,1:39,-20,2.734363528521053
35,40,Hearts of Fire,500,5,1987.0,Drama,1:35,5,2.734363528521053
92,80,Amazing Journey: The Story of the Who,500,5,2007.0,Documentary/Music,1:59,-12,2.734363528521053
92,98,Portrait of a Lady on Fire,250,315,2019.0,Gay and lesbian/Drama,2:01,6,36.42873547273243
91,96,Pain and Glory,250,295,2019.0,Drama,1:53,5,34.96542086073288
81,84,Waves,250,249,2019.0,Drama,2:15,3,31.450285477474228
55,87,Shirley,250,245,2020.0,Drama/Mystery and thriller,1:47,32,31.133561386575195
61,96,First Cow,250,187,2019.0,Western/Drama,2:02,35,26.296684997953903
71,70,The High Note,250,185,2020.0,Drama/Music,1:53,-1,26.120550779067592
23,83,She Dies Tomorrow,250,183,2020.0,Drama/Mystery and thriller,1:24,60,25.943701036580038
89,82,Official Secrets,250,165,2019.0,Drama/Mystery and thriller,1:52,-7,24.317978218708763
40,79,True History of the Kelly Gang,250,162,2019.0,Drama/Crime,2:04,39,24.0406875503036
77,90,Luce,250,162,2019.0,Drama,1:49,13,24.0406875503036
80,99,Amazing Grace,250,160,2018.0,Documentary/Music,1:27,19,23.854756574160536
50,91,In Fabric,250,159,2018.0,Comedy/Horror,1:58,41,23.761464418909437
49,89,The Nest,250,156,2020.0,Drama/Mystery and thriller,1:47,40,23.480258506151625
50,27,The Aftermath,250,155,2019.0,Romance/History,1:49,-23,23.38607355742051
84,93,Babyteeth,250,147,2019.0,Comedy/Drama,1:57,9,22.624205359490148
67,71,All Is True,250,139,2018.0,Drama/History,1:41,4,21.84661977512174
50,72,The Happy Prince,250,137,2018.0,Gay and lesbian/Drama,1:45,22,21.649623817070065
81,67,The White Crow,250,133,2018.0,Drama/Biography,2:07,-14,21.252365464220812
74,95,The Mustang,250,133,2019.0,Drama,1:36,21,21.252365464220812
58,71,Teen Spirit,250,130,2018.0,Music/Drama,1:32,13,20.951474621135226
53,26,Wild Mountain Thyme,250,126,2020.0,Romance,1:42,-27,20.546203756731995
62,65,The Man Who Killed Don Quixote,250,124,2018.0,Comedy/Adventure,2:13,3,20.341761273786197
44,88,Madeline's Madeline,250,122,2018.0,Drama,1:34,44,20.136078432395202
56,71,Becky,250,119,2020.0,Action/Crime,1:33,15,19.82516684143501
71,89,Sputnik,250,114,2020.0,Sci fi/Horror,1:47,18,19.300365436139025
48,44,Mary Magdalene,250,113,2018.0,Drama,2:00,-4,19.194377290564812
27,49,The Craft: Legacy,250,111,2020.0,Fantasy/Mystery and thriller,1:37,22,18.981339705756774
23,41,You Should Have Left,250,111,2020.0,Horror/Mystery and thriller,1:33,18,18.981339705756774
46,75,The Wretched,250,110,2019.0,Horror/Mystery and thriller,1:35,29,18.874281508207943
50,56,The Bookshop,250,108,2017.0,Drama,1:53,6,18.659063693305395
56,47,A Rainy Day in New York,250,107,2019.0,Comedy,1:32,-9,18.55089473417879
49,84,The Final Year,250,105,2017.0,Documentary,1:29,35,18.333412575379587
50,70,Double Lover,250,104,2017.0,Drama/Mystery and thriller,1:48,20,18.22408939365073
63,92,The Dark and the Wicked,250,102,2020.0,Horror/Mystery and thriller,1:34,29,18.004253009684938
79,94,Shadow,250,102,2018.0,Sports and fitness/Adventure,1:56,15,18.004253009684938
68,90,The Kindergarten Teacher,250,102,2018.0,Drama,1:36,22,18.004253009684938
43,73,Piercing,250,100,2018.0,Horror/Mystery and thriller,1:21,30,17.78279410038923
58,84,The Other Side of the Wind,250,98,2018.0,Drama/Comedy,2:02,26,17.55966787263607
44,27,Bliss,250,97,2021.0,Sci fi,1:44,-17,17.447464924548626
93,98,Billie Eilish: The World's a Little Blurry,250,96,2021.0,Documentary/Music,2:21,5,17.334827353454408
77,89,Skate Kitchen,250,93,2018.0,Drama,1:46,12,16.994243740562503
40,62,The Oath,250,92,2018.0,Other/Comedy,1:33,22,16.879803711855995
62,77,Author: The JT LeRoy Story,250,92,2016.0,Documentary,1:50,15,16.879803711855995
78,88,The Midwife,250,90,2017.0,Drama/Comedy,1:57,10,16.64951428545866
81,91,Happy as Lazzaro,250,89,2018.0,Fantasy/Drama,2:05,10,16.533650545237286
48,83,The Hole in the Ground,250,89,2019.0,Horror/Mystery and thriller,1:30,35,16.533650545237286
81,88,"Love, Gilda",250,89,2018.0,Documentary,1:26,7,16.533650545237286
60,81,Fast Color,250,86,2018.0,Sci fi/Drama,1:40,21,16.183093078793917
26,33,King of Thieves,250,84,2018.0,Drama/Comedy,1:48,7,15.946836950911226
66,87,The Third Murder,250,83,2017.0,Drama/Crime,2:05,21,15.827918586512368
32,74,The Mercy,250,82,2018.0,Drama/Biography,1:41,42,15.708461709271033
75,89,Oxygen,250,82,2021.0,Sci fi/Mystery and thriller,1:41,14,15.708461709271033
83,76,Skin,250,80,2018.0,Drama/Biography,1:58,-7,15.467895945971296
92,90,Echo in the Canyon,250,80,2018.0,Documentary/Music,1:22,-2,15.467895945971296
71,91,Maria by Callas: In Her Own Words,250,80,2017.0,Documentary/Music,1:53,20,15.467895945971296
80,96,A Shaun the Sheep Movie: Farmageddon,250,78,2019.0,Sci fi/Kids and family,1:27,16,15.225063992104127
53,79,The Lovers and the Despot,250,77,2016.0,Documentary,1:35,26,15.102773291691431
74,82,Pope Francis -- A Man of His Word,250,77,2018.0,Documentary,1:36,8,15.102773291691431
52,87,1BR,250,77,2019.0,Horror/Mystery and thriller,1:30,35,15.102773291691431
57,93,Becoming,250,74,2020.0,Documentary,1:29,36,14.732275265126917
45,49,Flower,250,73,2017.0,Drama/Comedy,1:30,4,14.607530022406213
66,89,The Wolf of Snow Hollow,250,73,2020.0,Horror/Mystery and thriller,1:23,23,14.607530022406213
29,20,Coffee & Kareem,250,71,2020.0,Comedy/Action,1:28,-9,14.356099772615265
34,69,We Summon the Darkness,250,70,2019.0,Mystery and thriller/Horror,1:23,35,14.229389747854103
29,16,The Fanatic,250,69,2019.0,Mystery and thriller,1:28,-13,14.101999070345963
78,100,Shirkers,250,69,2018.0,Documentary,1:36,22,14.101999070345963
36,35,Love. Wedding. Repeat,250,69,2020.0,Comedy,1:40,-1,14.101999070345963
30,31,Mojave,250,68,2015.0,Mystery and thriller,1:33,1,13.973914138485368
52,47,Arkansas,250,66,2020.0,Drama/Crime,1:55,-5,13.715604699135167
36,52,England Is Mine,250,65,2017.0,Music/Drama,1:39,16,13.58535050847747
80,88,Plus One,250,64,2019.0,Romance,1:39,8,13.454342644059432
70,63,Paradise Hills,250,63,2019.0,Mystery and thriller,1:35,-7,13.322564864824612
87,86,The Boy Who Harnessed the Wind,250,63,2019.0,Drama,1:53,-1,13.322564864824612
55,93,The Guardians,250,61,2017.0,Drama/History,2:15,38,13.056631493342596
85,85,Sweet Bean,250,60,2015.0,Comedy/Drama,1:53,0,12.922440211617326
41,43,Hampstead,250,60,2017.0,Romance,1:43,2,12.922440211617326
84,93,Giant Little Ones,250,59,2018.0,Drama,1:34,9,12.78740756158519
66,92,Heal the Living,250,59,2016.0,Drama,1:43,26,12.78740756158519
43,74,Between Two Ferns: The Movie,250,58,2019.0,Comedy,1:22,31,12.651513870765422
47,71,Horse Girl,250,58,2020.0,Drama/Comedy,1:44,24,12.651513870765422
76,89,A Ciambra,250,57,2017.0,Drama,1:58,13,12.514738658402138
68,60,Finding Fela,250,57,2014.0,Documentary,2:00,-8,12.514738658402138
73,82,Light of My Life,250,56,2019.0,Drama,1:59,9,12.377060587439436
14,5,The Last Thing He Wanted,250,56,2020.0,Drama/Crime,1:55,-9,12.377060587439436
65,32,From the Land of the Moon,250,56,2016.0,Drama/Romance,2:00,-33,12.377060587439436
52,73,Lost Girls,250,55,2020.0,Drama,1:35,21,12.238457412731087
62,62,The Informer,250,55,2019.0,Drama/Crime,1:53,0,12.238457412731087
33,22,Submergence,250,54,2017.0,Drama/Romance,1:52,-11,12.098905925115496
53,74,Go for Sisters,250,54,2013.0,Drama/Crime,2:03,21,12.098905925115496
73,28,The Secret: Dare to Dream,250,53,2020.0,Drama/Romance,1:47,-45,11.958381890942793
52,81,Where Is Kyra?,250,53,2017.0,Drama,1:38,29,11.958381890942793
66,87,The Great Hack,250,53,2019.0,Documentary,2:15,21,11.958381890942793
82,58,Valley Girl,250,52,2020.0,Romance/Musical,1:43,-24,11.8168599865911
57,90,Creepy,250,52,2016.0,Mystery and thriller,2:10,33,11.8168599865911
60,85,Polina,250,52,2016.0,Drama,1:48,25,11.8168599865911
39,58,In the Shadow of the Moon,250,52,2019.0,Mystery and thriller,1:55,19,11.8168599865911
54,73,Galveston,250,52,2018.0,Crime/Mystery and thriller,1:31,19,11.8168599865911
69,92,On the Beach at Night Alone,250,51,2017.0,Drama,1:41,23,11.674313727451958
74,90,L'économie du couple,250,50,2016.0,Drama,1:40,16,11.530715390799685
68,88,Neon Bull,250,50,2015.0,Drama,1:43,20,11.530715390799685
65,78,The Standoff at Sparrow Creek,250,50,2018.0,Mystery and thriller,1:29,13,11.530715390799685
46,44,A Liar's Autobiography - The Untrue Story of Monty Python's Graham Chapman,250,50,2012.0,Comedy/Gay and lesbian,1:25,-2,11.530715390799685
39,62,Viva,250,50,2007.0,Comedy/Drama,2:00,23,11.530715390799685
81,96,1985,250,49,2018.0,Drama/Gay and lesbian,1:25,15,11.3860359318845
69,61,The Young Karl Marx,250,49,2017.0,Drama/Biography,1:58,-8,11.3860359318845
77,98,Night Comes On,250,49,2018.0,Drama,1:26,21,11.3860359318845
71,43,Where Hands Touch,250,49,2018.0,Romance/Drama,2:02,-28,11.3860359318845
17,12,Siberia,250,49,2018.0,Romance/Mystery and thriller,1:44,-5,11.3860359318845
73,83,Confirmation,250,48,2016.0,Drama,1:50,10,11.240244892502977
42,52,In the Name of My Daughter,250,48,2014.0,Drama/Mystery and thriller,2:02,10,11.240244892502977
42,51,The Strange Color of Your Body's Tears,250,47,2013.0,Mystery and thriller,1:42,9,11.093310301199846
38,30,Shock and Awe,250,47,2017.0,Drama,1:30,-8,11.093310301199846
50,87,The Breaker Upperers,250,47,2018.0,Comedy,1:30,37,11.093310301199846
67,85,Hockney,250,47,2014.0,Documentary,1:52,18,11.093310301199846
74,91,Eating Animals,250,46,2017.0,Documentary,1:35,17,10.945198564139895
50,76,The Escape,250,46,2017.0,Drama,1:41,26,10.945198564139895
65,91,Presenting Princess Shaw,250,46,2015.0,Documentary,1:20,26,10.945198564139895
55,87,The Night Eats the World,250,45,2018.0,Horror/Mystery and thriller,1:33,32,10.795874345554918
39,56,The Lodgers,250,45,2017.0,Horror/Mystery and thriller,1:33,17,10.795874345554918
32,36,The Night Clerk,250,45,2020.0,Mystery and thriller,1:30,4,10.795874345554918
33,55,Pioneer,250,44,2013.0,Mystery and thriller,1:46,22,10.645300436514761
19,45,Da Sweet Blood of Jesus,250,44,2014.0,Comedy/Drama,2:03,26,10.645300436514761
77,73,Escape From Pretoria,250,44,2020.0,Drama/Mystery and thriller,1:41,-4,10.645300436514761
62,91,Do Not Resist,250,44,2016.0,Documentary,1:13,29,10.645300436514761
58,89,Cloud 9,250,44,2008.0,Romance/Drama,1:38,31,10.645300436514761
67,86,Norman Lear: Just Another Version of You,250,43,2016.0,Documentary,1:31,19,10.493437610589469
69,60,"Hugh Hefner: Playboy, Activist and Rebel",250,43,2009.0,Documentary,2:15,-9,10.493437610589469
38,58,Set Fire to the Stars,250,43,2014.0,Biography/Drama,1:36,20,10.493437610589469
40,72,Beloved Sisters,250,43,2014.0,Biography/Drama,2:20,32,10.493437610589469
66,72,Gunnin' for That No. 1 Spot,250,43,2008.0,Documentary,1:30,6,10.493437610589469
85,88,The Trials of Muhammad Ali,250,42,2013.0,Biography/Documentary,1:34,3,10.34024446475599
95,90,Far From the Tree,250,42,2017.0,Documentary,1:33,-5,10.34024446475599
76,90,Koch,250,42,2012.0,Documentary/Biography,1:38,14,10.34024446475599
56,100,My Journey Through French Cinema,250,41,2016.0,Documentary,3:15,44,10.185677243651742
73,88,Dancing in Jaffa,250,41,2013.0,Documentary,1:26,15,10.185677243651742
77,90,Siddharth,250,41,2013.0,Drama,1:36,13,10.185677243651742
45,83,The Land of Steady Habits,250,41,2018.0,Drama/Comedy,1:38,38,10.185677243651742
39,61,Yakuza Apocalypse,250,41,2015.0,Horror/Action,1:55,22,10.185677243651742
76,95,Outside In,250,41,2017.0,Drama,1:49,19,10.185677243651742
52,90,Possum,250,41,2018.0,Drama/Horror,1:25,38,10.185677243651742
43,46,Chasing Madoff,250,41,2011.0,Documentary,1:31,3,10.185677243651742
42,44,The Yellow Birds,250,41,2017.0,War/Drama,1:50,2,10.185677243651742
39,68,Keyhole,250,41,2011.0,Drama/Mystery and thriller,1:34,29,10.185677243651742
40,63,I Think We're Alone Now,250,41,2018.0,Sci fi/Drama,1:33,23,10.185677243651742
79,93,In Search of Beethoven,250,41,2009.0,Documentary,2:19,14,10.185677243651742
71,68,CSNY: Deja Vu,250,41,2008.0,Documentary/Music,1:36,-3,10.185677243651742
49,70,Paterno,250,40,2018.0,Drama/Biography,1:45,21,10.029689644980788
48,90,A Vigilante,250,40,2018.0,Drama,1:31,42,10.029689644980788
40,95,See You Yesterday,250,40,2019.0,Adventure/Sci fi,1:26,55,10.029689644980788
67,80,Michael,250,40,2011.0,Drama,1:36,13,10.029689644980788
65,98,Home of the Brave,250,40,1949.0,War,1:25,33,10.029689644980788
56,85,The Quake,250,40,2018.0,Adventure/Mystery and thriller,1:48,29,10.029689644980788
43,80,Three Hearts,250,40,2014.0,Romance/Drama,1:46,37,10.029689644980788
70,36,The Secret Scripture,250,39,2016.0,Drama/Romance,1:48,-34,9.872232603526719
51,95,Sweetheart,250,39,2019.0,Horror/Mystery and thriller,1:22,44,9.872232603526719
78,77,Bombay Beach,250,39,2011.0,Musical/Drama,1:20,-1,9.872232603526719
84,100,California Typewriter,250,39,2016.0,Documentary,1:43,16,9.872232603526719
60,64,All the Bright Places,250,39,2020.0,Drama/Romance,1:47,4,9.872232603526719
42,69,Pilgrimage,250,39,2017.0,Drama/Adventure,1:36,27,9.872232603526719
51,46,Zaytoun,250,39,2012.0,Drama,1:47,-5,9.872232603526719
85,95,Chavela,250,38,2017.0,Music/Documentary,1:31,10,9.713254050808038
75,89,Advanced Style,250,38,2014.0,Comedy/Biography,1:13,14,9.713254050808038
62,89,Passion,250,38,2010.0,Documentary,1:30,27,9.713254050808038
72,66,Hit So Hard,250,38,2011.0,Music/Biography,1:43,-6,9.713254050808038
61,53,Woman Walks Ahead,250,38,2017.0,Western/Drama,1:42,-8,9.713254050808038
45,43,Arizona,250,37,2018.0,Comedy,1:25,-2,9.552698646911638
36,54,Some Velvet Morning,250,37,2013.0,Drama,1:23,18,9.552698646911638
66,81,Anton Chekhov's The Duel,250,37,2009.0,Drama,1:35,15,9.552698646911638
46,89,Master Z: Ip Man Legacy,250,37,2018.0,Sports and fitness/Action,1:48,43,9.552698646911638
22,84,Girl on the Third Floor,250,37,2019.0,Horror/Mystery and thriller,1:33,62,9.552698646911638
73,83,Pussy Riot - A Punk Prayer,250,36,2013.0,Crime/Music,1:30,10,9.390507480439723
69,92,Grease: Live!,250,36,2016.0,,,23,9.390507480439723
42,72,Take Me to the River,250,36,2015.0,Gay and lesbian/Drama,1:24,30,9.390507480439723
85,94,Chris & Don: A Love Story,250,36,2007.0,Documentary,1:30,9,9.390507480439723
53,86,Stray Dogs,250,36,2013.0,Drama,2:18,33,9.390507480439723
14,19,Dark Streets,250,36,2008.0,Drama/Mystery and thriller,1:23,5,9.390507480439723
34,37,Close,250,35,2019.0,Mystery and thriller/Action,1:34,3,9.22661773178138
51,14,Nomis,250,35,2018.0,Mystery and thriller/Action,1:38,-37,9.22661773178138
54,83,Pyewacket,250,35,2017.0,Horror/Mystery and thriller,1:30,29,9.22661773178138
41,0,London Fields,250,35,2018.0,Mystery and thriller,1:58,-41,9.22661773178138
56,54,Citizen Koch,250,35,2013.0,Documentary,1:50,-2,9.22661773178138
30,51,The Ticket,250,35,2016.0,Drama,1:38,21,9.22661773178138
45,77,The Kindergarten Teacher,250,35,2014.0,Drama,1:59,32,9.22661773178138
35,71,Final Score,250,35,2018.0,Action/Mystery and thriller,1:45,36,9.22661773178138
26,29,The Silence,250,35,2019.0,Sci fi/Horror,1:30,3,9.22661773178138
74,97,Last Men in Aleppo,250,35,2017.0,Documentary/War,1:44,23,9.22661773178138
40,60,Bird People,250,35,2014.0,Romance/Drama,2:08,20,9.22661773178138
49,66,The Polka King,250,35,2017.0,Comedy/Biography,1:35,17,9.22661773178138
56,91,Fresh Dressed,250,35,2015.0,Documentary,1:24,35,9.22661773178138
53,71,Kelly & Cal,250,35,2014.0,Comedy/Drama,1:49,18,9.22661773178138
33,68,Antibirth,250,34,2016.0,Horror/Mystery and thriller,1:34,35,9.060962294042406
46,38,Railroad Tigers,250,34,2016.0,Action/Comedy,2:04,-8,9.060962294042406
56,56,Simon and the Oaks,250,34,2011.0,Drama,2:02,0,9.060962294042406
37,62,Felt,250,34,2014.0,Horror/Mystery and thriller,1:20,25,9.060962294042406
42,74,Everyday,250,34,2012.0,Drama,1:46,32,9.060962294042406
53,38,Slaughterhouse Rulez,250,34,2018.0,Comedy/Horror,1:44,-15,9.060962294042406
57,94,The Levelling,250,34,2016.0,Drama,1:23,37,9.060962294042406
53,74,Putty Hill,250,34,2010.0,Drama,1:27,21,9.060962294042406
39,52,Jimmy P.,250,33,2013.0,Drama,1:57,13,8.893469344897873
46,55,When Comedy Went to School,250,33,2013.0,Documentary,1:17,9,8.893469344897873
47,55,Tokyo Tribe,250,33,2014.0,Musical/Sports and fitness,1:56,8,8.893469344897873
57,82,A Master Builder,250,33,2013.0,Drama,2:07,25,8.893469344897873
85,88,Dancer,250,33,2016.0,Documentary,1:25,3,8.893469344897873
69,21,Uncle Nino,250,33,2003.0,Comedy/Drama,1:40,-48,8.893469344897873
50,33,Morning Light,250,33,2008.0,Documentary,1:40,-17,8.893469344897873
63,97,We Come as Friends,250,32,2014.0,Documentary,1:50,34,8.724061861322062
81,78,"Hey, Boo: Harper Lee and To Kill a Mockingbird",250,32,2010.0,Documentary,1:22,-3,8.724061861322062
65,78,Archive,250,32,2020.0,Sci fi,1:45,13,8.724061861322062
35,47,In Darkness,250,32,2018.0,Mystery and thriller,1:50,12,8.724061861322062
67,69,The Changeover,250,32,2017.0,Mystery and thriller/Fantasy,1:35,2,8.724061861322062
16,31,Hellions,250,32,2015.0,Mystery and thriller/Horror,1:20,15,8.724061861322062
59,88,The Ravenous,250,32,2017.0,Horror/Mystery and thriller,1:43,29,8.724061861322062
62,75,The Human Resources Manager,250,32,2010.0,Drama,1:43,13,8.724061861322062
55,81,The Yes Men Are Revolting,250,32,2014.0,Documentary,1:31,26,8.724061861322062
64,75,Steve McQueen: The Man & Le Mans,250,32,2015.0,Documentary,1:42,11,8.724061861322062
32,16,Spinning Into Butter,250,32,2007.0,Drama,1:26,-16,8.724061861322062
89,75,A Man Named Pearl,250,32,2006.0,Documentary,1:18,-14,8.724061861322062
66,81,Blame,250,31,2017.0,Drama,1:40,15,8.552657067536824
48,52,The Thorn in the Heart,250,31,2009.0,Documentary,1:26,4,8.552657067536824
42,65,Detour,250,31,2016.0,Mystery and thriller,1:37,23,8.552657067536824
40,94,600 Miles,250,31,2015.0,Mystery and thriller/Drama,1:25,54,8.552657067536824
83,94,A Band Called Impaled Rektum,250,31,2018.0,Music/Comedy,1:32,11,8.552657067536824
41,74,The Last Sentence,250,31,2012.0,Drama/History,2:06,33,8.552657067536824
71,90,Concerning Violence,250,31,2014.0,Drama,1:18,19,8.552657067536824
59,94,Richard Linklater: Dream Is Destiny,250,31,2016.0,Documentary,1:30,35,8.552657067536824
52,77,Realive,250,31,2016.0,Sci fi,1:48,25,8.552657067536824
63,94,The Deep,250,31,2012.0,Drama,1:33,31,8.552657067536824
72,94,The Betrayal,250,31,2008.0,Documentary,1:36,22,8.552657067536824
76,84,Stonewall Uprising,250,31,2010.0,Documentary,1:22,8,8.552657067536824
87,90,Carol Channing: Larger Than Life,250,31,2011.0,Documentary,1:23,3,8.552657067536824
49,77,Double Take,250,30,2009.0,Drama,1:20,28,8.379165804519056
24,37,Swerve,250,30,2011.0,Drama/Crime,1:23,13,8.379165804519056
73,87,What Our Fathers Did: A Nazi Legacy,250,30,2015.0,Documentary,1:33,14,8.379165804519056
49,67,Wolf Totem,250,30,2015.0,Adventure/Drama,1:58,18,8.379165804519056
84,87,Mr. Gaga,250,30,2015.0,Documentary,1:40,3,8.379165804519056
17,3,Arsenal,250,30,2017.0,Mystery and thriller/Action,1:32,-14,8.379165804519056
27,53,One More Time,250,30,2015.0,Comedy/Drama,1:38,26,8.379165804519056
27,20,Zipper,250,30,2015.0,Drama/Mystery and thriller,1:52,-7,8.379165804519056
27,37,Cheerful Weather for the Wedding,250,30,2012.0,Comedy/Drama,1:32,10,8.379165804519056
65,93,Songs My Brothers Taught Me,250,30,2015.0,Drama,1:41,28,8.379165804519056
79,93,Boogie Man: The Lee Atwater Story,250,30,2008.0,Documentary/Biography,1:26,14,8.379165804519056
79,87,Prodigal Sons,250,30,2008.0,Documentary,1:26,8,8.379165804519056
41,28,Reincarnated,250,29,2012.0,Music/Documentary,1:36,-13,8.20349180691225
43,55,The Strange Ones,250,29,2017.0,Drama/Mystery and thriller,1:21,12,8.20349180691225
61,79,Voyeur,250,29,2017.0,Documentary,1:36,18,8.20349180691225
49,10,Basmati Blues,250,29,2017.0,Musical/Romance,1:46,-39,8.20349180691225
52,83,Kiki,250,29,2016.0,Gay and lesbian/Documentary,1:35,31,8.20349180691225
81,76,Little Pink House,250,29,2017.0,Drama,1:39,-5,8.20349180691225
61,52,Blood Done Sign My Name,250,29,2010.0,Drama,2:08,-9,8.20349180691225
35,66,Union Square,250,29,2011.0,Drama,1:20,31,8.20349180691225
67,90,Hava Nagila (The Movie),250,29,2012.0,Documentary,1:13,23,8.20349180691225
56,86,6 Balloons,250,29,2018.0,Drama,1:15,30,8.20349180691225
53,69,Like Me,250,29,2017.0,Horror/Mystery and thriller,1:20,16,8.20349180691225
67,90,Bessie,250,29,2015.0,Biography/Music,2:00,23,8.20349180691225
55,34,Formosa Betrayed,250,29,2009.0,Drama/Crime,1:48,-21,8.20349180691225
74,76,Absolute Wilson,250,29,2006.0,Documentary,1:45,2,8.20349180691225
49,29,Outlaws and Angels,250,28,2016.0,Western/Drama,2:00,-20,8.02553087005176
83,93,One of Us,250,28,2017.0,,,10,8.02553087005176
85,82,We Are X,250,28,2016.0,Music/Documentary,1:33,-3,8.02553087005176
44,71,Darling,250,28,2015.0,Horror/Mystery and thriller,1:18,27,8.02553087005176
35,32,Fun Mom Dinner,250,28,2017.0,Comedy,1:21,-3,8.02553087005176
65,71,Nothing Bad Can Happen,250,28,2013.0,Drama/Mystery and thriller,1:50,6,8.02553087005176
72,61,Dog Years,250,28,2017.0,Drama/Comedy,1:36,-11,8.02553087005176
78,79,William Kunstler: Disturbing the Universe,250,28,2009.0,Documentary,1:25,1,8.02553087005176
82,96,Sami Blood,250,28,2016.0,Drama,1:48,14,8.02553087005176
88,86,Pelotero,250,28,2011.0,Documentary,1:17,-2,8.02553087005176
41,86,Love After Love,250,28,2017.0,Drama,1:31,45,8.02553087005176
42,86,The Golem,250,28,2018.0,Horror/Mystery and thriller,1:35,44,8.02553087005176
51,89,Antarctica: Ice and Sky,250,28,2015.0,Documentary,1:29,38,8.02553087005176
82,93,Benda Bilili!,250,28,2010.0,Documentary/Music,1:25,11,8.02553087005176
73,89,Gerhard Richter Painting,250,28,2011.0,Documentary,1:37,16,8.02553087005176
91,89,The Topp Twins: Untouchable Girls,250,28,2009.0,Comedy/Documentary,1:24,-2,8.02553087005176
78,11,Sidney Hall,250,27,2017.0,Drama/Mystery and thriller,1:59,-67,7.845169885845621
45,70,The Devil's Doorway,250,27,2018.0,Horror,1:17,25,7.845169885845621
20,48,Down a Dark Hall,250,27,2018.0,Horror/Mystery and thriller,1:36,28,7.845169885845621
72,85,Stephen Hawking Biography,250,27,2013.0,Comedy/Biography,1:29,13,7.845169885845621
60,74,Take Me to the River,250,27,2014.0,Documentary,1:37,14,7.845169885845621
56,78,The Color Wheel,250,27,2011.0,Romance/Comedy,1:23,22,7.845169885845621
39,74,Memphis,250,27,2013.0,Drama,1:19,35,7.845169885845621
69,93,Ai Weiwei: The Fake Case,250,27,2013.0,Documentary,1:26,24,7.845169885845621
78,93,Manuscripts Don't Burn,250,27,2013.0,Drama,2:05,15,7.845169885845621
56,48,Cold Skin,250,27,2017.0,Horror/Mystery and thriller,1:36,-8,7.845169885845621
42,48,Gerontophilia,250,27,2013.0,Gay and lesbian/Romance,1:30,6,7.845169885845621
39,81,Elstree 1976,250,27,2015.0,Documentary,1:30,42,7.845169885845621
45,67,Step Up to the Plate,250,27,2012.0,Documentary,1:26,22,7.845169885845621
88,78,If You Build It,250,27,2013.0,Documentary,1:22,-10,7.845169885845621
60,74,I'm Going to Explode,250,27,2008.0,Comedy/Drama,1:42,14,7.845169885845621
79,93,Living in Emergency: Stories of Doctors Without Borders,250,27,2008.0,Documentary,1:33,14,7.845169885845621
76,89,Harry Dean Stanton: Partly Fiction,250,27,2012.0,Documentary/Biography,1:17,13,7.845169885845621
39,67,Videocracy,250,27,2009.0,Documentary,1:25,28,7.845169885845621
59,85,Frontrunners,250,27,2008.0,Documentary,1:23,26,7.845169885845621
45,81,Let It Snow,250,26,2019.0,Other/Romance,1:33,36,7.662285721192069
53,92,The Seventh Fire,250,26,2015.0,Drama/Documentary,1:18,39,7.662285721192069
59,96,"Black Coal, Thin Ice",250,26,2014.0,Drama/Crime,1:46,37,7.662285721192069
66,77,"My Love, Don't Cross That River",250,26,2014.0,Documentary,1:26,11,7.662285721192069
31,23,The Clapper,250,26,2017.0,Comedy,1:29,-8,7.662285721192069
50,46,American Son,250,26,2019.0,Drama,1:30,-4,7.662285721192069
59,88,Burning Sands,250,26,2017.0,Drama,1:36,29,7.662285721192069
58,81,Walk With Me,250,26,2017.0,Documentary,1:28,23,7.662285721192069
88,81,Last Call at the Oasis,250,26,2011.0,Documentary,1:45,-7,7.662285721192069
76,38,Unbroken: Path to Redemption,250,26,2018.0,Biography/Drama,1:38,-38,7.662285721192069
56,81,Handsome Harry,250,26,2009.0,Drama,1:34,25,7.662285721192069
64,92,The Final Member,250,26,2012.0,Documentary,1:12,28,7.662285721192069
61,69,Beyond the Edge,250,26,2013.0,Documentary/Adventure,,8,7.662285721192069
41,65,Jeff,250,26,2012.0,Documentary,1:16,24,7.662285721192069
86,69,The First Saturday in May,250,26,2007.0,Documentary,1:36,-17,7.662285721192069
43,48,Capture the Flag,250,25,2015.0,Adventure/Animation,1:37,5,7.476743906106103
67,64,Reality,250,25,2014.0,Comedy,1:35,-3,7.476743906106103
34,84,Whitewash,250,25,2013.0,Drama/Comedy,1:30,50,7.476743906106103
51,16,Tyler Perry's A Fall From Grace,250,25,2020.0,Mystery and thriller,2:00,-35,7.476743906106103
77,84,Heartstone,250,25,2016.0,Drama/Gay and lesbian,2:09,7,7.476743906106103
55,68,California Solo,250,25,2012.0,Drama,1:34,13,7.476743906106103
62,84,"The Man Nobody Knew: In Search of My Father, CIA Spymaster William Colby",250,25,2011.0,Documentary,1:44,22,7.476743906106103
32,36,Misery Loves Comedy,250,25,2015.0,Comedy/Documentary,1:34,4,7.476743906106103
77,92,Ali's Wedding,250,25,2017.0,Romance,1:46,15,7.476743906106103
48,52,Vallanzasca,250,25,2010.0,Drama/Biography,2:05,4,7.476743906106103
39,80,Dormant Beauty,250,25,2012.0,Drama,1:55,41,7.476743906106103
42,60,All the Wilderness,250,25,2014.0,Drama,1:57,18,7.476743906106103
46,64,The Dry Land,250,25,2010.0,Drama,1:32,18,7.476743906106103
79,92,Obscene,250,25,2007.0,Documentary/Biography,1:37,13,7.476743906106103
79,80,Who is Dayani Cristal?,250,25,2013.0,Documentary,1:22,1,7.476743906106103
83,92,Speed Sisters,250,24,2015.0,Adventure/Drama,1:20,9,7.288397090280924
59,88,Braid,250,24,2018.0,Horror/Mystery and thriller,1:22,29,7.288397090280924
55,54,The Playroom,250,24,2012.0,Drama,1:23,-1,7.288397090280924
15,29,Dark Summer,250,24,2015.0,Horror/Mystery and thriller,1:22,14,7.288397090280924
84,79,Rising From Ashes,250,24,2012.0,Documentary,1:20,-5,7.288397090280924
58,100,Breaking a Monster,250,24,2015.0,Music/Documentary,1:33,42,7.288397090280924
48,67,Bloodsucking Bastards,250,24,2015.0,Horror/Comedy,1:27,19,7.288397090280924
58,96,Hunter Gatherer,250,24,2016.0,Drama,1:28,38,7.288397090280924
57,58,Year of the Fish,250,24,2007.0,Romance/Fantasy,1:36,1,7.288397090280924
84,100,Sky Ladder: The Art of Cai Guo-Qiang,250,24,2016.0,Documentary,1:16,16,7.288397090280924
67,92,Rocko's Modern Life: Static Cling,250,24,2018.0,,,25,7.288397090280924
88,83,Jason Becker: Not Dead Yet,250,24,2012.0,Documentary,1:27,-5,7.288397090280924
51,75,Spark: A Burning Man Story,250,24,2013.0,Documentary,1:52,24,7.288397090280924
36,33,Puerto Ricans in Paris,250,24,2015.0,Comedy,1:22,-3,7.288397090280924
33,38,Cub,250,24,2014.0,Horror,1:25,5,7.288397090280924
24,13,A Promise,250,24,2013.0,Romance/Drama,1:35,-11,7.288397090280924
40,58,My Life Directed By Nicolas Winding Refn,250,24,2014.0,Documentary,0:58,18,7.288397090280924
57,67,Terraferma,250,24,2011.0,Drama,1:32,10,7.288397090280924
47,75,Salvo,250,24,2013.0,Romance/Drama,1:44,28,7.288397090280924
35,75,Canopy,250,24,2013.0,War/Drama,1:24,40,7.288397090280924
41,54,Small Time,250,24,2014.0,Drama,1:35,13,7.288397090280924
86,88,Somewhere Between,250,24,2011.0,Documentary,1:34,2,7.288397090280924
88,96,On the Bowery,250,24,1956.0,Documentary,1:05,8,7.288397090280924
40,42,A Bloody Aria,250,24,2006.0,Drama/Horror,1:55,2,7.288397090280924
56,88,Wonderful Town,250,24,2007.0,Comedy/Drama,1:32,32,7.288397090280924
58,65,"Love, Marilyn",250,23,2012.0,Documentary,1:45,7,7.097083215743026
78,74,Take Every Wave: The Life of Laird Hamilton,250,23,2017.0,Documentary,1:58,-4,7.097083215743026
89,91,Far Out Isn't Far Enough: The Tomi Ungerer Story,250,23,2012.0,Documentary,1:38,2,7.097083215743026
56,13,Little Italy,250,23,2018.0,Romance,1:42,-43,7.097083215743026
21,17,The Girl in the Photographs,250,23,2015.0,Horror/Mystery and thriller,1:35,-4,7.097083215743026
63,78,Smash His Camera,250,23,2010.0,Documentary,1:27,15,7.097083215743026
27,39,Lavender,250,23,2016.0,Mystery and thriller,1:33,12,7.097083215743026
26,17,Inescapable,250,23,2012.0,Mystery and thriller,1:33,-9,7.097083215743026
38,30,In Dubious Battle,250,23,2016.0,Drama/History,1:54,-8,7.097083215743026
65,70,Coming Through the Rye,250,23,2015.0,Drama,1:37,5,7.097083215743026
37,100,Chris Rock: Tamborine,250,23,2018.0,Comedy/Stand up,1:04,63,7.097083215743026
37,100,Seoul Station,250,23,2016.0,Horror/Animation,1:32,63,7.097083215743026
56,91,Transpecos,250,23,2016.0,Mystery and thriller,1:26,35,7.097083215743026
29,61,Carnage Park,250,23,2016.0,Action/Horror,1:20,32,7.097083215743026
30,4,Hangman,250,23,2017.0,Drama/Crime,1:38,-26,7.097083215743026
76,52,The End of Poverty?,250,23,2008.0,Documentary,1:46,-24,7.097083215743026
78,83,The Dhamma Brothers,250,23,2008.0,Documentary,1:16,5,7.097083215743026
74,91,Homicide,250,23,1991.0,Drama/Crime,1:40,17,7.097083215743026
63,65,Holly,250,23,2006.0,Drama,1:54,2,7.097083215743026
71,73,Prodigy,250,22,2017.0,Sci fi/Mystery and thriller,1:20,2,6.9026233386080005
41,64,Jackie & Ryan,250,22,2014.0,Romance/Drama,1:30,23,6.9026233386080005
58,64,The Tribes of Palos Verdes,250,22,2017.0,Drama/Comedy,1:45,6,6.9026233386080005
29,50,We Are Wizards,250,22,2008.0,Documentary,1:19,21,6.9026233386080005
82,86,The Pruitt-Igoe Myth,250,22,2011.0,Documentary,1:23,4,6.9026233386080005
82,100,Uncertain,250,22,2015.0,Comedy/Drama,1:22,18,6.9026233386080005
74,77,The Ivory Game,250,22,2016.0,Documentary,1:52,3,6.9026233386080005
72,95,Himizu,250,22,2011.0,Drama,2:09,23,6.9026233386080005
34,50,Edge of Winter,250,22,2016.0,Mystery and thriller/Drama,1:29,16,6.9026233386080005
64,55,The Lost Husband,250,22,2020.0,Drama,1:49,-9,6.9026233386080005
28,18,Mothers and Daughters,250,22,2016.0,Drama,1:30,-10,6.9026233386080005
61,82,Nightingale,250,22,2014.0,Drama,1:23,21,6.9026233386080005
30,82,Dying Laughing,250,22,2016.0,Comedy/Documentary,1:29,52,6.9026233386080005
88,73,Angel of Mine,250,22,2019.0,Drama/Mystery and thriller,1:38,-15,6.9026233386080005
72,45,Waiting for Lightning,250,22,2012.0,Documentary,1:36,-27,6.9026233386080005
68,91,The Day He Arrives,250,22,2011.0,Drama,1:19,23,6.9026233386080005
77,77,Virtual JFK: Vietnam If Kennedy Had Lived,250,22,2008.0,Documentary,1:22,0,6.9026233386080005
79,100,Li'l Quinquin,250,22,2015.0,,,21,6.9026233386080005
48,82,1001 Grams,250,22,2014.0,Drama,1:33,34,6.9026233386080005
61,64,Coldwater,250,22,2013.0,Drama/Mystery and thriller,1:44,3,6.9026233386080005
85,64,Nicky's Family,250,22,2011.0,Documentary,1:38,-21,6.9026233386080005
57,82,Test,250,22,2013.0,Gay and lesbian/Drama,1:29,25,6.9026233386080005
75,91,Jim: The James Foley Story,250,22,2016.0,Documentary/Biography,1:50,16,6.9026233386080005
71,68,Blessed Is the Match: The Life and Death of Hannah Senesh,250,22,2008.0,Documentary,1:26,-3,6.9026233386080005
68,86,Parched,250,22,2015.0,Drama,1:56,18,6.9026233386080005
65,64,The Nature of Existence,250,22,2009.0,Documentary,1:34,-1,6.9026233386080005
39,36,The Most Hated Woman in America,250,22,2017.0,Biography/Drama,1:31,-3,6.9026233386080005
89,77,Excellent Cadavers,250,22,2005.0,Documentary,1:31,-12,6.9026233386080005
74,100,Rewind This!,250,21,2013.0,Documentary,1:34,26,6.704819013328363
16,19,Dirty Dancing,250,21,2017.0,Musical/Drama,2:18,3,6.704819013328363
79,95,The Bill Murray Stories: Life Lessons Learned From a Mythical Man,250,21,2018.0,Documentary,1:10,16,6.704819013328363
66,62,Beneath the Harvest Sky,250,21,2013.0,Drama,1:56,-4,6.704819013328363
48,29,The Hero of Color City,250,21,2014.0,Adventure/Animation,1:17,-19,6.704819013328363
73,62,Broadway Idiot,250,21,2013.0,Documentary,1:21,-11,6.704819013328363
66,62,A Bag of Hammers,250,21,2011.0,Drama/Comedy,1:25,-4,6.704819013328363
55,62,The French Minister,250,21,2013.0,Drama,1:53,7,6.704819013328363
23,33,The Hunter's Prayer,250,21,2017.0,Mystery and thriller/Action,1:31,10,6.704819013328363
46,62,The World Made Straight,250,21,2015.0,Drama,1:59,16,6.704819013328363
68,90,Patience (After Sebald),250,21,2012.0,Documentary,1:30,22,6.704819013328363
40,76,The Son of Bigfoot,250,21,2017.0,Comedy/Animation,1:32,36,6.704819013328363
61,90,Dragonslayer,250,21,2011.0,Documentary,1:13,29,6.704819013328363
28,43,The Station,250,21,2013.0,Horror,1:37,15,6.704819013328363
29,52,24 Hours to Live,250,21,2017.0,Mystery and thriller/Action,1:33,23,6.704819013328363
86,90,Mortal Kombat Legends: Scorpion's Revenge,250,21,2020.0,Action/Adventure,1:20,4,6.704819013328363
44,86,Glass Chin,250,21,2014.0,Drama/Mystery and thriller,1:28,42,6.704819013328363
87,95,How to Change the World,250,21,2015.0,Documentary,1:53,8,6.704819013328363
34,38,Last Weekend,250,21,2014.0,Comedy/Drama,1:34,4,6.704819013328363
43,81,I Used to Be Darker,250,21,2013.0,Drama,1:30,38,6.704819013328363
64,67,Limelight,250,21,2011.0,Documentary,1:32,3,6.704819013328363
41,19,Blind,250,21,2017.0,Romance/Drama,1:46,-22,6.704819013328363
31,62,Goodbye to All That,250,21,2014.0,Comedy/Drama,1:27,31,6.704819013328363
42,57,"Noma, My Perfect Storm",250,21,2015.0,Documentary,1:35,15,6.704819013328363
28,38,Abattoir,250,21,2016.0,Horror/Mystery and thriller,1:38,10,6.704819013328363
90,86,Last Days Here,250,21,2011.0,Documentary/Music,1:31,-4,6.704819013328363
32,43,A Night in Old Mexico,250,21,2013.0,Comedy/Drama,1:44,11,6.704819013328363
99,95,The Ringmaster,250,21,2019.0,Documentary,1:28,-4,6.704819013328363
78,95,Ping Pong,250,21,2012.0,Documentary,1:20,17,6.704819013328363
88,90,Note by Note: The Making of Steinway L1037,250,21,2007.0,Documentary,1:21,2,6.704819013328363
42,70,The Knight Before Christmas,250,20,2019.0,Other/Romance,1:33,28,6.503449126242364
60,90,Bill,250,20,2015.0,Adventure/Comedy,1:34,30,6.503449126242364
62,65,The Final Master,250,20,2015.0,Drama/Sports and fitness,1:49,3,6.503449126242364
33,65,Falling Inn Love,250,20,2019.0,Romance,1:38,32,6.503449126242364
48,25,"Literally, Right Before Aaron",250,20,2017.0,Romance,1:42,-23,6.503449126242364
36,70,X,250,20,2011.0,Mystery and thriller,,34,6.503449126242364
20,70,Don't Leave Home,250,20,2018.0,Horror/Mystery and thriller,1:26,50,6.503449126242364
84,95,Palio,250,20,2015.0,Drama/Documentary,1:31,11,6.503449126242364
63,100,Chicken People,250,20,2016.0,Comedy/Documentary,1:23,37,6.503449126242364
51,60,How to Live Forever,250,20,2009.0,Documentary,1:32,9,6.503449126242364
60,95,The Creeping Garden,250,20,2014.0,Documentary,1:21,35,6.503449126242364
75,95,Louis C.K.: 2017,250,20,2017.0,,,20,6.503449126242364
51,75,Five Star,250,20,2014.0,Drama,1:22,24,6.503449126242364
43,25,Broken Horses,250,20,2015.0,Drama/Action,1:41,-18,6.503449126242364
45,50,Easy Money II,250,20,2012.0,Drama/Crime,1:39,5,6.503449126242364
62,70,A Fierce Green Fire,250,20,2012.0,Documentary,1:41,8,6.503449126242364
49,95,The Similars,250,20,2015.0,Sci fi/Horror,1:29,46,6.503449126242364
58,95,Paul Goodman Changed My Life,250,20,2011.0,Documentary/Biography,1:29,37,6.503449126242364
54,90,Mediterranea,250,20,2015.0,Drama,1:50,36,6.503449126242364
61,40,Believe Me,250,20,2014.0,Comedy/Drama,1:34,-21,6.503449126242364
33,55,Made in America,250,20,2013.0,Documentary/Music,1:33,22,6.503449126242364
91,90,Forever,250,20,2006.0,Documentary,1:37,-1,6.503449126242364
41,80,Waiting for Armageddon,250,20,2009.0,Documentary,1:14,39,6.503449126242364
74,75,The Crimson Wing: Mystery of the Flamingos,250,20,2008.0,Documentary,1:17,1,6.503449126242364
82,95,An Actor's Revenge,250,20,1963.0,Drama,1:53,13,6.503449126242364
69,85,Black White & Gray: A Portrait of Sam Wagstaff and Robert Mapplethorpe,250,20,2007.0,Documentary,1:10,16,6.503449126242364
18,58,Bite,250,19,2015.0,Horror,1:28,40,6.298266028731006
69,79,The Suicide Theory,250,19,2014.0,Drama,1:38,10,6.298266028731006
75,95,Jerry Before Seinfeld,250,19,2017.0,Comedy/Stand up,1:01,20,6.298266028731006
43,84,Road Games,250,19,2015.0,Mystery and thriller,1:35,41,6.298266028731006
82,100,The Bleeding Edge,250,19,2018.0,Documentary,1:39,18,6.298266028731006
52,58,Eddie: The Sleepwalking Cannibal,250,19,2012.0,Horror/Comedy,1:23,6,6.298266028731006
43,53,The Girl,250,19,2012.0,Drama,1:35,10,6.298266028731006
74,79,Battle for Brooklyn,250,19,2010.0,Drama,1:33,5,6.298266028731006
49,42,The Package,250,19,2018.0,Comedy,1:34,-7,6.298266028731006
74,79,The Bachelors,250,19,2017.0,Drama/Comedy,1:39,5,6.298266028731006
57,95,Night Across the Street,250,19,2012.0,Drama,1:50,38,6.298266028731006
98,100,Emanuel,250,19,2019.0,Documentary,1:20,2,6.298266028731006
30,37,Dealin' With Idiots,250,19,2013.0,Comedy,1:23,7,6.298266028731006
80,95,Visual Acoustics: The Modernism of Julius Shulman,250,19,2008.0,Documentary,1:23,15,6.298266028731006
86,74,Indivisible,250,19,2018.0,Drama/War,1:59,-12,6.298266028731006
84,84,The Short Game,250,19,2013.0,Documentary,1:35,0,6.298266028731006
63,26,Rushlights,250,19,2012.0,Romance/Drama,1:36,-37,6.298266028731006
36,47,In Our Nature,250,19,2012.0,Drama,1:43,11,6.298266028731006
22,32,The Taste of Money,250,19,2012.0,Drama/Mystery and thriller,1:54,10,6.298266028731006
74,100,Modern Life,250,19,2008.0,Documentary,1:28,26,6.298266028731006
49,74,Dead Man's Burden,250,19,2012.0,Western,1:33,25,6.298266028731006
60,84,Beauty (Skoonheid),250,19,2011.0,,,24,6.298266028731006
90,68,Mardi Gras: Made in China,250,19,2005.0,Documentary,1:18,-22,6.298266028731006
26,28,Knife Fight,250,18,2012.0,Drama,1:39,2,6.088990769440213
67,94,Batman: Return of the Caped Crusaders,250,18,2016.0,Adventure/Animation,1:18,27,6.088990769440213
52,28,Backwards,250,18,2012.0,Drama,1:29,-24,6.088990769440213
65,44,Vincent N Roxxy,250,18,2016.0,Drama/Crime,1:50,-21,6.088990769440213
89,50,Mumia: Long Distance Revolutionary,250,18,2012.0,Drama/Biography,2:00,-39,6.088990769440213
54,22,6 Below: Miracle on the Mountain,250,18,2017.0,Drama/Adventure,1:37,-32,6.088990769440213
40,33,A Man's Story,250,18,2010.0,Documentary,1:38,-7,6.088990769440213
50,72,Wah Do Dem,250,18,2009.0,Adventure/Drama,1:16,22,6.088990769440213
35,61,The Liability,250,18,2012.0,Mystery and thriller/Action,1:22,26,6.088990769440213
67,61,Fightville,250,18,2011.0,Documentary,1:25,-6,6.088990769440213
42,56,Killing Kennedy,250,18,2013.0,Drama,1:30,14,6.088990769440213
39,39,Tru Loved,250,18,2008.0,Comedy/Romance,1:39,0,6.088990769440213
31,22,Ithaca,250,18,2015.0,Drama,1:36,-9,6.088990769440213
68,83,Tchoupitoulas,250,18,2012.0,Documentary,1:20,15,6.088990769440213
44,78,The Visitor,250,18,1979.0,Sci fi/Horror,1:30,34,6.088990769440213
80,94,Tatsumi,250,18,2011.0,Biography/Drama,1:36,14,6.088990769440213
60,67,Guilty of Romance,250,18,2011.0,Drama,2:24,7,6.088990769440213
39,0,Reuniting the Rubins,250,18,2010.0,Comedy/Drama,1:39,-39,6.088990769440213
67,82,Monk With a Camera: The Life and Journey of Nicholas Vreeland,250,17,2014.0,Documentary,1:30,15,5.875307153057772
31,59,Small Crimes,250,17,2017.0,Drama/Crime,1:35,28,5.875307153057772
60,71,Newness,250,17,2017.0,Drama,1:52,11,5.875307153057772
45,47,Maya the Bee Movie,250,17,2014.0,Comedy/Animation,1:19,2,5.875307153057772
70,88,Don't Come Back From the Moon,250,17,2017.0,Drama,1:38,18,5.875307153057772
35,0,Safelight,250,17,2015.0,Drama,1:24,-35,5.875307153057772
36,47,Mademoiselle C,250,17,2013.0,Documentary,1:33,11,5.875307153057772
58,76,Tony,250,17,2009.0,Drama/Crime,1:12,18,5.875307153057772
35,47,They're Watching,250,17,2016.0,Horror/Mystery and thriller,1:35,12,5.875307153057772
46,47,Ordinary World,250,17,2016.0,Drama/Comedy,1:26,1,5.875307153057772
45,59,Jamie Marks Is Dead,250,17,2014.0,Drama/Horror,1:41,14,5.875307153057772
67,76,A Murder in the Park,250,17,2014.0,Documentary,1:31,9,5.875307153057772
54,94,The Head Hunter,250,17,2018.0,Adventure/Horror,1:12,40,5.875307153057772
37,47,Tower Block,250,17,2012.0,Mystery and thriller,1:30,10,5.875307153057772
68,53,London Town,250,17,2016.0,Drama,1:32,-15,5.875307153057772
98,88,Ne Zha,250,17,2019.0,Animation/Adventure,1:50,-10,5.875307153057772
74,94,The Trouble With the Truth,250,17,2011.0,Drama,1:36,20,5.875307153057772
71,71,Newlyweeds,250,17,2013.0,Comedy,1:27,0,5.875307153057772
20,65,Act of God,250,17,2009.0,Documentary,1:15,45,5.875307153057772
72,82,Herman's House,250,17,2011.0,Documentary,1:20,10,5.875307153057772
40,69,Ava's Possessions,250,16,2015.0,Horror/Comedy,1:29,29,5.656854249492381
72,94,The Bitter Buddha,250,16,2012.0,Comedy/Documentary,1:30,22,5.656854249492381
84,75,Unbranded,250,16,2015.0,Documentary,1:45,-9,5.656854249492381
56,88,Guidance,250,16,2014.0,Comedy,1:21,32,5.656854249492381
78,69,Go-ji-jeon,250,16,2011.0,Drama/War,2:13,-9,5.656854249492381
48,25,Bravetown,250,16,2015.0,Drama,1:50,-23,5.656854249492381
70,88,Mosquita y Mari,250,16,2011.0,Drama/Gay and lesbian,1:25,18,5.656854249492381
74,94,Floyd Norman: An Animated Life,250,16,2016.0,Documentary,1:28,20,5.656854249492381
54,94,Bound by Flesh,250,16,2012.0,Documentary,1:30,40,5.656854249492381
60,81,Only the Young,250,16,2012.0,Romance/Documentary,1:08,21,5.656854249492381
64,44,Cuck,250,16,2019.0,Drama,1:55,-20,5.656854249492381
33,13,In My Sleep,250,16,2009.0,Drama/Mystery and thriller,1:30,-20,5.656854249492381
61,81,Putin's Kiss,250,16,2011.0,Documentary,1:24,20,5.656854249492381
36,31,Not Another Happy Ending,250,16,2013.0,Romance,1:42,-5,5.656854249492381
70,69,American Teacher,250,16,2011.0,Documentary,1:21,-1,5.656854249492381
43,25,After the Ball,250,16,2015.0,Romance,1:42,-18,5.656854249492381
92,94,The Lovely Month of May,250,16,1963.0,Documentary,2:04,2,5.656854249492381
11,0,United Passions,250,16,2014.0,Drama/History,1:50,-11,5.656854249492381
40,56,Citizen Gangster,250,16,2011.0,Drama/Biography,1:45,16,5.656854249492381
80,94,The Freshman,250,16,1925.0,Comedy,1:10,14,5.656854249492381
47,94,La France,250,16,2007.0,Drama,1:42,47,5.656854249492381
64,88,Superman: Red Son,250,16,2020.0,Action/Adventure,1:24,24,5.656854249492381
84,81,"Wild Horse, Wild Ride",250,16,2011.0,Documentary/Western,1:46,-3,5.656854249492381
81,88,Bomb It,250,16,2007.0,Documentary,1:33,7,5.656854249492381
56,93,Manson Family Vacation,250,15,2015.0,Drama/Mystery and thriller,1:24,37,5.433216825139731
70,80,Bad Hurt,250,15,2015.0,Drama,1:41,10,5.433216825139731
24,13,Brightest Star,250,15,2013.0,Drama/Romance,1:20,-11,5.433216825139731
31,53,Lassiter,250,15,1984.0,Adventure,1:40,22,5.433216825139731
38,73,The Funhouse Massacre,250,15,2015.0,Other/Horror,1:30,35,5.433216825139731
36,27,Sweetwater,250,15,2013.0,Western,1:34,-9,5.433216825139731
79,100,Aida's Secrets,250,15,2016.0,Documentary,1:30,21,5.433216825139731
35,0,Life on the Line,250,15,2015.0,Drama/Mystery and thriller,1:38,-35,5.433216825139731
26,53,What Lies Below,250,15,2020.0,Mystery and thriller,1:27,27,5.433216825139731
34,7,Billionaire Boys Club,250,15,2018.0,Drama/Mystery and thriller,1:48,-27,5.433216825139731
56,53,Shanghai Calling,250,15,2012.0,Romance,1:39,-3,5.433216825139731
57,93,AWOL,250,15,2016.0,Gay and lesbian/Drama,1:25,36,5.433216825139731
72,67,Nappily Ever After,250,15,2018.0,Drama/Romance,,-5,5.433216825139731
36,13,Savannah,250,15,2013.0,Drama,1:50,-23,5.433216825139731
65,20,Hollow,250,15,2012.0,Horror,1:29,-45,5.433216825139731
77,87,Trashed,250,15,2012.0,Documentary,1:38,10,5.433216825139731
94,100,Which Way Is the Front Line From Here? The Life and Time of Tim Hetherington,250,15,2013.0,War/Documentary,1:19,6,5.433216825139731
22,20,Affluenza,250,15,2014.0,Drama,1:24,-2,5.433216825139731
51,0,Freedom,250,15,2014.0,Drama/History,1:33,-51,5.433216825139731
39,67,It Stains the Sands Red,250,15,2016.0,Horror/Mystery and thriller,1:32,28,5.433216825139731
47,73,"No God, No Master",250,15,2012.0,Drama/Crime,1:34,26,5.433216825139731
82,67,The Machine Which Makes Everything Disappear,250,15,2012.0,Documentary,1:41,-15,5.433216825139731
51,80,The Future,250,15,2013.0,Drama,1:34,29,5.433216825139731
39,93,Don't Kill It,250,15,2016.0,Action/Horror,1:33,54,5.433216825139731
35,67,Cannibal,250,15,2013.0,Mystery and thriller,1:57,32,5.433216825139731
71,73,My Reincarnation,250,15,2010.0,Documentary,1:40,2,5.433216825139731
31,40,The Hollow Point,250,15,2016.0,Drama/Crime,1:37,9,5.433216825139731
84,53,Ashes in the Snow,250,15,2018.0,Drama/History,1:39,-31,5.433216825139731
38,0,General Education,250,15,2012.0,Comedy,1:25,-38,5.433216825139731
68,87,Night and Day (Bam gua nat),250,15,2009.0,,,19,5.433216825139731
83,93,Free Angela and All Political Prisoners,250,15,2012.0,Documentary,1:41,10,5.433216825139731
36,20,Delhi Safari,250,15,2012.0,Kids and family/Comedy,1:36,-16,5.433216825139731
14,27,Amnesiac,250,15,2014.0,Mystery and thriller,1:24,13,5.433216825139731
34,40,Lizzie Borden Took an Ax,250,15,2014.0,Drama,1:30,6,5.433216825139731
59,73,Hello Lonesome,250,15,2010.0,Comedy/Drama,1:31,14,5.433216825139731
21,40,The Girl From the Naked Eye,250,15,2012.0,Action/Mystery and thriller,1:24,19,5.433216825139731
12,7,Assassin's Bullet,250,15,2012.0,Action/Mystery and thriller,1:31,-5,5.433216825139731
55,40,21 Years: Richard Linklater,250,15,2014.0,Documentary,1:19,-15,5.433216825139731
42,27,33 Postcards,250,15,2011.0,Drama,1:37,-15,5.433216825139731
71,53,Kicking It,250,15,2008.0,Documentary,1:38,-18,5.433216825139731
51,21,Dorfman in Love,250,14,2011.0,Romance,1:35,-30,5.203912939677927
60,100,The Dresser,250,14,2015.0,Drama,1:45,40,5.203912939677927
38,50,The Scribbler,250,14,2014.0,Sci fi/Mystery and thriller,1:30,12,5.203912939677927
48,21,Rim of the World,250,14,2019.0,Adventure/Action,1:38,-27,5.203912939677927
16,14,The Guillotines,250,14,2012.0,Drama/Sports and fitness,1:52,-2,5.203912939677927
34,50,My Piece of the Pie,250,14,2011.0,Drama/Comedy,1:49,16,5.203912939677927
52,71,Papadopoulos & Sons,250,14,2012.0,Drama/Comedy,1:45,19,5.203912939677927
75,79,Beautiful Darling,250,14,2010.0,Documentary,1:25,4,5.203912939677927
59,14,Survive the Night,250,14,2020.0,Mystery and thriller/Action,1:20,-45,5.203912939677927
27,29,Overdrive,250,14,2017.0,Mystery and thriller/Action,1:33,2,5.203912939677927
49,79,Burt's Buzz,250,14,2013.0,Documentary,1:28,30,5.203912939677927
81,57,Farmageddon,250,14,2011.0,Documentary,1:30,-24,5.203912939677927
71,50,Conor McGregor: Notorious,250,14,2017.0,Documentary,1:35,-21,5.203912939677927
46,36,Connected,250,14,2011.0,Documentary,1:22,-10,5.203912939677927
40,57,The Girl Is in Trouble,250,14,2012.0,Mystery and thriller,1:34,17,5.203912939677927
50,93,My Year Without Sex,250,14,2009.0,Drama/Comedy,1:36,43,5.203912939677927
50,43,Choose Connor,250,14,2007.0,Drama,1:49,-7,5.203912939677927
28,36,Screwed,250,14,2011.0,Drama,1:50,8,5.203912939677927
44,29,4 Minute Mile,250,14,2014.0,Drama,1:36,-15,5.203912939677927
41,29,Allegiance,250,14,2012.0,Drama/Mystery and thriller,1:31,-12,5.203912939677927
36,14,All Nighter,250,14,2017.0,Comedy,1:26,-22,5.203912939677927
62,86,I Am Bolt,250,14,2016.0,Documentary,1:47,24,5.203912939677927
58,43,The Berlin File,250,14,2013.0,Action/Drama,2:00,-15,5.203912939677927
93,93,No Distance Left to Run,250,14,2010.0,Documentary/Music,1:42,0,5.203912939677927
55,86,Xenia,250,14,2014.0,Gay and lesbian/Drama,2:08,31,5.203912939677927
76,64,The Lottery,250,14,2010.0,Drama,1:21,-12,5.203912939677927
55,93,Future Weather,250,14,2012.0,Drama,1:40,38,5.203912939677927
37,100,Sidekick,250,14,2005.0,Adventure/Fantasy,1:27,63,5.203912939677927
56,43,Mercy,250,14,2009.0,Romance/Drama,1:27,-13,5.203912939677927
38,57,Rich and Famous,250,14,1981.0,Drama,1:55,19,5.203912939677927
63,77,And Punching the Clown,250,13,2016.0,Comedy,1:35,14,4.968377601139757
20,15,Pound of Flesh,250,13,2015.0,Mystery and thriller/Action,1:44,-5,4.968377601139757
45,31,The Devil's Violinist,250,13,2013.0,Drama/Biography,2:02,-14,4.968377601139757
14,38,Contracted: Phase II,250,13,2015.0,Horror/Mystery and thriller,1:18,24,4.968377601139757
73,85,The Rising: Ballad of Mangal Pandey,250,13,2005.0,Drama/Biography,2:30,12,4.968377601139757
52,85,River,250,13,2015.0,Mystery and thriller,1:35,33,4.968377601139757
49,54,Walter,250,13,2015.0,Drama,1:34,5,4.968377601139757
68,100,Red Dog: True Blue,250,13,2016.0,Drama/Comedy,1:28,32,4.968377601139757
45,31,Septembers of Shiraz,250,13,2015.0,Drama/Mystery and thriller,1:50,-14,4.968377601139757
89,54,Kassim the Dream,250,13,2008.0,Documentary,1:27,-35,4.968377601139757
25,31,Undoing,250,13,2006.0,Drama,1:30,6,4.968377601139757
30,0,Acts of Violence,250,13,2018.0,Mystery and thriller/Action,1:26,-30,4.968377601139757
72,100,Mario,250,13,2018.0,Gay and lesbian/Drama,1:59,28,4.968377601139757
71,92,Bad Day for the Cut,250,13,2017.0,Mystery and thriller,1:39,21,4.968377601139757
13,23,The Pact II,250,13,2014.0,Horror/Mystery and thriller,1:36,10,4.968377601139757
23,31,The Wait,250,13,2013.0,Drama/Mystery and thriller,1:36,8,4.968377601139757
25,62,Anguish,250,13,2015.0,Horror/Mystery and thriller,1:31,37,4.968377601139757
49,62,Toe to Toe,250,13,2009.0,Drama,1:44,13,4.968377601139757
90,69,The Sons of Tennessee Williams,250,13,2010.0,Documentary/Biography,1:20,-21,4.968377601139757
73,69,A Bottle in the Gaza Sea,250,13,2011.0,Drama,1:39,-4,4.968377601139757
73,92,Two Lives,250,13,2012.0,Mystery and thriller,1:35,19,4.968377601139757
72,38,Death by China,250,13,2012.0,Documentary,1:19,-34,4.968377601139757
54,8,I Still See You,250,13,2018.0,Mystery and thriller,1:36,-46,4.968377601139757
33,15,The Curse of Sleeping Beauty,250,13,2016.0,Mystery and thriller/Adventure,1:27,-18,4.968377601139757
86,100,Batman Vs. Teenage Mutant Ninja Turtles,250,13,2019.0,Animation/Sci fi,1:24,14,4.968377601139757
56,62,Five Dances,250,13,2013.0,Gay and lesbian/Drama,1:23,6,4.968377601139757
85,92,The Death of Superman,250,13,2018.0,Action/Adventure,1:21,7,4.968377601139757
62,54,Jack of the Red Hearts,250,13,2015.0,Drama,1:40,-8,4.968377601139757
61,54,Demon House,250,13,2018.0,Documentary/Horror,1:51,-7,4.968377601139757
87,100,Mommy Dead and Dearest,250,13,2017.0,Documentary,1:22,13,4.968377601139757
23,77,F,250,13,2010.0,Mystery and thriller,1:19,54,4.968377601139757
72,100,They Call It Myanmar: Lifting the Curtain,250,13,2012.0,Documentary,1:10,28,4.968377601139757
82,54,Brother,250,13,2010.0,Drama,1:36,-28,4.968377601139757
67,100,Gloria,250,13,2014.0,Biography/Drama,2:06,33,4.968377601139757
52,62,The Blue Tooth Virgin,250,13,2008.0,Comedy,1:20,10,4.968377601139757
61,62,Old Goats,250,13,2010.0,Comedy/Biography,1:41,1,4.968377601139757
55,77,Dr. Cyclops,250,13,1940.0,Sci fi,1:15,22,4.968377601139757
23,8,New York City Serenade,250,13,2007.0,Comedy/Drama,1:43,-15,4.968377601139757
84,92,We Are Together,250,13,2006.0,Documentary/Music,1:27,8,4.968377601139757
57,92,Diamond Hunters,250,13,1956.0,Action,1:32,35,4.968377601139757
33,67,Inner Demons,250,12,2014.0,Horror,1:25,34,4.725940818339814
40,75,Abraham Lincoln,250,12,1930.0,Biography,1:37,35,4.725940818339814
61,75,The Angel,250,12,2018.0,Drama/Mystery and thriller,1:30,14,4.725940818339814
79,42,Jane's Journey,250,12,2010.0,Documentary,1:46,-37,4.725940818339814
18,8,The Damned,250,12,2010.0,Drama/Crime,0:28,-10,4.725940818339814
52,17,Look Away,250,12,2018.0,Mystery and thriller,1:43,-35,4.725940818339814
67,92,The Absent One,250,12,2014.0,Drama/Crime,1:59,25,4.725940818339814
31,8,That's What She Said,250,12,2012.0,Comedy,1:24,-23,4.725940818339814
63,58,The Shock Doctrine,250,12,2009.0,Documentary,1:25,-5,4.725940818339814
22,58,The Windmill Massacre,250,12,2016.0,Horror/Mystery and thriller,1:25,36,4.725940818339814
77,58,The Brainwashing of My Dad,250,12,2015.0,Documentary,1:35,-19,4.725940818339814
71,83,The Crimson Kimono,250,12,1959.0,Drama/Crime,1:24,12,4.725940818339814
75,100,Banksy Does New York,250,12,2014.0,Documentary,1:19,25,4.725940818339814
57,67,Sword Master,250,12,2016.0,Action/Sports and fitness,1:45,10,4.725940818339814
38,17,Vendetta,250,12,2013.0,Mystery and thriller/Action,1:46,-21,4.725940818339814
50,83,Front Cover,250,12,2015.0,Gay and lesbian/Drama,1:27,33,4.725940818339814
35,42,Spinning Man,250,12,2018.0,Mystery and thriller,1:40,7,4.725940818339814
78,17,God Bless the Broken Road,250,12,2018.0,Drama,1:53,-61,4.725940818339814
71,92,Ray Harryhausen: Special Effects Titan,250,12,2011.0,Documentary,1:30,21,4.725940818339814
29,25,Inbred,250,12,2011.0,Horror/Comedy,1:34,-4,4.725940818339814
52,25,Burning Blue,250,12,2014.0,Gay and lesbian/Drama,1:44,-27,4.725940818339814
34,17,Bringing Up Bobby,250,12,2009.0,Comedy,1:33,-17,4.725940818339814
9,17,Ironclad: Battle for Blood,250,12,2014.0,Action/Drama,1:48,8,4.725940818339814
10,25,Escape Plan: The Extractors,250,12,2019.0,,,15,4.725940818339814
42,17,Listening,250,12,2014.0,Sci fi/Mystery and thriller,1:40,-25,4.725940818339814
65,100,The Wise Kids,250,12,2011.0,Gay and lesbian/Drama,1:35,35,4.725940818339814
54,8,Girl on a Bicycle,250,12,2013.0,Romance,1:41,-46,4.725940818339814
53,33,Radio Free Albemuth,250,12,2010.0,Sci fi/Mystery and thriller,1:51,-20,4.725940818339814
38,92,Shelley,250,12,2016.0,Horror/Mystery and thriller,1:32,54,4.725940818339814
60,100,Burton and Taylor,250,12,2013.0,Biography/Drama,1:23,40,4.725940818339814
33,42,Awakening the Zodiac,250,12,2017.0,Mystery and thriller,1:40,9,4.725940818339814
53,42,Leonie!,250,12,2011.0,Drama,1:33,-11,4.725940818339814
70,17,The Crash,250,12,2017.0,Drama/Crime,1:24,-53,4.725940818339814
80,83,All in This Tea,250,12,2007.0,Documentary,1:10,3,4.725940818339814
47,25,The Narrows,250,12,2008.0,Drama,1:46,-22,4.725940818339814
74,42,RiP! A Remix Manifesto,250,12,2009.0,Documentary/Music,1:20,-32,4.725940818339814
69,67,The Immortalists,250,12,2014.0,Documentary/Drama,1:18,-2,4.725940818339814
73,92,Found Memories,250,12,2011.0,Drama,1:38,19,4.725940818339814
51,83,Hide,250,12,2008.0,Mystery and thriller,1:30,32,4.725940818339814
70,50,"What Did You Do in the War, Daddy?",250,12,1966.0,Comedy,1:59,-20,4.725940818339814
37,17,Happiness Runs,250,12,2010.0,Drama,1:28,-20,4.725940818339814
91,100,Stephen Tobolowsky's Birthday Party,250,12,2005.0,1h 27m,,9,4.725940818339814
81,83,Careful,250,12,1992.0,Comedy/Drama,1:40,2,4.725940818339814
15,33,Summer Love,250,12,2006.0,Western/Drama,1:34,18,4.725940818339814
89,83,Beyond Belief,250,12,2007.0,Documentary,1:38,-6,4.725940818339814
39,27,Grumpy Cat's Worst Christmas Ever,250,11,2014.0,Other/Comedy,1:25,-12,4.475797488182033
36,9,Someday This Pain Will Be Useful to You,250,11,2011.0,Drama,1:35,-27,4.475797488182033
49,45,Message From the King,250,11,2016.0,Mystery and thriller/Action,1:42,-4,4.475797488182033
26,0,The Walking Deceased,250,11,2015.0,Horror/Comedy,1:28,-26,4.475797488182033
47,73,A Christmas Prince,250,11,2017.0,Other/Romance,1:32,26,4.475797488182033
80,73,Good Ol' Boy,250,11,2015.0,Drama/Comedy,1:42,-7,4.475797488182033
48,82,Rabies,250,11,2010.0,Horror,1:30,34,4.475797488182033
46,36,Yelling to the Sky,250,11,2011.0,Drama,1:34,-10,4.475797488182033
78,100,The Central Park Effect,250,11,2012.0,Documentary,1:00,22,4.475797488182033
61,55,Picture Me,250,11,2009.0,Documentary,1:22,-6,4.475797488182033
26,27,Drone,250,11,2017.0,Mystery and thriller/Action,1:31,1,4.475797488182033
78,82,Audience of One,250,11,2007.0,Documentary,1:28,4,4.475797488182033
16,9,Reverb,250,11,2008.0,Horror,1:28,-7,4.475797488182033
25,18,Cassadaga,250,11,2011.0,Horror/Mystery and thriller,1:53,-7,4.475797488182033
84,27,Mad as Hell,250,11,2014.0,Comedy/Biography,1:22,-57,4.475797488182033
50,0,Father of the Year,250,11,2018.0,Comedy,1:30,-50,4.475797488182033
17,55,Malevolent,250,11,2018.0,Horror/Mystery and thriller,1:28,38,4.475797488182033
69,73,Seve: The Movie,250,11,2014.0,Drama/Biography,2:04,4,4.475797488182033
85,91,Food Chains,250,11,2014.0,Documentary,1:22,6,4.475797488182033
27,18,Jewtopia,250,11,2012.0,Romance,1:30,-9,4.475797488182033
92,0,Is That a Gun in Your Pocket?,250,11,2016.0,Comedy,1:37,-92,4.475797488182033
66,82,I Will Follow,250,11,2010.0,Drama,1:28,16,4.475797488182033
53,91,Killing Them Safely,250,11,2015.0,Documentary/Drama,1:40,38,4.475797488182033
20,9,Heatstroke,250,11,2013.0,Mystery and thriller,1:32,-11,4.475797488182033
29,55,Saint,250,11,2010.0,Comedy/Horror,1:26,26,4.475797488182033
49,91,The Last Days,250,11,2013.0,Sci fi/Mystery and thriller,1:42,42,4.475797488182033
87,100,American Radical: The Trials of Norman Finkelstein,250,11,2009.0,Documentary/Biography,1:24,13,4.475797488182033
55,82,S&Man,250,11,2010.0,,,27,4.475797488182033
70,91,Gonjiam: Haunted Asylum,250,11,2018.0,Horror/Mystery and thriller,1:33,21,4.475797488182033
99,64,Rockaway,250,11,2017.0,Drama/Adventure,1:30,-35,4.475797488182033
24,73,The Final Wish,250,11,2018.0,Horror/Mystery and thriller,1:35,49,4.475797488182033
48,27,Cost of a Soul,250,11,2010.0,Drama/Crime,1:30,-21,4.475797488182033
53,64,PT 109,250,11,1963.0,Biography,2:20,11,4.475797488182033
73,100,Moonrise,250,11,1948.0,Drama,1:30,27,4.475797488182033
72,64,Loins of Punjab Presents,250,11,2007.0,Comedy,1:28,-8,4.475797488182033
37,45,Down the Shore,250,11,2011.0,Drama/Mystery and thriller,1:33,8,4.475797488182033
31,18,Free the Nipple,250,11,2014.0,Comedy,1:19,-13,4.475797488182033
83,73,Violeta Went to Heaven,250,11,2011.0,Biography/Drama,1:50,-10,4.475797488182033
71,45,Uncle Nick,250,11,2015.0,Comedy,1:33,-26,4.475797488182033
81,100,At the Death House Door,250,11,2008.0,Documentary,1:38,19,4.475797488182033
91,91,Face to Face,250,11,2010.0,Drama,1:27,0,4.475797488182033
87,36,Least Among Saints,250,11,2012.0,Drama,1:45,-51,4.475797488182033
37,27,The Pleasure of Being Robbed,250,11,2008.0,Comedy/Drama,1:11,-10,4.475797488182033
61,82,Nursery University,250,11,2008.0,Documentary,1:30,21,4.475797488182033
58,82,The Love We Make,250,11,2011.0,Documentary,1:34,24,4.475797488182033
28,9,Bonded by Blood,250,11,2010.0,Drama/Crime,1:40,-19,4.475797488182033
47,9,Nickelodeon,250,11,1976.0,Comedy/Drama,2:01,-38,4.475797488182033
38,45,Confucius,250,11,2010.0,Biography/Drama,2:05,7,4.475797488182033
59,40,Pete Davidson: Alive From New York,250,10,2020.0,Comedy/Stand up,0:49,-19,4.216965034285822
69,40,Clandestine Childhood,250,10,2011.0,Drama,1:48,-29,4.216965034285822
30,60,Three Night Stand,250,10,2013.0,Romance,1:26,30,4.216965034285822
53,80,God of War,250,10,2017.0,War/Adventure,1:57,27,4.216965034285822
58,90,For a Woman,250,10,2013.0,Drama,1:50,32,4.216965034285822
83,40,Run the Race,250,10,2018.0,Drama,1:41,-43,4.216965034285822
26,20,The Barber,250,10,2014.0,Mystery and thriller,1:35,-6,4.216965034285822
70,90,Minuscule: Valley of the Lost Ants,250,10,2013.0,Adventure/Animation,1:29,20,4.216965034285822
71,50,Drew: The Man Behind the Poster,250,10,2013.0,Biography/Documentary,1:37,-21,4.216965034285822
52,80,Redwood Highway,250,10,2013.0,Drama,1:30,28,4.216965034285822
25,80,Pod,250,10,2015.0,Horror,1:18,55,4.216965034285822
62,30,Boys of Abu Ghraib,250,10,2014.0,Drama/War,1:42,-32,4.216965034285822
38,30,Sharknado 5: Global Swarming,250,10,2017.0,Sci fi/Comedy,1:30,-8,4.216965034285822
19,50,Mr. Jones,250,10,2013.0,Mystery and thriller,1:24,31,4.216965034285822
56,40,Black Coffee,250,10,2014.0,Romance,1:25,-16,4.216965034285822
42,100,Under the Gun,250,10,2016.0,Documentary,1:50,58,4.216965034285822
70,80,Orchestra of Exiles,250,10,2012.0,Documentary,1:25,10,4.216965034285822
63,100,Lust Stories,250,10,2018.0,Drama,2:00,37,4.216965034285822
52,60,Vanishing Waves,250,10,2012.0,Mystery and thriller/Romance,2:04,8,4.216965034285822
49,20,A Plumm Summer,250,10,2007.0,Adventure/Kids and family,1:39,-29,4.216965034285822
22,20,The Late Bloomer,250,10,2016.0,Romance,1:30,-2,4.216965034285822
46,60,Streamers,250,10,1983.0,Drama,1:58,14,4.216965034285822
56,80,Those People,250,10,2015.0,Romance/Gay and lesbian,1:28,24,4.216965034285822
29,50,Big Driver,250,10,2014.0,Mystery and thriller,1:30,21,4.216965034285822
72,70,An Englishman in New York,250,10,2009.0,Gay and lesbian/Drama,1:15,-2,4.216965034285822
65,40,The Paranoids,250,10,2008.0,Comedy/Drama,1:44,-25,4.216965034285822
67,100,Boogie,250,10,2008.0,Comedy/Drama,1:42,33,4.216965034285822
56,90,The Dark Tapes,250,10,2017.0,Sci fi/Horror,1:38,34,4.216965034285822
62,80,Father's Day,250,10,2011.0,Comedy/Action,1:39,18,4.216965034285822
57,80,Psychokinesis,250,10,2018.0,Action/Adventure,1:41,23,4.216965034285822
48,90,What Still Remains,250,10,2018.0,Drama/Mystery and thriller,1:32,42,4.216965034285822
82,90,Judex,250,10,1963.0,Drama,1:35,8,4.216965034285822
33,20,Sammy 2,250,10,2013.0,Kids and family/Comedy,1:28,-13,4.216965034285822
72,80,A Brony Tale,250,10,2014.0,Documentary,1:19,8,4.216965034285822
42,80,Mountain Men,250,10,2014.0,Comedy/Adventure,1:30,38,4.216965034285822
46,50,Clip,250,10,2012.0,Drama,1:40,4,4.216965034285822
63,40,The Super,250,10,2017.0,Mystery and thriller,1:30,-23,4.216965034285822
85,90,Out of the Clear Blue Sky,250,10,2012.0,Documentary,1:48,5,4.216965034285822
86,100,The Breaking Point,250,10,1950.0,Drama,1:37,14,4.216965034285822
26,40,Hellraiser: Judgment,250,10,2018.0,Horror,1:21,14,4.216965034285822
81,90,The Last Gladiators,250,10,2011.0,Documentary,1:34,9,4.216965034285822
42,50,Poker Night,250,10,2014.0,Mystery and thriller,1:45,8,4.216965034285822
64,80,Operation Red Sea,250,10,2018.0,Action/Adventure,2:19,16,4.216965034285822
37,20,Lost in the Sun,250,10,2015.0,Crime/Mystery and thriller,1:35,-17,4.216965034285822
74,50,Girlfriend,250,10,2010.0,Drama,1:34,-24,4.216965034285822
19,40,The Diabolical,250,10,2015.0,Horror/Mystery and thriller,1:26,21,4.216965034285822
42,60,Calvin Marshall,250,10,2010.0,Comedy/Drama,1:33,18,4.216965034285822
88,100,Precious Life,250,10,2010.0,Documentary,1:27,12,4.216965034285822
73,20,Hello Herman,250,10,2011.0,Drama,1:25,-53,4.216965034285822
20,50,Godspeed,250,10,2009.0,Mystery and thriller,1:39,30,4.216965034285822
73,80,The End of America,250,10,2008.0,Documentary,1:14,7,4.216965034285822
54,50,BearCity,250,10,2010.0,Gay and lesbian/Romance,1:45,-4,4.216965034285822
44,90,Trigger Man,250,10,2007.0,Drama/Horror,1:20,46,4.216965034285822
31,30,Young Yakuza,250,10,2007.0,Documentary,1:39,-1,4.216965034285822
40,11,The Secret Lives of Dorks,250,9,2013.0,Comedy,1:31,-29,3.9482220388574776
50,11,The Preppie Connection,250,9,2015.0,Drama,1:35,-39,3.9482220388574776
79,67,The Rise and Rise of Bitcoin,250,9,2014.0,Documentary,1:30,-12,3.9482220388574776
12,0,Future World,250,9,2018.0,Sci fi/Mystery and thriller,1:30,-12,3.9482220388574776
17,11,Eloise,250,9,2017.0,Horror/Mystery and thriller,1:29,-6,3.9482220388574776
8,33,SXTape,250,9,2013.0,Horror,1:25,25,3.9482220388574776
72,78,Too Late Blues,250,9,1962.0,Drama,1:40,6,3.9482220388574776
49,67,Toad Road,250,9,2012.0,Horror/Mystery and thriller,1:16,18,3.9482220388574776
88,22,Sgt. Will Gardner,250,9,2019.0,Drama,2:05,-66,3.9482220388574776
36,56,The Devil's Rock,250,9,2011.0,War/Action,1:26,20,3.9482220388574776
73,100,The Sunshine Makers,250,9,2015.0,Documentary,1:30,27,3.9482220388574776
96,78,Good Fortune,250,9,2016.0,Documentary,1:26,-18,3.9482220388574776
30,22,Truth or Die,250,9,2012.0,Horror/Mystery and thriller,1:32,-8,3.9482220388574776
47,11,Back in the Day,250,9,2014.0,Comedy,1:33,-36,3.9482220388574776
54,11,Not as a Stranger,250,9,1955.0,Drama,2:15,-43,3.9482220388574776
54,100,The Unseen,250,9,2016.0,Sci fi/Horror,1:44,46,3.9482220388574776
71,89,The Immaculate Conception of Little Dizzle,250,9,2009.0,Comedy,1:40,18,3.9482220388574776
29,11,Breaking the Girls,250,9,2013.0,Gay and lesbian/Drama,1:23,-18,3.9482220388574776
55,0,Midgets vs. Mascots,250,9,2009.0,Comedy,1:25,-55,3.9482220388574776
98,89,May It Last: A Portrait of the Avett Brothers,250,9,2017.0,Music/Documentary,1:44,-9,3.9482220388574776
69,44,Permanent,250,9,2017.0,Comedy,1:33,-25,3.9482220388574776
75,78,Severe Clear,250,9,2009.0,Documentary,1:33,3,3.9482220388574776
96,56,Pimp,250,9,2018.0,Drama/Crime,1:50,-40,3.9482220388574776
72,33,Blossoms in the Dust,250,9,1941.0,Biography,1:40,-39,3.9482220388574776
82,67,Things Never Said,250,9,2012.0,Drama,1:51,-15,3.9482220388574776
98,11,Against the Night,250,9,2017.0,Horror,1:25,-87,3.9482220388574776
14,11,Rites of Spring,250,9,2011.0,Horror,1:21,-3,3.9482220388574776
56,89,Life 2.0,250,9,2010.0,Documentary,1:40,33,3.9482220388574776
44,56,Making Plans for Lena,250,9,2009.0,Drama,1:45,12,3.9482220388574776
86,100,General Della Rovere,250,9,1959.0,Drama,2:19,14,3.9482220388574776
11,11,Spiders,250,9,2013.0,Horror/Mystery and thriller,1:29,0,3.9482220388574776
43,89,The Last King,250,9,2016.0,Action/Drama,1:39,46,3.9482220388574776
77,100,Cloudburst,250,9,2011.0,Comedy/Drama,1:33,23,3.9482220388574776
36,33,I'll Follow You Down,250,9,2013.0,Sci fi/Mystery and thriller,1:32,-3,3.9482220388574776
75,22,River Runs Red,250,9,2018.0,Drama/Crime,1:35,-53,3.9482220388574776
44,33,Matru Ki Bijlee Ka Mandola,250,9,2013.0,Romance,2:27,-11,3.9482220388574776
45,22,Daylight Robbery,250,9,2008.0,Drama/Crime,1:32,-23,3.9482220388574776
38,67,Around the Block,250,9,2013.0,Drama,1:44,29,3.9482220388574776
55,0,Weapons,250,9,2007.0,Drama/Crime,1:25,-55,3.9482220388574776
62,67,Snowmen,250,9,2010.0,Adventure,1:26,5,3.9482220388574776
36,56,In Old Arizona,250,9,1929.0,Western,1:37,20,3.9482220388574776
71,78,Mum & Dad,250,9,2008.0,Horror,1:24,7,3.9482220388574776
48,56,New World Order,250,9,2009.0,Documentary,1:25,8,3.9482220388574776
50,67,"Road, Movie",250,9,2009.0,Comedy/Drama,1:35,17,3.9482220388574776
47,44,Beware the Gonzo,250,9,2010.0,Comedy,1:34,-3,3.9482220388574776
39,56,Randy and the Mob,250,9,2007.0,Comedy,1:39,17,3.9482220388574776
73,89,The Citadel,250,9,1938.0,Drama,1:52,16,3.9482220388574776
57,56,Fix,250,9,2008.0,Drama,1:33,-1,3.9482220388574776
60,78,Grand Canyon Adventure: River at Risk,250,9,2008.0,Documentary,0:43,18,3.9482220388574776
44,56,Who Slew Auntie Roo?,250,9,1972.0,Horror,1:29,12,3.9482220388574776
44,78,Life Is a Bed of Roses,250,9,1983.0,Fantasy,1:50,34,3.9482220388574776
50,11,Towards Darkness,250,9,2007.0,Drama/Mystery and thriller,1:34,-39,3.9482220388574776
69,75,"Doin' It in the Park: Pick-Up Basketball, NYC",250,8,2012.0,Documentary,1:30,6,3.668016172818685
62,25,Cook Off!,250,8,2017.0,Comedy,1:38,-37,3.668016172818685
74,100,High Ground,250,8,2012.0,Documentary,1:31,26,3.668016172818685
9,13,Day of the Dead: Bloodline,250,8,2018.0,Horror,1:30,4,3.668016172818685
57,75,Buddymoon,250,8,2016.0,Comedy,1:20,18,3.668016172818685
57,63,Rise of the Legend,250,8,2014.0,Sports and fitness/Action,2:11,6,3.668016172818685
20,0,Breaking Point,250,8,2009.0,Drama/Crime,1:33,-20,3.668016172818685
19,38,Harbinger Down,250,8,2015.0,Sci fi/Horror,1:22,19,3.668016172818685
72,88,Suicide Squad: Hell to Pay,250,8,2018.0,Adventure/Action,1:31,16,3.668016172818685
71,75,Unleashed,250,8,2016.0,Romance/Fantasy,1:36,4,3.668016172818685
69,63,Protektor,250,8,2009.0,Drama/History,1:43,-6,3.668016172818685
75,25,Undrafted,250,8,2016.0,Comedy,1:40,-50,3.668016172818685
70,75,Once I Was a Beehive,250,8,2015.0,Drama/Comedy,1:59,5,3.668016172818685
74,75,Mirage (Durante la tormenta),250,8,2018.0,,,1,3.668016172818685
36,63,Free Samples,250,8,2012.0,Drama/Comedy,1:20,27,3.668016172818685
69,50,Goodbye Charlie,250,8,1964.0,Comedy,1:57,-19,3.668016172818685
82,88,Wonder Woman: Bloodlines,250,8,2019.0,Action/Adventure,1:23,6,3.668016172818685
11,0,10 Rules for Sleeping Around,250,8,2013.0,Comedy,1:34,-11,3.668016172818685
31,38,The Art of Being Straight,250,8,2008.0,Comedy/Gay and lesbian,1:11,7,3.668016172818685
82,100,Stolen Seas,250,8,2012.0,Documentary/Drama,1:30,18,3.668016172818685
52,63,Five,250,8,1951.0,Sci fi,1:33,11,3.668016172818685
78,75,Hellbound?,250,8,2012.0,Documentary,1:25,-3,3.668016172818685
25,50,The Warrior's Gate,250,8,2016.0,Action/Fantasy,1:48,25,3.668016172818685
24,50,Sket,250,8,2011.0,Drama/Crime,1:23,26,3.668016172818685
33,88,Roger Corman's Death Race 2050,250,8,2017.0,Sci fi/Action,1:33,55,3.668016172818685
39,88,Savaged,250,8,2013.0,Action/Horror,1:31,49,3.668016172818685
53,88,I Remember You,250,8,2017.0,Horror,1:45,35,3.668016172818685
65,0,The Snow Queen,250,8,2012.0,Kids and family/Animation,1:20,-65,3.668016172818685
31,63,The 4th Dimension,250,8,2006.0,Sci fi/Mystery and thriller,1:22,32,3.668016172818685
54,75,Memories of the Sword,250,8,2015.0,Action,2:01,21,3.668016172818685
54,100,Know Your Mushrooms,250,8,2008.0,Documentary,1:14,46,3.668016172818685
87,100,Lost Soul: The Doomed Journey of Richard Stanley's Island of Dr. Moreau,250,8,2014.0,Documentary/Adventure,1:37,13,3.668016172818685
53,75,True Adolescents,250,8,2009.0,Comedy,1:28,22,3.668016172818685
85,100,Ride the Pink Horse,250,8,1947.0,Drama/Crime,1:41,15,3.668016172818685
59,75,Strange Cargo,250,8,1940.0,Adventure,1:53,16,3.668016172818685
30,25,Holding Trevor,250,8,2007.0,Romance/Gay and lesbian,1:28,-5,3.668016172818685
57,88,Manborg,250,8,2011.0,Comedy/Sci fi,1:10,31,3.668016172818685
79,100,Last Holiday,250,8,1950.0,Comedy/Drama,1:29,21,3.668016172818685
36,38,Stick,250,8,1985.0,Drama/Crime,1:49,2,3.668016172818685
48,100,A Throw of Dice,250,8,1929.0,Drama,1:27,52,3.668016172818685
16,13,Final Exam,250,8,1981.0,Horror,1:30,-3,3.668016172818685
83,100,A Woman's Face,250,8,1941.0,Drama/Crime,1:46,17,3.668016172818685
82,88,The Hands of Orlac,250,8,1924.0,Drama/Crime,1:32,6,3.668016172818685
80,29,Helicopter Mom,250,7,2014.0,Gay and lesbian/Comedy,1:23,-51,3.374320069567275
55,43,No Tears for the Dead,250,7,2014.0,Action,1:56,-12,3.374320069567275
52,57,The Pirates,250,7,2014.0,Adventure,2:10,5,3.374320069567275
29,14,The Squeeze,250,7,1987.0,Comedy,1:41,-15,3.374320069567275
27,86,Close Range,250,7,2015.0,Action,1:30,59,3.374320069567275
42,86,Legacy,250,7,2010.0,Mystery and thriller,1:33,44,3.374320069567275
58,100,Orange Sunshine,250,7,2016.0,Documentary,1:45,42,3.374320069567275
35,14,This Beautiful City,250,7,2007.0,Drama,1:25,-21,3.374320069567275
47,71,Found,250,7,2012.0,Horror/Mystery and thriller,1:43,24,3.374320069567275
85,100,Lost Angels: Skid Row Is My Home,250,7,2010.0,Documentary,1:17,15,3.374320069567275
68,57,Talihina Sky: The Story of Kings of Leon,250,7,2011.0,Documentary,1:27,-11,3.374320069567275
35,0,Homer & Eddie,250,7,1989.0,Drama/Comedy,1:40,-35,3.374320069567275
93,100,Cuba and the Cameraman,250,7,2017.0,Documentary,1:53,7,3.374320069567275
29,57,Bigfoot: The Lost Coast Tapes,250,7,2012.0,Horror/Mystery and thriller,1:27,28,3.374320069567275
30,29,Love Hurts,250,7,2009.0,Romance,1:35,-1,3.374320069567275
15,0,Muck,250,7,2015.0,Horror,1:30,-15,3.374320069567275
56,0,Merah Putih,250,7,2009.0,Drama/War,1:48,-56,3.374320069567275
85,29,Passage to Mars,250,7,2016.0,Documentary,1:34,-56,3.374320069567275
67,86,Citizen Soldier Birds Eye View,250,7,2016.0,War/Documentary,1:35,19,3.374320069567275
85,86,BB King: The Life of Riley,250,7,2014.0,Documentary,2:03,1,3.374320069567275
70,100,Golden Kingdom,250,7,2015.0,Drama,1:44,30,3.374320069567275
75,86,Richard Pryor: Omit the Logic,250,7,2013.0,Comedy/Documentary,1:30,11,3.374320069567275
16,0,All Roads Lead to Rome,250,7,2015.0,Comedy/Romance,1:27,-16,3.374320069567275
30,71,Delivery,250,7,2013.0,Horror/Mystery and thriller,1:27,41,3.374320069567275
79,100,Days of Wrath,250,7,2008.0,Drama,1:34,21,3.374320069567275
24,29,Kindergarten Cop 2,250,7,2016.0,Comedy,1:40,5,3.374320069567275
42,86,Pushover,250,7,1954.0,Drama/Crime,1:28,44,3.374320069567275
50,86,Come Undone,250,7,2010.0,Drama,2:06,36,3.374320069567275
51,100,Age of Consent,250,7,1969.0,Drama,1:39,49,3.374320069567275
53,86,The Empty Hours,250,7,2013.0,Romance,1:40,33,3.374320069567275
82,100,Laws of Gravity,250,7,1992.0,Drama/Crime,1:40,18,3.374320069567275
72,57,Chasing the Dragon,250,7,2017.0,Drama/Biography,2:08,-15,3.374320069567275
9,14,Hard Breakers,250,7,2010.0,Comedy,1:38,5,3.374320069567275
32,57,Bitter Feast,250,7,2010.0,Mystery and thriller,1:35,25,3.374320069567275
62,71,Fists of Legend,250,7,2013.0,Action/Drama,2:33,9,3.374320069567275
67,100,Legion of Brothers,250,7,2017.0,Documentary,1:19,33,3.374320069567275
79,100,The World Before Her,250,7,2012.0,Documentary,1:30,21,3.374320069567275
18,29,Pornography,250,7,2009.0,Mystery and thriller,1:53,11,3.374320069567275
37,43,Antboy,250,7,2013.0,Comedy/Fantasy,1:17,6,3.374320069567275
15,43,Doom: Annihilation,250,7,2019.0,Sci fi/Action,1:37,28,3.374320069567275
58,29,The Tower,250,7,2012.0,Action/Mystery and thriller,2:01,-29,3.374320069567275
58,29,White Night Wedding,250,7,2008.0,Drama,1:36,-29,3.374320069567275
20,86,Salvage,250,7,2009.0,Horror,1:19,66,3.374320069567275
78,86,"Rachel, Rachel",250,7,1968.0,Drama,1:41,8,3.374320069567275
55,14,All Roads Lead Home,250,7,2008.0,Drama,1:48,-41,3.374320069567275
54,0,Trade of Innocents,250,7,2012.0,Drama/Mystery and thriller,1:31,-54,3.374320069567275
89,86,Abel Raises Cain,250,7,2005.0,Documentary,1:22,-3,3.374320069567275
33,29,Fade to Black,250,7,2006.0,Mystery and thriller,1:45,-4,3.374320069567275
67,100,Wichita,250,7,1955.0,Western,1:21,33,3.374320069567275
70,100,Comanche Station,250,7,1960.0,Western,1:14,30,3.374320069567275
51,86,$ (Dollars),250,7,1971.0,Comedy/Drama,2:00,35,3.374320069567275
78,100,Ashug-Karibi,250,7,1988.0,Drama,1:30,22,3.374320069567275
73,43,"East Side, West Side",250,7,1949.0,Drama,1:48,-30,3.374320069567275
60,50,Broken Hill,250,6,2009.0,Music/Drama,1:42,-10,3.064393493081416
75,83,Rhymes for Young Ghouls,250,6,2013.0,Drama,1:26,8,3.064393493081416
82,83,Angry Monk: Reflections on Tibet,250,6,2005.0,Documentary,1:37,1,3.064393493081416
61,67,Showrunners: The Art of Running a TV Show,250,6,2014.0,Documentary,1:30,6,3.064393493081416
61,50,From Noon Till Three,250,6,1976.0,Western/Comedy,1:39,-11,3.064393493081416
48,50,Sky,250,6,2015.0,Drama,1:43,2,3.064393493081416
56,67,The Tender Trap,250,6,1955.0,Comedy,1:51,11,3.064393493081416
85,100,The Confession,250,6,1970.0,Mystery and thriller,2:20,15,3.064393493081416
56,50,The Man From Earth: Holocene,250,6,2017.0,Sci fi,1:38,-6,3.064393493081416
86,100,The 24 Hour War,250,6,2016.0,Drama/History,1:38,14,3.064393493081416
25,0,Amateur Night,250,6,2016.0,Comedy,1:33,-25,3.064393493081416
95,100,Trouble Is My Business,250,6,2017.0,Crime/Adventure,1:56,5,3.064393493081416
29,100,Kim Possible,250,6,2019.0,Comedy/Adventure,1:32,71,3.064393493081416
6,0,L.A. Slasher,250,6,2015.0,Horror/Comedy,1:26,-6,3.064393493081416
55,83,Skid Row,250,6,2007.0,Documentary,1:20,28,3.064393493081416
66,100,A Conspiracy of Faith,250,6,2016.0,Drama/Crime,1:59,34,3.064393493081416
52,50,Fanny by Gaslight,250,6,1944.0,Drama,1:48,-2,3.064393493081416
41,33,Good Kids,250,6,2016.0,Comedy,1:30,-8,3.064393493081416
45,17,Lost Horizon,250,6,1973.0,Musical,2:23,-28,3.064393493081416
20,17,The Intruders,250,6,2015.0,Mystery and thriller,1:30,-3,3.064393493081416
33,0,See You in Valhalla,250,6,2015.0,Drama/Comedy,1:30,-33,3.064393493081416
80,67,God Bless Ozzy Osbourne,250,6,2010.0,Documentary,1:31,-13,3.064393493081416
59,17,One Small Hitch,250,6,2013.0,Romance,1:44,-42,3.064393493081416
41,67,The Auteur,250,6,2008.0,Comedy,1:20,26,3.064393493081416
74,100,The Anthropologist,250,6,2015.0,Documentary,1:21,26,3.064393493081416
24,0,Urge,250,6,2015.0,Mystery and thriller,1:29,-24,3.064393493081416
57,17,Under the Yum Yum Tree,250,6,1963.0,Comedy,1:50,-40,3.064393493081416
36,17,Come Back to Me,250,6,2014.0,Horror,1:36,-19,3.064393493081416
0,33,Satan Hates You,250,6,2010.0,Horror,1:34,33,3.064393493081416
73,50,FrackNation,250,6,2013.0,Documentary,1:16,-23,3.064393493081416
32,0,Catch Hell,250,6,2014.0,Drama/Crime,1:38,-32,3.064393493081416
83,83,Yesterday Was a Lie,250,6,2008.0,Romance/Sci fi,1:29,0,3.064393493081416
60,100,Operator,250,6,2016.0,Comedy/Drama,1:27,40,3.064393493081416
66,33,The Dark Valley,250,6,2014.0,Drama,1:55,-33,3.064393493081416
46,33,Little Fauss and Big Halsy,250,6,1970.0,Drama,1:39,-13,3.064393493081416
19,17,The Howling: Reborn,250,6,2011.0,Horror,1:32,-2,3.064393493081416
42,17,Saving Santa,250,6,2013.0,Comedy/Animation,1:24,-25,3.064393493081416
80,100,Crossing Arizona,250,6,2006.0,Documentary,1:37,20,3.064393493081416
19,33,Liz,250,6,1979.0,Drama/Other,1:20,14,3.064393493081416
29,33,Cottage Country,250,6,2013.0,Comedy/Mystery and thriller,1:31,4,3.064393493081416
64,67,Trapeze,250,6,1956.0,Drama,1:45,3,3.064393493081416
29,50,Out of the Dark,250,6,1989.0,Comedy/Mystery and thriller,1:30,21,3.064393493081416
73,83,Rose Marie,250,6,1936.0,Musical,1:50,10,3.064393493081416
58,50,The Sensation of Sight,250,6,2006.0,Drama,2:14,-8,3.064393493081416
44,83,Model Shop,250,6,1969.0,Drama,1:30,39,3.064393493081416
45,17,War of the Worlds: Goliath,250,6,2014.0,War/Sci fi,1:28,-28,3.064393493081416
45,0,Jannat 2,250,6,2012.0,Romance/Mystery and thriller,3:00,-45,3.064393493081416
38,17,Six Sex Scenes & a Murder,250,6,2008.0,Mystery and thriller,1:15,-21,3.064393493081416
59,50,Whaledreamers,250,6,2006.0,Documentary,1:24,-9,3.064393493081416
48,50,Sassy Pants,250,6,2012.0,Comedy/Gay and lesbian,1:27,2,3.064393493081416
93,100,Still Bill,250,6,2009.0,Documentary/Biography,1:18,7,3.064393493081416
62,100,The War Requiem,250,6,1988.0,Musical,1:25,38,3.064393493081416
45,33,Between Love & Goodbye,250,6,2008.0,Romance/Drama,1:37,-12,3.064393493081416
71,83,Abe Lincoln in Illinois,250,6,1940.0,Biography,1:50,12,3.064393493081416
96,100,The Other Side of the Mirror - Bob Dylan Newport 1963-1965,250,6,2007.0,,,4,3.064393493081416
53,83,Apres Lui,250,6,2007.0,Drama,1:32,30,3.064393493081416
20,0,When Time Ran Out,250,6,1980.0,Adventure,2:01,-20,3.064393493081416
39,17,The Gay Bed and Breakfast of Terror,250,6,2007.0,Horror,1:50,-22,3.064393493081416
82,67,The Secret of Santa Vittoria,250,6,1969.0,Comedy,2:20,-15,3.064393493081416
23,20,A Perfect Man,250,5,2012.0,Drama/Romance,1:35,-3,2.734363528521053
87,0,The After Party,250,5,2018.0,Music/Comedy,2:00,-87,2.734363528521053
46,40,John Doe: Vigilante,250,5,2014.0,Drama/Crime,1:33,-6,2.734363528521053
54,80,Doomsday Book,250,5,2012.0,Drama,1:55,26,2.734363528521053
93,60,Chimera Strain,250,5,2018.0,Sci fi/Mystery and thriller,1:20,-33,2.734363528521053
31,80,Ek Thi Daayan,250,5,2013.0,Romance/Horror,2:13,49,2.734363528521053
82,20,My Uncle Rafael,250,5,2011.0,Comedy,1:42,-62,2.734363528521053
64,60,On the Road With Judas,250,5,2007.0,Drama/Comedy,1:32,-4,2.734363528521053
52,40,Fetih 1453,250,5,2012.0,Adventure/War,2:40,-12,2.734363528521053
42,80,Dead Hooker in a Trunk,250,5,2009.0,Action,1:32,38,2.734363528521053
99,100,Maktub,250,5,2017.0,Drama/Comedy,1:40,1,2.734363528521053
27,20,Iceman,250,5,2014.0,Sci fi/Action,1:44,-7,2.734363528521053
48,0,Status Update,250,5,2018.0,Comedy,1:46,-48,2.734363528521053
39,40,No Blade of Grass,250,5,1970.0,Sci fi,1:37,1,2.734363528521053
91,100,Teen Titans Go! Vs. Teen Titans,250,5,2019.0,Animation/Action,1:16,9,2.734363528521053
25,40,The Bleeding House,250,5,2010.0,Horror/Mystery and thriller,1:35,15,2.734363528521053
60,80,To Kill a Priest,250,5,1988.0,Mystery and thriller,1:56,20,2.734363528521053
56,40,Wild Thing,250,5,1987.0,Action,1:32,-16,2.734363528521053
50,40,Field of Lost Shoes,250,5,2014.0,War/Drama,1:36,-10,2.734363528521053
16,0,Drunk Parents,250,5,2019.0,Comedy,1:37,-16,2.734363528521053
63,40,The Stalking Moon,250,5,1968.0,Western,1:49,-23,2.734363528521053
81,60,Hostile,250,5,2017.0,Horror/Mystery and thriller,1:23,-21,2.734363528521053
26,60,Joy Ride 3: Roadkill,250,5,2014.0,Horror/Mystery and thriller,1:36,34,2.734363528521053
71,80,Into Temptation,250,5,2009.0,Drama,1:35,9,2.734363528521053
47,80,The Lady in the Car With Glasses and a Gun,250,5,2015.0,Mystery and thriller,1:33,33,2.734363528521053
34,0,In/Sight,250,5,2011.0,Mystery and thriller,1:32,-34,2.734363528521053
12,0,Deep Blue Sea 2,250,5,2018.0,,,-12,2.734363528521053
81,80,Don't Let Me Drown,250,5,2009.0,Romance/Drama,1:42,-1,2.734363528521053
57,60,The Group,250,5,1966.0,Gay and lesbian/Drama,2:30,3,2.734363528521053
79,100,11:55,250,5,2016.0,Drama/Crime,1:20,21,2.734363528521053
20,40,By the Gun,250,5,2014.0,Drama/Crime,1:49,20,2.734363528521053
46,80,The Fish Child,250,5,2009.0,Drama,1:36,34,2.734363528521053
29,0,What Women Want,250,5,2011.0,Comedy/Romance,1:56,-29,2.734363528521053
71,80,Snake and Mongoose,250,5,2013.0,Drama,1:42,9,2.734363528521053
68,100,Kid Galahad,250,5,1937.0,Drama,1:41,32,2.734363528521053
51,100,Teenage Cocktail,250,5,2016.0,Gay and lesbian/Drama,1:28,49,2.734363528521053
48,100,Memoria,250,5,2016.0,Drama,1:10,52,2.734363528521053
21,0,You Got Served: Beat the World,250,5,2011.0,Drama,1:31,-21,2.734363528521053
27,60,The Fields,250,5,2011.0,,,33,2.734363528521053
18,20,All Hat,250,5,2007.0,Western/Drama,1:29,2,2.734363528521053
64,40,Falling Overnight,250,5,2011.0,Drama,1:28,-24,2.734363528521053
27,0,Sexual Chronicles of a French Family,250,5,2012.0,Comedy,1:17,-27,2.734363528521053
38,80,Machine Gun McCain,250,5,1969.0,Drama/Crime,1:34,42,2.734363528521053
76,80,La Roue,250,5,1923.0,Drama,3:00,4,2.734363528521053
17,80,Penance,250,5,2008.0,Horror/Mystery and thriller,1:25,63,2.734363528521053
69,80,The Human Comedy,250,5,1943.0,Comedy/Drama,1:58,11,2.734363528521053
27,0,Action Replayy,250,5,2010.0,Sci fi/Romance,2:11,-27,2.734363528521053
93,100,Shahid,250,5,2012.0,Biography/Drama,1:45,7,2.734363528521053
47,80,Ten Nights of Dreams,250,5,2006.0,Fantasy,1:40,33,2.734363528521053
88,100,Maytime,250,5,1937.0,Musical,2:12,12,2.734363528521053
60,60,A Marine Story,250,5,2010.0,Drama,1:38,0,2.734363528521053
49,100,The Aggression Scale,250,5,2012.0,Drama/Crime,1:25,51,2.734363528521053
82,100,Wild Combination: A Portrait of Arthur Russell,250,5,2008.0,Documentary/Romance,1:10,18,2.734363528521053
57,80,The Village Barbershop,250,5,2008.0,Drama,1:39,23,2.734363528521053
56,60,The Waiting Room,250,5,2007.0,Drama,1:50,4,2.734363528521053
36,0,Dim Sum Funeral,250,5,2008.0,Comedy/Drama,1:35,-36,2.734363528521053
75,100,Wool 100 Percent,250,5,2006.0,Comedy/Fantasy,1:40,25,2.734363528521053
59,100,Daisy Kenyon,250,5,1947.0,Romance,1:39,41,2.734363528521053
71,100,Day of the Outlaw,250,5,1959.0,Western,1:31,29,2.734363528521053
88,60,Kapò,250,5,1959.0,Drama/History,1:56,-28,2.734363528521053
63,80,Love on the Run,250,5,1936.0,Comedy,1:20,17,2.734363528521053
84,100,Remembrance of Things to Come,250,5,2001.0,Documentary,0:42,16,2.734363528521053
67,80,Up the Down Staircase,250,5,1967.0,Drama,2:04,13,2.734363528521053
85,94,Marriage Story,100,388,2019.0,Drama/Comedy,2:16,9,41.49729885406728
91,97,Dolemite Is My Name,100,232,2019.0,Comedy/Biography,1:58,6,30.090540621339713
87,92,Wild Rose,100,194,2018.0,Comedy/Music,1:41,5,26.907669282564235
62,88,The Truth,100,156,2019.0,Drama,1:46,26,23.480258506151625
76,45,After the Wedding,100,155,2019.0,Drama,1:52,-31,23.38607355742051
69,99,Ash Is Purest White,100,153,2018.0,Romance/Drama,2:21,30,23.197017186759677
65,96,Atlantics,100,152,2019.0,Drama,1:45,31,23.102141654099842
55,30,Red Joan,100,151,2018.0,Drama/Crime,1:50,-25,23.007031762531238
61,89,Black Bear,100,146,2020.0,Drama,1:44,28,22.52789093302636
58,99,Miss Juneteenth,100,135,2020.0,Drama,1:43,41,21.451546410907937
53,79,How to Build a Girl,100,135,2019.0,Comedy,1:42,26,21.451546410907937
50,91,High Flying Bird,100,134,2019.0,Drama,1:30,41,21.35209529135088
87,98,David Byrne's American Utopia,100,133,2020.0,Musical,2:15,11,21.252365464220812
45,67,The Seagull,100,126,2018.0,Drama,1:38,22,20.546203756731995
76,54,Train to Busan Presents: Peninsula,100,123,2020.0,Action/Mystery and thriller,1:56,-22,20.23907662547856
89,99,Collective,100,122,2019.0,Documentary,1:49,10,20.136078432395202
48,57,The Hummingbird Project,100,122,2018.0,Drama,1:51,9,20.136078432395202
97,98,Maiden,100,118,2018.0,Documentary,1:33,1,19.720878370380042
52,87,The Trip to Greece,100,117,2020.0,Comedy,1:52,35,19.616257942185833
43,68,Little Joe,100,117,2019.0,Sci fi/Horror,1:45,25,19.616257942185833
29,80,The Beach House,100,107,2019.0,Horror,1:28,51,18.55089473417879
46,87,Sea Fever,100,107,2019.0,Sci fi/Horror,1:30,41,18.55089473417879
34,75,The Other Lamb,100,105,2019.0,Drama/Horror,1:37,41,18.333412575379587
75,92,Beanpole,100,103,2019.0,Drama,2:17,17,18.1143712989759
71,84,The Traitor,100,103,2019.0,Drama/Biography,2:25,13,18.1143712989759
85,99,Totally Under Control,100,102,2020.0,Documentary,2:03,14,18.004253009684938
78,99,Saint Frances,100,101,2019.0,Drama/Comedy,1:46,21,17.893729120895756
90,100,Crip Camp,100,98,2020.0,Documentary,1:47,10,17.55966787263607
79,66,The Public,100,97,2018.0,Drama,1:59,-13,17.447464924548626
54,95,Little Woods,100,96,2018.0,Drama,1:45,41,17.334827353454408
60,57,Resistance,100,95,2020.0,Drama/Biography,2:00,-3,17.22174892188519
44,67,The Secret Garden,100,94,2020.0,Drama/Fantasy,1:39,23,17.108223236119827
54,85,Misbehaviour,100,94,2020.0,Comedy/Drama,1:46,31,17.108223236119827
45,59,Them That Follow,100,93,2019.0,Drama/Mystery and thriller,1:38,14,16.994243740562503
39,90,Blood Quantum,100,93,2019.0,Horror,1:36,51,16.994243740562503
62,93,Sword of Trust,100,92,2019.0,Comedy,1:29,31,16.879803711855995
52,64,The Day Shall Come,100,91,2019.0,Comedy,1:28,12,16.764896252714394
64,79,Photograph,100,90,2019.0,Drama/Romance,1:48,15,16.64951428545866
65,53,Waiting for the Barbarians,100,90,2019.0,Drama/History,1:52,-12,16.64951428545866
84,98,Deadwood: The Movie,100,88,2019.0,Western,1:49,14,16.417297572912943
60,97,La llorona,100,88,2019.0,Drama/Crime,1:37,37,16.417297572912943
86,88,Freaks,100,84,2018.0,Sci fi/Mystery and thriller,1:45,2,15.946836950911226
41,44,Made in Italy,100,81,2020.0,Drama/Comedy,1:34,3,15.588457268119896
58,83,Daniel Isn't Real,100,80,2019.0,Horror/Mystery and thriller,1:36,25,15.467895945971296
65,81,Tigertail,100,80,2020.0,Drama,1:31,16,15.467895945971296
22,50,Ismael's Ghosts,100,78,2017.0,Romance/Drama,1:54,28,15.225063992104127
85,100,Driveways,100,76,2019.0,Drama,1:23,15,14.979885547093689
41,86,I Used to Go Here,100,76,2020.0,Comedy,1:20,45,14.979885547093689
59,66,Spree,100,76,2020.0,Mystery and thriller/Comedy,1:32,7,14.979885547093689
58,79,Loro,100,75,2018.0,Drama/Biography,2:38,21,14.856389929209026
41,71,Amulet,100,75,2020.0,Horror/Mystery and thriller,1:39,30,14.856389929209026
44,45,"Endings, Beginnings",100,74,2019.0,Drama,1:50,1,14.732275265126917
47,78,12 Hour Shift,100,74,2020.0,Comedy/Mystery and thriller,1:28,31,14.732275265126917
71,59,Charlie Says,100,73,2018.0,Drama,1:50,-12,14.607530022406213
74,61,Trial by Fire,100,70,2018.0,Drama/Biography,2:07,-13,14.229389747854103
50,81,The Wind,100,70,2018.0,Western/Horror,1:26,31,14.229389747854103
40,97,"Hale County This Morning, This Evening",100,69,2018.0,Documentary,1:16,57,14.101999070345963
69,94,The Shadow of Violence,100,68,2019.0,Drama/Crime,1:41,25,13.973914138485368
88,91,End of Sentence,100,67,2019.0,Drama,1:36,3,13.8451208742507
77,72,Gwen,100,64,2018.0,Horror/Drama,1:24,-5,13.454342644059432
88,92,The Garden Left Behind,100,64,2019.0,Drama,1:28,4,13.454342644059432
72,95,The Mortuary Collection,100,63,2019.0,Horror/Fantasy,1:50,23,13.322564864824612
46,87,Starfish,100,62,2018.0,Drama/Horror,1:39,41,13.190000315557024
84,95,The Mole Agent,100,62,2020.0,Documentary,1:30,11,13.190000315557024
76,98,Beats,100,62,2019.0,Drama/Comedy,1:41,22,13.190000315557024
62,18,Playmobil: The Movie,100,62,2019.0,Kids and family/Comedy,1:39,-44,13.190000315557024
44,62,Satanic Panic,100,61,2019.0,Comedy/Horror,1:28,18,13.056631493342596
58,97,Harpoon,100,61,2019.0,Mystery and thriller/Comedy,1:23,39,13.056631493342596
75,78,The Inventor: Out for Blood in Silicon Valley,100,60,2019.0,Documentary,1:59,3,12.922440211617326
73,82,To the Stars,100,60,2019.0,Gay and lesbian/Drama,1:51,9,12.922440211617326
82,92,Miles Davis: Birth of the Cool,100,59,2019.0,Music/Documentary,1:55,10,12.78740756158519
37,62,The Secrets We Keep,100,58,2020.0,Mystery and thriller,1:38,25,12.651513870765422
80,98,Circus of Books,100,57,2019.0,Gay and lesbian/Biography,1:32,18,12.514738658402138
73,68,Fisherman's Friends,100,56,2019.0,Drama/Comedy,1:52,-5,12.377060587439436
50,75,Archenemy,100,56,2020.0,Mystery and thriller/Action,1:30,25,12.377060587439436
48,39,Nostalgia,100,56,2018.0,Drama,1:54,-9,12.377060587439436
64,84,Scare Me,100,55,2020.0,Horror,1:44,20,12.238457412731087
78,87,Yellow Rose,100,55,2019.0,Music/Drama,1:35,9,12.238457412731087
34,29,The Captive,100,55,2014.0,Mystery and thriller,1:52,-5,12.238457412731087
62,89,Banana Split,100,54,2018.0,Comedy,1:28,27,12.098905925115496
60,81,VFW,100,54,2019.0,Mystery and thriller/Action,1:32,21,12.098905925115496
62,83,The Divine Order,100,54,2017.0,Drama/History,1:36,21,12.098905925115496
36,24,Inheritance,100,54,2020.0,Mystery and thriller,1:51,-12,12.098905925115496
64,44,Robert the Bruce,100,52,2019.0,Drama/History,2:04,-20,11.8168599865911
38,67,Golden Exits,100,52,2017.0,Drama,1:34,29,11.8168599865911
57,69,The Command,100,51,2018.0,Drama,1:57,12,11.674313727451958
58,71,Aniara,100,51,2018.0,Sci fi/Drama,1:46,13,11.674313727451958
66,92,A Good Woman Is Hard to Find,100,51,2019.0,Drama/Crime,1:37,26,11.674313727451958
66,69,Rent-a-Pal,100,51,2020.0,Mystery and thriller,1:48,3,11.674313727451958
79,90,Divide and Conquer: The Story of Roger Ailes,100,51,2018.0,Documentary,1:47,11,11.674313727451958
66,94,Hunter Hunter,100,50,2020.0,Mystery and thriller/Horror,1:33,28,11.530715390799685
32,60,Tyrel,100,50,2018.0,Drama/Comedy,1:26,28,11.530715390799685
48,52,An Evening With Beverly Luff Linn,100,50,2018.0,Comedy,1:48,4,11.530715390799685
42,70,The Kill Team,100,50,2019.0,War/Drama,1:27,28,11.530715390799685
31,63,The Owners,100,49,2020.0,Mystery and thriller,1:32,32,11.3860359318845
45,49,A Kid Like Jake,100,49,2018.0,Drama,1:32,4,11.3860359318845
60,88,Claire's Camera,100,49,2017.0,Comedy/Drama,1:09,28,11.3860359318845
64,90,Framing John DeLorean,100,48,2019.0,Documentary,1:49,26,11.240244892502977
56,46,Spell,100,48,2020.0,Horror/Mystery and thriller,1:31,-10,11.240244892502977
86,96,Dating Amber,100,48,2020.0,Drama/Gay and lesbian,1:32,10,11.240244892502977
50,43,Sergio,100,47,2020.0,Drama,1:58,-7,11.093310301199846
25,68,Happily,100,47,2021.0,Comedy/Romance,1:36,43,11.093310301199846
83,98,Ryuichi Sakamoto: Coda,100,47,2017.0,Music/Documentary,1:41,15,11.093310301199846
82,72,A Call to Spy,100,47,2019.0,Drama/History,2:04,-10,11.093310301199846
89,94,The Great Buster: A Celebration,100,47,2018.0,Documentary,1:42,5,11.093310301199846
89,91,Rumble: The Indians Who Rocked the World,100,46,2017.0,Music/Documentary,1:43,2,10.945198564139895
64,78,Lu Over the Wall,100,46,2017.0,Comedy/Adventure,1:47,14,10.945198564139895
65,91,Uncorked,100,46,2020.0,Drama,1:44,26,10.945198564139895
49,70,Puppet Master: The Littlest Reich,100,46,2018.0,Horror,1:30,21,10.945198564139895
91,98,Rodents of Unusual Size,100,46,2017.0,Documentary,1:11,7,10.945198564139895
59,54,Swimming With Men,100,46,2018.0,Comedy,1:37,-5,10.945198564139895
63,73,Back to Burgundy,100,45,2017.0,Drama/Comedy,1:53,10,10.795874345554918
96,59,Fatima,100,44,2020.0,Drama/History,1:53,-37,10.645300436514761
44,77,Nightmare Cinema,100,44,2018.0,Horror,1:59,33,10.645300436514761
91,100,A Secret Love,100,44,2020.0,Drama/Gay and lesbian,1:23,9,10.645300436514761
25,36,Primal,100,44,2019.0,Action,1:37,11,10.645300436514761
68,53,Freak Show,100,43,2017.0,Drama/Gay and lesbian,1:31,-15,10.493437610589469
29,84,Mohawk,100,43,2017.0,History/Drama,1:31,55,10.493437610589469
73,62,Edie,100,42,2017.0,Drama,1:42,-11,10.34024446475599
24,33,Death of Me,100,42,2020.0,Horror/Mystery and thriller,1:34,9,10.34024446475599
42,39,Ghosts of War,100,41,2020.0,Horror/Mystery and thriller,1:35,-3,10.185677243651742
84,90,Itzhak,100,40,2017.0,Music/Documentary,1:23,6,10.029689644980788
60,83,That Summer,100,40,2017.0,Documentary,1:20,23,10.029689644980788
55,50,Earthquake Bird,100,40,2019.0,Drama/Crime,1:47,-5,10.029689644980788
71,90,Pin Cushion,100,40,2017.0,Drama,1:22,19,10.029689644980788
56,87,A Poem Is a Naked Person,100,39,1974.0,Music/Documentary,1:30,31,9.872232603526719
30,67,Bitch,100,39,2017.0,Comedy,1:36,37,9.872232603526719
77,100,Harmonium,100,39,2016.0,Drama,1:58,23,9.872232603526719
85,79,Bad Reputation,100,38,2018.0,Music/Documentary,1:35,-6,9.713254050808038
31,13,Kings,100,38,2017.0,Drama,1:27,-18,9.713254050808038
58,76,Rejoice & Shout,100,38,2010.0,Documentary,1:55,18,9.713254050808038
82,92,They'll Love Me When I'm Dead,100,37,2018.0,Documentary,1:38,10,9.552698646911638
72,89,Give Me Liberty,100,37,2019.0,Drama/Comedy,1:50,17,9.552698646911638
41,57,Duck Butter,100,37,2018.0,Drama/Gay and lesbian,1:33,16,9.552698646911638
36,41,Gauguin: Voyage to Tahiti,100,37,2017.0,Drama/Biography,1:42,5,9.552698646911638
52,62,Entanglement,100,37,2017.0,Romance,1:25,10,9.552698646911638
60,54,All Day and a Night,100,37,2020.0,Drama,2:01,-6,9.552698646911638
39,76,I Trapped the Devil,100,37,2019.0,Horror/Other,1:22,37,9.552698646911638
90,100,Bathtubs Over Broadway,100,36,2018.0,Documentary,1:27,10,9.390507480439723
20,0,Stratton,100,36,2017.0,Mystery and thriller/Action,1:35,-20,9.390507480439723
88,97,Tell Me Who I Am,100,36,2019.0,Drama,1:25,9,9.390507480439723
80,97,Tehran Taboo,100,36,2017.0,Drama/Animation,1:36,17,9.390507480439723
49,89,After Midnight,100,36,2019.0,Horror,1:23,40,9.390507480439723
59,44,Madame,100,36,2017.0,Romance,1:31,-15,9.390507480439723
58,92,Beetle Queen Conquers Tokyo,100,36,2009.0,Documentary,1:30,34,9.390507480439723
30,44,Evergreen,100,36,2004.0,Drama,1:27,14,9.390507480439723
80,89,Joan Didion: The Center Will Not Hold,100,35,2017.0,Documentary,1:34,9,9.22661773178138
75,74,Super Size Me 2: Holy Chicken!,100,35,2017.0,Documentary,1:33,-1,9.22661773178138
58,37,Patrick,100,35,2018.0,Comedy,1:34,-21,9.22661773178138
70,69,Eric Clapton: Life in 12 Bars,100,35,2017.0,Music/Documentary,2:15,-1,9.22661773178138
18,9,Force of Nature,100,35,2020.0,Mystery and thriller/Action,1:31,-9,9.22661773178138
73,71,Danger Close: The Battle of Long Tan,100,35,2019.0,Drama/History,1:58,-2,9.22661773178138
82,80,Scare Package,100,35,2019.0,Comedy/Horror,1:43,-2,9.22661773178138
64,94,The Rape of Recy Taylor,100,35,2017.0,Drama,1:31,30,9.22661773178138
39,79,Buffalo Boys,100,34,2018.0,Western/Adventure,1:42,40,9.060962294042406
84,82,Quincy,100,34,2018.0,Music/Documentary,2:04,-2,9.060962294042406
70,56,Mortal,100,34,2020.0,Mystery and thriller/Fantasy,1:44,-14,9.060962294042406
66,85,Vazante,100,34,2017.0,Drama/History,1:56,19,9.060962294042406
59,68,Come Sunday,100,34,2018.0,Biography/Drama,1:46,9,9.060962294042406
31,38,Point Blank,100,34,2019.0,Action/Mystery and thriller,1:26,7,9.060962294042406
79,79,The China Hustle,100,34,2017.0,Documentary,1:24,0,9.060962294042406
26,36,Ardor,100,33,2014.0,Adventure/Mystery and thriller,1:40,10,8.893469344897873
71,12,An Acceptable Loss,100,33,2018.0,Mystery and thriller,1:42,-59,8.893469344897873
68,67,Manolo: The Boy Who Made Shoes for Lizards,100,33,2017.0,Documentary,1:29,-1,8.893469344897873
76,97,People's Republic of Desire,100,33,2018.0,Documentary,1:35,21,8.893469344897873
70,70,Abe,100,33,2019.0,Comedy/Drama,1:25,0,8.893469344897873
89,97,Harold and Lillian: A Hollywood Love Story,100,33,2015.0,Documentary,1:34,8,8.893469344897873
70,69,Adopt a Highway,100,32,2019.0,Drama,1:21,-1,8.724061861322062
38,81,Midnighters,100,32,2017.0,Other/Horror,1:34,43,8.724061861322062
67,88,October Country,100,32,2009.0,Documentary,1:20,21,8.724061861322062
65,97,Mavis!,100,32,2015.0,Biography/Music,1:20,32,8.724061861322062
29,19,The Haunting of Sharon Tate,100,32,2019.0,Horror/Mystery and thriller,1:34,-10,8.724061861322062
37,69,Triple Threat,100,32,2019.0,Sports and fitness/Action,1:36,32,8.724061861322062
62,94,Old Stone,100,31,2016.0,Drama/Mystery and thriller,1:20,32,8.552657067536824
84,77,Full Battle Rattle,100,31,2008.0,Documentary,1:32,-7,8.552657067536824
74,100,The World Before Your Feet,100,31,2018.0,Documentary,1:35,26,8.552657067536824
51,74,Danny Says,100,31,2015.0,Documentary/Music,1:44,23,8.552657067536824
74,90,Portrait of Wally,100,31,2012.0,Documentary,1:30,16,8.552657067536824
42,32,2067,100,31,2020.0,Sci fi/Mystery and thriller,1:54,-10,8.552657067536824
40,61,The New Romantic,100,31,2018.0,Romance,1:22,21,8.552657067536824
44,68,The Decent One,100,31,2014.0,Documentary/Drama,1:34,24,8.552657067536824
74,77,Strange Powers: Stephin Merritt and the Magnetic Fields,100,31,2010.0,Documentary,1:24,3,8.552657067536824
55,20,The Death and Life of John F. Donovan,100,30,2018.0,Drama,2:03,-35,8.379165804519056
44,100,Babylon,100,30,1980.0,Drama,1:35,56,8.379165804519056
16,37,State Like Sleep,100,30,2018.0,Drama/Mystery and thriller,1:44,21,8.379165804519056
61,70,Roxanne Roxanne,100,30,2017.0,Biography/Music,1:38,9,8.379165804519056
29,27,Five Nights in Maine,100,30,2015.0,Drama,1:24,-2,8.379165804519056
72,90,Afternoon of a Faun: Tanaquil Le Clercq,100,30,2013.0,Documentary,1:31,18,8.379165804519056
69,48,The Cartel,100,29,2009.0,Documentary,1:30,-21,8.20349180691225
55,55,Half Magic,100,29,2018.0,Romance,1:40,0,8.20349180691225
78,90,One Week and a Day,100,29,2016.0,Drama,1:38,12,8.20349180691225
76,93,Saturday Church,100,29,2017.0,Gay and lesbian/Drama,1:22,17,8.20349180691225
51,93,Hagazussa: A Heathen's Curse,100,29,2017.0,Horror,1:42,42,8.20349180691225
78,72,Dumbstruck,100,29,2010.0,Documentary,1:25,-6,8.20349180691225
80,96,Becoming Astrid,100,28,2018.0,Drama/Biography,2:03,16,8.02553087005176
79,39,Blue Iguana,100,28,2018.0,Comedy,1:48,-40,8.02553087005176
51,75,Flammable Children,100,28,2018.0,Comedy,1:37,24,8.02553087005176
69,75,Anchor and Hope,100,28,2017.0,Drama/Gay and lesbian,1:53,6,8.02553087005176
97,96,Better Days,100,28,2019.0,Drama,2:15,-1,8.02553087005176
52,75,The Long Dumb Road,100,28,2018.0,Comedy,1:30,23,8.02553087005176
20,21,October Gale,100,28,2014.0,Drama/Mystery and thriller,1:31,1,8.02553087005176
56,61,Jonathan,100,28,2018.0,Sci fi/Drama,1:41,5,8.02553087005176
73,96,The Death and Life of Marsha P. Johnson,100,28,2017.0,Documentary,1:45,23,8.02553087005176
28,57,They Remain,100,28,2017.0,Horror/Mystery and thriller,1:42,29,8.02553087005176
45,33,Wolves,100,27,2016.0,Drama,1:50,-12,7.845169885845621
26,33,Loitering With Intent,100,27,2014.0,Drama/Comedy,1:15,7,7.845169885845621
60,85,Sollers Point,100,27,2017.0,Drama,1:41,25,7.845169885845621
69,30,Little Women,100,27,2018.0,Drama,1:52,-39,7.845169885845621
46,85,Harry Benson: Shoot First,100,27,2016.0,Documentary,1:27,39,7.845169885845621
64,78,Behind the Burly Q,100,27,2010.0,Documentary,1:37,14,7.845169885845621
71,96,Karl Marx City,100,26,2016.0,Documentary,1:29,25,7.662285721192069
86,92,In Search of Greatness,100,26,2018.0,Documentary,1:20,6,7.662285721192069
76,96,John Mulaney & The Sack Lunch Bunch,100,26,2019.0,Comedy/Kids and family,1:10,20,7.662285721192069
72,58,Have a Good Trip: Adventures in Psychedelics,100,26,2020.0,Documentary,,-14,7.662285721192069
86,85,God Knows Where I Am,100,26,2016.0,Documentary,1:39,-1,7.662285721192069
74,58,Crown Vic,100,26,2019.0,Mystery and thriller/Action,1:40,-16,7.662285721192069
46,58,May in the Summer,100,26,2013.0,Comedy/Drama,1:37,12,7.662285721192069
49,42,Whisky Galore!,100,26,2016.0,Comedy,1:39,-7,7.662285721192069
55,23,Otherhood,100,26,2019.0,Comedy,1:40,-32,7.662285721192069
33,85,Hermia & Helena,100,26,2016.0,Comedy/Drama,1:27,52,7.662285721192069
47,40,All We Had,100,25,2016.0,Drama,1:45,-7,7.476743906106103
60,84,Women Art Revolution,100,25,2010.0,Documentary,1:23,24,7.476743906106103
35,64,St. Agatha,100,25,2018.0,Horror/Mystery and thriller,1:30,29,7.476743906106103
39,24,Running With the Devil,100,25,2019.0,Drama/Crime,1:40,-15,7.476743906106103
55,40,El Chicano,100,25,2018.0,Mystery and thriller/Action,1:47,-15,7.476743906106103
60,72,Nancy Drew and the Hidden Staircase,100,25,2019.0,Adventure/Mystery and thriller,1:29,12,7.476743906106103
50,88,La Sapienza,100,25,2014.0,Drama,1:37,38,7.476743906106103
42,16,Dear Dictator,100,25,2017.0,Comedy,1:30,-26,7.476743906106103
9,21,Looking Glass,100,24,2018.0,Mystery and thriller,1:44,12,7.288397090280924
10,4,211,100,24,2018.0,Mystery and thriller/Action,1:23,-6,7.288397090280924
57,92,Deidra & Laney Rob a Train,100,24,2017.0,Drama/Crime,1:20,35,7.288397090280924
48,38,Backstabbing for Beginners,100,24,2018.0,Drama/Mystery and thriller,1:48,-10,7.288397090280924
64,63,Planet of the Humans,100,24,2019.0,Documentary,1:40,-1,7.288397090280924
78,100,Mercury 13,100,24,2018.0,Documentary,1:19,22,7.288397090280924
50,71,Web Junkie,100,24,2013.0,Drama/Biography,1:14,21,7.288397090280924
75,58,Django,100,24,2017.0,Music/Drama,1:55,-17,7.288397090280924
81,92,Pelican Dreams,100,24,2014.0,Documentary,1:20,11,7.288397090280924
42,79,Beyond Clueless,100,24,2014.0,Drama,1:29,37,7.288397090280924
96,96,Springsteen on Broadway,100,24,2018.0,,,0,7.288397090280924
91,88,Budrus,100,24,2009.0,Documentary/Biography,1:18,-3,7.288397090280924
73,75,Andre Gregory: Before and After Dinner,100,24,2013.0,Documentary,1:48,2,7.288397090280924
68,83,Urok,100,23,2014.0,Drama,1:47,15,7.097083215743026
86,78,El último traje,100,23,2017.0,Drama/Comedy,1:32,-8,7.097083215743026
46,61,The Occupant,100,23,2020.0,Drama/Mystery and thriller,1:43,15,7.097083215743026
36,57,Slice,100,23,2018.0,Horror/Comedy,1:23,21,7.097083215743026
33,65,Still/Born,100,23,2017.0,Mystery and thriller/Horror,1:27,32,7.097083215743026
63,83,Level 16,100,23,2018.0,Mystery and thriller/Sci fi,1:42,20,7.097083215743026
38,4,Jacob's Ladder,100,23,2019.0,Mystery and thriller,1:29,-34,7.097083215743026
42,30,The Legacy of a Whitetail Deer Hunter,100,23,2018.0,Comedy/Drama,1:23,-12,7.097083215743026
64,61,Mad to Be Normal,100,23,2017.0,Biography/Drama,1:46,-3,7.097083215743026
73,96,"Bikram: Yogi, Guru, Predator",100,23,2019.0,Documentary/Drama,1:26,23,7.097083215743026
43,52,The Forgiven,100,23,2017.0,Drama/Mystery and thriller,1:55,9,7.097083215743026
80,78,Big Boys Gone Bananas!,100,23,2011.0,Documentary/Biography,1:30,-2,7.097083215743026
62,78,Cupcakes,100,23,2013.0,Comedy/Gay and lesbian,1:32,16,7.097083215743026
44,9,Despite the Falling Snow,100,22,2016.0,Romance/Mystery and thriller,1:33,-35,6.9026233386080005
44,14,Krystal,100,22,2017.0,Drama/Comedy,1:33,-30,6.9026233386080005
67,77,American Folk,100,22,2017.0,Drama/Music,1:39,10,6.9026233386080005
82,91,Jinn,100,22,2018.0,Drama,1:31,9,6.9026233386080005
85,82,The Opening Act,100,22,2020.0,Comedy,1:30,-3,6.9026233386080005
43,59,Walt & El Grupo,100,22,2008.0,Documentary,1:46,16,6.9026233386080005
59,14,Damascus Cover,100,22,2017.0,Mystery and thriller/Action,1:33,-45,6.9026233386080005
85,41,The Big Ugly,100,22,2020.0,Drama/Crime,1:46,-44,6.9026233386080005
50,86,Time Share,100,22,2018.0,Drama,1:36,36,6.9026233386080005
48,64,Kaleidoscope,100,22,2016.0,Mystery and thriller,1:40,16,6.9026233386080005
47,82,Meeting Resistance,100,22,2007.0,Documentary,1:24,35,6.9026233386080005
40,52,Elizabeth Harvest,100,21,2018.0,Sci fi/Mystery and thriller,1:48,12,6.704819013328363
44,86,Bestiaire,100,21,2012.0,Documentary,1:12,42,6.704819013328363
38,76,Second Coming,100,21,2014.0,Drama,1:45,38,6.704819013328363
64,90,Never Grow Old,100,21,2019.0,Western/Mystery and thriller,1:40,26,6.704819013328363
64,29,Hammer of the Gods,100,21,2013.0,Drama/History,1:39,-35,6.704819013328363
19,48,Red Christmas,100,21,2016.0,Other/Horror,1:22,29,6.704819013328363
36,67,Helen,100,21,2008.0,Drama,1:19,31,6.704819013328363
37,24,The Postcard Killings,100,21,2020.0,Mystery and thriller,1:44,-13,6.704819013328363
60,90,My Great Night,100,21,2015.0,Comedy,1:38,30,6.704819013328363
84,100,Planet Earth: One Amazing Day,100,21,2017.0,Documentary,1:35,16,6.704819013328363
68,100,Ali Wong: Hard Knock Wife,100,21,2018.0,,,32,6.704819013328363
70,57,Dancing Across Borders,100,21,2009.0,Documentary,1:28,-13,6.704819013328363
22,57,War Story,100,21,2014.0,Drama,1:30,35,6.704819013328363
51,76,Monster Party,100,21,2018.0,Horror/Mystery and thriller,1:29,25,6.704819013328363
33,71,The Ice Cream Truck,100,21,2017.0,Comedy/Horror,1:36,38,6.704819013328363
81,67,My Father and the Man in Black,100,21,2012.0,Documentary,1:30,-14,6.704819013328363
56,71,Prince,100,21,2015.0,Drama,1:18,15,6.704819013328363
33,62,La Maison de la radio,100,21,2013.0,Documentary,1:39,29,6.704819013328363
58,14,Redemption Day,100,21,2021.0,Mystery and thriller/Action,1:40,-44,6.704819013328363
37,33,Who Killed Nancy?,100,21,2009.0,Documentary/Music,1:40,-4,6.704819013328363
22,10,Happy Family,100,21,2017.0,Comedy/Animation,1:36,-12,6.704819013328363
31,40,Only,100,20,2019.0,Mystery and thriller,1:38,9,6.503449126242364
76,55,Can We Take a Joke?,100,20,2015.0,Documentary,1:15,-21,6.503449126242364
81,85,First Match,100,20,2018.0,Drama,1:42,4,6.503449126242364
22,0,John Henry,100,20,2020.0,Drama/Mystery and thriller,1:31,-22,6.503449126242364
62,95,The World Is Yours,100,20,2018.0,Drama/Crime,,33,6.503449126242364
62,95,It's Not Yet Dark,100,20,2016.0,Documentary,1:17,33,6.503449126242364
75,85,Defamation,100,20,2009.0,Documentary,1:31,10,6.503449126242364
34,50,Brave New Jersey,100,20,2016.0,Comedy,1:31,16,6.503449126242364
49,45,Youth in Oregon,100,20,2016.0,Drama/Comedy,1:39,-4,6.503449126242364
43,50,Blood Fest,100,20,2018.0,Horror/Comedy,1:30,7,6.503449126242364
88,95,Becks,100,20,2017.0,Music/Drama,1:31,7,6.503449126242364
61,70,The Outrageous Sophie Tucker,100,20,2014.0,Documentary,1:36,9,6.503449126242364
47,60,Running From Crazy,100,20,2012.0,Drama/Biography,1:45,13,6.503449126242364
56,85,Violet,100,20,2014.0,Drama,1:22,29,6.503449126242364
7,35,24 Exposures,100,20,2013.0,Mystery and thriller,1:17,28,6.503449126242364
47,95,Tikkun,100,20,2015.0,Drama,2:00,48,6.503449126242364
73,70,Buena Vista Social Club: Adiós,100,20,2017.0,Music/Documentary,1:50,-3,6.503449126242364
72,75,Hair High,100,20,2004.0,Comedy/Animation,1:18,3,6.503449126242364
51,35,The Female Brain,100,20,2017.0,Romance,1:40,-16,6.503449126242364
67,80,Eva Hesse,100,20,2016.0,Documentary/Biography,1:45,13,6.503449126242364
90,100,John Mulaney: Kid Gorgeous at Radio City,100,20,2018.0,Comedy/Stand up,1:04,10,6.503449126242364
64,60,Us and Them,100,20,2017.0,Drama/Crime,1:23,-4,6.503449126242364
62,65,Days of Grace,100,20,2011.0,Mystery and thriller,2:13,3,6.503449126242364
63,65,Hey Bartender!,100,20,2013.0,Documentary,1:32,2,6.503449126242364
89,90,The Sentence,100,20,2018.0,,,1,6.503449126242364
48,60,You Might Be the Killer,100,20,2018.0,Horror,2:00,12,6.503449126242364
53,50,The Free World,100,20,2016.0,Romance/Drama,1:40,-3,6.503449126242364
33,45,Military Intelligence and You!,100,20,2006.0,Comedy,1:18,12,6.503449126242364
43,68,"Rabin, the Last Day",100,19,2015.0,Drama,2:33,25,6.298266028731006
79,95,Li and the Poet,100,19,2011.0,Drama,1:32,16,6.298266028731006
59,32,Irreplaceable You,100,19,2018.0,Drama/Romance,1:36,-27,6.298266028731006
44,68,Head Count,100,19,2018.0,Horror/Mystery and thriller,1:30,24,6.298266028731006
69,84,Avengement,100,19,2019.0,Action,1:27,15,6.298266028731006
36,47,Preggoland,100,19,2014.0,Drama/Comedy,1:49,11,6.298266028731006
57,53,Bloodline,100,19,2018.0,Horror/Mystery and thriller,1:38,-4,6.298266028731006
52,63,The Odyssey,100,19,2016.0,Drama/Adventure,2:03,11,6.298266028731006
61,100,They Will Have to Kill Us First,100,19,2015.0,Documentary,1:45,39,6.298266028731006
71,42,Katie Says Goodbye,100,19,2016.0,Drama,1:28,-29,6.298266028731006
62,79,Mega Time Squad,100,19,2018.0,Adventure/Action,1:26,17,6.298266028731006
79,74,Bernard and Huey,100,19,2017.0,Drama/Comedy,1:30,-5,6.298266028731006
38,74,11 Minutes,100,19,2015.0,Mystery and thriller,1:21,36,6.298266028731006
25,5,The Courier,100,19,2019.0,Action,1:37,-20,6.298266028731006
50,89,The Iron Ministry,100,19,2014.0,Documentary,1:22,39,6.298266028731006
51,63,The Banana Splits Movie,100,19,2019.0,Horror,1:26,12,6.298266028731006
67,89,Sunday's Illness,100,19,2018.0,Drama,1:53,22,6.298266028731006
60,79,24 Days,100,19,2014.0,Drama,1:50,19,6.298266028731006
24,32,Inside,100,19,2016.0,Horror/Mystery and thriller,1:31,8,6.298266028731006
43,47,The Catechism Cataclysm,100,19,2011.0,Comedy,1:21,4,6.298266028731006
79,79,Runoff,100,19,2014.0,Drama,1:30,0,6.298266028731006
30,0,The Knot,100,19,2012.0,Romance,1:32,-30,6.298266028731006
44,42,The Girl King,100,19,2015.0,Biography/Drama,1:46,-2,6.298266028731006
15,16,Septic Man,100,19,2013.0,Horror,1:27,1,6.298266028731006
52,84,Charlotte Rampling: The Look,100,19,2011.0,Documentary,1:38,32,6.298266028731006
86,84,Force of Nature: The David Suzuki Movie,100,19,2010.0,Documentary,1:33,-2,6.298266028731006
84,89,I Am Lisa,100,19,2020.0,Horror/Mystery and thriller,1:32,5,6.298266028731006
29,63,Claire in Motion,100,19,2016.0,Drama/Mystery and thriller,1:23,34,6.298266028731006
23,17,Tasting Menu,100,18,2013.0,Drama/Comedy,1:27,-6,6.088990769440213
16,28,Rattlesnake,100,18,2019.0,Mystery and thriller,1:25,12,6.088990769440213
60,100,A Gray State,100,18,2017.0,Documentary,1:33,40,6.088990769440213
64,83,Don't Call Me Son,100,18,2016.0,Drama,1:22,19,6.088990769440213
95,61,Shooting Heroin,100,18,2019.0,Drama/Mystery and thriller,,-34,6.088990769440213
23,22,Bleeding Steel,100,18,2017.0,Sci fi/Mystery and thriller,1:50,-1,6.088990769440213
24,28,Mara,100,18,2018.0,Horror/Mystery and thriller,1:38,4,6.088990769440213
48,61,Policeman,100,18,2011.0,Drama,1:45,13,6.088990769440213
31,61,Bullet Head,100,18,2017.0,Drama/Crime,1:33,30,6.088990769440213
75,83,After Everything,100,18,2018.0,Romance,1:35,8,6.088990769440213
17,28,House of the Sleeping Beauties,100,18,2006.0,Drama,1:39,11,6.088990769440213
81,39,MFKZ,100,18,2017.0,Sci fi/Anime,1:30,-42,6.088990769440213
76,83,Our Man in Tehran,100,18,2013.0,Documentary,1:25,7,6.088990769440213
33,28,The Time Being,100,18,2012.0,Mystery and thriller,1:28,-5,6.088990769440213
73,61,Through a Lens Darkly: Black Photographers and the Emergence of a People,100,18,2014.0,Documentary,1:30,-12,6.088990769440213
53,67,Ancien and the Magic Tablet,100,18,2017.0,Anime/Drama,1:50,14,6.088990769440213
47,56,This Changes Everything,100,18,2015.0,Documentary,1:29,9,6.088990769440213
79,83,Saving Marriage,100,18,2006.0,Documentary/Gay and lesbian,1:30,4,6.088990769440213
58,72,Soul Boys of the Western World,100,18,2014.0,Documentary/Biography,1:50,14,6.088990769440213
76,89,It Came From Kuchar,100,18,2009.0,Comedy/Documentary,1:26,13,6.088990769440213
36,72,"If You Don't, I Will",100,18,2014.0,Comedy,1:42,36,6.088990769440213
33,39,Special Treatment,100,18,2010.0,Comedy/Drama,1:35,6,6.088990769440213
84,89,The Great Buddha+,100,18,2017.0,Comedy,1:44,5,6.088990769440213
88,89,The Desert of Forbidden Art,100,18,2010.0,Drama/Documentary,1:20,1,6.088990769440213
73,88,Social Animals,100,17,2018.0,Documentary,1:26,15,5.875307153057772
19,18,One Last Heist,100,17,2017.0,Drama/Crime,1:40,-1,5.875307153057772
61,47,Curvature,100,17,2017.0,Sci fi/Mystery and thriller,1:30,-14,5.875307153057772
66,65,WolfCop II,100,17,2016.0,Horror/Comedy,1:22,-1,5.875307153057772
61,88,Zoo,100,17,2017.0,Drama/War,1:37,27,5.875307153057772
67,88,Batman: Hush,100,17,2019.0,Adventure/Action,1:22,21,5.875307153057772
47,59,Klown Forever,100,17,2015.0,Comedy,1:39,12,5.875307153057772
44,71,Reset,100,17,2015.0,Documentary,1:50,27,5.875307153057772
46,65,Finding Altamira,100,17,2016.0,Drama/History,1:33,19,5.875307153057772
24,24,Stay,100,17,2013.0,Drama,1:39,0,5.875307153057772
89,88,The Witch: Part 1. The Subversion (Manyeo),100,17,2018.0,,,-1,5.875307153057772
38,29,Can You Keep a Secret?,100,17,2019.0,Romance,1:34,-9,5.875307153057772
12,29,Secret Obsession,100,17,2019.0,Drama/Mystery and thriller,1:37,17,5.875307153057772
38,59,Line of Duty,100,17,2019.0,Mystery and thriller/Action,1:39,21,5.875307153057772
78,0,The Music of Silence,100,17,2017.0,Music/Drama,2:10,-78,5.875307153057772
52,76,Jerry Seinfeld: 23 Hours to Kill,100,17,2020.0,Stand up/Comedy,1:00,24,5.875307153057772
25,47,Two Men in Town,100,17,2014.0,Drama,1:56,22,5.875307153057772
61,76,112 Weddings,100,17,2014.0,Documentary,1:35,15,5.875307153057772
83,100,Cousin Jules,100,17,1972.0,Documentary,1:31,17,5.875307153057772
79,88,"Louise Bourgeois: The Spider, the Mistress and the Tangerine",100,17,2008.0,Documentary,1:39,9,5.875307153057772
55,71,Uncertain Terms,100,17,2014.0,Comedy/Drama,1:15,16,5.875307153057772
46,94,The Cage Fighter,100,17,2017.0,Documentary,1:21,48,5.875307153057772
29,0,Speed Kills,100,17,2018.0,Drama/Action,1:42,-29,5.875307153057772
50,53,Good for Nothing,100,17,2012.0,Comedy/Western,1:32,3,5.875307153057772
73,88,Liberty Kid,100,17,2007.0,Drama,1:32,15,5.875307153057772
10,24,All Things to All Men,100,17,2012.0,Drama/Crime,1:24,14,5.875307153057772
77,88,A Small Act,100,17,2010.0,Documentary,1:28,11,5.875307153057772
45,94,SHOT! The Psycho-Spiritual Mantra of Rock,100,17,2016.0,Documentary/Music,1:35,49,5.875307153057772
62,94,Colliding Dreams,100,17,2015.0,Documentary,2:15,32,5.875307153057772
63,82,Juanita,100,17,2019.0,Drama,1:30,19,5.875307153057772
34,47,One & Two,100,17,2015.0,Drama/Mystery and thriller,1:30,13,5.875307153057772
33,47,A Christmas Prince: The Royal Wedding,100,17,2018.0,Romance,1:30,14,5.875307153057772
73,88,When I Walk,100,17,2013.0,Documentary,1:24,15,5.875307153057772
39,76,Stop the Pounding Heart,100,17,2013.0,Drama,1:41,37,5.875307153057772
89,94,The Pinochet Case,100,17,2001.0,Documentary,1:54,5,5.875307153057772
82,76,Plot for Peace,100,17,2013.0,Documentary/Mystery and thriller,1:24,-6,5.875307153057772
53,59,American Animal,100,17,2011.0,Comedy/Drama,1:35,6,5.875307153057772
85,100,Booker's Place: A Mississippi Story,100,17,2012.0,Documentary/Mystery and thriller,1:30,15,5.875307153057772
49,63,Applecart,100,16,2017.0,Horror,1:26,14,5.656854249492381
73,94,Number 37,100,16,2018.0,Mystery and thriller,1:40,21,5.656854249492381
44,94,The Last Impresario,100,16,2013.0,Biography,1:25,50,5.656854249492381
32,44,Quartet,100,16,1981.0,Drama,1:41,12,5.656854249492381
56,50,Feel the Beat,100,16,2020.0,Drama,1:49,-6,5.656854249492381
46,6,The Amityville Murders,100,16,2018.0,Horror/Mystery and thriller,1:38,-40,5.656854249492381
29,38,Tricked,100,16,2013.0,Documentary,1:20,9,5.656854249492381
46,94,Sand Dollars,100,16,2014.0,Gay and lesbian/Drama,1:24,48,5.656854249492381
66,69,Sunset Edge,100,16,2015.0,Drama/Mystery and thriller,1:23,3,5.656854249492381
57,94,Last Hijack,100,16,2014.0,Documentary,1:25,37,5.656854249492381
88,69,Babysplitters,100,16,2019.0,Comedy,1:59,-19,5.656854249492381
43,56,Septien,100,16,2011.0,Drama,1:19,13,5.656854249492381
79,88,The Law in These Parts,100,16,2011.0,Drama/History,1:41,9,5.656854249492381
76,81,Unlovable,100,16,2018.0,Drama/Comedy,1:20,5,5.656854249492381
23,44,Jackals,100,16,2016.0,Mystery and thriller,1:25,21,5.656854249492381
34,38,Let My People Go!,100,16,2011.0,Comedy,1:25,4,5.656854249492381
47,75,Antrum: The Deadliest Film Ever Made,100,16,2018.0,Horror,1:35,28,5.656854249492381
25,38,Devil's Gate,100,16,2018.0,Mystery and thriller,1:35,13,5.656854249492381
57,31,Welcome to Happiness,100,16,2015.0,Drama/Fantasy,1:48,-26,5.656854249492381
46,69,Cut Snake,100,16,2014.0,Drama/Crime,1:34,23,5.656854249492381
78,81,Soundtrack for a Revolution,100,16,2009.0,Music/Drama,1:22,3,5.656854249492381
68,81,Becoming Traviata,100,16,2012.0,Documentary/Music,1:53,13,5.656854249492381
75,63,"Philip Roth, Without Complexes",100,16,2011.0,Documentary/Biography,0:52,-12,5.656854249492381
15,13,McCanick,100,16,2013.0,Drama/Crime,1:36,-2,5.656854249492381
73,88,Off and Running,100,16,2009.0,Documentary,1:16,15,5.656854249492381
78,88,Shakespeare High,100,16,2011.0,Documentary,1:20,10,5.656854249492381
45,75,Dreams Rewired,100,16,2015.0,Documentary,1:28,30,5.656854249492381
15,0,Elfie Hopkins,100,16,2012.0,Horror/Mystery and thriller,1:29,-15,5.656854249492381
88,81,As the Palaces Burn,100,16,2014.0,Documentary/Music,2:00,-7,5.656854249492381
25,31,Crave,100,16,2012.0,Drama/Mystery and thriller,1:53,6,5.656854249492381
37,44,Used People,100,16,1992.0,Drama,1:55,7,5.656854249492381
24,25,Trap for Cinderella,100,16,2013.0,Drama,1:40,1,5.656854249492381
93,75,Alice Neel,100,16,2007.0,Documentary,1:22,-18,5.656854249492381
59,75,Our City Dreams,100,16,2008.0,Documentary,1:27,16,5.656854249492381
59,56,Waveriders,100,16,2008.0,Documentary/Biography,1:20,-3,5.656854249492381
58,80,Cyber-Seniors,100,15,2013.0,Documentary,1:15,22,5.433216825139731
40,87,Almayer's Folly,100,15,2011.0,Drama,2:07,47,5.433216825139731
76,100,Seeing Allred,100,15,2018.0,Documentary,1:36,24,5.433216825139731
20,7,7 Guardians of the Tomb,100,15,2018.0,Adventure/Fantasy,1:30,-13,5.433216825139731
40,53,Life's a Breeze,100,15,2013.0,Drama/Comedy,1:30,13,5.433216825139731
54,73,Payback,100,15,2012.0,Documentary,1:26,19,5.433216825139731
15,33,After the Fall,100,15,2014.0,Drama/Crime,1:50,18,5.433216825139731
38,13,The Greening of Whitney Brown,100,15,2011.0,Adventure,1:27,-25,5.433216825139731
32,27,Marfa Girl,100,15,2012.0,Drama,1:45,-5,5.433216825139731
75,73,Weekend of a Champion,100,15,1972.0,Documentary,1:33,-2,5.433216825139731
34,40,Blackwood,100,15,2014.0,Adventure/Mystery and thriller,1:30,6,5.433216825139731
81,40,The Dinner Party,100,15,2020.0,Horror,1:55,-41,5.433216825139731
36,53,The Last Laugh,100,15,2019.0,Comedy,1:38,17,5.433216825139731
41,60,Burn Country,100,15,2016.0,Drama/Mystery and thriller,1:43,19,5.433216825139731
47,67,Victor Crowley,100,15,2017.0,Horror/Comedy,1:22,20,5.433216825139731
57,93,Between the Lines,100,15,1977.0,Drama/Comedy,1:41,36,5.433216825139731
15,27,The Wilde Wedding,100,15,2017.0,Romance,1:36,12,5.433216825139731
42,67,The Great Museum,100,15,2014.0,Documentary,1:34,25,5.433216825139731
76,100,Riot in Cell Block 11,100,15,1954.0,Action,1:20,24,5.433216825139731
53,87,Kiss the Water,100,15,2013.0,Biography/Documentary,1:20,34,5.433216825139731
56,93,The Great Flood,100,15,2012.0,Documentary,1:16,37,5.433216825139731
43,60,In a Relationship,100,15,2018.0,Romance,1:32,17,5.433216825139731
48,67,My Father Die,100,15,2016.0,Action/Mystery and thriller,1:30,19,5.433216825139731
66,93,Rift,100,15,2017.0,Gay and lesbian/Drama,1:51,27,5.433216825139731
48,100,Jenny Slate: Stage Fright,100,15,2019.0,Stand up,,52,5.433216825139731
41,80,The Memory Thief,100,15,2007.0,Drama,1:35,39,5.433216825139731
50,67,Picasso and Braque Go to the Movies,100,15,2007.0,Documentary,1:00,17,5.433216825139731
50,67,One Track Heart: The Story of Krishna Das,100,15,2012.0,Documentary/Biography,1:14,17,5.433216825139731
63,47,White Knight,100,15,2011.0,Comedy,1:26,-16,5.433216825139731
66,53,Under the Electric Sky,100,15,2014.0,Documentary,1:25,-13,5.433216825139731
50,100,Of Men and War,100,15,2014.0,Documentary,2:22,50,5.433216825139731
61,93,The Last Race,100,15,2018.0,Documentary,1:14,32,5.433216825139731
48,87,At the Edge of the World,100,15,2008.0,Documentary,1:37,39,5.433216825139731
65,73,The Matador,100,15,2008.0,Documentary,1:15,8,5.433216825139731
76,50,Follow Me: The Yoni Netanyahu Story,100,14,2012.0,Documentary,1:27,-26,5.203912939677927
62,36,Hunting Elephants,100,14,2013.0,Comedy,1:47,-26,5.203912939677927
8,79,Amy Schumer Growing,100,14,2019.0,Comedy,1:00,71,5.203912939677927
98,100,Jump Shot: The Kenny Sailors Story,100,14,2019.0,Biography/Documentary,1:13,2,5.203912939677927
84,93,Seed: The Untold Story,100,14,2016.0,Documentary,1:34,9,5.203912939677927
63,93,Sample This,100,14,2012.0,Documentary,1:25,30,5.203912939677927
36,86,A Sinner in Mecca,100,14,2015.0,Gay and lesbian/Documentary,1:19,50,5.203912939677927
21,29,Lovesick,100,14,2014.0,Romance,1:24,8,5.203912939677927
26,43,The Sleepwalker,100,14,2014.0,Drama/Mystery and thriller,1:31,17,5.203912939677927
57,14,The Little Vampire,100,14,2017.0,Comedy/Adventure,1:23,-43,5.203912939677927
50,57,The Hippopotamus,100,14,2017.0,Comedy,1:29,7,5.203912939677927
81,43,The Good Catholic,100,14,2017.0,Drama/Romance,1:36,-38,5.203912939677927
12,7,There's Always Woodstock,100,14,2014.0,Romance,1:30,-5,5.203912939677927
36,71,Deep Blue Sea 3,100,14,2020.0,Sci fi/Horror,1:39,35,5.203912939677927
55,57,Return to Nuke 'Em High: Volume 1,100,14,2013.0,Horror/Comedy,1:25,2,5.203912939677927
70,100,Survivors Guide to Prison,100,14,2018.0,Documentary,1:42,30,5.203912939677927
55,7,Losing Control,100,14,2011.0,Romance,1:31,-48,5.203912939677927
27,21,Nerdland,100,14,2016.0,Animation/Comedy,1:23,-6,5.203912939677927
17,7,No Stranger Than Love,100,14,2015.0,Romance/Fantasy,1:29,-10,5.203912939677927
52,21,Shirin in Love,100,14,2014.0,Romance,1:44,-31,5.203912939677927
61,79,Before You Know It,100,14,2013.0,Documentary/Biography,1:52,18,5.203912939677927
4,7,Tomorrow You're Gone,100,14,2012.0,Mystery and thriller,1:31,3,5.203912939677927
66,43,The Duelist,100,14,2016.0,Mystery and thriller/Drama,1:49,-23,5.203912939677927
16,50,The Drowning,100,14,2016.0,Drama/Mystery and thriller,1:35,34,5.203912939677927
32,71,The Happy Sad,100,14,2013.0,Gay and lesbian/Drama,1:27,39,5.203912939677927
58,64,The Nun,100,14,2013.0,Drama,1:51,6,5.203912939677927
71,57,The VelociPastor,100,14,2018.0,Comedy/Action,1:15,-14,5.203912939677927
74,86,Shepard & Dark,100,14,2012.0,Drama,1:32,12,5.203912939677927
64,64,Iceberg Slim: Portrait of a Pimp,100,14,2012.0,Documentary/Biography,1:29,0,5.203912939677927
30,7,Don Peyote,100,14,2014.0,Comedy/Drama,1:30,-23,5.203912939677927
43,29,Jellyfish Eyes,100,14,2013.0,Adventure/Fantasy,1:43,-14,5.203912939677927
67,86,Class Rank,100,14,2017.0,Comedy,1:48,19,5.203912939677927
40,57,It's About You,100,14,2012.0,Documentary,1:20,17,5.203912939677927
44,57,Wild Rovers,100,14,1971.0,Western,2:16,13,5.203912939677927
46,64,Make-Out With Violence,100,14,2008.0,Romance,1:45,18,5.203912939677927
62,57,Food Beware: The French Organic Revolution,100,14,2008.0,Documentary,1:52,-5,5.203912939677927
17,7,Ghosted,100,14,2009.0,Drama/Mystery and thriller,1:32,-10,5.203912939677927
47,64,Last Summer in the Hamptons,100,14,1995.0,Comedy,1:45,17,5.203912939677927
78,92,From Nowhere,100,13,2016.0,Drama,1:29,14,4.968377601139757
72,100,Disturbing the Peace,100,13,2016.0,Documentary,1:23,28,4.968377601139757
79,92,Rebirth,100,13,2011.0,Documentary,1:44,13,4.968377601139757
57,77,Algorithms,100,13,2013.0,Documentary,1:40,20,4.968377601139757
36,46,A Year in Mooring,100,13,2011.0,Drama,1:28,10,4.968377601139757
53,54,Crash Pad,100,13,2017.0,Romance,1:33,1,4.968377601139757
17,8,Reprisal,100,13,2018.0,Mystery and thriller/Action,1:29,-9,4.968377601139757
36,0,Days and Nights,100,13,2013.0,Drama,1:32,-36,4.968377601139757
36,23,Black November,100,13,2012.0,Drama/Action,1:36,-13,4.968377601139757
85,85,Santoalla,100,13,2016.0,Mystery and thriller/Documentary,1:23,0,4.968377601139757
84,38,Farmland,100,13,2014.0,Documentary,1:17,-46,4.968377601139757
23,62,"Drive, He Said",100,13,1971.0,Drama,1:30,39,4.968377601139757
55,46,Heleno,100,13,2011.0,Biography,1:57,-9,4.968377601139757
25,23,Intruder,100,13,2016.0,Horror/Mystery and thriller,1:35,-2,4.968377601139757
39,38,Men at Lunch,100,13,2012.0,Documentary,1:11,-1,4.968377601139757
100,100,The Uncondemned,100,13,2015.0,Documentary,1:21,0,4.968377601139757
44,69,Savage Dog,100,13,2017.0,Drama/Action,1:35,25,4.968377601139757
15,15,Let's Be Evil,100,13,2016.0,Sci fi/Mystery and thriller,1:23,0,4.968377601139757
63,54,Sagrada - The Mystery of Creation,100,13,2012.0,Documentary,1:29,-9,4.968377601139757
44,31,Echoes of War,100,13,2015.0,Western/Drama,1:40,-13,4.968377601139757
39,15,Cookie,100,13,1989.0,Comedy,1:33,-24,4.968377601139757
54,85,Under the Boardwalk: The Monopoly Story,100,13,2010.0,Documentary,1:28,31,4.968377601139757
41,77,Salvation Army,100,13,2013.0,Gay and lesbian/Drama,1:22,36,4.968377601139757
71,85,The Wolf's Call,100,13,2019.0,War/Drama,1:55,14,4.968377601139757
58,69,Don't Tell a Soul,100,13,2020.0,Mystery and thriller,1:24,11,4.968377601139757
63,100,Patton Oswalt: Annihilation,100,13,2017.0,,,37,4.968377601139757
29,8,31 North 62 East,100,13,2009.0,Mystery and thriller,1:40,-21,4.968377601139757
81,77,A Will for the Woods,100,13,2013.0,Drama,1:42,-4,4.968377601139757
63,69,Lucha Mexico,100,13,2015.0,Documentary,1:45,6,4.968377601139757
49,62,Take Your Pills,100,13,2018.0,Documentary,1:27,13,4.968377601139757
42,92,In My Father's House,100,13,2015.0,Documentary,1:33,50,4.968377601139757
69,38,Milton's Secret,100,13,2016.0,Drama,1:28,-31,4.968377601139757
44,62,Most Likely to Murder,100,13,2018.0,Comedy,1:20,18,4.968377601139757
85,92,Wish Me Away,100,13,2011.0,Documentary/Gay and lesbian,1:36,7,4.968377601139757
62,31,Cas & Dylan,100,13,2013.0,Comedy/Drama,1:30,-31,4.968377601139757
80,31,Po,100,13,2016.0,Drama,1:34,-49,4.968377601139757
26,69,Loren Cass,100,13,2006.0,Drama,1:23,43,4.968377601139757
29,23,Enter the Dangerous Mind,100,13,2013.0,Mystery and thriller,1:28,-6,4.968377601139757
92,100,Among Wolves,100,13,2016.0,Documentary,1:34,8,4.968377601139757
66,77,Haemoo,100,13,2014.0,Drama/Mystery and thriller,1:51,11,4.968377601139757
56,77,May the Devil Take You,100,13,2018.0,Horror,1:50,21,4.968377601139757
55,46,Closer to the Moon,100,13,2013.0,Drama,1:50,-9,4.968377601139757
52,62,The Dish & the Spoon,100,13,2011.0,Comedy/Drama,1:32,10,4.968377601139757
62,85,Fly Away,100,13,2012.0,Drama,1:25,23,4.968377601139757
44,92,Viola,100,13,2012.0,Drama,1:05,48,4.968377601139757
72,62,Beside Still Waters,100,13,2013.0,Comedy/Romance,1:16,-10,4.968377601139757
18,15,Iowa,100,13,2006.0,Drama,1:44,-3,4.968377601139757
47,83,Evergreen: The Road to Legalization,100,12,2013.0,Documentary,1:26,36,4.725940818339814
63,67,Jews and Baseball: An American Love Story,100,12,2010.0,Documentary,1:30,4,4.725940818339814
73,67,The Lullaby,100,12,2017.0,Horror,2:05,-6,4.725940818339814
76,67,Winter in the Blood,100,12,2013.0,Drama,1:38,-9,4.725940818339814
35,33,The Rambler,100,12,2013.0,Drama/Horror,1:39,-2,4.725940818339814
38,50,Summer of Blood,100,12,2014.0,Horror,1:26,12,4.725940818339814
76,50,The Legend of Ben Hall,100,12,2016.0,History/Action,2:19,-26,4.725940818339814
69,92,Born to Fly: Elizabeth Streb vs. Gravity,100,12,2014.0,Biography/Action,1:22,23,4.725940818339814
61,83,The Messenger,100,12,2015.0,Documentary,1:30,22,4.725940818339814
59,67,A Short History of Decay,100,12,2013.0,Comedy,1:33,8,4.725940818339814
42,67,Lazy Eye,100,12,2016.0,Gay and lesbian/Drama,1:30,25,4.725940818339814
70,42,Let Fury Have the Hour,100,12,2011.0,Documentary,1:27,-28,4.725940818339814
30,25,Jack Goes Home,100,12,2016.0,Horror/Mystery and thriller,1:40,-5,4.725940818339814
46,67,Google Me,100,12,2007.0,Documentary,1:37,21,4.725940818339814
30,33,Officer Downe,100,12,2016.0,Fantasy/Action,1:31,3,4.725940818339814
39,50,"Fear, Inc.",100,12,2016.0,Comedy/Horror,1:31,11,4.725940818339814
47,67,The Automatic Hate,100,12,2015.0,Drama/Mystery and thriller,1:38,20,4.725940818339814
67,50,First Comes Love,100,12,2013.0,Documentary,1:46,-17,4.725940818339814
18,0,Armed Response,100,12,2017.0,Horror/Mystery and thriller,1:33,-18,4.725940818339814
24,0,A Beautiful Life,100,12,2008.0,Drama/Romance,1:21,-24,4.725940818339814
30,17,Be Afraid,100,12,2017.0,Sci fi/Mystery and thriller,1:39,-13,4.725940818339814
69,83,The Flaw,100,12,2011.0,Drama/History,1:22,14,4.725940818339814
36,50,Some Days Are Better Than Others,100,12,2010.0,Drama,1:33,14,4.725940818339814
65,100,The Damned: Don't You Wish That We Were Dead,100,12,2015.0,Biography,1:50,35,4.725940818339814
47,67,Villain,100,12,1971.0,Drama/Crime,1:38,20,4.725940818339814
21,8,Cherry Tree,100,12,2015.0,Horror,1:25,-13,4.725940818339814
69,92,Been So Long,100,12,2018.0,Musical,1:40,23,4.725940818339814
73,83,A Necessary Death,100,12,2008.0,Documentary,1:41,10,4.725940818339814
42,75,Cold Sweat,100,12,2010.0,Horror/Mystery and thriller,1:30,33,4.725940818339814
82,92,9500 Liberty,100,12,2009.0,Documentary,1:20,10,4.725940818339814
8,17,Jersey Shore Massacre,100,12,2014.0,Comedy/Horror,1:28,9,4.725940818339814
17,17,Twelve Thirty,100,12,2010.0,Drama,2:00,0,4.725940818339814
73,58,Second Opinion: Laetrile at Sloan-Kettering,100,12,2014.0,Documentary,1:16,-15,4.725940818339814
67,67,Here and There,100,12,2009.0,Comedy/Drama,1:25,0,4.725940818339814
59,58,The Editor,100,12,2014.0,Comedy/Horror,1:42,-1,4.725940818339814
48,17,A Country Called Home,100,12,2015.0,Drama,1:30,-31,4.725940818339814
54,17,I Do,100,12,2012.0,Comedy/Drama,1:31,-37,4.725940818339814
58,67,Never Apologize,100,12,2007.0,Documentary,1:51,9,4.725940818339814
48,9,Sundown,100,11,2016.0,Adventure/Romance,1:43,-39,4.475797488182033
65,91,The Unicorn,100,11,2018.0,Comedy,1:28,26,4.475797488182033
54,100,We Go On,100,11,2016.0,Drama/Horror,1:30,46,4.475797488182033
23,9,Dark House,100,11,2014.0,Horror/Mystery and thriller,1:43,-14,4.475797488182033
86,100,Mr. Dynamite: The Rise of James Brown,100,11,2014.0,,,14,4.475797488182033
9,18,Big Sky,100,11,2015.0,Drama/Mystery and thriller,1:30,9,4.475797488182033
80,100,Recovery Boys,100,11,2018.0,Documentary,1:29,20,4.475797488182033
47,27,No Escape,100,11,2020.0,Mystery and thriller/Horror,1:31,-20,4.475797488182033
79,91,All Square,100,11,2018.0,Comedy,1:33,12,4.475797488182033
25,18,Narcopolis,100,11,2014.0,Sci fi/Mystery and thriller,1:36,-7,4.475797488182033
49,36,Attraction,100,11,2017.0,Sci fi/Drama,2:17,-13,4.475797488182033
38,55,Attack of the Lederhosen Zombies,100,11,2016.0,Horror/Comedy,1:18,17,4.475797488182033
47,36,Flock of Dudes,100,11,2016.0,Comedy,1:30,-11,4.475797488182033
24,45,Missionary,100,11,2013.0,Mystery and thriller,1:30,21,4.475797488182033
38,0,Gun Shy,100,11,2017.0,Action/Comedy,1:26,-38,4.475797488182033
41,18,Scorched Earth,100,11,2018.0,Action,1:34,-23,4.475797488182033
25,55,Acts of Vengeance,100,11,2017.0,Action,1:26,30,4.475797488182033
90,45,So B. It,100,11,2016.0,Drama,1:38,-45,4.475797488182033
25,9,Backtrace,100,11,2018.0,Mystery and thriller/Action,1:27,-16,4.475797488182033
80,73,M.O.M. (Mothers of Monsters),100,11,2020.0,Mystery and thriller,1:38,-7,4.475797488182033
60,64,Sophie and the Rising Sun,100,11,2016.0,Drama/Romance,1:56,4,4.475797488182033
70,18,My Best Enemy,100,11,2011.0,Drama/History,1:45,-52,4.475797488182033
36,27,The Last Sharknado: It's About Time,100,11,2018.0,Sci fi/Comedy,1:30,-9,4.475797488182033
81,100,A Tuba to Cuba,100,11,2018.0,Music/Documentary,1:24,19,4.475797488182033
72,82,When I Saw You,100,11,2012.0,Drama,1:33,10,4.475797488182033
29,27,Murder of a Cat,100,11,2014.0,Comedy/Mystery and thriller,1:36,-2,4.475797488182033
79,100,Chameleon,100,11,2019.0,Mystery and thriller,1:20,21,4.475797488182033
39,100,Egg,100,11,2018.0,Comedy,1:23,61,4.475797488182033
59,55,Decoding Deepak,100,11,2012.0,Documentary,1:23,-4,4.475797488182033
49,64,Last Rampage,100,11,2017.0,Drama/Crime,1:33,15,4.475797488182033
30,9,ClownTown,100,11,2016.0,Horror/Mystery and thriller,1:26,-21,4.475797488182033
70,91,I Am Thor,100,11,2015.0,Biography,1:24,21,4.475797488182033
34,9,The Unspoken,100,11,2015.0,Horror/Mystery and thriller,1:31,-25,4.475797488182033
35,100,Lyle,100,11,2014.0,Gay and lesbian/Drama,1:05,65,4.475797488182033
65,82,Laila's Birthday,100,11,2008.0,Comedy/Drama,1:11,17,4.475797488182033
61,45,Little Red Wagon,100,11,2012.0,Drama,1:44,-16,4.475797488182033
57,27,Craptastic!,100,11,2011.0,Documentary,1:29,-30,4.475797488182033
36,36,Sugar Mountain,100,11,2016.0,Drama/Mystery and thriller,1:46,0,4.475797488182033
86,100,Transformer,100,11,2017.0,Documentary,1:19,14,4.475797488182033
36,100,"One Cut, One Life",100,11,2014.0,Biography,1:47,64,4.475797488182033
89,100,The American Nurse,100,11,2013.0,Documentary,1:21,11,4.475797488182033
56,64,The Cold Lands,100,11,2013.0,Drama,1:41,8,4.475797488182033
85,91,Valentine Road,100,11,2013.0,Documentary/Gay and lesbian,1:29,6,4.475797488182033
26,45,Restless City,100,11,2011.0,Drama,1:20,19,4.475797488182033
49,91,Fake It So Real,100,11,2011.0,Documentary,1:34,42,4.475797488182033
51,9,Run the Tide,100,11,2016.0,Drama,1:40,-42,4.475797488182033
47,55,Speech & Debate,100,11,2017.0,Comedy,1:55,8,4.475797488182033
18,55,The Pack,100,11,2015.0,Horror/Mystery and thriller,1:30,37,4.475797488182033
44,73,Blinky Bill the Movie,100,11,2015.0,Kids and family/Comedy,1:33,29,4.475797488182033
21,55,See You in the Morning,100,11,1989.0,Romance,1:59,34,4.475797488182033
33,64,The Patrol,100,11,2013.0,War/Drama,1:23,31,4.475797488182033
82,100,Everlasting,100,11,2016.0,Romance/Drama,1:25,18,4.475797488182033
78,36,Yogawoman,100,11,2011.0,Documentary,1:24,-42,4.475797488182033
50,45,Black Out,100,11,2012.0,Drama/Action,1:32,-5,4.475797488182033
71,18,Just 45 Minutes From Broadway,100,11,2012.0,Drama,1:52,-53,4.475797488182033
50,73,The Happy Poet,100,11,2010.0,Comedy/Drama,1:25,23,4.475797488182033
84,64,The Human Scale,100,11,2012.0,Documentary,1:23,-20,4.475797488182033
92,100,Semper Fi: Always Faithful,100,11,2011.0,Documentary,1:15,8,4.475797488182033
29,36,Give Me Your Hand,100,11,2004.0,Documentary,2:02,7,4.475797488182033
27,36,Code Name: Geronimo,100,11,2012.0,,,9,4.475797488182033
14,45,Morning,100,11,2010.0,Drama,1:35,31,4.475797488182033
63,73,Sushi: The Global Catch,100,11,2011.0,Documentary,1:15,10,4.475797488182033
57,73,Kings of the Evening,100,11,2007.0,Drama,1:40,16,4.475797488182033
86,100,Rio Breaks,100,11,2009.0,Documentary,1:25,14,4.475797488182033
61,64,Poisoned by Polonium: The Litvinenko File,100,11,2007.0,Documentary,1:45,3,4.475797488182033
55,82,Kamp Katrina,100,11,2007.0,Documentary,1:13,27,4.475797488182033
71,60,Benji,100,10,2018.0,Drama,1:27,-11,4.216965034285822
40,10,Dixieland,100,10,2015.0,Drama/Crime,1:32,-30,4.216965034285822
75,90,Dude Bro Party Massacre III,100,10,2015.0,Horror/Comedy,1:43,15,4.216965034285822
68,70,Leave It on the Floor,100,10,2011.0,Musical/Romance,1:46,2,4.216965034285822
16,20,Dead Awake,100,10,2016.0,Horror/Mystery and thriller,1:39,4,4.216965034285822
71,90,Thank You for Playing,100,10,2015.0,Biography,1:20,19,4.216965034285822
58,40,Commitment,100,10,2013.0,Action,1:53,-18,4.216965034285822
74,80,White Fang,100,10,2018.0,Adventure/Animation,1:25,6,4.216965034285822
92,40,Useless Humans,100,10,2020.0,Sci fi/Comedy,1:17,-52,4.216965034285822
59,90,Blood on the Mountain,100,10,2016.0,Documentary,1:33,31,4.216965034285822
70,100,Steve Martin and Martin Short: An Evening You Will Forget for the Rest of Your Life,100,10,2018.0,,,30,4.216965034285822
42,30,Gravy,100,10,2015.0,Other/Horror,1:35,-12,4.216965034285822
79,90,Comradeship,100,10,1931.0,Drama,1:33,11,4.216965034285822
79,100,SoulMate,100,10,2016.0,Drama/Romance,1:50,21,4.216965034285822
51,100,Sarah Silverman: A Speck of Dust,100,10,2017.0,,,49,4.216965034285822
88,30,Love Thy Nature,100,10,2014.0,Documentary,1:16,-58,4.216965034285822
34,80,30 Miles From Nowhere,100,10,1970.0,,,46,4.216965034285822
30,60,Stella Days,100,10,2011.0,Drama,1:27,30,4.216965034285822
43,50,Leprechaun Returns,100,10,2018.0,Horror/Comedy,1:32,7,4.216965034285822
54,70,Len and Company,100,10,2015.0,Drama/Comedy,1:42,16,4.216965034285822
70,60,Desperate Acts of Magic,100,10,2013.0,Comedy,1:26,-10,4.216965034285822
81,40,For My Father,100,10,2008.0,Drama,1:40,-41,4.216965034285822
32,30,The Midnight Man,100,10,2016.0,Horror/Mystery and thriller,1:33,-2,4.216965034285822
12,20,The Last Heist,100,10,2016.0,Mystery and thriller/Action,1:24,8,4.216965034285822
65,90,The Decline,100,10,2020.0,Mystery and thriller,1:23,25,4.216965034285822
19,70,Rogue,100,10,2020.0,Mystery and thriller/Action,1:30,51,4.216965034285822
94,80,"Look at Us Now, Mother!",100,10,2015.0,Comedy/Documentary,1:26,-14,4.216965034285822
15,40,Ejecta,100,10,2014.0,Sci fi,1:27,25,4.216965034285822
78,100,Better This World,100,10,2011.0,Documentary,1:22,22,4.216965034285822
61,50,The Human Experiment,100,10,2013.0,Documentary,0:52,-11,4.216965034285822
52,20,The Dog Lover,100,10,2016.0,Drama,1:42,-32,4.216965034285822
15,10,The Gracefield Incident,100,10,2017.0,Sci fi/Horror,1:29,-5,4.216965034285822
21,20,I Will Follow You Into the Dark,100,10,2013.0,Horror/Mystery and thriller,1:51,-1,4.216965034285822
80,60,American Meat,100,10,2010.0,Documentary,1:24,-20,4.216965034285822
25,10,And Now a Word From Our Sponsor,100,10,2012.0,Comedy/Drama,1:27,-15,4.216965034285822
80,90,Six Million and One,100,10,2011.0,Documentary,1:33,10,4.216965034285822
70,80,Errementari: The Blacksmith and the Devil,100,10,2017.0,Horror/Fantasy,1:38,10,4.216965034285822
35,100,Frankenstein,100,10,2015.0,Horror/Mystery and thriller,1:30,65,4.216965034285822
97,80,North Hollywood,100,10,2021.0,Comedy/Drama,1:33,-17,4.216965034285822
100,100,The Miners' Hymns,100,10,2010.0,Documentary/Drama,0:52,0,4.216965034285822
35,70,Cold Moon,100,10,2016.0,Drama/Crime,1:32,35,4.216965034285822
75,90,Nuclear Nation,100,10,2012.0,Documentary,2:25,15,4.216965034285822
55,80,Bidder 70,100,10,2012.0,Documentary,1:13,25,4.216965034285822
55,100,The Girls in the Band,100,10,2011.0,Documentary/Music,1:21,45,4.216965034285822
58,30,A Bird of the Air,100,10,2011.0,Romance,1:38,-28,4.216965034285822
38,50,Summer Camp,100,10,2015.0,Horror/Mystery and thriller,1:24,12,4.216965034285822
44,60,Uncle Kent,100,10,2011.0,Comedy/Drama,1:12,16,4.216965034285822
85,100,Hondros,100,10,2017.0,Documentary/Biography,1:26,15,4.216965034285822
25,50,Gut,100,10,2012.0,Horror/Mystery and thriller,1:30,25,4.216965034285822
80,60,The Unknown Soldier,100,10,2006.0,Documentary,1:37,-20,4.216965034285822
72,100,The Chant of Jimmie Blacksmith,100,10,1978.0,Drama,1:48,28,4.216965034285822
47,20,Hannah Free,100,10,2009.0,Gay and lesbian/Drama,1:26,-27,4.216965034285822
55,100,King Georges,100,9,2015.0,Documentary,1:17,45,3.9482220388574776
29,33,Dark Tourist,100,9,2012.0,Mystery and thriller,1:20,4,3.9482220388574776
63,89,Shakespeare Wallah,100,9,1965.0,Drama,2:00,26,3.9482220388574776
21,67,10x10,100,9,2018.0,Mystery and thriller,1:28,46,3.9482220388574776
77,100,The Promise,100,9,2016.0,Documentary,2:10,23,3.9482220388574776
52,78,Scalene,100,9,2011.0,Drama/Mystery and thriller,1:36,26,3.9482220388574776
71,78,The Suspect,100,9,2013.0,Mystery and thriller/Action,2:17,7,3.9482220388574776
50,67,Schneider vs. Bax,100,9,2015.0,Mystery and thriller/Comedy,1:36,17,3.9482220388574776
44,78,Floating Skyscrapers,100,9,2013.0,Drama/Romance,1:25,34,3.9482220388574776
45,89,Red Knot,100,9,2014.0,Drama,1:20,44,3.9482220388574776
50,100,Gebo and the Shadow,100,9,2012.0,Drama,1:35,50,3.9482220388574776
84,78,Dying to Know: Ram Dass & Timothy Leary,100,9,2014.0,Drama/Biography,1:39,-6,3.9482220388574776
35,22,Jake Squared,100,9,2013.0,Drama/Comedy,1:40,-13,3.9482220388574776
57,67,Shock Wave,100,9,2017.0,Mystery and thriller/Action,1:59,10,3.9482220388574776
86,78,Hasan Minhaj: Homecoming King,100,9,2017.0,Comedy/Stand up,1:12,-8,3.9482220388574776
48,78,"2 Autumns, 3 Winters",100,9,2013.0,Romance,1:27,30,3.9482220388574776
49,67,Going Down in LA-LA Land,100,9,2011.0,Drama/Romance,1:45,18,3.9482220388574776
55,78,We the People: The Market Basket Effect,100,9,2016.0,Documentary,1:16,23,3.9482220388574776
53,100,The Samurai,100,9,2014.0,Mystery and thriller/Horror,1:20,47,3.9482220388574776
22,33,Hellbenders,100,9,2012.0,Horror/Comedy,1:26,11,3.9482220388574776
82,22,I Hate Kids,100,9,2018.0,Comedy,1:29,-60,3.9482220388574776
22,0,The Poison Rose,100,9,2019.0,Mystery and thriller,1:38,-22,3.9482220388574776
5,11,The Moment,100,9,2013.0,Mystery and thriller,1:32,6,3.9482220388574776
63,89,The Unspeakable Act,100,9,2012.0,Drama,1:31,26,3.9482220388574776
42,56,Over Your Dead Body,100,9,2014.0,Horror,1:34,14,3.9482220388574776
53,0,Deadline,100,9,2012.0,Mystery and thriller,1:35,-53,3.9482220388574776
37,22,Awful Nice,100,9,2013.0,Comedy,1:28,-15,3.9482220388574776
43,44,Pokémon the Movie: Mewtwo Strikes Back Evolution,100,9,2019.0,Adventure/Anime,1:38,1,3.9482220388574776
50,33,Refuge,100,9,2012.0,Drama,1:24,-17,3.9482220388574776
26,22,Hurry Sundown,100,9,1967.0,Drama,2:26,-4,3.9482220388574776
23,22,14 Cameras,100,9,2018.0,Horror/Mystery and thriller,1:30,-1,3.9482220388574776
73,100,We Won't Grow Old Together,100,9,1972.0,Drama,1:43,27,3.9482220388574776
78,78,An Affair of the Heart,100,9,2012.0,Documentary,1:34,0,3.9482220388574776
57,44,American Hangman,100,9,2019.0,Mystery and thriller,1:39,-13,3.9482220388574776
29,22,The Seventh Dwarf,100,9,2014.0,Comedy/Adventure,1:28,-7,3.9482220388574776
61,44,Walk Away Renee,100,9,2011.0,Drama,1:30,-17,3.9482220388574776
31,11,Ghost Team,100,9,2016.0,Adventure/Horror,1:23,-20,3.9482220388574776
39,22,Angels in Stardust,100,9,2013.0,Drama/Comedy,1:41,-17,3.9482220388574776
64,0,The Condemned,100,9,2012.0,Mystery and thriller,1:44,-64,3.9482220388574776
12,22,"Tell Me That You Love Me, Junie Moon",100,9,1970.0,Drama/Comedy,1:52,10,3.9482220388574776
63,89,Blood Punch,100,9,2013.0,Horror/Mystery and thriller,1:44,26,3.9482220388574776
62,33,Wedding Palace,100,9,2011.0,Romance,1:38,-29,3.9482220388574776
60,56,Changeland,100,9,2019.0,Comedy/Drama,,-4,3.9482220388574776
60,56,Assimilate,100,9,2019.0,Sci fi,1:33,-4,3.9482220388574776
55,44,After Words,100,9,2015.0,Drama/Romance,1:31,-11,3.9482220388574776
82,89,London: The Modern Babylon,100,9,2012.0,Documentary,2:05,7,3.9482220388574776
72,44,A Violent Man,100,9,2017.0,Drama/Crime,1:47,-28,3.9482220388574776
38,33,My Mistress,100,9,2014.0,Drama,1:44,-5,3.9482220388574776
19,11,Hit by Lightning,100,9,2014.0,Comedy,1:29,-8,3.9482220388574776
68,78,Dolly Parton's Coat of Many Colors,100,9,2015.0,Biography/Drama,1:30,10,3.9482220388574776
25,11,The Basement,100,9,2018.0,Horror,1:30,-14,3.9482220388574776
29,22,Absence,100,9,2013.0,Mystery and thriller,1:22,-7,3.9482220388574776
27,78,Tales From the Hood 2,100,9,2018.0,Horror,1:51,51,3.9482220388574776
77,100,Vivan las Antipodas!,100,9,2011.0,Documentary,1:48,23,3.9482220388574776
30,11,Welcome Home,100,9,2018.0,Mystery and thriller,1:37,-19,3.9482220388574776
63,67,All Mistakes Buried,100,9,2015.0,Mystery and thriller,1:24,4,3.9482220388574776
66,89,Lez Bomb,100,9,2018.0,Comedy/Gay and lesbian,1:29,23,3.9482220388574776
61,33,Boarding School,100,9,2018.0,Horror/Mystery and thriller,1:50,-28,3.9482220388574776
62,89,Stink!,100,9,2015.0,Documentary,1:31,27,3.9482220388574776
46,89,Shockproof,100,9,1949.0,Drama/Crime,1:19,43,3.9482220388574776
39,78,Garn,100,9,2016.0,Documentary,1:16,39,3.9482220388574776
60,89,Bei yazi de nanhai (Taking Father Home),100,9,2006.0,,,29,3.9482220388574776
38,44,The Toe Tactic,100,9,2008.0,Drama,1:23,6,3.9482220388574776
74,100,Wasted! The Story of Food Waste,100,9,2017.0,Documentary,1:25,26,3.9482220388574776
45,33,Donovan's Echo,100,9,2011.0,Mystery and thriller/Drama,1:35,-12,3.9482220388574776
81,100,Haunters: The Art of the Scare,100,9,2017.0,Documentary/Horror,1:28,19,3.9482220388574776
46,22,Step Sisters,100,9,2018.0,Comedy,1:44,-24,3.9482220388574776
60,33,Hard Sell,100,9,2016.0,Comedy/Drama,1:36,-27,3.9482220388574776
41,89,Elf: Buddy's Musical Christmas,100,9,2014.0,,,48,3.9482220388574776
12,11,Bullet,100,9,2014.0,Drama/Action,1:22,-1,3.9482220388574776
47,44,The Debt,100,9,2015.0,Mystery and thriller,1:39,-3,3.9482220388574776
23,22,Ghoul,100,9,2015.0,Horror,1:29,-1,3.9482220388574776
65,100,The Winding Stream,100,9,2014.0,Documentary,1:30,35,3.9482220388574776
50,22,The Strongest Man,100,9,2015.0,Comedy,1:40,-28,3.9482220388574776
60,89,"Madrid, 1987",100,9,2011.0,Drama,1:45,29,3.9482220388574776
48,56,The Young Savages,100,9,1961.0,Drama/Mystery and thriller,1:50,8,3.9482220388574776
26,0,Black Water,100,9,2018.0,Action/Mystery and thriller,1:45,-26,3.9482220388574776
24,56,388 Arletta Avenue,100,9,2011.0,Mystery and thriller,1:26,32,3.9482220388574776
85,67,Fresh,100,9,2009.0,Documentary,1:10,-18,3.9482220388574776
81,22,Alice,100,9,2010.0,,,-59,3.9482220388574776
70,67,The Zen of Bennett,100,9,2012.0,Documentary,1:27,-3,3.9482220388574776
44,33,A Girl and a Gun,100,9,2013.0,Documentary,1:16,-11,3.9482220388574776
33,56,Thirteen Women,100,9,1932.0,Mystery and thriller,1:14,23,3.9482220388574776
58,78,The GoodTimesKid,100,9,2005.0,Comedy/Action,1:17,20,3.9482220388574776
87,89,Olympia Part One: Festival of the Nations,100,9,1938.0,Documentary,1:59,2,3.9482220388574776
33,13,Carter & June,100,8,2017.0,Action/Comedy,1:27,-20,3.668016172818685
63,100,Justice League vs the Fatal Five,100,8,2019.0,Fantasy/Animation,1:17,37,3.668016172818685
60,100,Batman vs. Two-Face,100,8,2017.0,Animation/Action,1:12,40,3.668016172818685
39,38,Another,100,8,2014.0,Horror/Mystery and thriller,1:20,-1,3.668016172818685
76,100,Beyond Borders: Esteros,100,8,2016.0,Drama/Gay and lesbian,1:23,24,3.668016172818685
46,38,Three Worlds,100,8,2012.0,Drama,1:40,-8,3.668016172818685
40,25,Speed-Dating,100,8,2010.0,Romance/Comedy,1:38,-15,3.668016172818685
82,88,"Oh, Hello On Broadway",100,8,2017.0,Comedy,1:42,6,3.668016172818685
70,38,Cruise,100,8,2018.0,Drama/Romance,1:30,-32,3.668016172818685
36,50,The Living,100,8,2014.0,Mystery and thriller,1:30,14,3.668016172818685
19,25,Antisocial,100,8,2013.0,Horror,1:29,6,3.668016172818685
14,25,Open Water 3: Cage Dive,100,8,2017.0,Mystery and thriller/Horror,1:20,11,3.668016172818685
48,38,Holiday in the Wild,100,8,2019.0,Other/Romance,1:25,-10,3.668016172818685
84,88,Our Vinyl Weighs a Ton: This Is Stones Throw Records,100,8,2013.0,Documentary,1:32,4,3.668016172818685
70,63,Magical Universe,100,8,2013.0,Documentary,1:18,-7,3.668016172818685
89,75,Moss,100,8,2017.0,Adventure/Romance,1:21,-14,3.668016172818685
33,13,Steam,100,8,2007.0,Drama,2:00,-20,3.668016172818685
56,50,The Red Robin,100,8,2013.0,Drama/Mystery and thriller,1:46,-6,3.668016172818685
22,25,The Humanity Bureau,100,8,2017.0,Sci fi/Mystery and thriller,1:35,3,3.668016172818685
8,25,Beast of Burden,100,8,2018.0,Mystery and thriller/Action,1:29,17,3.668016172818685
69,50,The Scenesters,100,8,2009.0,Drama/Crime,1:42,-19,3.668016172818685
54,38,Cardboard Boxer,100,8,2016.0,Drama,1:28,-16,3.668016172818685
27,13,No manches Frida 2,100,8,2019.0,Comedy,1:42,-14,3.668016172818685
31,13,Woody Woodpecker,100,8,2017.0,Comedy/Adventure,1:34,-18,3.668016172818685
48,13,The Night Visitor,100,8,1970.0,Mystery and thriller,1:42,-35,3.668016172818685
63,75,Public Schooled,100,8,2017.0,Comedy,1:26,12,3.668016172818685
53,88,Room for Rent,100,8,2017.0,Mystery and thriller/Comedy,1:29,35,3.668016172818685
33,13,Huntsville,100,8,2017.0,Drama/Mystery and thriller,1:27,-20,3.668016172818685
19,0,Slumber,100,8,2017.0,Mystery and thriller/Horror,1:25,-19,3.668016172818685
21,25,Submerged,100,8,2015.0,Drama/Mystery and thriller,1:39,4,3.668016172818685
82,75,Leave the World Behind,100,8,2014.0,Music/Documentary,1:35,-7,3.668016172818685
46,50,No Men Beyond This Point,100,8,2015.0,Sci fi/Comedy,1:20,4,3.668016172818685
45,75,Brahman Naman,100,8,2016.0,Comedy,1:35,30,3.668016172818685
48,50,The Beat Beneath My Feet,100,8,2014.0,Comedy/Music,1:32,2,3.668016172818685
97,88,Immortal,100,8,2020.0,Drama/Mystery and thriller,,-9,3.668016172818685
64,88,Trigger,100,8,2010.0,Drama,1:23,24,3.668016172818685
38,88,Havana Motor Club,100,8,2015.0,Documentary/Drama,1:24,50,3.668016172818685
93,88,The Phenomenon,100,8,2020.0,Documentary,1:41,-5,3.668016172818685
19,13,Sword of Vengeance,100,8,2015.0,Drama/Action,1:27,-6,3.668016172818685
41,0,Spaceman,100,8,2016.0,Drama,1:30,-41,3.668016172818685
10,25,Splintered,100,8,2010.0,Horror/Mystery and thriller,1:25,15,3.668016172818685
30,88,Night of the Living Deb,100,8,2015.0,Comedy,1:25,58,3.668016172818685
31,88,Hope Springs Eternal,100,8,2018.0,Comedy/Drama,1:18,57,3.668016172818685
59,75,Forgetting the Girl,100,8,2012.0,Drama/Mystery and thriller,1:25,16,3.668016172818685
87,100,Jim Gaffigan: Noble Ape,100,8,2018.0,Comedy,1:10,13,3.668016172818685
34,38,Comes a Bright Day,100,8,2012.0,Romance,1:35,4,3.668016172818685
57,75,Patch Town,100,8,2014.0,Musical/Fantasy,1:24,18,3.668016172818685
22,13,The White Haired Witch of Lunar Kingdom,100,8,2014.0,Fantasy,1:44,-9,3.668016172818685
71,88,The Jewish Cardinal,100,8,2013.0,Biography/Drama,1:36,17,3.668016172818685
37,38,The Wannabe,100,8,2015.0,Drama/Crime,1:30,1,3.668016172818685
47,13,The Houses October Built 2,100,8,2017.0,Horror/Mystery and thriller,1:41,-34,3.668016172818685
33,100,Stations of the Elevated,100,8,1981.0,Documentary,0:46,67,3.668016172818685
43,88,Hearts of the West,100,8,1975.0,Comedy,1:42,45,3.668016172818685
64,38,Jane Wants a Boyfriend,100,8,2015.0,Comedy/Drama,1:41,-26,3.668016172818685
35,50,Between Us,100,8,2016.0,Comedy/Romance,1:33,15,3.668016172818685
54,13,Locker 13,100,8,2014.0,Drama/Mystery and thriller,1:35,-41,3.668016172818685
71,100,Monks: The Transatlantic Feedback,100,8,2007.0,Documentary/Music,1:40,29,3.668016172818685
73,100,16 Acres,100,8,2012.0,Documentary/Drama,1:35,27,3.668016172818685
59,50,Meet Me in Montenegro,100,8,2014.0,Romance,1:30,-9,3.668016172818685
48,75,Rabid Dogs,100,8,2015.0,Action,1:40,27,3.668016172818685
7,0,Cam2Cam,100,8,2014.0,Horror/Mystery and thriller,1:31,-7,3.668016172818685
83,100,Kingdom of Us,100,8,2017.0,Documentary/Drama,1:49,17,3.668016172818685
42,25,Getting Straight,100,8,1970.0,Comedy/Drama,2:04,-17,3.668016172818685
50,63,Violet Tendencies,100,8,2010.0,Comedy,1:39,13,3.668016172818685
87,88,Gogol Bordello Non-Stop,100,8,2008.0,Documentary,1:33,1,3.668016172818685
59,100,Never Say Macbeth,100,8,2007.0,Comedy,1:27,41,3.668016172818685
75,88,Burning the Future: Coal in America,100,8,2008.0,Documentary,1:29,13,3.668016172818685
19,13,The Silver Chalice,100,8,1954.0,Drama,2:24,-6,3.668016172818685
15,14,Excuse Me for Living,100,7,2012.0,Romance,1:47,-1,3.374320069567275
57,57,1:54,100,7,2016.0,Drama/Gay and lesbian,1:46,0,3.374320069567275
29,43,Killing Jesus,100,7,2015.0,Drama/History,1:30,14,3.374320069567275
23,14,The Adventurers,100,7,2017.0,Adventure/Action,1:44,-9,3.374320069567275
34,43,Christmas Inheritance,100,7,2017.0,Other/Romance,1:44,9,3.374320069567275
87,86,Period. End of Sentence.,100,7,2018.0,Documentary,0:26,-1,3.374320069567275
53,100,Crush the Skull,100,7,2015.0,Horror/Mystery and thriller,1:20,47,3.374320069567275
28,43,10 Cent Pistol,100,7,2014.0,Drama/Crime,1:31,15,3.374320069567275
29,57,Brother Nature,100,7,2016.0,Comedy,1:37,28,3.374320069567275
68,14,Vigilante Diaries,100,7,2016.0,Mystery and thriller/Action,1:24,-54,3.374320069567275
39,86,Gernika,100,7,2016.0,Romance/War,1:50,47,3.374320069567275
94,71,Snapshots,100,7,2018.0,Drama,1:35,-23,3.374320069567275
64,86,Tomorrow Ever After,100,7,2016.0,Sci fi/Comedy,1:35,22,3.374320069567275
39,71,The Jurassic Games,100,7,2018.0,Sci fi/Mystery and thriller,1:26,32,3.374320069567275
18,57,Hickok,100,7,2017.0,Western/Action,1:28,39,3.374320069567275
77,100,John Leguizamo's Latin History For Morons,100,7,2018.0,,,23,3.374320069567275
49,29,Almost Friends,100,7,2016.0,Romance,1:41,-20,3.374320069567275
31,29,Iron Sky: The Coming Race,100,7,2019.0,Action/Sci fi,1:32,-2,3.374320069567275
70,71,Gringo Trails,100,7,2013.0,Documentary,1:19,1,3.374320069567275
68,100,The Fruit Hunters,100,7,2012.0,Documentary,1:35,32,3.374320069567275
64,86,The Whisperer in Darkness,100,7,2011.0,Sci fi/Mystery and thriller,1:44,22,3.374320069567275
36,29,Tehilim,100,7,2007.0,Drama,1:36,-7,3.374320069567275
64,86,Girl Flu,100,7,2016.0,Drama/Comedy,1:32,22,3.374320069567275
91,100,The Devil We Know,100,7,2018.0,Documentary,1:35,9,3.374320069567275
85,86,People of a Feather,100,7,2011.0,Documentary,1:30,1,3.374320069567275
33,43,Went to Coney Island on a Mission From God ... Be Back by Five,100,7,1997.0,Drama/Comedy,1:34,10,3.374320069567275
70,86,The Night Watchmen,100,7,2016.0,Horror/Comedy,1:20,16,3.374320069567275
32,43,Bleed,100,7,2016.0,Horror/Mystery and thriller,1:22,11,3.374320069567275
84,86,The Big Fix,100,7,2011.0,Documentary,1:48,2,3.374320069567275
59,100,Catching Feelings,100,7,2017.0,Drama/Comedy,2:04,41,3.374320069567275
12,0,Mercenaries,100,7,2011.0,Action,1:37,-12,3.374320069567275
63,29,New Life,100,7,2016.0,Drama/Romance,1:28,-34,3.374320069567275
27,71,"No Pay, Nudity",100,7,2016.0,Drama/Comedy,1:32,44,3.374320069567275
69,71,Wolf,100,7,2013.0,Action,2:03,2,3.374320069567275
20,0,Any Day,100,7,2015.0,Drama,1:38,-20,3.374320069567275
77,43,Patriocracy,100,7,2011.0,Documentary,1:28,-34,3.374320069567275
75,86,Eleni,100,7,1985.0,Drama,1:57,11,3.374320069567275
71,14,Living Among Us,100,7,2018.0,Horror,1:21,-57,3.374320069567275
72,100,Raw Faith,100,7,2010.0,Documentary,1:34,28,3.374320069567275
16,29,I Am Happiness on Earth,100,7,2014.0,Drama/Gay and lesbian,2:02,13,3.374320069567275
39,29,Tio Papi,100,7,2013.0,Drama/Comedy,1:26,-10,3.374320069567275
28,14,Top Cat Begins,100,7,2015.0,Comedy/Animation,1:29,-14,3.374320069567275
67,100,A Midsummer Night's Dream,100,7,2014.0,Fantasy/Comedy,2:24,33,3.374320069567275
66,71,Candy Jar,100,7,2018.0,Comedy,1:32,5,3.374320069567275
69,100,Famous Nathan,100,7,2014.0,Documentary,1:36,31,3.374320069567275
41,86,Crack in the World,100,7,1965.0,Sci fi,1:36,45,3.374320069567275
82,14,Autumn Lights,100,7,2016.0,Drama/Mystery and thriller,1:38,-68,3.374320069567275
53,86,The Art Star and the Sudanese Twins,100,7,2007.0,Drama,1:49,33,3.374320069567275
12,14,Nightlight,100,7,2015.0,Horror/Mystery and thriller,1:24,2,3.374320069567275
17,14,Hangar 10,100,7,2014.0,Sci fi/Horror,1:47,-3,3.374320069567275
60,29,Trafficked,100,7,2017.0,Drama/Mystery and thriller,1:44,-31,3.374320069567275
27,43,Holy Ghost People,100,7,2013.0,Mystery and thriller,1:33,16,3.374320069567275
40,71,The Forgotten Space,100,7,2010.0,Documentary,1:56,31,3.374320069567275
44,71,Greenwich Village: Music That Defined a Generation,100,7,2012.0,Documentary,2:01,27,3.374320069567275
90,100,Eagles of Death Metal: Nos Amis (Our Friends),100,7,2017.0,Documentary/Music,1:23,10,3.374320069567275
54,14,Saving Grace B. Jones,100,7,2009.0,Drama/Mystery and thriller,1:55,-40,3.374320069567275
70,100,Sidewalk Stories,100,7,1989.0,Comedy,1:37,30,3.374320069567275
74,57,Super Duper Alice Cooper,100,7,2014.0,Documentary,1:26,-17,3.374320069567275
65,100,The Only Real Game,100,7,2013.0,Documentary,1:22,35,3.374320069567275
65,43,The Anonymous People,100,7,2013.0,Documentary,1:28,-22,3.374320069567275
5,0,Fall Down Dead,100,7,2007.0,Mystery and thriller,1:33,-5,3.374320069567275
86,100,Free China: The Courage to Believe,100,7,2011.0,Documentary/Biography,0:53,14,3.374320069567275
52,100,Dead Sushi,100,7,2012.0,Comedy/Horror,1:31,48,3.374320069567275
87,71,Gone Doggy Gone,100,7,2014.0,Comedy/Drama,1:29,-16,3.374320069567275
76,100,Jingle Bell Rocks!,100,7,2013.0,Documentary/Other,1:34,24,3.374320069567275
28,29,A New Life,100,7,1988.0,Comedy,1:44,1,3.374320069567275
78,71,Four Horsemen,100,7,2012.0,Documentary,1:37,-7,3.374320069567275
44,86,Bananas!,100,7,2009.0,Documentary/Drama,1:27,42,3.374320069567275
7,71,Fred Won't Move Out,100,7,2012.0,Drama,1:14,64,3.374320069567275
14,0,Wrecker,100,7,2015.0,Action/Mystery and thriller,1:23,-14,3.374320069567275
15,43,My Bakery in Brooklyn,100,7,2016.0,Comedy/Drama,1:40,28,3.374320069567275
48,71,In the Courtyard,100,7,2014.0,Comedy/Drama,1:37,23,3.374320069567275
28,14,Electric Slide,100,7,2014.0,Action/Drama,1:35,-14,3.374320069567275
39,71,Dial a Prayer,100,7,2015.0,Comedy/Drama,1:38,32,3.374320069567275
36,86,Caught Inside,100,7,2010.0,Action/Adventure,1:33,50,3.374320069567275
66,71,Pokémon the Movie: The Power of Us,100,7,2018.0,Anime/Action,1:53,5,3.374320069567275
37,43,Girlfriend's Day,100,7,2017.0,Comedy,1:10,6,3.374320069567275
65,100,Dream Big: Engineering Our World,100,7,2017.0,Documentary,0:40,35,3.374320069567275
69,43,Mariachi gringo,100,7,2012.0,Romance,1:47,-26,3.374320069567275
66,100,Black Pond,100,7,2011.0,Comedy/Drama,1:23,34,3.374320069567275
51,57,A Date With Judy,100,7,1948.0,Comedy/Musical,1:53,6,3.374320069567275
50,43,The Reflecting Pool,100,7,2007.0,Drama,,-7,3.374320069567275
22,14,Release,100,7,2010.0,Drama,1:27,-8,3.374320069567275
60,86,The Gates,100,7,2005.0,Documentary,1:38,26,3.374320069567275
69,57,Simon,100,7,1980.0,Comedy,1:37,-12,3.374320069567275
56,43,Daniel,100,7,1983.0,Drama,2:09,-13,3.374320069567275
71,86,The Optimists of Nine Elms,100,7,1973.0,,,15,3.374320069567275
98,100,Marlene,100,7,1984.0,Documentary,1:35,2,3.374320069567275
100,67,Love in Dangerous Times,100,6,2020.0,Comedy/Romance,,-33,3.064393493081416
82,67,Admiral,100,6,2015.0,Drama/Biography,2:02,-15,3.064393493081416
45,83,The Debt Collector,100,6,2018.0,Sports and fitness/Action,1:36,38,3.064393493081416
99,33,Ode to Passion,100,6,2020.0,Musical/Drama,2:08,-66,3.064393493081416
65,50,Fort McCoy,100,6,2011.0,Drama/History,1:41,-15,3.064393493081416
68,33,Dear Heart,100,6,1965.0,Comedy,1:54,-35,3.064393493081416
75,100,Levitated Mass: The Story of Michael Heizer's Monolithic Sculpture,100,6,2014.0,,,25,3.064393493081416
95,0,96 Souls,100,6,2016.0,Drama/Mystery and thriller,1:52,-95,3.064393493081416
71,83,9 Full Moons,100,6,2013.0,Drama/Romance,1:43,12,3.064393493081416
29,33,Drones,100,6,2013.0,Mystery and thriller,1:39,4,3.064393493081416
83,50,Donny's Bar Mitzvah,100,6,2021.0,Comedy,1:19,-33,3.064393493081416
88,100,Make Happy,100,6,2016.0,,,12,3.064393493081416
40,0,The Con Is On,100,6,2018.0,Comedy,1:30,-40,3.064393493081416
90,67,Long Shot: The Kevin Laue Story,100,6,2012.0,Documentary,1:33,-23,3.064393493081416
54,83,Aliyah,100,6,2012.0,Drama,1:27,29,3.064393493081416
55,17,The Healer,100,6,2017.0,Drama,1:43,-38,3.064393493081416
48,83,Dr. Feelgood: Dealer or Healer?,100,6,2016.0,Documentary,1:21,35,3.064393493081416
50,67,Seeds of Time,100,6,2013.0,Documentary,1:17,17,3.064393493081416
55,17,Crypto,100,6,2019.0,Mystery and thriller,1:45,-38,3.064393493081416
83,50,High Strung Free Dance,100,6,2018.0,Romance,1:43,-33,3.064393493081416
25,0,Solis,100,6,2018.0,Sci fi/Adventure,1:33,-25,3.064393493081416
92,100,The C Word,100,6,2016.0,Documentary,1:29,8,3.064393493081416
11,0,Dawn Patrol,100,6,2014.0,Drama,1:28,-11,3.064393493081416
60,100,Life Tracker,100,6,2012.0,Sci fi,1:42,40,3.064393493081416
46,0,Welcome to Curiosity,100,6,2018.0,Mystery and thriller,1:35,-46,3.064393493081416
60,0,Mission Park,100,6,2013.0,Drama/Crime,1:50,-60,3.064393493081416
63,83,Accident Man,100,6,2018.0,Mystery and thriller/Action,1:52,20,3.064393493081416
54,33,Lost for Words,100,6,2013.0,Drama/Romance,1:47,-21,3.064393493081416
51,33,No Clue,100,6,2013.0,Comedy,1:36,-18,3.064393493081416
60,33,1 Night,100,6,2016.0,Drama/Romance,1:20,-27,3.064393493081416
64,67,Four,100,6,2013.0,,,3,3.064393493081416
39,33,The Holiday Calendar,100,6,2018.0,Other/Romance,1:34,-6,3.064393493081416
48,33,A Beginner's Guide to Endings,100,6,2010.0,Drama/Comedy,1:36,-15,3.064393493081416
55,67,Pocha: Manifest Destiny,100,6,2015.0,Drama/Crime,1:24,12,3.064393493081416
23,17,Last Day of Summer,100,6,2009.0,Drama/Comedy,1:45,-6,3.064393493081416
23,33,The Human Factor,100,6,1979.0,Mystery and thriller,1:55,10,3.064393493081416
36,100,Experiment Perilous,100,6,1944.0,Mystery and thriller,1:31,64,3.064393493081416
67,100,LFO,100,6,2013.0,Drama/Sci fi,1:34,33,3.064393493081416
47,100,Found Footage,100,6,2016.0,Horror,1:40,53,3.064393493081416
89,100,Louie Bluie,100,6,1985.0,Documentary,1:00,11,3.064393493081416
93,100,Butterfly Girl,100,6,2014.0,Documentary,1:18,7,3.064393493081416
63,67,Breakup at a Wedding,100,6,2013.0,Romance,1:25,4,3.064393493081416
10,33,Most Likely to Die,100,6,2015.0,Horror,1:20,23,3.064393493081416
42,100,Songs From the North,100,6,2014.0,Documentary,1:12,58,3.064393493081416
35,67,The Neighbor,100,6,2016.0,Mystery and thriller,1:24,32,3.064393493081416
81,17,Close Encounters of the Fifth Kind: Contact has Begun,100,6,2020.0,Documentary,,-64,3.064393493081416
76,83,Sons of Perdition,100,6,2010.0,Documentary,1:25,7,3.064393493081416
48,33,The Monkey King 3,100,6,2018.0,Romance/Action,1:56,-15,3.064393493081416
72,17,"Sex, Death and Bowling",100,6,2015.0,Comedy/Drama,1:32,-55,3.064393493081416
47,50,The Monster Project,100,6,2017.0,Horror/Mystery and thriller,1:35,3,3.064393493081416
38,33,"Yes, Giorgio",100,6,1982.0,Comedy/Musical,1:50,-5,3.064393493081416
59,100,Harold's Going Stiff,100,6,2010.0,Comedy/Horror,,41,3.064393493081416
75,67,The Mask You Live In,100,6,2015.0,Documentary,1:37,-8,3.064393493081416
62,17,Coming Up Roses,100,6,2011.0,Drama,1:33,-45,3.064393493081416
70,0,Breaking & Exiting,100,6,2018.0,Romance,1:18,-70,3.064393493081416
71,100,Art Is ... the Permanent Revolution,100,6,2011.0,Documentary,1:22,29,3.064393493081416
77,33,Habermann,100,6,2010.0,Romance/War,1:44,-44,3.064393493081416
91,100,Us and Them,100,6,2018.0,Drama,2:00,9,3.064393493081416
56,83,Heart of the Beholder,100,6,2005.0,Drama,1:46,27,3.064393493081416
58,67,ReGeneration,100,6,2010.0,Documentary,1:21,9,3.064393493081416
35,100,Estranged,100,6,2015.0,Horror/Mystery and thriller,1:41,65,3.064393493081416
50,83,Happy Anniversary,100,6,2018.0,Comedy,1:18,33,3.064393493081416
58,100,Lunch,100,6,2012.0,Documentary,1:18,42,3.064393493081416
78,83,Changing the Game,100,6,2012.0,Action,1:43,5,3.064393493081416
60,83,Northern Light,100,6,2013.0,Documentary,1:45,23,3.064393493081416
59,33,Magic Beyond Words: The J.K. Rowling Story,100,6,2011.0,Biography/Drama,1:30,-26,3.064393493081416
61,50,Jaffa,100,6,2009.0,Drama,1:46,-11,3.064393493081416
38,50,Best Laid Plans,100,6,2012.0,Drama,1:43,12,3.064393493081416
50,83,Genius on Hold,100,6,2013.0,Documentary,1:32,33,3.064393493081416
27,67,The Dungeon Masters,100,6,2008.0,Documentary/Drama,1:33,40,3.064393493081416
74,50,Stevie Nicks: In Your Dreams,100,6,2012.0,Documentary,1:52,-24,3.064393493081416
48,100,The Evil Within,100,6,2017.0,Horror,1:38,52,3.064393493081416
18,0,Once Upon a Time in Brooklyn,100,6,2013.0,Drama/Crime,1:56,-18,3.064393493081416
38,0,Polanski Unauthorized,100,6,2009.0,Biography/Drama,1:29,-38,3.064393493081416
63,100,Cold November,100,6,2017.0,Drama,1:32,37,3.064393493081416
79,50,War Child,100,6,2008.0,Documentary,1:34,-29,3.064393493081416
86,100,Daughter of the Nile,100,6,1987.0,Drama,1:33,14,3.064393493081416
92,67,Beautifully Broken,100,6,2018.0,Drama,1:48,-25,3.064393493081416
38,33,Citizen Duane,100,6,2006.0,Comedy/Drama,1:30,-5,3.064393493081416
49,67,Lost in Thailand,100,6,2012.0,Comedy,1:45,18,3.064393493081416
13,0,Andròn -- The Black Labyrinth,100,6,2015.0,Sci fi/Action,1:40,-13,3.064393493081416
63,67,The Garden of Earthly Delights,100,6,2004.0,Drama,1:43,4,3.064393493081416
50,33,Girly,100,6,1970.0,Mystery and thriller,1:41,-17,3.064393493081416
44,83,It Happened in Brooklyn,100,6,1947.0,Comedy/Musical,1:45,39,3.064393493081416
50,33,Hitler: The Last Ten Days,100,6,1973.0,Drama/History,1:46,-17,3.064393493081416
75,100,Dear Pillow,100,6,2004.0,Drama,1:25,25,3.064393493081416
73,60,Floored,100,5,2009.0,Documentary,1:18,-13,2.734363528521053
36,60,Flutter,100,5,2011.0,Drama/Mystery and thriller,1:25,24,2.734363528521053
51,100,Chastity Bites,100,5,2013.0,Horror/Comedy,1:35,49,2.734363528521053
66,60,An Interview With God,100,5,2018.0,Drama,1:37,-6,2.734363528521053
82,100,Bag It,100,5,2010.0,Comedy/Drama,1:19,18,2.734363528521053
71,40,Planeat,100,5,2010.0,Documentary,1:27,-31,2.734363528521053
39,40,El Camino Christmas,100,5,2017.0,Other/Comedy,1:28,1,2.734363528521053
68,40,The Man Who Shook the Hand of Vicente Fernandez,100,5,2012.0,Drama/Comedy,1:39,-28,2.734363528521053
52,60,Rasputin and the Empress,100,5,1932.0,Drama/History,2:03,8,2.734363528521053
46,20,Where's the Money,100,5,2017.0,Comedy,1:26,-26,2.734363528521053
40,20,Bob Lazar: Area 51 & Flying Saucers,100,5,2018.0,Documentary,1:37,-20,2.734363528521053
54,80,Out of Print,100,5,2014.0,Documentary,1:26,26,2.734363528521053
38,40,Death House,100,5,2017.0,Horror,1:35,2,2.734363528521053
38,20,Autumn Blood,100,5,2013.0,Mystery and thriller,1:40,-18,2.734363528521053
91,100,Give Up Tomorrow,100,5,2011.0,Drama/Crime,1:35,9,2.734363528521053
42,0,Guest House,100,5,2020.0,Comedy,1:24,-42,2.734363528521053
46,20,The Lookalike,100,5,2014.0,Drama/Crime,1:40,-26,2.734363528521053
38,80,Black Mountain Side,100,5,2013.0,Horror/Mystery and thriller,1:39,42,2.734363528521053
66,80,Flavors of Youth,100,5,2018.0,Drama/Romance,1:14,14,2.734363528521053
77,60,American Circumcision,100,5,2017.0,Documentary,1:41,-17,2.734363528521053
69,80,My Italian Secret: The Forgotten Heroes,100,5,2014.0,Biography,1:32,11,2.734363528521053
28,40,Tremors: A Cold Day in Hell,100,5,2018.0,Sci fi/Horror,1:38,12,2.734363528521053
12,0,Air Strike,100,5,2018.0,Drama/History,1:37,-12,2.734363528521053
80,80,Little White Lie,100,5,2014.0,Drama/Biography,1:05,0,2.734363528521053
10,0,The 2nd,100,5,2020.0,Mystery and thriller/Action,1:33,-10,2.734363528521053
68,60,Fat,100,5,2013.0,Drama,1:25,-8,2.734363528521053
66,40,The Hollow,100,5,2016.0,Drama/Crime,2:08,-26,2.734363528521053
50,100,Pit Stop,100,5,2013.0,Drama/Gay and lesbian,1:20,50,2.734363528521053
50,40,The Strange Woman,100,5,1946.0,Drama,1:40,-10,2.734363528521053
93,80,Honor Flight,100,5,2012.0,Drama/War,1:22,-13,2.734363528521053
51,60,Altered Carbon: Resleeved,100,5,2020.0,Sci fi/Anime,1:14,9,2.734363528521053
85,80,Pay 2 Play: Democracy's High Stakes,100,5,2014.0,,,-5,2.734363528521053
28,20,Billionaire Ransom,100,5,2016.0,Mystery and thriller,1:47,-8,2.734363528521053
37,60,The Killer Is Loose,100,5,1956.0,Mystery and thriller,1:13,23,2.734363528521053
45,20,All Summers End,100,5,2017.0,Drama,1:50,-25,2.734363528521053
65,40,3 Nights in the Desert,100,5,2014.0,Drama,1:30,-25,2.734363528521053
72,80,The Keeping Hours,100,5,2017.0,Drama/Romance,1:31,8,2.734363528521053
56,100,Who Is KK Downey?,100,5,2008.0,Comedy,1:30,44,2.734363528521053
70,80,Sun Dogs,100,5,2017.0,Drama/Comedy,1:34,10,2.734363528521053
25,40,6 Ways to Sundown,100,5,2015.0,Mystery and thriller/Action,1:43,15,2.734363528521053
18,0,Contract to Kill,100,5,2016.0,Mystery and thriller/Action,1:30,-18,2.734363528521053
31,20,Dangerous Ishhq,100,5,2012.0,Mystery and thriller,,-11,2.734363528521053
48,0,The Coldest Game,100,5,2019.0,Mystery and thriller,1:43,-48,2.734363528521053
66,100,Saving Capitalism,100,5,2017.0,,,34,2.734363528521053
73,20,The Mandela Effect,100,5,2019.0,Mystery and thriller,1:20,-53,2.734363528521053
72,80,The Quiet Room,100,5,1996.0,Drama,1:31,8,2.734363528521053
13,0,The Institute,100,5,2017.0,Mystery and thriller,1:30,-13,2.734363528521053
50,80,Three Blind Mice,100,5,2008.0,Drama/Comedy,1:34,30,2.734363528521053
71,60,CodeGirl,100,5,2015.0,Documentary,1:47,-11,2.734363528521053
65,20,Indigo Children,100,5,2012.0,Drama,1:16,-45,2.734363528521053
41,60,It Had to Be You,100,5,2015.0,Romance,1:25,19,2.734363528521053
73,40,Amanda and Jack Go Glamping,100,5,2017.0,Romance,1:34,-33,2.734363528521053
41,60,About Scout,100,5,2015.0,Drama,1:49,19,2.734363528521053
73,80,Grown Up Movie Star,100,5,2009.0,Gay and lesbian/Drama,1:34,7,2.734363528521053
40,0,Sex Doll,100,5,2016.0,Mystery and thriller,1:44,-40,2.734363528521053
48,60,The Actress,100,5,1953.0,Drama,1:30,12,2.734363528521053
20,0,Butcher Boys,100,5,2013.0,Horror,1:33,-20,2.734363528521053
46,0,Will,100,5,2011.0,Drama,1:42,-46,2.734363528521053
17,20,Club Life,100,5,2015.0,Drama,1:30,3,2.734363528521053
72,80,I Am Not an Easy Man,100,5,2018.0,Comedy,1:38,8,2.734363528521053
60,60,"Joshua Tree, 1951: A Portrait of James Dean",100,5,2012.0,Gay and lesbian/Drama,1:33,0,2.734363528521053
82,100,A Whisper to a Roar,100,5,2012.0,Documentary,1:34,18,2.734363528521053
47,80,The Bouncer,100,5,2018.0,Action/Mystery and thriller,1:22,33,2.734363528521053
33,40,The Year Dolly Parton Was My Mom,100,5,2011.0,Comedy/Drama,1:35,7,2.734363528521053
6,20,First Family,100,5,1980.0,Comedy,1:44,14,2.734363528521053
68,60,Amateur,100,5,2018.0,Drama,1:36,-8,2.734363528521053
60,20,"Won Ton Ton, the Dog Who Saved Hollywood",100,5,1975.0,Comedy,1:32,-40,2.734363528521053
31,40,Traded,100,5,2016.0,Western/Drama,1:38,9,2.734363528521053
30,60,The Happy House,100,5,2013.0,Comedy,1:20,30,2.734363528521053
62,100,Run Robot Run,100,5,2006.0,Comedy,1:22,38,2.734363528521053
44,40,The Warring States,100,5,2011.0,War/Drama,2:05,-4,2.734363528521053
69,80,The Grace of Jake,100,5,2015.0,Comedy/Drama,1:32,11,2.734363528521053
47,20,The Lightkeepers,100,5,2009.0,Comedy,1:36,-27,2.734363528521053
20,0,Shadows and Lies,100,5,2010.0,Drama,1:48,-20,2.734363528521053
63,80,Picture Day,100,5,2012.0,Comedy/Drama,1:33,17,2.734363528521053
93,60,Assaulted: Civil Rights Under Fire,100,5,2013.0,Documentary,1:19,-33,2.734363528521053
68,80,Jess & Moss,100,5,2011.0,Drama,1:23,12,2.734363528521053
94,100,McConkey,100,5,2013.0,Documentary/Biography,1:49,6,2.734363528521053
43,40,The Last Run,100,5,1971.0,Drama/Crime,1:40,-3,2.734363528521053
36,20,Petunia,100,5,2012.0,Comedy/Drama,1:48,-16,2.734363528521053
16,20,Outpost: Black Sun,100,5,2011.0,Action/Horror,1:38,4,2.734363528521053
30,80,The Face of Fu Manchu,100,5,1965.0,Horror,1:34,50,2.734363528521053
65,80,Good Neighbor Sam,100,5,1964.0,Comedy,2:10,15,2.734363528521053
72,100,Crawford,100,5,2008.0,Documentary,1:14,28,2.734363528521053
30,40,Some Kind of Hero,100,5,1982.0,Comedy,1:35,10,2.734363528521053
82,86,Color Out of Space,50,206,2019.0,Sci fi/Horror,1:51,4,27.93617951273954
69,87,Supernova,50,167,2020.0,Gay and lesbian/Drama,1:33,18,24.501788937948916
65,91,Clemency,50,150,2019.0,Drama,1:53,26,22.911685375307673
61,77,Judy & Punch,50,138,2019.0,Comedy,1:45,16,21.748255626180264
64,67,The Glorias,50,128,2020.0,Drama/Biography,2:19,3,20.749432874416154
31,21,Lucy in the Sky,50,125,2019.0,Drama,2:04,-10,20.444135848948562
55,77,Military Wives,50,122,2019.0,Drama/Comedy,1:52,22,20.136078432395202
71,99,MLK/FBI,50,121,2020.0,Documentary,1:42,28,20.032763155216593
61,87,Spaceship Earth,50,110,2020.0,Documentary,1:54,26,18.874281508207943
86,96,The Painter and the Thief,50,108,2020.0,Documentary,1:42,10,18.659063693305395
63,82,The Painted Bird,50,106,2019.0,Drama,2:49,19,18.442346006574258
70,88,Deerskin,50,105,2019.0,Comedy,1:17,18,18.333412575379587
89,93,Love and Monsters,50,102,2020.0,Comedy/Adventure,1:49,4,18.004253009684938
69,93,Diane,50,97,2018.0,Drama,1:35,24,17.447464924548626
75,96,By the Grace of God,50,96,2018.0,Drama,2:17,21,17.334827353454408
69,82,Sometimes Always Never,50,95,2018.0,Drama/Comedy,1:31,13,17.22174892188519
59,42,Vita & Virginia,50,91,2018.0,Gay and lesbian/Drama,1:50,-17,16.764896252714394
40,56,J.T. LeRoy,50,84,2018.0,Drama,1:48,16,15.946836950911226
77,87,Where's My Roy Cohn?,50,82,2019.0,Documentary,1:37,10,15.708461709271033
67,67,I Am Woman,50,81,2019.0,Biography/Music,1:57,0,15.588457268119896
85,96,Feels Good Man,50,80,2020.0,Documentary,1:32,11,15.467895945971296
37,44,The Wedding Guest,50,73,2018.0,Mystery and thriller,1:34,7,14.607530022406213
81,97,Midnight Family,50,72,2019.0,Documentary/Drama,1:21,16,14.482142292408389
72,20,The Tax Collector,50,71,2020.0,Drama/Crime,1:35,-52,14.356099772615265
18,34,Domino,50,71,2019.0,Drama/Crime,1:29,16,14.356099772615265
71,94,John Lewis: Good Trouble,50,70,2020.0,Documentary,1:36,23,14.229389747854103
77,66,Matthias & Maxime,50,70,2019.0,Drama,1:59,-11,14.229389747854103
28,21,Stardust,50,70,2020.0,Biography/Music,1:49,-7,14.229389747854103
86,100,Welcome to Chechnya,50,69,2020.0,Gay and lesbian/Documentary,1:47,14,14.101999070345963
72,100,All In: The Fight for Democracy,50,65,2020.0,Documentary,1:42,28,13.58535050847747
30,68,Human Capital,50,62,2019.0,Drama,1:37,38,13.190000315557024
58,80,Koko-di Koko-da,50,61,2019.0,Horror/Comedy,1:26,22,13.056631493342596
71,95,Lucky Grandma,50,61,2019.0,Drama,1:40,24,13.056631493342596
64,70,Butt Boy,50,57,2019.0,Mystery and thriller/Comedy,1:39,6,12.514738658402138
46,84,Depraved,50,57,2019.0,Horror/Mystery and thriller,1:54,38,12.514738658402138
70,93,Premature,50,56,2019.0,Romance/Drama,1:26,23,12.377060587439436
90,39,The Song of Names,50,56,2019.0,Drama/Mystery and thriller,1:53,-51,12.377060587439436
53,96,Blood on Her Name,50,56,2019.0,Drama/Crime,1:25,43,12.377060587439436
50,33,The Sunlit Night,50,55,2019.0,Romance,1:49,-17,12.238457412731087
49,75,Jungleland,50,55,2019.0,Drama,1:30,26,12.238457412731087
62,53,Tell It to the Bees,50,55,2018.0,Drama/Romance,1:46,-9,12.238457412731087
78,95,Come as You Are,50,55,2019.0,Comedy/Drama,1:47,17,12.238457412731087
90,83,You Cannot Kill David Arquette,50,54,2020.0,Documentary,1:30,-7,12.098905925115496
16,25,Corporate Animals,50,51,2019.0,Comedy,1:26,9,11.674313727451958
96,96,Crock of Gold: A Few Rounds With Shane MacGowan,50,51,2020.0,Music/Documentary,2:04,0,11.674313727451958
38,80,Porno,50,50,2019.0,Horror/Comedy,1:38,42,11.530715390799685
67,44,Three Christs,50,48,2017.0,Drama,1:59,-23,11.240244892502977
49,27,A Million Little Pieces,50,48,2018.0,Drama,1:53,-22,11.240244892502977
24,41,Centigrade,50,46,2020.0,Drama/Mystery and thriller,2:07,17,10.945198564139895
35,39,Donnybrook,50,46,2018.0,Drama/Mystery and thriller,1:42,4,10.945198564139895
67,100,House of Hummingbird,50,46,2018.0,Drama,2:18,33,10.945198564139895
47,52,Person to Person,50,46,2017.0,Drama/Comedy,1:24,5,10.945198564139895
95,100,Rewind,50,44,2019.0,Drama/Documentary,1:26,5,10.645300436514761
67,73,The Apparition,50,44,2018.0,Drama/Mystery and thriller,2:24,6,10.645300436514761
65,98,The Last Tree,50,43,2019.0,Drama,1:40,33,10.493437610589469
78,93,Minor Premise,50,43,2020.0,Sci fi/Mystery and thriller,1:34,15,10.493437610589469
19,67,Body at Brighton Rock,50,42,2019.0,Mystery and thriller,1:27,48,10.34024446475599
67,93,Styx,50,42,2018.0,Drama/Mystery and thriller,1:34,26,10.34024446475599
94,100,"Scream, Queen! My Nightmare on Elm Street",50,42,2019.0,Documentary/Gay and lesbian,1:39,6,10.34024446475599
72,93,Capital in the Twenty-First Century,50,41,2019.0,Documentary,1:43,21,10.185677243651742
63,34,Being Frank,50,41,2018.0,Comedy,1:49,-29,10.185677243651742
22,30,Backtrack,50,40,2015.0,Mystery and thriller,1:30,8,10.029689644980788
49,69,Most Wanted,50,39,2020.0,Mystery and thriller/Crime,2:05,20,9.872232603526719
78,89,Top End Wedding,50,38,2019.0,Comedy/Romance,1:53,11,9.713254050808038
75,89,Benjamin,50,38,2018.0,Gay and lesbian/Romance,1:25,14,9.713254050808038
20,30,The Stand In,50,37,2020.0,Romance,1:41,10,9.552698646911638
62,67,The Wave,50,36,2019.0,Sci fi,1:27,5,9.390507480439723
74,97,Liyana,50,36,2017.0,Documentary,1:17,23,9.390507480439723
82,91,The Short History of the Long Road,50,35,2019.0,Drama,1:30,9,9.22661773178138
39,71,Wrinkles the Clown,50,34,2019.0,Documentary/Comedy,1:18,32,9.060962294042406
97,97,Buoyancy,50,34,2019.0,Drama,1:35,0,9.060962294042406
71,94,Angels Wear White,50,33,2017.0,Drama,1:47,23,8.893469344897873
80,42,The Song of Sway Lake,50,33,2017.0,Drama/Romance,1:40,-38,8.893469344897873
64,72,Low Tide,50,32,2019.0,Drama,1:26,8,8.724061861322062
54,97,Z,50,32,2019.0,Horror/Mystery and thriller,1:23,43,8.724061861322062
20,22,Iron Mask,50,32,2019.0,Action/Adventure,2:10,2,8.724061861322062
94,94,Screwball,50,32,2018.0,Documentary,1:45,0,8.724061861322062
42,47,Allure,50,32,2017.0,Gay and lesbian/Drama,1:45,5,8.724061861322062
31,56,Rabid,50,32,2019.0,Horror,1:48,25,8.724061861322062
35,44,Tone-Deaf,50,32,2019.0,Comedy/Horror,1:27,9,8.724061861322062
54,52,The Bay of Silence,50,31,2020.0,Mystery and thriller,1:20,-2,8.552657067536824
40,52,Porto,50,31,2016.0,Romance/Drama,1:16,12,8.552657067536824
73,84,Aziz Ansari: Right Now,50,31,2019.0,Comedy/Stand up,1:05,11,8.552657067536824
62,100,"A Bread Factory, Part One: For the Sake of Gold",50,30,2018.0,,,38,8.379165804519056
84,97,Queen of Hearts,50,30,2019.0,Drama,1:40,13,8.379165804519056
28,57,Game of Death,50,30,2017.0,Horror/Mystery and thriller,1:13,29,8.379165804519056
65,45,Ode to Joy,50,29,2019.0,Romance,1:38,-20,8.20349180691225
40,21,Infamous,50,29,2020.0,Drama/Crime,1:40,-19,8.20349180691225
61,62,Children of the Sea,50,29,2019.0,Fantasy/Animation,1:50,1,8.20349180691225
20,38,Chick Fight,50,29,2020.0,Comedy/Action,1:37,18,8.20349180691225
65,17,The Kindness of Strangers,50,29,2019.0,Drama,1:52,-48,8.20349180691225
69,72,Chef Flynn,50,29,2018.0,Documentary,1:22,3,8.20349180691225
83,86,Woodstock: Three Days That Defined a Generation,50,29,2019.0,Documentary/Music,1:36,3,8.20349180691225
63,46,Finding Steve McQueen,50,28,2018.0,Drama/Crime,1:30,-17,8.02553087005176
36,61,Girl,50,28,2020.0,Mystery and thriller,1:32,25,8.02553087005176
30,36,Trick,50,28,2019.0,Mystery and thriller/Horror,1:37,6,8.02553087005176
24,59,Shortcut,50,27,2020.0,Horror/Mystery and thriller,1:20,35,7.845169885845621
36,30,The Queen of Spain,50,27,2016.0,Comedy,2:08,-6,7.845169885845621
87,85,"Empathy, Inc.",50,27,2018.0,Drama/Mystery and thriller,,-2,7.845169885845621
14,4,Mary,50,27,2019.0,Horror/Mystery and thriller,1:24,-10,7.845169885845621
67,81,#Unfit: The Psychology of Donald Trump,50,27,2020.0,Documentary,1:23,14,7.845169885845621
26,26,The Doorman,50,27,2020.0,Mystery and thriller/Action,1:36,0,7.845169885845621
80,59,The Case for Christ,50,27,2017.0,Drama/Biography,1:52,-21,7.845169885845621
58,85,Song of Granite,50,27,2017.0,Biography/Music,1:44,27,7.845169885845621
72,88,Volition,50,26,2019.0,Sci fi/Mystery and thriller,1:31,16,7.662285721192069
76,58,Urban Hymn,50,26,2015.0,Music/Drama,1:54,-18,7.662285721192069
38,46,Body Cam,50,26,2020.0,Horror/Mystery and thriller,1:37,8,7.662285721192069
24,19,Friendsgiving,50,26,2020.0,Comedy/Other,1:35,-5,7.662285721192069
33,12,Aardvark,50,26,2017.0,Drama,1:29,-21,7.662285721192069
88,54,Clara,50,26,2018.0,Sci fi/Drama,1:45,-34,7.662285721192069
69,69,Phyllis and Harold,50,26,2008.0,Documentary,1:24,0,7.662285721192069
32,40,Proximity,50,25,2019.0,Sci fi,1:59,8,7.476743906106103
59,72,The Rachel Divide,50,25,2018.0,Documentary,1:30,13,7.476743906106103
36,50,Lost Girls & Love Hotels,50,24,2020.0,Drama/Romance,1:37,14,7.288397090280924
48,71,The Seasons in Quincy: Four Portraits of John Berger,50,24,2016.0,Biography/Documentary,1:30,23,7.288397090280924
41,39,Blood and Money,50,23,2020.0,Mystery and thriller/Action,1:29,-2,7.097083215743026
68,39,Nekrotronic,50,23,2018.0,Sci fi/Comedy,1:39,-29,7.097083215743026
57,87,Lifechanger,50,23,2018.0,Horror/Mystery and thriller,1:24,30,7.097083215743026
39,91,Sembene!,50,23,2015.0,Biography,1:22,52,7.097083215743026
54,26,Hooking Up,50,23,2020.0,Comedy/Drama,1:44,-28,7.097083215743026
33,41,An Ordinary Man,50,22,2017.0,Drama/Mystery and thriller,1:30,8,6.9026233386080005
14,23,Here and Now (Blue Night),50,22,2018.0,,,9,6.9026233386080005
65,100,Wolfman's Got Nards,50,22,2018.0,Horror/Documentary,1:31,35,6.9026233386080005
53,41,Come What May,50,22,2015.0,Drama/War,1:54,-12,6.9026233386080005
43,86,The Weekend,50,22,2018.0,Comedy,1:26,43,6.9026233386080005
45,18,A Little Something for Your Birthday,50,22,2017.0,Romance,1:34,-27,6.9026233386080005
45,73,Followed,50,22,2018.0,Horror,1:37,28,6.9026233386080005
48,90,4 Days in France,50,21,2016.0,Gay and lesbian/Drama,2:22,42,6.704819013328363
89,86,Tater Tot & Patton,50,21,2017.0,Drama,1:31,-3,6.704819013328363
90,100,Apocalypse Now: Final Cut,50,21,2019.0,,,10,6.704819013328363
91,100,Invader Zim: Enter the Florpus,50,21,2019.0,,,9,6.704819013328363
37,52,The Sea,50,21,2013.0,Drama,1:26,15,6.704819013328363
53,60,The Motive,50,20,2017.0,Mystery and thriller,1:54,7,6.503449126242364
76,65,The Riot Act,50,20,2018.0,Western/Mystery and thriller,1:41,-11,6.503449126242364
19,15,A Score to Settle,50,20,2019.0,Mystery and thriller/Action,1:44,-4,6.503449126242364
10,20,Disturbing the Peace,50,20,2020.0,Mystery and thriller/Action,1:40,10,6.503449126242364
24,25,The Main Event,50,20,2020.0,Comedy,1:41,1,6.503449126242364
19,35,Hunted,50,20,2015.0,Action/Adventure,1:44,16,6.503449126242364
36,65,The Shed,50,20,2019.0,Horror/Mystery and thriller,1:38,29,6.503449126242364
46,40,Gerrymandering,50,20,2010.0,Documentary,1:21,-6,6.503449126242364
76,70,Embattled,50,20,2020.0,Drama,1:57,-6,6.503449126242364
74,65,Stella's Last Weekend,50,20,2018.0,Drama/Romance,1:42,-9,6.503449126242364
46,90,Ornette: Made in America,50,20,1985.0,Documentary,1:30,44,6.503449126242364
67,85,F.T.A.,50,20,1972.0,Documentary,1:37,18,6.503449126242364
60,63,A Month of Sundays,50,19,2015.0,Drama/Comedy,1:49,3,6.298266028731006
50,63,Wild in the Streets,50,19,1968.0,Comedy,1:37,13,6.298266028731006
32,79,The Apostate,50,19,2015.0,Comedy,1:20,47,6.298266028731006
63,26,Killerman,50,19,2019.0,Drama/Action,1:52,-37,6.298266028731006
54,95,Tucked,50,19,2018.0,Drama,1:20,41,6.298266028731006
28,11,"Berlin, I Love You",50,18,2019.0,Romance,2:00,-17,6.088990769440213
70,89,The Great Hip Hop Hoax,50,18,2013.0,Music/Comedy,1:32,19,6.088990769440213
69,83,All These Small Moments,50,18,2018.0,Drama,1:25,14,6.088990769440213
41,94,Time for Ilhan,50,18,2018.0,Documentary,1:28,53,6.088990769440213
83,61,Mighty Oak,50,18,2020.0,Comedy/Music,1:42,-22,6.088990769440213
42,83,The Price,50,18,2017.0,Drama,1:32,41,6.088990769440213
51,94,The Dead Center,50,18,2018.0,Mystery and thriller,1:33,43,6.088990769440213
86,78,Scarred Hearts,50,18,2016.0,Drama/History,2:21,-8,6.088990769440213
58,67,The Parts You Lose,50,18,2019.0,Drama/Mystery and thriller,1:34,9,6.088990769440213
44,56,The Kreutzer Sonata,50,18,2008.0,Drama,1:39,12,6.088990769440213
47,41,Under the Eiffel Tower,50,17,2018.0,Romance,1:27,-6,5.875307153057772
89,88,Feast of the Seven Fishes,50,17,2019.0,Other/Comedy,1:39,-1,5.875307153057772
86,65,Ramen Heads,50,17,2017.0,Documentary,1:33,-21,5.875307153057772
69,65,It Happened in L.A.,50,17,2017.0,Romance,1:37,-4,5.875307153057772
81,88,A Suitable Girl,50,17,2017.0,Documentary,1:30,7,5.875307153057772
80,94,The Newspaperman: The Life and Times of Ben Bradlee,50,17,2017.0,,,14,5.875307153057772
56,24,Luis and the Aliens,50,17,2018.0,Comedy/Animation,1:26,-32,5.875307153057772
55,88,Mia and the White Lion,50,17,2018.0,Kids and family/Adventure,1:38,33,5.875307153057772
77,59,The Kids Grow Up,50,17,2009.0,Documentary,1:30,-18,5.875307153057772
50,94,A Skin So Soft,50,17,2017.0,Documentary,1:33,44,5.875307153057772
67,75,The Forest of the Lost Souls,50,16,2017.0,Horror/Drama,1:11,8,5.656854249492381
47,75,Sobibor,50,16,2018.0,Drama/Biography,2:00,28,5.656854249492381
50,81,Without Name,50,16,2016.0,Drama/Mystery and thriller,1:33,31,5.656854249492381
78,81,A Boy Called Sailboat,50,16,2018.0,Comedy/Drama,1:32,3,5.656854249492381
78,25,The Host,50,16,2020.0,Drama/Crime,1:43,-53,5.656854249492381
74,19,Semper Fi,50,16,2019.0,Mystery and thriller,1:39,-55,5.656854249492381
26,6,Behind You,50,16,2020.0,Horror,1:26,-20,5.656854249492381
49,56,Then Came You,50,16,2020.0,Romance,1:37,7,5.656854249492381
71,88,Soni,50,16,2018.0,Drama,1:37,17,5.656854249492381
88,94,A Sun,50,16,2019.0,Drama/Crime,2:36,6,5.656854249492381
31,50,Postcards From London,50,16,2018.0,Gay and lesbian/Drama,1:29,19,5.656854249492381
19,38,Two Jacks,50,16,2012.0,Comedy/Drama,1:30,19,5.656854249492381
17,33,The Chamber,50,15,2016.0,Mystery and thriller,1:30,16,5.433216825139731
32,20,Love Aaj Kal,50,15,2020.0,Romance/Drama,2:22,-12,5.433216825139731
32,67,Grigris,50,15,2013.0,Drama,1:41,35,5.433216825139731
55,80,Dovlatov,50,15,2018.0,Drama,2:06,25,5.433216825139731
81,67,Burn Your Maps,50,15,2016.0,Drama/Adventure,1:42,-14,5.433216825139731
80,87,A Space Program,50,15,2015.0,Documentary,1:12,7,5.433216825139731
52,67,I'll Take Your Dead,50,15,2018.0,Horror,1:23,15,5.433216825139731
73,33,Modern Life Is Rubbish,50,15,2017.0,Romance,1:45,-40,5.433216825139731
71,100,Uncle Peckerhead,50,15,2020.0,Horror/Comedy,1:37,29,5.433216825139731
48,67,Rainbow Time,50,15,2016.0,Drama/Comedy,1:31,19,5.433216825139731
22,53,Tip Top,50,15,2013.0,Comedy/Mystery and thriller,1:46,31,5.433216825139731
71,80,A Simple Wedding,50,15,2018.0,Romance,1:28,9,5.433216825139731
76,53,American Dreamer,50,15,2018.0,Mystery and thriller,1:32,-23,5.433216825139731
22,40,Nails,50,15,2017.0,Horror,1:25,18,5.433216825139731
36,27,Crazy About Tiffany's,50,15,2016.0,Documentary,1:27,-9,5.433216825139731
58,67,Jobriath A.D.,50,15,2011.0,Documentary,1:42,9,5.433216825139731
56,60,Bikes vs Cars,50,15,2015.0,Documentary,1:30,4,5.433216825139731
33,13,L.A. Twister,50,15,2004.0,Comedy,1:32,-20,5.433216825139731
93,14,After We Collided,50,14,2020.0,Drama/Romance,1:47,-79,5.203912939677927
39,14,Sextuplets,50,14,2019.0,Comedy,1:39,-25,5.203912939677927
66,79,Belzebuth,50,14,2019.0,Horror,1:54,13,5.203912939677927
83,50,Miss Virginia,50,14,2019.0,Drama,1:42,-33,5.203912939677927
96,100,Turnover,50,14,2019.0,Drama/Comedy,2:03,4,5.203912939677927
36,57,Perestroika,50,14,2007.0,Drama,1:56,21,5.203912939677927
60,79,Jesús,50,14,2016.0,Drama,1:25,19,5.203912939677927
35,71,The Housemaid: Co Hau Gai,50,14,2016.0,Romance/Horror,1:45,36,5.203912939677927
22,23,All the Devil's Men,50,13,2018.0,Mystery and thriller/Action,1:40,1,4.968377601139757
33,8,A Thousand Kisses Deep,50,13,2011.0,Sci fi/Romance,1:24,-25,4.968377601139757
33,0,The Gallows Act II,50,13,2019.0,Horror/Mystery and thriller,1:39,-33,4.968377601139757
39,85,Ruin Me,50,13,2017.0,Horror/Mystery and thriller,1:27,46,4.968377601139757
19,62,Lying and Stealing,50,13,2019.0,Mystery and thriller/Crime,1:40,43,4.968377601139757
36,46,Asher,50,13,2018.0,Action,1:44,10,4.968377601139757
66,85,Lady J,50,13,2018.0,Drama/Romance,1:49,19,4.968377601139757
36,23,Money Plane,50,13,2020.0,Mystery and thriller/Action,1:22,-13,4.968377601139757
33,8,Chlorine,50,13,2013.0,Drama,1:35,-25,4.968377601139757
21,62,"Mother, May I Sleep With Danger?",50,13,2016.0,Gay and lesbian/Mystery and thriller,1:30,41,4.968377601139757
49,92,Maze,50,13,2017.0,Drama/Mystery and thriller,1:32,43,4.968377601139757
23,23,Drunkboat,50,13,2010.0,Drama,1:38,0,4.968377601139757
47,54,At First Light,50,13,2018.0,Sci fi/Mystery and thriller,1:31,7,4.968377601139757
36,77,Just Do It: A Tale of Modern-Day Outlaws,50,13,2011.0,Documentary,1:28,41,4.968377601139757
99,25,Sno Babies,50,12,2020.0,Drama,1:49,-74,4.725940818339814
82,83,Love and Saucers,50,12,2017.0,Biography/Mystery and thriller,1:07,1,4.725940818339814
27,42,Girls With Balls,50,12,2018.0,Comedy,1:17,15,4.725940818339814
67,75,After Louie,50,12,2017.0,Gay and lesbian/Drama,1:40,8,4.725940818339814
52,17,Mrs. Serial Killer,50,12,2020.0,Drama/Crime,1:46,-35,4.725940818339814
46,0,Radioflash,50,12,2019.0,Adventure/Mystery and thriller,1:43,-46,4.725940818339814
54,92,The Grief of Others,50,12,2015.0,Drama,1:43,38,4.725940818339814
79,17,A Violent Separation,50,12,2019.0,Drama/Crime,1:46,-62,4.725940818339814
42,42,Turning Green,50,12,2005.0,Drama/Comedy,1:25,0,4.725940818339814
76,75,Long Lost,50,12,2018.0,Mystery and thriller,1:35,-1,4.725940818339814
79,67,Method to the Madness of Jerry Lewis,50,12,2012.0,,,-12,4.725940818339814
73,83,Scaffolding,50,12,2017.0,Drama,1:30,10,4.725940818339814
61,75,11/8/16,50,12,2017.0,Documentary,1:44,14,4.725940818339814
33,0,Trading Paint,50,12,2018.0,Action,1:28,-33,4.725940818339814
52,58,Day of the Flowers,50,12,2012.0,Drama/Romance,1:42,6,4.725940818339814
68,67,The Delinquent Season,50,12,2017.0,Romance/Drama,1:44,-1,4.725940818339814
12,42,Drifter,50,12,2016.0,Horror/Mystery and thriller,1:26,30,4.725940818339814
59,67,Mad Tiger,50,12,2015.0,Comedy/Documentary,1:22,8,4.725940818339814
83,50,Music From the Big House,50,12,2010.0,Documentary,1:26,-33,4.725940818339814
50,50,"Small, Beautifully Moving Parts",50,12,2011.0,Comedy/Drama,1:12,0,4.725940818339814
80,75,In Search of Haydn,50,12,2012.0,Documentary/Biography,1:42,-5,4.725940818339814
62,83,Black Cop,50,12,2017.0,Drama,1:31,21,4.725940818339814
40,75,Romeo and Juliet in Yiddish,50,12,2010.0,Comedy/Drama,1:32,35,4.725940818339814
39,83,Room for Rent,50,12,2019.0,Mystery and thriller,1:21,44,4.725940818339814
40,33,Meeting Spencer,50,12,2011.0,Comedy,1:26,-7,4.725940818339814
67,92,Motherland,50,12,2008.0,Documentary,1:20,25,4.725940818339814
69,36,Honeyglue,50,11,2015.0,Drama/Romance,1:47,-33,4.475797488182033
29,0,My Dead Boyfriend,50,11,2016.0,Romance,1:30,-29,4.475797488182033
100,64,Sin Alas,50,11,2015.0,Drama,1:30,-36,4.475797488182033
43,9,Lucky Day,50,11,2019.0,Mystery and thriller/Action,1:40,-34,4.475797488182033
14,64,Axolotl Overkill,50,11,2017.0,Drama/Comedy,1:34,50,4.475797488182033
92,73,Abe & Phil's Last Poker Game,50,11,2017.0,Drama/Comedy,1:25,-19,4.475797488182033
96,100,King in the Wilderness,50,11,2018.0,Documentary,1:51,4,4.475797488182033
42,91,Legend of the Demon Cat,50,11,2017.0,Mystery and thriller/Fantasy,2:09,49,4.475797488182033
74,55,Tatterdemalion,50,11,2017.0,Drama/Mystery and thriller,1:45,-19,4.475797488182033
41,45,The Blackout Experiments,50,11,2016.0,Documentary,1:21,4,4.475797488182033
64,82,Scary Stories,50,11,2018.0,Documentary,1:22,18,4.475797488182033
31,45,Open 24 Hours,50,11,2018.0,Horror,1:37,14,4.475797488182033
50,55,Joffrey: Mavericks of American Dance,50,11,2011.0,Documentary/Biography,1:30,5,4.475797488182033
50,91,"Farewell, Herr Schwarz",50,11,2014.0,Documentary,1:36,41,4.475797488182033
91,64,Far From Vietnam,50,11,1967.0,Documentary,1:50,-27,4.475797488182033
50,91,Ghostbox Cowboy,50,11,2018.0,Comedy/Drama,1:30,41,4.475797488182033
73,91,Ghost Bird,50,11,2009.0,Documentary,1:25,18,4.475797488182033
17,36,The Last New Yorker,50,11,2006.0,Drama,1:30,19,4.475797488182033
37,45,Tortoise in Love,50,11,2010.0,Comedy,1:30,8,4.475797488182033
43,45,Just a Breath Away (Dans la brume),50,11,2018.0,,,2,4.475797488182033
24,9,Don't Sleep,50,11,2017.0,Horror/Mystery and thriller,1:35,-15,4.475797488182033
60,91,Arthur Miller: Writer,50,11,2017.0,Documentary,1:38,31,4.475797488182033
87,73,NoBody's Perfect,50,11,2008.0,Documentary,1:24,-14,4.475797488182033
63,80,Go!,50,10,2020.0,Action,1:42,17,4.216965034285822
34,30,A Christmas Prince: The Royal Baby,50,10,2019.0,Other/Romance,1:25,-4,4.216965034285822
32,60,Roseanne for President!,50,10,2015.0,Documentary,1:37,28,4.216965034285822
27,60,Itsy Bitsy,50,10,2019.0,Horror/Mystery and thriller,1:35,33,4.216965034285822
48,70,Welcome to Mercy,50,10,2018.0,Mystery and thriller,1:44,22,4.216965034285822
46,80,Gored,50,10,2015.0,Documentary,1:15,34,4.216965034285822
63,80,A Crooked Somebody,50,10,2017.0,Mystery and thriller,1:42,17,4.216965034285822
79,90,Peppermint Soda,50,10,1979.0,Drama/Comedy,1:37,11,4.216965034285822
58,100,Every Time I Die,50,10,2019.0,Horror/Mystery and thriller,1:38,42,4.216965034285822
34,90,Stoned Bros.,50,10,2009.0,Comedy,1:30,56,4.216965034285822
37,90,Bit,50,10,2019.0,Horror/Comedy,1:30,53,4.216965034285822
54,10,Lazy Susan,50,10,2020.0,Comedy,1:30,-44,4.216965034285822
63,30,Madness in the Method,50,10,2019.0,Comedy,1:39,-33,4.216965034285822
44,10,A Nice Girl Like You,50,10,2020.0,Romance,1:34,-34,4.216965034285822
40,90,B&B,50,10,2017.0,Gay and lesbian/Mystery and thriller,1:27,50,4.216965034285822
86,90,Tread,50,10,2019.0,Documentary,1:29,4,4.216965034285822
80,60,When the Dragon Swallowed the Sun,50,10,2010.0,Documentary,1:55,-20,4.216965034285822
73,60,Loot,50,10,2008.0,Documentary,1:26,-13,4.216965034285822
57,20,The Escape of Prisoner 614,50,10,2018.0,Comedy/Western,1:35,-37,4.216965034285822
53,90,Downriver,50,10,2015.0,Gay and lesbian/Drama,1:39,37,4.216965034285822
83,20,The Great Alaskan Race,50,10,2019.0,Drama/Adventure,1:27,-63,4.216965034285822
86,50,DriverX,50,10,2017.0,Comedy/Drama,1:38,-36,4.216965034285822
83,90,Marathon: The Patriots Day Bombing,50,10,2016.0,,,7,4.216965034285822
52,60,Shepherds and Butchers,50,10,2016.0,Drama,1:46,8,4.216965034285822
81,90,Trust Machine: The Story of Blockchain,50,10,2018.0,Documentary,1:24,9,4.216965034285822
32,20,Marguerite & Julien,50,10,2015.0,Drama/Romance,1:48,-12,4.216965034285822
96,90,Paint,50,10,2020.0,Comedy,1:35,-6,4.216965034285822
50,10,Harlem Aria,50,10,1999.0,Drama,1:40,-40,4.216965034285822
39,70,Turkey Bowl,50,10,2011.0,Comedy,1:04,31,4.216965034285822
85,70,Redline,50,10,2009.0,Sci fi/Action,1:42,-15,4.216965034285822
80,100,Daguerréotypes,50,10,1976.0,Documentary,1:20,20,4.216965034285822
57,60,Mercedes Sosa: The Voice of Latin America,50,10,2013.0,Documentary,1:30,3,4.216965034285822
38,50,Patagonia Rising,50,10,2011.0,Documentary/Western,1:27,12,4.216965034285822
69,100,The Ritchie Boys,50,10,2004.0,Documentary,1:36,31,4.216965034285822
86,89,Dear Ex,50,9,2018.0,Gay and lesbian/Drama,1:40,3,3.9482220388574776
35,44,Tremors: Shrieker Island,50,9,2020.0,Adventure/Horror,1:43,9,3.9482220388574776
56,100,Rodney King,50,9,2017.0,,,44,3.9482220388574776
60,78,The Boat,50,9,2018.0,Drama/Mystery and thriller,1:40,18,3.9482220388574776
86,67,Life Inside Out,50,9,2013.0,Drama,1:43,-19,3.9482220388574776
33,22,Looking for Palladin,50,9,2008.0,Drama/Comedy,1:55,-11,3.9482220388574776
47,78,The Revival,50,9,2017.0,Drama/Gay and lesbian,1:25,31,3.9482220388574776
3,0,The Murder of Nicole Brown Simpson,50,9,2019.0,Mystery and thriller,1:22,-3,3.9482220388574776
42,56,Seducing Charlie Barker,50,9,2010.0,Comedy,1:33,14,3.9482220388574776
51,44,The Wedding Year,50,9,2019.0,Romance,1:30,-7,3.9482220388574776
65,44,The Beat Hotel,50,9,2012.0,Drama/Biography,1:28,-21,3.9482220388574776
52,78,Ants on a Shrimp,50,9,2016.0,Documentary,1:28,26,3.9482220388574776
16,33,Ghost Stories,50,9,2020.0,Horror,2:24,17,3.9482220388574776
42,33,Ring of Fire,50,9,2013.0,Drama/Biography,1:30,-9,3.9482220388574776
48,56,Blumenthal,50,9,2013.0,Comedy,1:36,8,3.9482220388574776
29,0,Outside Bet,50,9,2012.0,Comedy,1:41,-29,3.9482220388574776
61,89,Eye for an Eye,50,9,2019.0,Mystery and thriller,1:47,28,3.9482220388574776
59,22,Big Kill,50,9,2018.0,Western/Action,2:09,-37,3.9482220388574776
47,11,Change in the Air,50,9,2018.0,Drama,1:34,-36,3.9482220388574776
85,56,The Battle of Pussy Willow Creek,50,9,2010.0,Comedy,1:35,-29,3.9482220388574776
43,22,Daughter of the Wolf,50,9,2019.0,Action/Mystery and thriller,1:31,-21,3.9482220388574776
43,33,Kampai! For the Love of Sake,50,9,2015.0,Documentary,1:35,-10,3.9482220388574776
71,89,In Search of Memory,50,9,2009.0,Documentary,1:35,18,3.9482220388574776
78,78,Road to Victory,50,9,2007.0,Drama,1:39,0,3.9482220388574776
29,78,Discreet,50,9,2017.0,Gay and lesbian/Drama,1:21,49,3.9482220388574776
16,0,Killers Anonymous,50,9,2019.0,Action/Mystery and thriller,1:36,-16,3.9482220388574776
64,44,Love Beats Rhymes,50,9,2017.0,Music/Drama,1:46,-20,3.9482220388574776
44,44,"Can't Stop, Won't Stop: A Bad Boy Story",50,9,2017.0,Documentary/Music,1:20,0,3.9482220388574776
76,78,Easy Living,50,9,2017.0,Comedy/Drama,1:20,2,3.9482220388574776
76,33,An Actor Prepares,50,9,2018.0,Comedy,1:37,-43,3.9482220388574776
55,44,Quitters,50,9,2015.0,Comedy/Drama,1:30,-11,3.9482220388574776
43,89,Sweaty Betty,50,9,2015.0,Drama,1:34,46,3.9482220388574776
25,44,The Pied Piper,50,9,1972.0,Fantasy,1:30,19,3.9482220388574776
67,25,House in the Alley,50,8,2012.0,Horror,1:33,-42,3.668016172818685
70,38,Smiley Face Killers,50,8,2020.0,Mystery and thriller,1:36,-32,3.668016172818685
67,88,White Rabbit,50,8,2018.0,Drama/Comedy,1:11,21,3.668016172818685
61,63,Applesauce,50,8,2015.0,Comedy,1:31,2,3.668016172818685
100,88,Left on Purpose,50,8,2015.0,Drama/Biography,1:35,-12,3.668016172818685
78,100,Mike Birbiglia: Thank God for Jokes,50,8,2017.0,Comedy/Stand up,1:10,22,3.668016172818685
14,50,Blood Money,50,8,2017.0,Mystery and thriller/Action,1:25,36,3.668016172818685
44,100,Mom and Me,50,8,2015.0,Documentary,1:17,56,3.668016172818685
46,50,Badland,50,8,2019.0,Western,1:57,4,3.668016172818685
52,75,Theory of Obscurity: A Film About The Residents,50,8,2015.0,Music/Documentary,1:27,23,3.668016172818685
67,100,Boston,50,8,2017.0,Documentary,2:03,33,3.668016172818685
42,75,Book of Monsters,50,8,2018.0,Horror/Comedy,1:24,33,3.668016172818685
30,13,Viking Destiny,50,8,2018.0,Action/Adventure,1:31,-17,3.668016172818685
96,75,The Captain,50,8,2019.0,Drama,1:51,-21,3.668016172818685
85,50,55 Steps,50,8,2017.0,Drama/Biography,1:55,-35,3.668016172818685
41,13,Charlie Casanova,50,8,2010.0,Drama/Crime,1:34,-28,3.668016172818685
56,75,Batman: Death in the Family,50,8,2020.0,Action/Animation,,19,3.668016172818685
63,88,Reversing Roe,50,8,2018.0,Documentary,1:39,25,3.668016172818685
15,75,Stray Bullets,50,8,2016.0,Drama/Crime,1:23,60,3.668016172818685
44,88,Imitation Girl,50,8,2017.0,Drama/Sci fi,1:24,44,3.668016172818685
67,75,Equal Means Equal,50,8,2014.0,Documentary,1:34,8,3.668016172818685
94,63,Man in Red Bandana,50,8,2017.0,Documentary,1:25,-31,3.668016172818685
38,50,Burning Annie,50,8,2004.0,Comedy/Drama,1:35,12,3.668016172818685
43,63,Drug Lord: The Legend of Shorty,50,8,2014.0,Documentary,1:30,20,3.668016172818685
54,75,Loves Her Gun,50,8,2013.0,Drama,1:39,21,3.668016172818685
27,25,The Kill Hole,50,8,2012.0,Action/Mystery and thriller,1:31,-2,3.668016172818685
50,63,Mateo,50,8,2014.0,Documentary,1:28,13,3.668016172818685
49,100,"Olympic Pride, American Prejudice",50,8,2015.0,Documentary,1:30,51,3.668016172818685
85,100,Con Artist,50,8,2009.0,Documentary,1:24,15,3.668016172818685
65,88,Be My Cat: A Film for Anne,50,8,2015.0,Drama/Crime,1:27,23,3.668016172818685
29,50,Endgame,50,8,2015.0,Drama,1:30,21,3.668016172818685
43,38,Tell Me Your Name,50,8,2018.0,Horror/Mystery and thriller,1:29,-5,3.668016172818685
59,100,Michelle Wolf: Joke Show,50,8,2019.0,Comedy/Stand up,,41,3.668016172818685
27,100,Traffic Stop,50,8,2017.0,Documentary,0:30,73,3.668016172818685
50,88,Natural Resistance,50,8,2014.0,Documentary,1:25,38,3.668016172818685
57,50,Fatal Countdown: Reset,50,8,2017.0,Sci fi/Action,1:46,-7,3.668016172818685
43,75,Frank Serpico,50,8,2017.0,Documentary,1:39,32,3.668016172818685
60,75,Who's Watching Oliver,50,8,2017.0,Drama/Horror,1:27,15,3.668016172818685
77,75,The Gardener,50,8,2016.0,Documentary,1:28,-2,3.668016172818685
33,63,American Jesus,50,8,2013.0,Documentary,1:20,30,3.668016172818685
70,75,It's Better to Jump,50,8,2013.0,Documentary,1:15,5,3.668016172818685
62,38,Night Watch,50,8,1973.0,Mystery and thriller,1:45,-24,3.668016172818685
29,63,The Velvet Vampire,50,8,1971.0,Horror,1:20,34,3.668016172818685
17,57,Big Muddy,50,7,2015.0,Drama,1:44,40,3.374320069567275
80,100,End Game,50,7,2018.0,Documentary,0:40,20,3.374320069567275
84,86,Bayou Maharajah: The Tragic Genius of James Booker,50,7,2013.0,Gay and lesbian/Documentary,1:30,2,3.374320069567275
45,29,Bethany,50,7,2017.0,Horror,1:30,-16,3.374320069567275
71,57,The Blackout,50,7,2019.0,Sci fi/Action,2:33,-14,3.374320069567275
50,71,My Sucky Teen Romance,50,7,2011.0,Comedy,1:17,21,3.374320069567275
89,29,Still Here,50,7,2020.0,Drama/Mystery and thriller,1:39,-60,3.374320069567275
12,71,The Inhabitants,50,7,2015.0,Horror/Mystery and thriller,1:30,59,3.374320069567275
51,86,Plagues of Breslau,50,7,2018.0,Drama/Crime,1:33,35,3.374320069567275
19,0,10 Minutes Gone,50,7,2019.0,Drama/Crime,1:28,-19,3.374320069567275
55,100,Brothers Hypnotic,50,7,2013.0,Documentary,1:20,45,3.374320069567275
28,29,The Last Summer,50,7,2019.0,Romance,1:49,1,3.374320069567275
58,100,Teacher,50,7,2019.0,Drama,1:40,42,3.374320069567275
48,57,Beautiful Something,50,7,2015.0,Gay and lesbian/Drama,1:32,9,3.374320069567275
75,100,Susanne Bartsch: On Top,50,7,2017.0,Documentary,1:24,25,3.374320069567275
61,86,Adventures in Babysitting,50,7,2016.0,Comedy/Adventure,1:30,25,3.374320069567275
48,86,Legacy of Lies,50,7,2020.0,Mystery and thriller/Action,1:41,38,3.374320069567275
46,43,Off-White Lies,50,7,2011.0,Drama,1:26,-3,3.374320069567275
55,71,Killer Kate!,50,7,2018.0,Horror/Mystery and thriller,1:20,16,3.374320069567275
75,86,The Forgotten Kingdom,50,7,2013.0,Drama/Romance,1:37,11,3.374320069567275
81,100,Just Charlie,50,7,2017.0,Drama,1:37,19,3.374320069567275
38,57,Free to Run,50,7,2016.0,Documentary,1:30,19,3.374320069567275
24,43,The Wedding Party,50,7,2010.0,Drama/Comedy,1:38,19,3.374320069567275
58,86,Mars,50,7,2010.0,Romance/Animation,1:30,28,3.374320069567275
59,86,Tap World,50,7,2015.0,Documentary/Music,1:12,27,3.374320069567275
65,29,The Last Witness,50,7,2018.0,History/Drama,1:33,-36,3.374320069567275
69,57,Akron,50,7,2015.0,Romance/Gay and lesbian,1:28,-12,3.374320069567275
90,86,Love Hunter,50,7,2013.0,Drama,1:26,-4,3.374320069567275
75,71,This Ain't No Mouse Music!,50,7,2013.0,Documentary,1:32,-4,3.374320069567275
50,100,How to Smell a Rose: A Visit With Ricky Leacock in Normandy,50,7,2014.0,Documentary/Biography,1:04,50,3.374320069567275
93,86,Dominick Dunne: After the Party,50,7,2008.0,,,-7,3.374320069567275
27,86,Tarzan of the Apes,50,7,1918.0,Adventure,0:55,59,3.374320069567275
44,33,The Steps,50,6,2015.0,Comedy,1:38,-11,3.064393493081416
31,100,Leslie Jones: Time Machine,50,6,2020.0,Comedy,,69,3.064393493081416
24,0,A Novel Romance,50,6,2011.0,Drama/Romance,1:31,-24,3.064393493081416
32,33,Bling,50,6,2016.0,Adventure/Romance,1:21,1,3.064393493081416
74,83,Gundala,50,6,2019.0,Sci fi/Adventure,2:03,9,3.064393493081416
33,33,Dark Signal,50,6,2016.0,Horror/Mystery and thriller,1:38,0,3.064393493081416
100,100,Momentum Generation,50,6,2018.0,Documentary,1:43,0,3.064393493081416
89,83,Daughters of the Sexual Revolution: The Untold Story of the Dallas Cowboys Cheerleaders,50,6,2018.0,Documentary,1:18,-6,3.064393493081416
98,100,Never Be Done: The Richard Glen Lett Story,50,6,2020.0,Biography/Comedy,1:20,2,3.064393493081416
52,83,Born to Dance,50,6,2015.0,Music/Drama,1:36,31,3.064393493081416
62,100,808,50,6,2015.0,Documentary,1:47,38,3.064393493081416
43,50,Bring Me the Head of the Machine Gun Woman,50,6,2012.0,Drama/Crime,1:15,7,3.064393493081416
70,17,Blood Brother,50,6,2018.0,Drama/Action,1:25,-53,3.064393493081416
93,50,Impossible Monsters,50,6,2019.0,Mystery and thriller,1:24,-43,3.064393493081416
76,83,A Fortunate Man,50,6,2018.0,Drama/History,2:42,7,3.064393493081416
90,100,Vito,50,6,2011.0,History/Gay and lesbian,1:33,10,3.064393493081416
29,33,Laugh Killer Laugh,50,6,2015.0,Drama/Crime,1:40,4,3.064393493081416
83,67,Southern Baptist Sissies,50,6,2013.0,Drama/Gay and lesbian,2:18,-16,3.064393493081416
49,0,Saving Zoë,50,6,2019.0,Mystery and thriller,1:35,-49,3.064393493081416
16,17,Twenty8k,50,6,2012.0,Mystery and thriller,1:46,1,3.064393493081416
67,50,Know How,50,6,2014.0,Musical/Drama,1:46,-17,3.064393493081416
47,83,Mission of Honor,50,6,2018.0,Drama/History,1:47,36,3.064393493081416
38,50,Johnny Frank Garrett's Last Word,50,6,2016.0,Horror,1:35,12,3.064393493081416
36,67,When Jews Were Funny,50,6,2013.0,Documentary,1:30,31,3.064393493081416
33,50,The Other Man: F.W. de Klerk and the End of Apartheid,50,6,2014.0,Drama/Biography,1:16,17,3.064393493081416
59,50,Foreverland,50,6,2011.0,Drama,1:33,-9,3.064393493081416
50,50,The Frontier,50,6,2015.0,Drama/Crime,1:28,0,3.064393493081416
86,100,Chi-Town,50,6,2018.0,Documentary,1:22,14,3.064393493081416
57,67,Hollywood to Dollywood,50,6,2010.0,Documentary,1:21,10,3.064393493081416
27,67,Caught,50,6,2017.0,Horror/Mystery and thriller,1:26,40,3.064393493081416
58,50,The Lesser Blessed,50,6,2012.0,Drama,1:26,-8,3.064393493081416
25,83,Luciferina,50,6,2018.0,Horror/Mystery and thriller,1:51,58,3.064393493081416
44,67,The Atoning,50,6,2017.0,Horror/Mystery and thriller,1:29,23,3.064393493081416
31,67,Fred Armisen: Standup For Drummers,50,6,2018.0,,,36,3.064393493081416
96,67,Tijuana Jackson: Purpose Over Prison,50,6,2020.0,Comedy,1:36,-29,3.064393493081416
73,67,Project Wild Thing,50,6,2013.0,Documentary/Drama,1:23,-6,3.064393493081416
89,83,The Legend of 420,50,6,2017.0,Documentary,1:27,-6,3.064393493081416
41,50,Vinyl,50,6,2012.0,Comedy,1:25,9,3.064393493081416
68,50,Age of Summer,50,6,2018.0,Comedy,1:29,-18,3.064393493081416
20,17,Cell 213,50,6,2010.0,Horror,1:49,-3,3.064393493081416
29,17,Clowntergeist,50,6,2016.0,Horror,1:20,-12,3.064393493081416
23,50,Switch,50,6,2012.0,,,27,3.064393493081416
85,100,Adjust Your Tracking: The Untold Story of the VHS Collector,50,6,2012.0,Documentary,1:24,15,3.064393493081416
14,0,Eulogy for a Vampire,50,6,2009.0,Horror,1:47,-14,3.064393493081416
54,67,The Last Big Thing,50,6,1996.0,Comedy,1:38,13,3.064393493081416
74,0,Live at the Foxes Den,50,5,2013.0,Drama/Romance,1:43,-74,2.734363528521053
85,100,Patrick's Day,50,5,2014.0,Drama,1:42,15,2.734363528521053
46,20,Who's Driving Doug,50,5,2016.0,Drama,1:39,-26,2.734363528521053
80,100,One October,50,5,2017.0,Drama,0:56,20,2.734363528521053
79,100,Bad Blood: The Movie,50,5,2016.0,Horror,1:20,21,2.734363528521053
36,20,Get Married If You Can,50,5,2014.0,Comedy,1:47,-16,2.734363528521053
39,40,Sightless,50,5,2020.0,Drama,1:29,1,2.734363528521053
46,100,Tiger Orange,50,5,2014.0,Drama/Gay and lesbian,1:15,54,2.734363528521053
51,80,Sarah Silverman: We are Miracles,50,5,2013.0,,,29,2.734363528521053
17,40,Backdraft 2,50,5,2019.0,Drama/Crime,1:42,23,2.734363528521053
36,0,Delirium,50,5,2018.0,Mystery and thriller/Horror,1:28,-36,2.734363528521053
54,40,Something of Value,50,5,1957.0,Drama,1:53,-14,2.734363528521053
59,60,Where the Hot Wind Blows,50,5,1959.0,Drama,2:00,1,2.734363528521053
58,80,Feminists: What Were They Thinking?,50,5,2018.0,Documentary,1:27,22,2.734363528521053
70,20,Brush With Danger,50,5,2014.0,Drama/Crime,1:30,-50,2.734363528521053
26,60,Down and Dangerous,50,5,2013.0,Drama/Crime,1:35,34,2.734363528521053
89,100,Antiquities,50,5,2018.0,Comedy,1:34,11,2.734363528521053
32,20,Furlough,50,5,2018.0,Comedy,1:23,-12,2.734363528521053
10,60,Worry Dolls,50,5,2016.0,Horror/Mystery and thriller,1:26,50,2.734363528521053
83,100,Boys,50,5,2018.0,Drama/Romance,1:22,17,2.734363528521053
49,20,Ace the Case,50,5,2016.0,Mystery and thriller/Comedy,1:34,-29,2.734363528521053
67,80,Uncle Harry,50,5,1945.0,Mystery and thriller,1:20,13,2.734363528521053
82,40,Faith Connections,50,5,2013.0,Drama/Biography,1:55,-42,2.734363528521053
32,0,Gangster Land,50,5,2017.0,Drama/Crime,1:28,-32,2.734363528521053
78,60,Speak,50,5,2011.0,Drama/Documentary,1:29,-18,2.734363528521053
52,40,Revenger,50,5,2018.0,,,-12,2.734363528521053
63,80,Hidden,50,5,2015.0,Horror/Mystery and thriller,1:23,17,2.734363528521053
57,60,Surrogate Valentine,50,5,2011.0,Comedy,1:16,3,2.734363528521053
84,40,Red Shoes and the Seven Dwarfs,50,5,2019.0,Action/Animation,1:32,-44,2.734363528521053
79,100,Tom Segura: Disgraceful,50,5,2018.0,,,21,2.734363528521053
6,20,Turkey Shoot,50,5,2014.0,Action,1:30,14,2.734363528521053
82,80,From the Head,50,5,2012.0,Drama,1:35,-2,2.734363528521053
23,40,A Farewell to Fools,50,5,2013.0,Comedy/War,1:30,17,2.734363528521053
55,40,"Bert Rigby, You're a Fool",50,5,1989.0,Comedy/Musical,1:34,-15,2.734363528521053
9,20,Beneath the Leaves,50,5,2019.0,Horror/Mystery and thriller,1:30,11,2.734363528521053
94,100,Bill Burr: I'm Sorry You Feel That Way,50,5,2014.0,,,6,2.734363528521053
67,20,The Odd Way Home,50,5,2013.0,Drama,1:27,-47,2.734363528521053
38,40,Misconception,50,5,2014.0,Documentary,1:33,2,2.734363528521053
91,20,The Brooklyn Banker,50,5,2016.0,Drama/Crime,1:39,-71,2.734363528521053
28,60,Godzilla: The Planet Eater,50,5,2018.0,Sci fi/Action,1:31,32,2.734363528521053
67,80,Spanish Lake,50,5,2014.0,Documentary,1:18,13,2.734363528521053
50,60,"Turtle Hill, Brooklyn",50,5,2011.0,Comedy/Drama,1:35,10,2.734363528521053
62,100,"Michael Bolton's Big, Sexy Valentine's Day Special",50,5,2017.0,,,38,2.734363528521053
43,60,Arcadia,50,5,2012.0,Drama,1:30,17,2.734363528521053
65,60,Barking Water,50,5,2009.0,Drama,1:20,-5,2.734363528521053
85,69,Ammonite,1,237,2020.0,Gay and lesbian/Drama,2:00,-16,30.494233135441753
43,58,Tesla,1,174,2020.0,Biography/Drama,1:42,15,25.13872691364861
60,60,Ophelia,1,131,2018.0,Drama/Romance,1:54,0,21.05205809326756
85,79,Marianne & Leonard: Words of Love,1,116,2019.0,Music/Biography,1:37,-6,19.511301649293156
88,97,First Love,1,116,2019.0,Comedy/Drama,1:48,9,19.511301649293156
84,45,Fatman,1,113,2020.0,Other/Mystery and thriller,1:40,-39,19.194377290564812
75,86,Come to Daddy,1,103,2019.0,Mystery and thriller/Comedy,1:33,11,18.1143712989759
66,75,Wander Darkly,1,97,2020.0,Drama,1:37,9,17.447464924548626
60,89,Save Yourselves!,1,90,2020.0,Sci fi/Comedy,1:33,29,16.64951428545866
63,90,Bull,1,87,2019.0,Drama,1:48,27,16.300447707594707
95,93,And Then We Danced,1,84,2019.0,Gay and lesbian/Drama,1:45,-2,15.946836950911226
67,93,"Bloody Nose, Empty Pockets",1,83,2020.0,Documentary,1:38,26,15.827918586512368
92,81,Memory: The Origins of Alien,1,80,2019.0,Documentary,1:35,-11,15.467895945971296
63,89,You Don't Nomi,1,80,2019.0,Documentary,1:32,26,15.467895945971296
86,74,The Death of Dick Long,1,77,2019.0,Drama/Comedy,1:40,-12,15.102773291691431
31,69,Knives and Skin,1,74,2019.0,Drama/Mystery and thriller,1:52,38,14.732275265126917
97,50,Burden,1,72,2018.0,Drama,2:09,-47,14.482142292408389
35,76,Tommaso,1,72,2019.0,Drama,1:55,41,14.482142292408389
26,56,Random Acts of Violence,1,72,2019.0,Horror,1:20,30,14.482142292408389
47,70,Kindred,1,71,2020.0,Mystery and thriller,1:41,23,14.356099772615265
40,51,Guns Akimbo,1,68,2019.0,Action/Comedy,1:35,11,13.973914138485368
56,88,What She Said: The Art of Pauline Kael,1,67,2018.0,Documentary,1:35,32,13.8451208742507
36,37,Out of Blue,1,67,2018.0,Drama/Crime,1:50,1,13.8451208742507
71,99,The Fight,1,67,2020.0,Documentary,1:36,28,13.8451208742507
79,92,Rebuilding Paradise,1,66,2020.0,Documentary,1:35,13,13.715604699135167
44,42,Guest of Honour,1,65,2019.0,Drama,1:45,-2,13.58535050847747
33,90,Luxor,1,61,2020.0,Drama/Romance,1:25,57,13.056631493342596
83,89,Cunningham,1,61,2019.0,Music/Biography,1:33,6,13.056631493342596
86,90,Tel Aviv on Fire,1,61,2018.0,Drama/Comedy,1:37,4,13.056631493342596
75,95,Stray,1,60,2021.0,Documentary,1:13,20,12.922440211617326
86,87,"Standing Up, Falling Down",1,60,2019.0,Drama/Comedy,1:31,1,12.922440211617326
86,89,Robin's Wish,1,57,2020.0,Documentary,1:17,3,12.514738658402138
44,41,The Tomorrow Man,1,56,2019.0,Drama/Romance,1:34,-3,12.377060587439436
69,73,"Family Romance, LLC",1,55,2019.0,Drama,1:29,4,12.238457412731087
64,65,Astronaut,1,55,2019.0,Drama,1:37,1,12.238457412731087
69,93,Cowboys,1,54,2020.0,Drama,1:23,24,12.098905925115496
68,78,Eternal Beauty,1,54,2019.0,Drama/Romance,1:35,10,12.098905925115496
69,93,We Are Little Zombies,1,54,2019.0,Drama,2:00,24,12.098905925115496
76,87,Untouchable,1,53,2019.0,Documentary,1:38,11,11.958381890942793
75,90,Rams,1,52,2020.0,Comedy/Drama,1:59,15,11.8168599865911
50,33,Mapplethorpe,1,52,2018.0,Gay and lesbian/Drama,1:42,-17,11.8168599865911
66,98,The Swerve,1,52,2018.0,Drama,1:35,32,11.8168599865911
33,56,Sibyl,1,52,2019.0,Comedy/Drama,1:40,23,11.8168599865911
92,100,The Paper Tigers,1,51,2020.0,Sports and fitness/Action,1:48,8,11.674313727451958
88,46,Girls of the Sun,1,50,2018.0,Drama/War,1:55,-42,11.530715390799685
69,82,Esto no es Berlín,1,50,2019.0,Drama,1:55,13,11.530715390799685
50,64,Clementine,1,50,2019.0,Drama,1:34,14,11.530715390799685
100,88,Desert One,1,50,2019.0,Documentary,1:47,-12,11.530715390799685
67,78,The True Adventures of Wolfboy,1,50,2019.0,Drama,1:28,11,11.530715390799685
70,63,The Artist's Wife,1,49,2019.0,Drama,1:35,-7,11.3860359318845
88,100,White Riot,1,49,2019.0,Documentary/Music,1:20,12,11.3860359318845
100,69,Haunt,1,48,2019.0,Other/Horror,1:32,-31,11.240244892502977
54,70,Olympic Dreams,1,47,2019.0,Romance,1:23,16,11.093310301199846
56,87,What You Gonna Do When The World's On Fire?,1,47,2018.0,Documentary,2:03,31,11.093310301199846
43,41,The Quarry,1,46,2020.0,Drama/Crime,1:38,-2,10.945198564139895
53,98,Fourteen,1,46,2019.0,Drama,1:34,45,10.945198564139895
91,96,Red Penguins,1,46,2019.0,Documentary,1:20,5,10.945198564139895
79,93,Working Man,1,45,2019.0,Drama,1:49,14,10.795874345554918
50,30,Dirt Music,1,44,2019.0,Romance,1:45,-20,10.645300436514761
58,75,Shooting the Mafia,1,44,2019.0,Documentary,1:40,17,10.645300436514761
94,95,My Darling Vivian,1,44,2020.0,Documentary,1:30,1,10.645300436514761
66,95,The Ghost of Peter Sellers,1,43,2018.0,Documentary,1:33,29,10.493437610589469
68,81,VHYes,1,42,2019.0,Comedy,1:12,13,10.34024446475599
94,98,Assassins,1,42,2020.0,Documentary,1:44,4,10.34024446475599
20,32,Rodin,1,41,2017.0,Drama/Romance,1:59,12,10.185677243651742
23,49,Four Kids and It,1,41,2019.0,Fantasy,1:50,26,10.185677243651742
50,66,Memoir of War,1,41,2017.0,Drama/War,2:07,16,10.185677243651742
60,67,Castle in the Ground,1,39,2019.0,Drama,1:45,7,9.872232603526719
69,85,Skin: A History of Nudity in the Movies,1,39,2020.0,Documentary,2:10,16,9.872232603526719
88,100,A Thousand Cuts,1,39,2020.0,Documentary,1:50,12,9.872232603526719
84,95,Jimmy Carter: Rock & Roll President,1,39,2020.0,Music/Documentary,1:35,11,9.872232603526719
69,90,In the Aisles,1,39,2018.0,Comedy/Romance,2:05,21,9.872232603526719
47,92,Nomad: In the Footsteps of Bruce Chatwin,1,38,2019.0,Documentary,1:29,45,9.713254050808038
78,62,Mrs. Lowry & Son,1,37,2019.0,Drama/Biography,1:32,-16,9.552698646911638
69,62,Love Sarah,1,37,2020.0,Romance,1:37,-7,9.552698646911638
25,46,Run This Town,1,37,2019.0,Mystery and thriller,1:38,21,9.552698646911638
48,17,Acrimony,1,36,2018.0,Drama/Mystery and thriller,2:00,-31,9.390507480439723
59,97,The Body Remembers When the World Broke Open,1,36,2019.0,Drama,1:45,38,9.390507480439723
54,60,Piranhas,1,35,2019.0,Drama/Crime,1:51,6,9.22661773178138
67,74,Out Stealing Horses,1,35,2019.0,Drama,2:03,7,9.22661773178138
56,74,Bully. Coward. Victim. The Story of Roy Cohn,1,35,2019.0,Documentary,1:37,18,9.22661773178138
77,97,Billie,1,35,2020.0,Documentary/Music,1:36,20,9.22661773178138
100,94,System Crasher,1,35,2019.0,Drama,1:50,-6,9.22661773178138
50,79,Das Vorspiel,1,34,2020.0,Drama,,29,9.060962294042406
92,65,The Quiet One,1,34,2019.0,Music/Documentary,1:45,-27,9.060962294042406
100,74,Flannery,1,34,2019.0,Documentary,1:37,-26,9.060962294042406
66,61,Liam Gallagher: As It Was,1,33,2019.0,Music/Documentary,1:25,-5,8.893469344897873
93,76,Tammy's Always Dying,1,33,2019.0,Drama,1:25,-17,8.893469344897873
96,100,Inmate #1: The Rise of Danny Trejo,1,32,2019.0,Documentary,1:50,4,8.724061861322062
83,81,Happy Happy Joy Joy: The Ren & Stimpy Story,1,32,2020.0,Documentary,1:44,-2,8.724061861322062
33,59,Caniba,1,32,2017.0,Documentary,1:30,26,8.724061861322062
71,94,"Crazy, Not Insane",1,32,2020.0,Documentary,1:58,23,8.724061861322062
55,94,The Deeper You Dig,1,32,2019.0,Drama/Horror,1:32,39,8.724061861322062
80,78,Natalie Wood: What Remains Behind,1,32,2020.0,Documentary,1:40,-2,8.724061861322062
21,65,On a Magical Night,1,31,2019.0,Drama/Comedy,1:26,44,8.552657067536824
68,45,LX 2048,1,31,2020.0,Sci fi,1:44,-23,8.552657067536824
10,58,Mrs. Hyde,1,31,2017.0,Comedy/Drama,1:35,48,8.552657067536824
49,68,Darlin',1,31,2019.0,Drama/Horror,1:40,19,8.552657067536824
87,97,The Donut King,1,31,2020.0,Documentary,1:30,10,8.552657067536824
33,74,Clara's Ghost,1,31,2018.0,Comedy,1:33,41,8.552657067536824
74,67,Almost Love,1,30,2019.0,Gay and lesbian/Romance,1:32,-7,8.379165804519056
89,97,Beasts Clawing at Straws,1,30,2020.0,Drama/Crime,1:49,8,8.379165804519056
75,87,White Noise,1,30,2020.0,Documentary,1:34,12,8.379165804519056
26,60,Trespassers,1,30,2018.0,Horror/Mystery and thriller,1:28,34,8.379165804519056
60,80,Hammer,1,30,2019.0,Drama/Crime,1:22,20,8.379165804519056
83,55,Strange but True,1,29,2019.0,Mystery and thriller,1:36,-28,8.20349180691225
93,100,Suzi Q,1,29,2019.0,Documentary/Music,1:38,7,8.20349180691225
46,66,The Furies,1,29,2019.0,Action/Mystery and thriller,1:22,20,8.20349180691225
100,96,Creem: America's Only Rock 'n' Roll Magazine,1,28,2019.0,Music/Documentary,1:15,-4,8.02553087005176
48,54,Lost Transmissions,1,28,2019.0,Drama,1:45,6,8.02553087005176
79,89,Zombie for Sale,1,28,2019.0,,,10,8.02553087005176
81,89,Socrates,1,28,2018.0,Drama,1:11,8,8.02553087005176
82,78,The 24th,1,27,2020.0,Drama/History,1:53,-4,7.845169885845621
70,100,Drunk Bus,1,27,2020.0,Drama/Comedy,1:20,30,7.845169885845621
100,89,The Dalai Lama: Scientist,1,27,2019.0,Documentary,1:34,-11,7.845169885845621
86,33,Measure for Measure,1,27,2019.0,Drama,1:47,-53,7.845169885845621
100,81,Aviva,1,27,2020.0,Drama/Romance,1:56,-19,7.845169885845621
33,4,"Love, Weddings & Other Disasters",1,27,2020.0,Romance,1:36,-29,7.845169885845621
57,81,Hearts and Bones,1,27,2019.0,Drama,1:51,24,7.845169885845621
38,19,Euphoria,1,27,2017.0,Drama,1:38,-19,7.845169885845621
38,27,Phil,1,26,2019.0,Drama/Comedy,1:41,-11,7.662285721192069
67,54,Skylines,1,26,2020.0,Sci fi/Mystery and thriller,1:50,-13,7.662285721192069
64,92,The Surrogate,1,26,2020.0,Drama/Gay and lesbian,1:33,28,7.662285721192069
62,50,The Sonata,1,26,2018.0,Horror/Mystery and thriller,1:28,-12,7.662285721192069
38,19,The Aspern Papers,1,26,2018.0,Drama,1:31,-19,7.662285721192069
100,81,Prima Ballerina,1,26,2009.0,,,-19,7.662285721192069
14,40,Thriller,1,25,2018.0,Horror/Mystery and thriller,1:26,26,7.476743906106103
50,32,The Devil Has a Name,1,25,2020.0,Comedy/Drama,1:37,-18,7.476743906106103
60,72,Ottolenghi and the Cakes of Versailles,1,25,2020.0,Documentary,1:15,12,7.476743906106103
90,17,The Silencing,1,24,2020.0,Mystery and thriller,1:33,-73,7.288397090280924
19,63,My Son,1,24,2017.0,Drama,1:24,44,7.288397090280924
75,92,Showbiz Kids,1,24,2020.0,Documentary,1:35,17,7.288397090280924
38,58,Bleak Street,1,24,2015.0,Drama,1:40,20,7.288397090280924
60,71,Our Mothers,1,24,2019.0,War/Drama,1:18,11,7.288397090280924
60,71,Stray Dolls,1,24,2019.0,Drama/Crime,1:37,11,7.288397090280924
21,39,Don't Go,1,23,2018.0,Mystery and thriller,1:32,18,7.097083215743026
89,65,P!nk: All I Know So Far,1,23,2021.0,Documentary/Music,1:39,-24,7.097083215743026
17,74,Adam,1,23,2019.0,Gay and lesbian/Comedy,1:35,57,7.097083215743026
93,91,QT8: The First Eight,1,23,2019.0,Documentary,1:40,-2,7.097083215743026
29,61,Tape,1,23,2020.0,Drama,1:38,32,7.097083215743026
58,87,Survival Skills,1,23,2020.0,Comedy,1:24,29,7.097083215743026
65,74,Ghost Light,1,23,2018.0,Comedy,1:42,9,7.097083215743026
89,96,Marona's Fantastic Tale,1,23,2019.0,Drama/Animation,1:32,7,7.097083215743026
57,50,That Good Night,1,22,2017.0,Drama,1:32,-7,6.9026233386080005
40,59,Mobile Homes,1,22,2017.0,Drama,1:46,19,6.9026233386080005
60,95,Goldie,1,22,2020.0,Drama,1:28,35,6.9026233386080005
59,36,Waiting for Anya,1,22,2020.0,Drama/History,1:49,-23,6.9026233386080005
56,100,"A Bread Factory, Part Two: Walk with Me a While",1,22,2018.0,,,44,6.9026233386080005
68,86,Inside the Rain,1,21,2019.0,Drama/Romance,1:30,18,6.704819013328363
28,52,Ladyworld,1,21,2018.0,Mystery and thriller,1:33,24,6.704819013328363
26,52,Summer Night,1,21,2019.0,Drama/Comedy,1:38,26,6.704819013328363
100,100,I Will Make You Mine,1,21,2020.0,Drama,1:20,0,6.704819013328363
37,57,Max Cloud,1,21,2020.0,Sci fi/Adventure,1:28,20,6.704819013328363
41,90,Riot Girls,1,21,2019.0,Action,1:22,49,6.704819013328363
68,90,Two Heads Creek,1,21,2019.0,Comedy/Horror,1:25,22,6.704819013328363
46,85,Ten Minutes to Midnight,1,20,2020.0,Horror/Mystery and thriller,1:13,39,6.503449126242364
60,75,CRSHD,1,20,2019.0,Comedy,1:20,15,6.503449126242364
74,75,Armstrong,1,20,2019.0,Documentary,1:40,1,6.503449126242364
49,45,Inherit the Viper,1,20,2019.0,Mystery and thriller/Drama,1:30,-4,6.503449126242364
100,100,"Harry Chapin: When in Doubt, Do Something",1,20,2020.0,Music/Documentary,,0,6.503449126242364
29,30,Into the Ashes,1,20,2019.0,Action/Mystery and thriller,1:37,1,6.503449126242364
68,95,The Planters,1,20,2019.0,Comedy,1:18,27,6.503449126242364
69,65,Sister Aimee,1,20,2019.0,Biography,1:27,-4,6.503449126242364
97,100,5B,1,20,2018.0,Documentary,1:35,3,6.503449126242364
56,55,Never Too Late,1,20,2020.0,Comedy/Drama,1:38,-1,6.503449126242364
83,84,Lake Michigan Monster,1,19,2018.0,Adventure/Comedy,1:18,1,6.298266028731006
61,89,Eva and Lola,1,19,2010.0,Drama/Romance,1:27,28,6.298266028731006
55,74,The Argument,1,19,2020.0,Comedy,1:21,19,6.298266028731006
71,83,Funny Story,1,18,2018.0,Drama/Gay and lesbian,1:25,12,6.088990769440213
38,50,The Outsider,1,18,2019.0,Western,1:26,12,6.088990769440213
18,22,Verotika,1,18,2019.0,Horror,1:30,4,6.088990769440213
50,44,Modern Persuasion,1,18,2020.0,Romance,1:27,-6,6.088990769440213
90,44,The Divine Fury,1,18,2019.0,Action/Horror,2:09,-46,6.088990769440213
55,28,Clover,1,18,2020.0,Comedy,1:31,-27,6.088990769440213
33,78,The Challenge,1,18,2016.0,Documentary,1:10,45,6.088990769440213
100,78,Wonders of the Sea,1,18,2017.0,Documentary,1:23,-22,6.088990769440213
60,17,Hot Air,1,18,2018.0,Drama,1:43,-43,6.088990769440213
50,83,In the Intense Now,1,18,2017.0,Documentary,2:07,33,6.088990769440213
100,65,Calling All Earthlings,1,17,2018.0,Documentary,1:14,-35,5.875307153057772
33,47,Sister of the Groom,1,17,2020.0,Drama/Romance,1:32,14,5.875307153057772
95,88,Princess of the Row,1,17,2019.0,Drama,1:25,-7,5.875307153057772
75,82,From the Vine,1,17,2019.0,Drama/Comedy,1:34,7,5.875307153057772
69,82,Auggie,1,17,2019.0,Drama/Sci fi,1:21,13,5.875307153057772
60,82,The Retreat,1,17,2021.0,Mystery and thriller,1:22,22,5.875307153057772
25,53,"If Not Now, When?",1,17,2021.0,Drama,1:51,28,5.875307153057772
84,88,37 Seconds,1,17,2019.0,Drama,1:55,4,5.875307153057772
54,53,Daguerrotype,1,17,2016.0,Drama/Horror,2:11,-1,5.875307153057772
59,100,James vs. His Future Self,1,17,2019.0,Drama,1:34,41,5.875307153057772
8,24,Psychopaths,1,17,2017.0,Horror,1:25,16,5.875307153057772
75,65,The Great Gilly Hopkins,1,17,2016.0,Comedy/Drama,1:37,-10,5.875307153057772
52,65,Seven Stages to Achieve Eternal Bliss by Passing Through the Gateway Chosen by the Holy Storsh,1,17,2018.0,Comedy,1:36,13,5.875307153057772
82,88,Summerland,1,17,2020.0,Comedy,,6,5.875307153057772
22,44,Critters Attack!,1,16,2019.0,Horror/Comedy,1:29,22,5.656854249492381
89,81,All I Can Say,1,16,2019.0,Documentary,1:42,-8,5.656854249492381
38,100,Cane River,1,16,1982.0,Romance,1:30,62,5.656854249492381
85,69,Warriors of the Rainbow: Seediq Bale,1,16,2011.0,Drama/History,2:30,-16,5.656854249492381
71,63,Skyman,1,16,2020.0,Sci fi,1:33,-8,5.656854249492381
71,69,To Your Last Death,1,16,2019.0,Horror/Animation,1:31,-2,5.656854249492381
14,50,The Giant,1,16,2019.0,Mystery and thriller,1:40,36,5.656854249492381
100,100,Charm City,1,16,2018.0,Documentary,1:48,0,5.656854249492381
73,88,AKA Jane Roe,1,16,2020.0,Documentary,,15,5.656854249492381
40,40,Wetlands,1,15,2017.0,Drama/Crime,1:38,0,5.433216825139731
88,87,15 Things You Didn't Know About Bigfoot (Number 1 Will Blow Your Mind!),1,15,2019.0,Comedy,1:23,-1,5.433216825139731
80,93,Pretending I'm a Superman: The Tony Hawk Video Game Story,1,15,2020.0,Documentary,1:20,13,5.433216825139731
62,67,The Swamp,1,15,2020.0,Documentary,,5,5.433216825139731
62,67,Emperor,1,15,2020.0,Drama/Biography,1:39,5,5.433216825139731
25,7,Isabelle,1,15,2018.0,Horror/Mystery and thriller,1:20,-18,5.433216825139731
30,73,Lost & Found,1,15,2017.0,Comedy,1:32,43,5.433216825139731
33,67,She's Missing,1,15,2019.0,Drama/Mystery and thriller,1:40,34,5.433216825139731
80,100,Making Montgomery Clift,1,15,2018.0,Documentary,1:28,20,5.433216825139731
80,47,Ricky Gervais: Humanity,1,15,2018.0,Comedy/Stand up,,-33,5.433216825139731
75,93,Jesus Shows You the Way to the Highway,1,15,2019.0,Sci fi/Mystery and thriller,1:23,18,5.433216825139731
21,73,Blood Vessel,1,15,2019.0,Horror,1:33,52,5.433216825139731
67,60,The Cannibal Club,1,15,2018.0,Horror/Comedy,1:21,-7,5.433216825139731
58,67,She's in Portland,1,15,2020.0,Drama/Comedy,1:41,9,5.433216825139731
100,87,The Man Standing Next,1,15,2020.0,Drama,1:54,-13,5.433216825139731
89,100,The River and the Wall,1,15,2019.0,Documentary,1:37,11,5.433216825139731
75,87,Vanilla,1,15,2019.0,Romance,1:27,12,5.433216825139731
57,64,Imaginary Order,1,14,2019.0,Drama/Comedy,1:41,7,5.203912939677927
48,86,Safe Spaces,1,14,2019.0,Comedy,1:33,38,5.203912939677927
47,21,Perfect,1,14,2018.0,Horror/Sci fi,1:25,-26,5.203912939677927
100,100,Unprescribed,1,14,2020.0,Documentary,,0,5.203912939677927
80,100,Maria Bamford: Old Baby,1,14,2017.0,,,20,5.203912939677927
60,71,The Place of No Words,1,14,2019.0,Drama,1:35,11,5.203912939677927
83,93,The Prince,1,14,2019.0,Drama,,10,5.203912939677927
80,100,Justin Timberlake + The Tennessee Kids,1,14,2016.0,,,20,5.203912939677927
94,71,Do You Trust This Computer?,1,14,2018.0,Documentary,1:30,-23,5.203912939677927
43,64,Dead Ant,1,14,2017.0,Comedy,1:27,21,5.203912939677927
88,93,Northwood Pie,1,14,2020.0,Drama/Romance,1:15,5,5.203912939677927
68,93,The Dark Divide,1,14,2020.0,Adventure/Drama,1:47,25,5.203912939677927
48,79,Murder to Mercy: The Cyntoia Brown Story,1,14,2020.0,Documentary,1:37,31,5.203912939677927
61,93,Pass Over,1,14,2018.0,Comedy/Drama,1:14,32,5.203912939677927
92,64,Cup of Cheer,1,14,2020.0,Comedy/Other,1:35,-28,5.203912939677927
71,79,There's Something in the Water,1,14,2019.0,Documentary,1:13,8,5.203912939677927
42,46,The Laws of Thermodynamics,1,13,2017.0,Romance/Comedy,1:40,4,4.968377601139757
30,23,Supercon,1,13,2018.0,Action/Comedy,1:40,-7,4.968377601139757
60,54,Stars Fell on Alabama,1,13,2021.0,Romance,1:43,-6,4.968377601139757
68,69,Bottom of the 9th,1,13,2019.0,Drama,1:51,1,4.968377601139757
67,92,Netizens,1,13,2018.0,Documentary,1:36,25,4.968377601139757
62,77,The Trouble With You,1,13,2018.0,Comedy/Drama,1:48,15,4.968377601139757
0,83,Reunion,1,12,2020.0,Mystery and thriller/Horror,1:35,83,4.725940818339814
0,25,The Price of Desire,1,12,2015.0,Drama,1:48,25,4.725940818339814
41,83,Hosts,1,12,2020.0,Horror,1:29,42,4.725940818339814
100,67,Teenage Badass,1,12,2020.0,Comedy,,-33,4.725940818339814
78,92,The Rest of Us,1,12,2019.0,Drama,1:20,14,4.725940818339814
77,92,School Life,1,12,2019.0,Drama/Comedy,1:51,15,4.725940818339814
100,100,Rom Boys: 40 Years of Rad,1,12,2020.0,Documentary,,0,4.725940818339814
37,100,"J.R. ""Bob"" Dobbs & The Church of the SubGenius",1,12,2019.0,Comedy/Documentary,1:20,63,4.725940818339814
53,58,Close Enemies (Freres Ennemis),1,12,2018.0,,,5,4.725940818339814
61,42,The Valley,1,12,2017.0,Drama/Mystery and thriller,1:35,-19,4.725940818339814
100,92,The Most Dangerous Year,1,12,2018.0,Documentary,1:30,-8,4.725940818339814
86,75,Loopers: The Caddie's Long Walk,1,12,2019.0,Documentary,1:20,-11,4.725940818339814
45,42,William,1,12,2019.0,Drama,1:42,-3,4.725940818339814
22,42,Seeds,1,12,2018.0,Horror/Mystery and thriller,1:30,20,4.725940818339814
61,100,All Is Good,1,12,2018.0,Drama,1:33,39,4.725940818339814
38,83,Four Hands,1,12,2017.0,Drama/Mystery and thriller,1:34,45,4.725940818339814
54,58,Coda,1,12,2020.0,Drama,1:36,4,4.725940818339814
100,92,Stay Human,1,12,2018.0,Documentary,1:34,-8,4.725940818339814
50,58,Crosscurrent,1,12,2016.0,Drama,1:56,8,4.725940818339814
74,83,The Collini Case,1,12,2019.0,Drama/Crime,2:03,9,4.725940818339814
33,50,The Night of the Virgin,1,12,2016.0,Comedy/Horror,1:56,17,4.725940818339814
67,100,Nail in the Coffin: The Fall and Rise of Vampiro,1,12,2019.0,Documentary,1:28,33,4.725940818339814
57,67,The Last Photograph,1,12,2017.0,Drama,1:25,10,4.725940818339814
45,45,Let's Scare Julie,1,11,2020.0,Horror/Mystery and thriller,1:23,0,4.475797488182033
86,82,Seventeen,1,11,2019.0,Drama,1:40,-4,4.475797488182033
13,0,Portals,1,11,2019.0,Sci fi/Horror,1:25,-13,4.475797488182033
43,91,The Emoji Story,1,11,2019.0,Documentary,1:21,48,4.475797488182033
100,91,Every Act of Life,1,11,2018.0,Biography/Documentary,1:32,-9,4.475797488182033
83,100,Terra Willy,1,11,2019.0,Sci fi/Comedy,1:29,17,4.475797488182033
59,82,Max Reload and the Nether Blasters,1,11,2020.0,Adventure/Fantasy,1:41,23,4.475797488182033
39,100,Dead Dicks,1,11,2020.0,Horror,,61,4.475797488182033
86,91,Don't Be Nice,1,11,2018.0,Documentary,1:36,5,4.475797488182033
100,64,Same Boat,1,11,2019.0,Romance,1:23,-36,4.475797488182033
77,73,The Soul Collector,1,11,2019.0,Horror,1:40,-4,4.475797488182033
25,36,Ip Man: Kung Fu Master,1,11,2019.0,Sports and fitness/Action,1:24,11,4.475797488182033
92,91,Parkland Rising,1,11,2019.0,Documentary,1:32,-1,4.475797488182033
81,64,Tuscaloosa,1,11,2019.0,Drama,1:40,-17,4.475797488182033
83,91,The Other Side of Everything,1,11,2017.0,Biography/Documentary,1:40,8,4.475797488182033
42,27,Outlaws,1,11,2017.0,Drama/Crime,1:32,-15,4.475797488182033
62,82,Murder in the Woods,1,11,2019.0,Horror/Mystery and thriller,1:30,20,4.475797488182033
90,64,Enter the Fat Dragon,1,11,2020.0,Sports and fitness/Action,1:37,-26,4.475797488182033
92,73,Sprinter,1,11,2018.0,Drama,1:54,-19,4.475797488182033
64,100,The Forest of Love,1,11,2019.0,Drama/Horror,2:31,36,4.475797488182033
73,100,International Falls,1,11,2019.0,Comedy,1:33,27,4.475797488182033
50,73,Uncle Kent 2,1,11,2015.0,Comedy/Drama,1:13,23,4.475797488182033
100,100,Pariah Dog,1,11,2019.0,Documentary,1:17,0,4.475797488182033
40,64,Union,1,11,2018.0,Drama/History,2:15,24,4.475797488182033
75,100,Philophobia: or the Fear of Falling in Love,1,11,2019.0,Comedy/Horror,1:25,25,4.475797488182033
35,55,Maine,1,11,2018.0,Drama,1:26,20,4.475797488182033
38,0,Run With the Hunted,1,11,2020.0,Drama/Crime,1:33,-38,4.475797488182033
85,91,We Believe In Dinosaurs,1,11,2019.0,Documentary,1:45,6,4.475797488182033
0,9,Maximum Impact,1,11,2018.0,Action/Adventure,1:50,9,4.475797488182033
29,82,W. Kamau Bell: Private School Negro,1,11,2018.0,,,53,4.475797488182033
73,91,Wetlands Preserved: The Story of an Activist Nightclub,1,11,2006.0,Documentary,1:33,18,4.475797488182033
93,100,Queen of Paradis,1,10,2020.0,Documentary,1:25,7,4.216965034285822
51,70,Think Like a Dog,1,10,2020.0,Fantasy/Kids and family,1:31,19,4.216965034285822
44,80,Rondo,1,10,2019.0,Mystery and thriller,1:30,36,4.216965034285822
23,20,Paydirt,1,10,2020.0,Drama/Crime,1:25,-3,4.216965034285822
86,100,Heroin(e),1,10,2017.0,Documentary,0:39,14,4.216965034285822
86,90,The Get Together,1,10,2020.0,Comedy,1:14,4,4.216965034285822
48,10,Intrigo: Death of an Author,1,10,2018.0,Drama/Crime,1:45,-38,4.216965034285822
91,50,Breath of the Gods,1,10,2011.0,Documentary,1:45,-41,4.216965034285822
36,20,The Pretenders,1,10,2018.0,,,-16,4.216965034285822
77,70,Bad Rap,1,10,2016.0,Documentary,1:22,-7,4.216965034285822
71,100,Olivia,1,10,1951.0,Drama/Gay and lesbian,1:36,29,4.216965034285822
12,90,Stars and Strife,1,10,2020.0,Documentary,,78,4.216965034285822
83,80,Cold Brook,1,10,2018.0,Drama/Comedy,1:42,-3,4.216965034285822
67,40,Sweetness in the Belly,1,10,2019.0,Drama,1:50,-27,4.216965034285822
67,90,Ice on Fire,1,10,2019.0,Documentary,1:38,23,4.216965034285822
40,60,Scarborough,1,10,2018.0,Drama/Romance,1:24,20,4.216965034285822
30,30,The Corrupted,1,10,2019.0,Drama/Crime,1:43,0,4.216965034285822
74,70,Ashfall,1,10,2019.0,Drama/Action,2:08,-4,4.216965034285822
43,50,2nd Date Sex,1,10,2019.0,Romance,1:38,7,4.216965034285822
87,60,Copwatch,1,10,2017.0,Documentary,1:35,-27,4.216965034285822
38,40,Chronically Metropolitan,1,10,2016.0,Drama/Comedy,1:30,2,4.216965034285822
74,80,The More You Ignore Me,1,10,2018.0,Comedy,1:38,6,4.216965034285822
83,100,It Started as a Joke,1,10,2019.0,Documentary,1:16,17,4.216965034285822
85,60,You Go To My Head,1,10,2017.0,Romance/Fantasy,1:56,-25,4.216965034285822
62,40,Spiral,1,10,2017.0,Documentary,1:19,-22,4.216965034285822
58,100,Say Her Name: The Life and Death of Sandra Bland,1,10,2018.0,Documentary,1:45,42,4.216965034285822
50,50,StarDog and TurboCat,1,10,2019.0,Kids and family/Comedy,1:31,0,4.216965034285822
71,100,Luz: The Flower of Evil,1,10,2019.0,Western/Horror,1:44,29,4.216965034285822
50,30,Rising High,1,10,2020.0,Comedy,1:34,-20,4.216965034285822
100,100,No Small Matter,1,10,2018.0,Documentary,,0,4.216965034285822
80,50,Money Machine,1,10,2020.0,Documentary,1:14,-30,4.216965034285822
55,20,Electric Man,1,10,2011.0,Comedy/Action,1:38,-35,4.216965034285822
80,56,The Rainbow Experiment,1,9,2018.0,Drama,1:29,-24,3.9482220388574776
75,78,King of Knives,1,9,2020.0,Drama/Comedy,1:35,3,3.9482220388574776
40,22,Kill Order,1,9,2017.0,Sci fi/Action,1:17,-18,3.9482220388574776
80,78,Until the Birds Return,1,9,2017.0,Drama,1:53,-2,3.9482220388574776
61,78,The Dark Red,1,9,2018.0,Horror/Mystery and thriller,1:41,17,3.9482220388574776
15,56,The Silent War,1,9,2018.0,War/Mystery and thriller,2:06,41,3.9482220388574776
46,44,Bachelorettes (Solteras),1,9,2018.0,,,-2,3.9482220388574776
81,44,The Battle of Jangsari,1,9,2019.0,War,1:48,-37,3.9482220388574776
100,100,Streetlight Harmonies,1,9,2020.0,Music/Documentary,1:24,0,3.9482220388574776
100,67,Just Say Goodbye,1,9,2017.0,Drama,1:46,-33,3.9482220388574776
82,89,Wayne,1,9,2018.0,Biography/Documentary,1:37,7,3.9482220388574776
30,44,Supervized,1,9,2019.0,Comedy,1:24,14,3.9482220388574776
80,78,Midnight Return: The Story of Billy Hayes and Turkey,1,9,2016.0,Documentary,1:39,-2,3.9482220388574776
60,44,Curtiz,1,9,2018.0,Drama/History,1:40,-16,3.9482220388574776
19,44,I Am Vengeance: Retaliation,1,9,2020.0,Action,1:30,25,3.9482220388574776
27,0,Mob Town,1,9,2019.0,Drama/Crime,1:29,-27,3.9482220388574776
70,56,What We Found,1,9,2020.0,Mystery and thriller,1:50,-14,3.9482220388574776
64,67,Lasso,1,9,2018.0,Horror,1:37,3,3.9482220388574776
78,56,Kepler's Dream,1,9,2016.0,Western/Drama,1:30,-22,3.9482220388574776
58,78,The Night Sitter,1,9,2018.0,,,20,3.9482220388574776
75,100,Ali Wong: Baby Cobra,1,9,2016.0,,,25,3.9482220388574776
80,100,My Prince Edward,1,9,2020.0,Drama,,20,3.9482220388574776
11,67,Black Site,1,9,2018.0,Sci fi/Action,1:27,56,3.9482220388574776
85,67,Scotch: A Golden Dream,1,9,2018.0,Documentary,1:27,-18,3.9482220388574776
22,56,Two/One,1,9,2019.0,Sci fi/Drama,1:40,34,3.9482220388574776
33,89,Soul on a String,1,9,2016.0,Drama/Mystery and thriller,2:22,56,3.9482220388574776
33,33,A Long Way From Home,1,9,2013.0,Drama,1:25,0,3.9482220388574776
50,33,Metamorphosis,1,9,2019.0,Horror/Mystery and thriller,1:53,-17,3.9482220388574776
91,89,See You Next Tuesday,1,9,2013.0,Comedy/Drama,1:22,-2,3.9482220388574776
26,11,Cats & Dogs 3: Paws Unite!,1,9,2020.0,Kids and family/Comedy,1:24,-15,3.9482220388574776
24,33,Victim,1,9,2011.0,Action/Drama,1:26,9,3.9482220388574776
44,78,Speed of Life,1,9,2019.0,Drama,1:16,34,3.9482220388574776
89,56,Daniel and Ana,1,9,2009.0,Drama/Mystery and thriller,1:30,-33,3.9482220388574776
100,89,Ice People,1,9,2008.0,Documentary,1:17,-11,3.9482220388574776
83,67,"Fanny, Annie & Danny",1,9,2010.0,Drama,1:22,-16,3.9482220388574776
49,63,Wolkenbruchs wunderliche Reise in die Arme einer Schickse,1,8,2018.0,,,14,3.668016172818685
95,63,Greatland,1,8,2020.0,Adventure/Fantasy,,-32,3.668016172818685
51,25,Making Babies,1,8,2018.0,Comedy,1:26,-26,3.668016172818685
74,50,"Live Twice, Love Once",1,8,2020.0,Comedy/Drama,,-24,3.668016172818685
96,100,John Mulaney: The Comeback Kid,1,8,2015.0,Comedy/Stand up,1:02,4,3.668016172818685
80,100,Rock Rubber 45s,1,8,2018.0,Documentary,1:36,20,3.668016172818685
84,100,American Relapse,1,8,2019.0,Documentary,1:45,16,3.668016172818685
29,63,Guest Artist,1,8,2019.0,Drama,1:14,34,3.668016172818685
100,50,The Mindfulness Movement,1,8,2020.0,Documentary,1:41,-50,3.668016172818685
50,75,Alone (Solo),1,8,2018.0,,,25,3.668016172818685
83,100,537 Votes,1,8,2020.0,Documentary,,17,3.668016172818685
30,38,I Am Vengeance,1,8,2018.0,Action,1:32,8,3.668016172818685
91,88,The Orange Years: The Nickelodeon Story,1,8,2020.0,Documentary,1:42,-3,3.668016172818685
85,25,Long Live Rock... Celebrate the Chaos,1,8,2021.0,Documentary/Music,1:20,-60,3.668016172818685
50,88,Bwoy,1,8,2016.0,Drama/Gay and lesbian,1:25,38,3.668016172818685
88,100,Fagara,1,8,2019.0,Drama,2:00,12,3.668016172818685
40,75,Red Hollywood,1,8,2014.0,,,35,3.668016172818685
35,50,4/20 Massacre,1,8,2018.0,Horror/Action,1:24,15,3.668016172818685
19,13,Prey,1,8,2019.0,Horror/Mystery and thriller,1:25,-6,3.668016172818685
46,38,Ovation,1,8,2015.0,Comedy,1:42,-8,3.668016172818685
56,63,"I Love You, Stupid",1,8,2020.0,Romance,1:27,7,3.668016172818685
73,100,Kill Chain: The Cyber War on America's Elections,1,8,2020.0,Documentary,1:31,27,3.668016172818685
73,75,"I, Pastafari",1,8,2019.0,Documentary,0:56,2,3.668016172818685
64,100,City of Joy,1,8,2016.0,Documentary,1:14,36,3.668016172818685
29,25,Aquaslash,1,8,2019.0,Horror,1:11,-4,3.668016172818685
83,88,Life After Flash,1,8,2017.0,Documentary,1:34,5,3.668016172818685
84,88,The Scheme,1,8,2020.0,Documentary,2:00,4,3.668016172818685
38,75,Spider in the Web,1,8,2019.0,Mystery and thriller,1:54,37,3.668016172818685
63,63,DeadTectives,1,8,2018.0,Horror/Comedy,1:32,0,3.668016172818685
38,100,Buddies,1,8,1985.0,Drama/Gay and lesbian,1:21,62,3.668016172818685
47,13,Spin Out,1,8,2016.0,Romance,1:32,-34,3.668016172818685
90,75,Family Obligations,1,8,2019.0,Drama/Comedy,1:22,-15,3.668016172818685
100,50,Up on the Glass,1,8,2020.0,Drama/Mystery and thriller,1:36,-50,3.668016172818685
73,38,Inside Game,1,8,2019.0,Drama,1:37,-35,3.668016172818685
84,88,Newly Single,1,8,2017.0,Comedy/Drama,1:36,4,3.668016172818685
71,75,Samurai Marathon 1855,1,8,2019.0,Drama/History,1:43,4,3.668016172818685
64,88,Gold Star,1,8,2017.0,Drama,1:30,24,3.668016172818685
25,25,The Legend of the Chupacabras,1,8,2016.0,Comedy/Action,1:21,0,3.668016172818685
19,0,Drive,1,8,2018.0,Action,2:27,-19,3.668016172818685
86,63,The Afterlight,1,8,2009.0,Drama,1:27,-23,3.668016172818685
100,88,Mary Pickford: The Muse of the Movies,1,8,2008.0,Documentary,1:42,-12,3.668016172818685
86,25,Tar,1,8,2020.0,Horror/Mystery and thriller,1:36,-61,3.668016172818685
71,75,"Ride, Rise, Roar",1,8,2010.0,Documentary/Music,1:27,4,3.668016172818685
44,50,A Distant Trumpet,1,8,1964.0,Western,1:57,6,3.668016172818685
41,43,Paris Is Us,1,7,2019.0,Drama/Romance,1:24,2,3.374320069567275
36,57,Camp Cold Brook,1,7,2018.0,Horror/Mystery and thriller,1:26,21,3.374320069567275
38,29,Paradox,1,7,2018.0,Western/Drama,1:13,-9,3.374320069567275
88,71,The Go-Getters,1,7,2018.0,Adventure/Comedy,1:23,-17,3.374320069567275
90,57,Gun and a Hotel Bible,1,7,2019.0,Drama,0:57,-33,3.374320069567275
21,43,White Chamber,1,7,2018.0,Drama,1:29,22,3.374320069567275
31,86,The Most Assassinated Woman in the World,1,7,2018.0,Mystery and thriller,1:42,55,3.374320069567275
71,43,Sweethearts of the Prison Rodeo,1,7,2009.0,Documentary,1:29,-28,3.374320069567275
88,43,15 Minutes of War,1,7,2019.0,Drama/Mystery and thriller,1:38,-45,3.374320069567275
62,14,The Hungry Ghosts,1,7,2009.0,Drama,1:45,-48,3.374320069567275
59,71,David Cross: Making America Great Again,1,7,2016.0,,,12,3.374320069567275
9,71,Ilana Glazer: The Planet is Burning,1,7,2020.0,Comedy/Stand up,0:59,62,3.374320069567275
65,0,American Dresser,1,7,2018.0,Drama,1:37,-65,3.374320069567275
86,100,Ask No Questions,1,7,2020.0,Documentary,1:19,14,3.374320069567275
57,71,Driven,1,7,2020.0,Horror/Comedy,1:30,14,3.374320069567275
40,57,Broil,1,7,2020.0,Horror/Mystery and thriller,1:30,17,3.374320069567275
42,71,The Tribe,1,7,2018.0,Comedy,1:30,29,3.374320069567275
46,86,The Black String,1,7,2019.0,Horror/Mystery and thriller,1:32,40,3.374320069567275
50,100,Hari Kondabolu: Warn Your Relatives,1,7,2018.0,,,50,3.374320069567275
27,14,The Child Remains,1,7,2017.0,Horror/Mystery and thriller,1:47,-13,3.374320069567275
71,43,They Reach,1,7,2020.0,Horror/Mystery and thriller,1:27,-28,3.374320069567275
62,71,Tom of Your Life,1,7,2020.0,Drama/Sci fi,1:32,9,3.374320069567275
64,29,Elis,1,7,2016.0,Music/Drama,1:50,-35,3.374320069567275
80,86,Vampira and Me,1,7,2012.0,Documentary,1:45,6,3.374320069567275
100,57,Love Free or Die: How the Bishop of New Hampshire Is Changing the World,1,7,2012.0,Gay and lesbian/Documentary,1:22,-43,3.374320069567275
95,86,American Street Kid,1,7,2016.0,Documentary,1:44,-9,3.374320069567275
53,100,Todd Glass: Act Happy,1,7,2018.0,,,47,3.374320069567275
86,100,Venus,1,7,2017.0,Drama/Comedy,1:35,14,3.374320069567275
80,100,First One In,1,7,2020.0,Comedy,1:38,20,3.374320069567275
53,86,Judd Apatow: The Return,1,7,2017.0,Comedy/Stand up,1:09,33,3.374320069567275
71,86,Use Me,1,7,2019.0,Mystery and thriller,1:31,15,3.374320069567275
36,57,Love at First Child,1,7,2015.0,Comedy,1:31,21,3.374320069567275
100,100,Waldo on Weed,1,7,2019.0,Documentary,1:27,0,3.374320069567275
100,43,The Mentor,1,7,2020.0,Mystery and thriller,1:14,-57,3.374320069567275
80,29,Easy Does It,1,7,2020.0,Adventure/Comedy,1:37,-51,3.374320069567275
90,100,Lost in America,1,7,2020.0,Documentary,1:34,10,3.374320069567275
14,0,Loqueesha,1,7,2019.0,Comedy,1:38,-14,3.374320069567275
91,71,Counterfeiters,1,7,2017.0,Drama,1:13,-20,3.374320069567275
56,57,Witches in the Woods,1,7,2019.0,Horror/Mystery and thriller,1:30,1,3.374320069567275
68,57,Above the Shadows,1,7,2019.0,Drama/Fantasy,1:45,-11,3.374320069567275
74,100,The Devil to Pay,1,7,2019.0,Mystery and thriller,1:27,26,3.374320069567275
58,100,Hannibal Buress: Comedy Camisado,1,7,2016.0,,,42,3.374320069567275
28,57,Ravage,1,7,2019.0,Action/Horror,1:17,29,3.374320069567275
71,71,Long Time Coming: A 1955 Baseball Story,1,7,2018.0,Documentary/Drama,1:27,0,3.374320069567275
50,71,Cut Shoot Kill,1,7,2017.0,Action/Horror,1:37,21,3.374320069567275
23,71,Dark Encounter,1,7,2019.0,Sci fi/Mystery and thriller,1:38,48,3.374320069567275
67,100,Brewmance,1,7,2021.0,Documentary/Special interest,1:42,33,3.374320069567275
83,100,Neal Brennan: 3 Mics,1,7,2017.0,,,17,3.374320069567275
100,71,Most Likely to Succeed,1,7,2019.0,Documentary,1:37,-29,3.374320069567275
80,57,Ms. White Light,1,7,2019.0,Comedy,1:37,-23,3.374320069567275
60,57,Juggernaut,1,7,2017.0,Drama/Crime,1:45,-3,3.374320069567275
63,86,Iron Fists and Kung Fu Kicks,1,7,2019.0,Documentary,1:40,23,3.374320069567275
13,0,Viktor,1,7,2014.0,Action/Mystery and thriller,1:38,-13,3.374320069567275
67,100,Softness of Bodies,1,7,2018.0,Comedy,1:15,33,3.374320069567275
60,43,Love Is Thicker Than Water,1,7,2016.0,Romance,1:41,-17,3.374320069567275
43,57,Knuckledust,1,7,2020.0,Action/Mystery and thriller,1:45,14,3.374320069567275
33,71,Lord Byron,1,7,2011.0,Comedy/Drama,1:35,38,3.374320069567275
86,86,Monster Road,1,7,2004.0,Documentary,1:19,0,3.374320069567275
33,43,Mother's Milk,1,7,2012.0,Drama,1:34,10,3.374320069567275
79,17,Chopsticks,1,6,2018.0,Drama,1:40,-62,3.064393493081416
52,100,Ghosts of Sugar Land,1,6,2019.0,Documentary,0:21,48,3.064393493081416
30,0,Invasion Planet Earth,1,6,2019.0,Sci fi/Mystery and thriller,1:38,-30,3.064393493081416
72,83,When Jeff Tried to Save the World,1,6,2018.0,Comedy,1:33,11,3.064393493081416
60,50,How Murray Saved Christmas,1,6,2014.0,,,-10,3.064393493081416
41,83,After We Leave,1,6,2019.0,Sci fi/Drama,1:22,42,3.064393493081416
22,17,Dead Water,1,6,2019.0,Mystery and thriller,1:29,-5,3.064393493081416
47,33,Look Away,1,6,2019.0,Drama/Comedy,1:30,-14,3.064393493081416
58,50,Miss Arizona,1,6,2018.0,Drama/Comedy,1:34,-8,3.064393493081416
86,83,The Archer,1,6,2017.0,Drama/Action,1:26,-3,3.064393493081416
48,83,The Mimic,1,6,2017.0,Drama/Horror,1:40,35,3.064393493081416
22,50,Elyse,1,6,2020.0,Drama,1:35,28,3.064393493081416
40,17,She's Just a Shadow,1,6,2019.0,Drama/Crime,1:57,-23,3.064393493081416
17,67,Candy Corn,1,6,2019.0,Other/Horror,1:25,50,3.064393493081416
62,0,How Sweet It Is,1,6,2013.0,Musical,1:44,-62,3.064393493081416
69,17,A Wizard's Tale,1,6,2018.0,Comedy/Adventure,1:37,-52,3.064393493081416
38,33,Better Start Running,1,6,2018.0,Adventure/Comedy,1:32,-5,3.064393493081416
80,33,The Climbers,1,6,2019.0,Adventure/Drama,2:05,-47,3.064393493081416
80,100,Two in the Bush: A Love Story,1,6,2018.0,Drama/Gay and lesbian,1:37,20,3.064393493081416
18,0,Acceleration,1,6,2019.0,Action,1:25,-18,3.064393493081416
32,0,Age of Kill,1,6,2015.0,Action,1:26,-32,3.064393493081416
33,33,Hackney's Finest,1,6,2014.0,Drama/Crime,1:29,0,3.064393493081416
29,17,The Stolen,1,6,2016.0,Adventure/Action,1:35,-12,3.064393493081416
43,100,Kevin Hart: Irresponsible,1,6,2019.0,Comedy/Stand up,,57,3.064393493081416
60,0,Backgammon,1,6,2015.0,Mystery and thriller,1:29,-60,3.064393493081416
41,33,Spy Intervention,1,6,2020.0,Adventure/Comedy,1:33,-8,3.064393493081416
67,100,Notes From The Field,1,6,2018.0,,,33,3.064393493081416
71,83,Black Boys,1,6,2020.0,Documentary,1:35,12,3.064393493081416
67,67,Skin in the Game,1,6,2018.0,Drama/Mystery and thriller,1:30,0,3.064393493081416
29,50,Get In,1,6,2019.0,Horror/Mystery and thriller,1:37,21,3.064393493081416
83,100,Odd Brodsky,1,6,2013.0,Comedy,1:33,17,3.064393493081416
48,83,The Crowd Roars,1,6,1932.0,Drama,1:25,35,3.064393493081416
38,17,The Great War,1,6,2019.0,War,1:50,-21,3.064393493081416
0,50,Evil Little Things,1,6,2019.0,Horror,1:20,50,3.064393493081416
77,83,Strike,1,6,2019.0,Adventure/Animation,1:40,6,3.064393493081416
73,33,e-Demon,1,6,2018.0,Horror/Mystery and thriller,1:26,-40,3.064393493081416
64,33,Pilgrim Song,1,6,2012.0,Drama,1:56,-31,3.064393493081416
76,83,Coyote Lake,1,6,2019.0,Mystery and thriller,1:33,7,3.064393493081416
62,33,See You Soon,1,6,2019.0,Drama/Romance,1:37,-29,3.064393493081416
0,83,The Heretics,1,6,2017.0,Mystery and thriller/Horror,1:27,83,3.064393493081416
38,33,One Night in Bangkok,1,6,2020.0,Mystery and thriller/Action,1:45,-5,3.064393493081416
64,100,Our Evil,1,6,2017.0,Horror,1:32,36,3.064393493081416
55,50,We Are Boats,1,6,2018.0,Drama/Fantasy,1:48,-5,3.064393493081416
53,50,Visions of Eight,1,6,1973.0,Documentary,1:45,-3,3.064393493081416
87,100,Mnemophrenia,1,6,2018.0,Sci fi/Drama,1:18,13,3.064393493081416
88,100,Three Sisters,1,6,2013.0,,,12,3.064393493081416
100,100,Where's Daddy?,1,6,2018.0,,,0,3.064393493081416
79,17,Dead Kids,1,6,2019.0,Mystery and thriller,1:38,-62,3.064393493081416
22,0,Showdown in Manila,1,6,2016.0,Action,1:26,-22,3.064393493081416
73,83,Tracy Morgan: Staying Alive,1,6,2017.0,,,10,3.064393493081416
30,0,Two on a Guillotine,1,6,1965.0,Horror,1:47,-30,3.064393493081416
33,67,Alright Now,1,6,2018.0,Comedy/Drama,1:35,34,3.064393493081416
100,100,Invisible Essence: The Little Prince,1,6,2018.0,Documentary,1:29,0,3.064393493081416
83,83,Baby Frankenstein,1,6,2018.0,Comedy/Sci fi,1:23,0,3.064393493081416
45,83,My Hindu Friend,1,6,2020.0,Drama,,38,3.064393493081416
33,67,Flex Is Kings,1,6,2013.0,Documentary,1:23,34,3.064393493081416
69,50,Who Killed Cock Robin?,1,6,2017.0,Drama/Crime,1:58,-19,3.064393493081416
56,100,Aziz Ansari: Buried Alive,1,6,2013.0,Comedy/Stand up,1:19,44,3.064393493081416
50,100,Breaking Surface,1,6,2020.0,Action/Drama,1:35,50,3.064393493081416
67,50,Good Sam,1,6,2019.0,Comedy,1:29,-17,3.064393493081416
62,50,Something,1,6,2018.0,Drama/Horror,1:26,-12,3.064393493081416
0,17,They're Inside,1,6,2019.0,Horror/Mystery and thriller,1:23,17,3.064393493081416
83,83,Fire in Paradise,1,6,2019.0,Documentary,0:40,0,3.064393493081416
73,50,Ghost Killers vs. Bloody Mary (Exterminadores do Além Contra a Loira do Banheiro),1,6,2018.0,,,-23,3.064393493081416
47,0,Get Gone,1,6,2019.0,Horror/Mystery and thriller,1:31,-47,3.064393493081416
64,100,Fare,1,6,2016.0,Drama/Mystery and thriller,1:15,36,3.064393493081416
62,33,Who Needs Enemies,1,6,2013.0,Drama/Crime,1:31,-29,3.064393493081416
67,100,The Good Postman,1,6,2016.0,Documentary,1:20,33,3.064393493081416
50,67,Domain,1,6,2017.0,Sci fi/Mystery and thriller,1:37,17,3.064393493081416
44,83,Gretchen,1,6,2006.0,Comedy,1:38,39,3.064393493081416
53,60,Daddy's Girl,1,5,2018.0,Horror,1:21,7,2.734363528521053
44,20,Hospitality,1,5,2018.0,Mystery and thriller,1:20,-24,2.734363528521053
67,60,Iliza: Elder Millennial,1,5,2018.0,,,-7,2.734363528521053
82,20,Range Runners,1,5,2019.0,Mystery and thriller,1:51,-62,2.734363528521053
38,60,Ultras,1,5,2020.0,Drama,1:48,22,2.734363528521053
25,60,Guilty,1,5,2020.0,Mystery and thriller,1:59,35,2.734363528521053
100,80,Cut and Chop,1,5,2020.0,Horror/Mystery and thriller,1:30,-20,2.734363528521053
93,40,Rag Doll,1,5,2019.0,Drama/Action,1:43,-53,2.734363528521053
35,100,Extremity,1,5,2018.0,Horror,1:38,65,2.734363528521053
20,40,Intrigo: Dear Agnes,1,5,2019.0,Mystery and thriller,1:40,20,2.734363528521053
73,100,Sun Ra: A Joyful Noise,1,5,1981.0,Music/Documentary,1:00,27,2.734363528521053
83,60,One Last Night,1,5,2018.0,Romance,1:17,-23,2.734363528521053
54,40,Into the Labyrinth,1,5,2019.0,Mystery and thriller,2:10,-14,2.734363528521053
95,60,Surviving Confession,1,5,2018.0,,,-35,2.734363528521053
33,100,Trevor Noah: Afraid of the Dark,1,5,2017.0,Horror/Comedy,1:07,67,2.734363528521053
13,80,Intensive Care,1,5,2018.0,Drama/Crime,1:20,67,2.734363528521053
28,0,The Legion,1,5,2020.0,Adventure/Action,1:36,-28,2.734363528521053
57,80,Coming to My Senses,1,5,2017.0,Adventure/Biography,1:25,23,2.734363528521053
68,80,Marc Maron: Too Real,1,5,2017.0,,,12,2.734363528521053
67,40,Heartlock,1,5,2018.0,Drama/Crime,1:36,-27,2.734363528521053
41,20,Enemy Lines,1,5,2020.0,Drama/History,1:33,-21,2.734363528521053
36,60,Monstrous,1,5,2020.0,Mystery and thriller/Horror,1:26,24,2.734363528521053
33,100,GTFO: Get the F&#% Out,1,5,2015.0,,,67,2.734363528521053
60,80,Beside Bowie: The Mick Ronson Story,1,5,2017.0,Music/Documentary,1:48,20,2.734363528521053
100,100,Anthony Jeselnik: Thoughts and Prayers,1,5,2015.0,Comedy/Stand up,1:00,0,2.734363528521053
31,40,Hell on the Border,1,5,2019.0,Western,1:27,9,2.734363528521053
40,40,Casanova Variations,1,5,2014.0,Drama,1:58,0,2.734363528521053
25,20,"To Each, Her Own",1,5,2018.0,Gay and lesbian/Romance,1:35,-5,2.734363528521053
100,80,The Maestro,1,5,2018.0,Music/Drama,1:34,-20,2.734363528521053
32,20,Hover,1,5,2018.0,Sci fi,1:50,-12,2.734363528521053
83,80,The Pickup Game,1,5,2019.0,Documentary,1:36,-3,2.734363528521053
62,100,Your Son,1,5,2018.0,Drama/Mystery and thriller,1:43,38,2.734363528521053
67,100,The Curse Of The Gothic Symphony,1,5,2011.0,,,33,2.734363528521053
38,20,Hooked,1,5,2017.0,Drama,1:31,-18,2.734363528521053
86,100,Manchild: The Schea Cotton Story,1,5,2016.0,Documentary,1:18,14,2.734363528521053
32,100,Dune Drifter,1,5,2020.0,Sci fi/Mystery and thriller,1:41,68,2.734363528521053
80,80,Killer Bees,1,5,2017.0,Documentary,1:25,0,2.734363528521053
33,60,It Came From the Desert,1,5,2017.0,Horror/Action,1:29,27,2.734363528521053
67,80,In Search of Chopin,1,5,2014.0,Documentary,1:50,13,2.734363528521053
62,60,18 Presents,1,5,2020.0,Drama,1:55,-2,2.734363528521053
88,100,Foosballers,1,5,2019.0,Documentary,1:36,12,2.734363528521053
50,40,Northern Borders,1,5,2013.0,Drama,1:48,-10,2.734363528521053
100,100,Man in Camo,1,5,2018.0,Documentary,1:25,0,2.734363528521053
100,100,Return to Hardwick,1,5,2019.0,Documentary,1:13,0,2.734363528521053
70,40,"Three Holes, Two Brads, and a Smoking Gun",1,5,2014.0,Drama/Mystery and thriller,1:30,-30,2.734363528521053
70,100,Michael Che Matters,1,5,2016.0,,,30,2.734363528521053
25,0,The Influence (La influencia),1,5,2019.0,,,-25,2.734363528521053
50,20,The Jack in the Box,1,5,2019.0,Horror,1:27,-30,2.734363528521053
19,40,Twin Murders: The Silence of the White City,1,5,2019.0,Mystery and thriller,1:50,21,2.734363528521053
90,100,Alien Boy: The Life and Death of James Chasse,1,5,2013.0,Drama/Crime,1:30,10,2.734363528521053
60,40,Brampton's Own,1,5,2018.0,Romance/Drama,1:30,-20,2.734363528521053
40,100,Steven Tyler: Out on a Limb,1,5,2018.0,Documentary/Music,1:33,60,2.734363528521053
55,40,Lucky Stiff,1,5,2014.0,Comedy/Musical,1:18,-15,2.734363528521053
92,60,Hearing Is Believing,1,5,2016.0,Documentary/Music,1:44,-32,2.734363528521053
83,100,Ghost,1,5,2020.0,Drama,1:28,17,2.734363528521053
50,20,The Adventure Club,1,5,2016.0,Adventure,1:30,-30,2.734363528521053
71,80,Escape and Evasion,1,5,2019.0,War/Drama,1:32,9,2.734363528521053
20,60,20 Weeks,1,5,2017.0,Romance/Drama,1:29,40,2.734363528521053
85,100,ReMastered: The Two Killings of Sam Cooke,1,5,2019.0,,,15,2.734363528521053
69,100,Life Overtakes Me,1,5,2019.0,Documentary,0:39,31,2.734363528521053
26,20,Viena and the Fantomes,1,5,2020.0,Romance/Music,1:45,-6,2.734363528521053
55,60,Herschell Gordon Lewis: The Godfather of Gore,1,5,2010.0,Documentary,1:46,5,2.734363528521053
75,80,Catwalk: Tales From The Cat Show Circuit,1,5,2018.0,,,5,2.734363528521053
17,0,Kill Ratio,1,5,2016.0,Action,1:27,-17,2.734363528521053
93,60,The Pilgrim's Progress,1,5,2019.0,Adventure/Animation,1:48,-33,2.734363528521053
64,80,Kevin Hart's Guide to Black History,1,5,2019.0,,,16,2.734363528521053
69,60,War on Whistleblowers: Free Press and the National Security State,1,5,2013.0,Documentary,1:07,-9,2.734363528521053
9,80,The Demolisher,1,5,2015.0,Action/Horror,1:25,71,2.734363528521053
100,100,Resisterhood,1,5,2020.0,Documentary,1:36,0,2.734363528521053
74,40,Walkaway Joe,1,5,2020.0,Drama,1:29,-34,2.734363528521053
78,40,Trail of Ashes,1,5,2020.0,Mystery and thriller,1:38,-38,2.734363528521053
85,100,Patton Oswalt: Finest Hour,1,5,2012.0,,,15,2.734363528521053
62,80,Katt Williams: Great America,1,5,2018.0,,,18,2.734363528521053
46,80,Lloyd the Conqueror,1,5,2011.0,Comedy,1:35,34,2.734363528521053
100,20,Mysteries of the Jesus Prayer,1,5,2010.0,Documentary,1:54,-80,2.734363528521053
9,20,The Possession Experiment,1,5,2016.0,Horror/Mystery and thriller,1:24,11,2.734363528521053
77,100,Man Camp,1,5,2019.0,Comedy,1:34,23,2.734363528521053
17,60,Wound,1,5,2010.0,Horror/Fantasy,1:16,43,2.734363528521053
60,40,Moments of Clarity,1,5,2015.0,Comedy/Adventure,1:37,-20,2.734363528521053
67,100,Foreign Parts,1,5,2010.0,Documentary/Drama,1:20,33,2.734363528521053
45,100,Murder Is My Beat,1,5,1955.0,Mystery and thriller,1:16,55,2.734363528521053
53,40,The Strange One,1,5,1957.0,Drama,1:40,-13,2.734363528521053
91,89,The Trial of the Chicago 7,1000,312,2020.0,History/Drama,2:09,-2,36.21150885156392
71,83,Console Wars,1,12,2020.0,Documentary,1:32,12,4.725940818339814
55,82,Hill of Freedom,50,17,2014.0,Drama,1:06,27,5.875307153057772
79,64,Animal Crackers,250,22,2017.0,Animation/Adventure,1:34,-15,6.9026233386080005
91,97,Sound of Metal,1000,234,2019.0,Music/Drama,2:00,6,30.252405352433488
52,94,Yourself and Yours,50,32,2016.0,Drama,1:26,42,8.724061861322062
51,87,On the Rocks,500,264,2020.0,Comedy,1:36,36,32.62138938955259
66,70,The One and Only Ivan,250,116,2020.0,Comedy/Kids and family,1:33,4,19.511301649293156
48,38,Magic Camp,100,13,2018.0,Comedy/Kids and family,,-10,4.968377601139757
19,8,Artemis Fowl,1000,171,2020.0,Fantasy/Adventure,1:33,-11,24.86695274122312
27,13,MILF,50,8,2018.0,,,-14,3.668016172818685
75,79,Greyhound,1000,224,2020.0,Drama/History,1:32,4,29.43777702680547
78,93,Howard,1,44,2018.0,,,15,10.645300436514761
80,87,The Dead and the Others,1,15,2018.0,Documentary,1:54,7,5.433216825139731
68,100,Crystal Swan,1,13,2018.0,Drama,1:33,32,4.968377601139757
33,43,The Lie,250,74,2018.0,Mystery and thriller,1:37,10,14.732275265126917
100,100,Small Group,1,5,2018.0,Drama/Comedy,2:01,0,2.734363528521053
72,89,Jingle Jangle: A Christmas Journey,500,73,2020.0,Musical/Fantasy,2:00,17,14.607530022406213
58,100,Bellingcat: Truth in a Post-Truth World,1,6,2018.0,Documentary,1:35,42,3.064393493081416
44,61,Radioactive,100,148,2019.0,Biography/History,1:43,17,22.72027439676837
50,65,The Lovebirds,500,172,2020.0,Romance,1:26,15,24.957741334700298
78,100,Take Me Somewhere Nice,1,14,2019.0,Drama,1:31,22,5.203912939677927
66,92,The Vast of Night,1000,243,2019.0,Fantasy/Mystery and thriller,1:30,26,30.97447264187668
33,48,Roald Dahl's The Witches,500,176,2020.0,Comedy/Fantasy,1:45,15,25.31893404088985
79,89,Zombie for Sale,1,28,2019.0,,,10,8.02553087005176
49,85,Parallel,1,13,2018.0,Drama/Mystery and thriller,1:44,36,4.968377601139757
66,87,Get Duked!,250,92,2019.0,Comedy/Mystery and thriller,1:27,21,16.879803711855995
42,100,2040,50,33,2019.0,Documentary/Drama,1:32,58,8.893469344897873
38,48,My Spy,1000,122,2020.0,Comedy/Action,1:39,10,20.136078432395202
71,17,Buddy Games,1,24,2019.0,Comedy,1:30,-54,7.288397090280924
50,95,An Easy Girl,50,22,2019.0,Comedy/Drama,1:28,45,6.9026233386080005
93,97,Promare,100,29,2019.0,Sci fi/Adventure,1:51,4,8.20349180691225
59,100,Cut off,1,7,2018.0,Crime/Horror,2:12,41,3.374320069567275
93,83,Psych 2: Lassie Come Home,100,12,2020.0,Comedy/Mystery and thriller,1:30,-10,4.725940818339814
89,93,Ride Your Wave,1,28,2019.0,Comedy/Anime,1:34,4,8.02553087005176
51,36,Seberg,250,132,2019.0,Biography/History,1:43,-15,21.152354044022278
79,64,The Devil All the Time,2500,207,2020.0,Mystery and thriller/Crime,2:18,-15,28.02086036400211
39,100,Dead Dicks,1,11,2020.0,Horror,,61,4.475797488182033
82,92,Leap of Faith: William Friedkin on The Exorcist,1,50,2019.0,Documentary/Mystery and thriller,1:44,10,11.530715390799685
52,71,7500,250,152,2019.0,Drama/Mystery and thriller,1:32,19,23.102141654099842
71,100,Echo,1,10,2019.0,Drama,1:19,29,4.216965034285822
60,90,The August Virgin,1,21,2019.0,Drama,2:05,30,6.704819013328363
46,72,An American Pickle,500,163,2020.0,Comedy,1:28,26,24.13333007004028
86,100,Phineas and Ferb the Movie: Candace Against the Universe,250,19,2020.0,Animation/Adventure,1:27,14,6.298266028731006
97,94,Dads,1,34,2019.0,Documentary,1:27,-3,9.060962294042406
50,86,Lingua Franca,1,51,2019.0,Drama,1:29,36,11.674313727451958
82,93,The Prince,1,14,2019.0,Drama,,11,5.203912939677927
76,97,Two of Us,1,74,2019.0,Romance/Gay and lesbian,1:35,21,14.732275265126917
40,79,Das Vorspiel,1,34,2020.0,Drama,,39,9.060962294042406
66,78,Blood Machines,50,18,2019.0,Adventure/Musical,,12,6.088990769440213
80,100,Song Lang,1,7,2018.0,Drama,1:30,20,3.374320069567275
73,77,Summerland,1,124,2020.0,Drama,1:39,4,20.341761273786197
66,76,Savage,50,29,2019.0,Drama/Crime,1:40,10,8.20349180691225
50,94,The Delivered,1,31,2019.0,Horror/Drama,1:52,44,8.552657067536824
87,98,I'm No Longer Here,100,41,2019.0,Drama,1:52,11,10.185677243651742
86,75,Pieces of a Woman,1000,222,2020.0,Drama,2:06,-11,29.273227574963673
49,81,I'm Your Woman,250,149,2020.0,Drama/Mystery and thriller,2:00,32,22.816100321808104
43,68,The Christmas Chronicles 2,500,57,2020.0,Fantasy/Comedy,1:55,25,12.514738658402138
93,100,Mucho Mucho Amor: The Legend of Walter Mercado,100,60,2020.0,Documentary,1:36,7,12.922440211617326
88,95,Lupin III: The First,50,21,2019.0,Comedy/Anime,1:33,7,6.704819013328363
57,90,We Are Freestyle Love Supreme,1,21,2020.0,Documentary/Music,1:30,33,6.704819013328363
39,62,Bad Hair,100,77,2020.0,Comedy/Horror,1:42,23,15.102773291691431
85,77,Uncle Frank,250,117,2020.0,Gay and lesbian/Drama,1:35,-8,19.616257942185833
86,98,Disclosure,100,52,2020.0,Documentary,1:40,12,11.8168599865911
75,100,His House,500,112,2020.0,Horror/Mystery and thriller,1:33,25,19.088036824679065
94,98,The Go-Go's,1,44,2020.0,Documentary/Music,1:38,4,10.645300436514761
81,99,On the Record,50,71,2020.0,Documentary,1:35,18,14.356099772615265
91,94,Boys State,100,141,2020.0,Documentary,1:49,3,22.042555624480066
78,100,Dick Johnson Is Dead,100,90,2020.0,Documentary,1:29,22,16.64951428545866
50,98,Time,100,116,2020.0,Documentary,1:21,48,19.511301649293156
69,98,The Forty-Year-Old Version,100,126,2020.0,Comedy/Drama,2:03,29,20.546203756731995
67,82,Charm City Kings,50,55,2020.0,Drama,2:05,15,12.238457412731087
78,93,Sylvie's Love,100,120,2020.0,Romance/Drama,1:54,15,19.92912718504312
88,95,Palm Springs,1000,220,2020.0,Romance,1:30,7,29.108121263755205
16,87,Cuties,1000,79,2020.0,Drama/Comedy,1:36,71,15.34676814846713
83,86,The Social Dilemma,500,65,2020.0,Documentary/Drama,1:34,3,13.58535050847747
48,82,I'm Thinking of Ending Things,1000,258,2020.0,Horror/Mystery and thriller,2:14,34,32.15602193394618
60,83,Mank,1000,325,2020.0,Biography/Drama,2:12,23,37.14728695255573
78,80,Safety,100,41,2020.0,Drama/Biography,2:02,2,10.185677243651742
73,83,Adú,50,6,2020.0,Drama,1:59,10,3.064393493081416
23,100,Gunjan Saxena: The Kargil Girl,250,15,2020.0,Drama/Biography,1:52,77,5.433216825139731
56,93,Residue,1,30,2020.0,Drama,1:30,37,8.379165804519056
96,95,David Attenborough: A Life on Our Planet,100,20,2020.0,Documentary,1:23,-1,6.503449126242364
84,26,Hillbilly Elegy,1000,245,2020.0,Drama,1:56,-58,31.133561386575195
100,67,Teenage Badass,1,12,2020.0,Comedy,,-33,4.725940818339814
73,88,AKA Jane Roe,1,16,2020.0,Documentary,,15,5.656854249492381
77,63,Eurovision Song Contest: The Story of Fire Saga,2500,175,2020.0,Comedy/Musical,2:00,-14,25.228927017388646
0,60,Skin Walker,1,5,2019.0,Horror/Mystery and thriller,1:30,60,2.734363528521053
76,91,Father Soldier Son,1,34,2020.0,Documentary,1:39,15,9.060962294042406
70,92,Hannah Gadsby: Douglas,100,26,2020.0,Comedy/Stand up,1:12,22,7.662285721192069
72,58,Have a Good Trip: Adventures in Psychedelics,100,26,2020.0,Documentary,,-14,7.662285721192069
70,60,Chemical Hearts,250,90,2020.0,Romance/Drama,1:33,-10,16.64951428545866
76,91,Little Fish,50,68,2020.0,Romance/Sci fi,1:41,15,13.973914138485368
70,80,The Old Guard,2500,268,2020.0,Action/Fantasy,2:05,10,32.929432503463254
54,92,Da 5 Bloods,1000,295,2020.0,Drama/War,2:35,38,34.96542086073288
78,93,A Whisker Away,100,14,2020.0,Fantasy/Adventure,1:44,15,5.203912939677927
93,100,Athlete A,100,56,2020.0,Documentary,1:43,7,12.377060587439436
90,98,Hamilton,1000,198,2020.0,Musical,2:40,8,27.253089591424086
54,73,Gulabo Sitabo,1,15,2020.0,Drama/Comedy,2:04,19,5.433216825139731
23,0,The Last Days of American Crime,250,43,2020.0,Action/Mystery and thriller,2:29,-23,10.493437610589469
39,28,The Kissing Booth 2,500,40,2020.0,Romance,2:12,-11,10.029689644980788
92,92,Spelling the Dream,1,26,2020.0,Documentary,,0,7.662285721192069
45,54,Choked: Paisa Bolta Hai,1,13,2020.0,Drama,1:54,9,4.968377601139757
37,57,Secret Society of Second Born Royals,50,30,2020.0,Action/Fantasy,1:39,20,8.379165804519056
92,100,Runner,1,15,2019.0,Documentary,1:28,8,5.433216825139731
53,75,Lost Bullet,50,8,2020.0,Action/Mystery and thriller,,22,3.668016172818685
75,81,Nobody Knows I'm Here,100,16,2020.0,Drama,1:31,6,5.656854249492381
23,86,Transhood,1,7,2020.0,Documentary,1:40,63,3.374320069567275
29,0,365 Days,1000,16,2020.0,Drama,1:56,-29,5.656854249492381
100,100,A Most Beautiful Thing,1,17,2020.0,Documentary,1:25,0,5.875307153057772
76,90,Dave Chappelle: 8:46,1,10,2020.0,Comedy,,14,4.216965034285822
29,15,Desperados,100,34,2020.0,Romance,1:45,-14,9.060962294042406
47,61,Project Power,1000,175,2020.0,Action/Fantasy,1:53,14,25.228927017388646
85,82,The Hater,100,22,2020.0,Drama,2:15,-3,6.9026233386080005
15,20,Fatal Affair,100,35,2020.0,Mystery and thriller,1:29,5,9.22661773178138
24,67,Seriously Single,1,6,2020.0,Romance,1:46,43,3.064393493081416
43,50,Offering to the Storm,1,6,2020.0,Mystery and thriller,2:18,7,3.064393493081416
90,95,Black Is King,2500,61,2020.0,Music,1:25,5,13.056631493342596
70,83,Bulbbul,1,18,2020.0,,,13,6.088990769440213
92,94,The Weight of Gold,1,16,2020.0,Documentary/Sports and fitness,,2,5.656854249492381
100,99,Wolfwalkers,1,156,2020.0,Animation/Fantasy,1:43,-1,23.480258506151625
67,50,The Pale Door,100,40,2020.0,Western/Horror,1:36,-17,10.029689644980788
62,67,Tom of Your Life,1,6,2020.0,Sci fi/Comedy,1:33,5,3.064393493081416
55,92,Alone,500,59,2020.0,Mystery and thriller,1:38,37,12.78740756158519
60,85,Work It,100,27,2020.0,Comedy/Musical,1:33,25,7.845169885845621
62,67,The Swamp,1,15,2020.0,Documentary,,5,5.433216825139731
61,88,#Alive,500,24,2020.0,Drama/Horror,1:38,27,7.288397090280924
83,23,The Binge,250,26,2020.0,Comedy,1:38,-60,7.662285721192069
80,96,Class Action Park,100,50,2020.0,Documentary,1:30,16,11.530715390799685
60,87,Yusuf Hawkins: Storm Over Brooklyn,1,15,2020.0,Documentary,1:40,27,5.433216825139731
71,71,All Together Now,50,24,2020.0,Drama,1:32,0,7.288397090280924
65,67,The Crimes That Bind,1,6,2020.0,Mystery and thriller,1:30,2,3.064393493081416
50,70,The Sleepover,100,20,2020.0,Action/Adventure,1:40,20,6.503449126242364
82,98,One Night in Miami,500,320,2020.0,Drama,1:50,16,36.78906382614162
36,60,Latte & the Magic Waterstone,1,5,2019.0,Animation/Comedy,1:29,24,2.734363528521053
65,100,John Was Trying to Contact Aliens,1,7,2019.0,Biography/Documentary,0:16,35,3.374320069567275
89,100,The Speed Cubers,1,13,2020.0,Documentary,0:40,11,4.968377601139757
67,64,Unknown Origins,50,11,2020.0,Drama/Comedy,1:36,-3,4.475797488182033
98,86,Rising Phoenix,50,21,2020.0,Documentary,1:46,-12,6.704819013328363
75,100,Raat Akeli Hai,1,8,2020.0,Drama/Mystery and thriller,2:30,25,3.668016172818685
40,39,Rebecca,500,220,2020.0,Mystery and thriller/Drama,2:01,-1,29.108121263755205
70,91,Enola Holmes,2500,201,2020.0,Mystery and thriller,2:03,21,27.510439959956123
97,88,Immortal,100,8,2020.0,Drama/Mystery and thriller,,-9,3.668016172818685
14,90,Unpregnant,2500,42,2020.0,Drama/Comedy,1:43,76,10.34024446475599
30,23,Books of Blood,50,26,2020.0,Horror/Mystery and thriller,,-7,7.662285721192069
25,0,Freaks: You're One of Us,50,5,2020.0,Action/Fantasy,1:32,-25,2.734363528521053
66,72,Black Box,250,61,2020.0,Mystery and thriller,1:40,6,13.056631493342596
29,47,Evil Eye,50,51,2020.0,Horror/Mystery and thriller,1:30,18,11.674313727451958
81,94,Dear Comrades!,1,52,2020.0,Drama/History,2:00,13,11.8168599865911
14,90,Stars and Strife,1,10,2020.0,Documentary,,76,4.216965034285822
36,79,I Am Greta,100,81,2020.0,Documentary,1:38,43,15.588457268119896
35,56,"Love, Guaranteed",250,25,2020.0,Romance,1:30,21,7.476743906106103
61,48,The Babysitter: Killer Queen,500,40,2020.0,Comedy/Horror,1:41,-13,10.029689644980788
44,17,Class of '83,1,12,2020.0,Drama/Crime,1:38,-27,4.725940818339814
73,33,The Rising Hawk,1,6,2019.0,Drama/History,2:15,-40,3.064393493081416
56,72,LEGO Star Wars Holiday Special,100,54,2020.0,Action/Adventure,,16,12.098905925115496
70,98,Spontaneous,250,58,2020.0,Comedy/Horror,1:42,28,12.651513870765422
74,82,The Boys in the Band,250,90,2020.0,Gay and lesbian/Drama,2:02,8,16.64951428545866
82,88,Summerland,1,17,2020.0,Comedy,,6,5.875307153057772
86,63,This Is Paris,1,8,2020.0,Documentary,,-23,3.668016172818685
91,76,Clouds,100,25,2020.0,Drama/Music,2:01,-15,7.476743906106103
31,44,The Paramedic,50,9,2020.0,Drama/Mystery and thriller,1:34,13,3.9482220388574776
43,90,Vampires vs. The Bronx,250,40,2019.0,Comedy/Horror,1:25,47,10.029689644980788
44,53,Hubie Halloween,1000,80,2020.0,Other/Comedy,1:43,9,15.467895945971296
27,38,Cadaver,50,8,2020.0,Drama/Horror,1:26,11,3.668016172818685
33,67,W Lesie Dzis nie Zasnie Nikt,100,6,2020.0,Horror/Mystery and thriller,1:42,34,3.064393493081416
100,100,"Harry Chapin: When in Doubt, Do Something",1,20,2020.0,Documentary/Music,,0,6.503449126242364
75,85,American Murder: The Family Next Door,100,20,2020.0,Crime/Documentary,,10,6.503449126242364
61,48,Black Beauty,50,46,2020.0,Drama,1:50,-13,10.945198564139895
94,100,My Octopus Teacher,250,21,2020.0,Documentary,1:25,6,6.704819013328363
99,86,Kiss the Ground,500,7,2020.0,Documentary,1:25,-13,3.374320069567275
76,93,40 Years a Prisoner,100,14,2020.0,Documentary,1:50,17,5.203912939677927
26,50,The Midnight Sky,1000,243,2020.0,Drama/Sci fi,1:58,24,30.97447264187668
40,44,Holidate,500,55,2020.0,Romance,1:43,4,12.238457412731087
72,97,What the Constitution Means to Me,1,30,2020.0,Documentary,,25,8.379165804519056
96,87,BLACKPINK: Light Up the Sky,500,15,2020.0,Documentary/Music,,-9,5.433216825139731
64,85,Borat Subsequent Moviefilm,2500,295,2020.0,Comedy,1:36,21,34.96542086073288
75,98,Ma Rainey's Black Bottom,500,284,2020.0,Music/Drama,1:34,23,34.144751986566035
100,100,Rom Boys: 40 Years of Rad,1,12,2020.0,Documentary,,0,4.725940818339814
55,75,Batman: Death in the Family,50,8,2020.0,Action/Animation,,20,3.668016172818685
76,83,Happiest Season,500,200,2020.0,Romance/Other,1:42,7,27.42481756762073
83,100,537 Votes,1,8,2020.0,Documentary,,17,3.668016172818685
50,67,The Retreat,1,6,2020.0,Horror,1:28,17,3.064393493081416
78,94,Bruce Springsteen's Letter to You,1,36,2020.0,Documentary/Music,,16,9.390507480439723
35,63,Sarah Cooper: Everything's Fine,50,19,2020.0,Comedy,,28,6.298266028731006
100,80,John Bronco,1,5,2020.0,Comedy,,-20,2.734363528521053
39,47,Operation Christmas Drop,100,17,2020.0,Romance/Other,1:35,8,5.875307153057772
100,89,Nasrin,1,9,2020.0,Documentary/Biography,1:32,-11,3.9482220388574776
89,92,A West Wing Special to Benefit When We All Vote,1,13,2020.0,Drama,,3,4.968377601139757
61,91,PG: Psycho Goreman,250,64,2020.0,Comedy/Horror,1:35,30,13.454342644059432
40,92,Baby Done,50,38,2020.0,Comedy,1:31,52,9.713254050808038
52,64,Dolly Parton's Christmas on the Square,100,33,2020.0,Musical/Other,1:38,12,8.893469344897873
63,55,The Prom,1000,200,2020.0,Comedy/Musical,2:11,-8,27.42481756762073
94,50,Greatland,1,6,2020.0,Adventure/Fantasy,,-44,3.064393493081416
77,78,L'Incredibile storia dell'Isola Delle Rose,100,9,2020.0,Comedy/Drama,1:57,1,3.9482220388574776
25,50,Kaali Khuhi,1,8,2020.0,Horror,1:30,25,3.668016172818685
35,58,The Princess Switch: Switched Again,100,24,2020.0,Other/Romance,1:37,23,7.288397090280924
100,67,Love in Dangerous Times,100,6,2020.0,Comedy/Romance,,-33,3.064393493081416
85,100,The Fresh Prince of Bel-Air Reunion,50,8,2020.0,Documentary,,15,3.668016172818685
57,70,Godmothered,250,70,2020.0,Fantasy/Comedy,1:50,13,14.229389747854103
43,73,We Can Be Heroes,500,45,2020.0,Action/Fantasy,1:40,30,10.795874345554918
97,100,Folklore: The Long Pond Studio Sessions,500,13,2020.0,Documentary/Music,,3,4.968377601139757
60,80,Yearly Departed,1,5,2020.0,Comedy/Stand up,,20,2.734363528521053
80,80,Mariah Carey's Magical Christmas Special,100,5,2020.0,Music/Variety,,0,2.734363528521053
90,50,"ariana grande: excuse me, i love you",500,6,2020.0,Documentary/Music,,-40,3.064393493081416
40,43,Caged,1,7,2021.0,Mystery and thriller,1:21,3,3.374320069567275
85,84,Finding 'Ohana,250,19,2021.0,Adventure/Action,2:03,-1,6.298266028731006
16,0,The Minimalists: Less Is Now,1,5,2021.0,Documentary,,-16,2.734363528521053
30,43,Locked Down,100,105,2021.0,Comedy/Romance,,13,18.333412575379587
78,88,The Dig,500,147,2021.0,Drama,1:52,10,22.624205359490148
79,54,Son of the South,1,13,2021.0,Drama,1:45,-25,4.968377601139757
58,86,The Story of Temple Drake,250,7,1933.0,Drama,1:10,28,3.374320069567275
86,86,Joan the Maid: The Battles,250,7,1994.0,Drama/History,1:52,0,3.374320069567275
79,94,Cluny Brown,500,16,1946.0,Comedy,1:40,15,5.656854249492381
71,100,Seven Days to Noon,250,5,1950.0,Mystery and thriller,1:33,29,2.734363528521053
64,88,It Always Rains on Sunday,100,17,1947.0,Crime/Drama,1:32,24,5.875307153057772
83,100,D-Day: Normandy 1944,250,6,2014.0,Documentary,0:43,17,3.064393493081416
71,50,Freetown,1000,12,2015.0,Drama,1:56,-21,4.725940818339814
94,97,Toy Story 4,50000,450,2019.0,Comedy/Kids and family,1:40,3,45.52582462974842
45,83,My Hindu Friend,1,6,2020.0,Drama,,38,3.064393493081416
38,20,The Pretenders,1,10,2018.0,,,-18,4.216965034285822
59,100,Snatchers,100,16,2019.0,Sci fi/Comedy,1:36,41,5.656854249492381
78,29,The Red Sea Diving Resort,500,41,2018.0,,,-49,10.185677243651742
67,92,Rocko's Modern Life: Static Cling,250,24,2018.0,,,25,7.288397090280924
44,66,Peterloo,100,160,2018.0,Drama/History,2:34,22,23.854756574160536
94,33,Shaft,5000,129,2019.0,Action/Comedy,1:51,-61,20.850600582083427
51,75,,100,28,,,,24,8.02553087005176
93,92,The Price of Everything,100,53,2018.0,Documentary,1:45,-1,11.958381890942793
62,94,Transit,100,178,2018.0,History/Drama,1:41,32,25.49837485437685
95,60,Surviving Confession,1,5,2018.0,,,-35,2.734363528521053
97,95,Be Natural: The Untold Story of Alice Guy-Blaché,100,86,2018.0,Documentary,1:43,-2,16.183093078793917
88,88,The Witch: Part 1. The Subversion (Manyeo),100,17,2018.0,,,0,5.875307153057772
57,89,Beats,100,9,2019.0,Drama,1:49,32,3.9482220388574776
62,100,Stray,1,9,2018.0,Drama,1:44,38,3.9482220388574776
95,72,The Aeronauts,1,187,2019.0,Drama/Adventure,1:41,-23,26.296684997953903
62,100,"A Bread Factory, Part One: For the Sake of Gold",50,30,2018.0,,,38,8.379165804519056
56,100,"A Bread Factory, Part Two: Walk with Me a While",1,22,2018.0,,,44,6.9026233386080005
50,58,Close Enemies (Freres Ennemis),1,12,2018.0,,,8,4.725940818339814
65,63,Driven,100,51,2018.0,Drama/Comedy,1:48,-2,11.674313727451958
91,91,The Elephant Queen,50,22,2018.0,Documentary/Drama,1:36,0,6.9026233386080005
49,63,Wolkenbruchs wunderliche Reise in die Arme einer Schickse,1,8,2018.0,,,14,3.668016172818685
87,85,"Empathy, Inc.",50,27,2018.0,Sci fi/Drama,,-2,7.845169885845621
83,100,Evelyn,1,7,2018.0,Documentary,1:40,17,3.374320069567275
82,86,Big Time Adolescence,250,83,2019.0,Comedy,1:30,4,15.827918586512368
87,88,Brittany Runs a Marathon,1000,185,2019.0,Comedy/Drama,1:43,1,26.120550779067592
92,94,Honey Boy,500,231,2019.0,Drama,1:33,2,30.00941209857022
48,96,Jawline,1,28,2019.0,Documentary,1:39,48,8.02553087005176
85,98,One Child Nation,100,100,2019.0,Documentary,1:25,13,17.78279410038923
77,79,Late Night,2500,292,2019.0,Drama/Comedy,1:42,2,34.74275727052265
83,82,The Report,1000,239,2019.0,Drama/Mystery and thriller,1:58,-1,30.654814192715765
59,80,The Amazing Johnathan Documentary,100,41,2019.0,Documentary,1:31,21,10.185677243651742
52,87,Selah and the Spades,50,107,2019.0,Drama,1:37,35,18.55089473417879
77,68,Troop Zero,250,65,2019.0,Comedy,1:37,-9,13.58535050847747
100,80,Little Monsters,1,130,2019.0,Horror/Comedy,1:34,-20,20.951474621135226
70,73,Bad Trip,250,56,2021.0,Comedy,1:24,3,12.377060587439436
93,93,If the Dancer Dances,1,15,2018.0,Documentary,1:23,0,5.433216825139731
56,100,La Misma Sangre,1,5,2019.0,Drama,1:20,44,2.734363528521053
74,98,Blow the Man Down,250,120,2019.0,Comedy/Drama,1:30,24,19.92912718504312
60,87,Bliss,100,45,2019.0,Horror,1:20,27,10.795874345554918
72,100,Slay the Dragon,1,48,2019.0,Documentary,1:41,28,11.240244892502977
58,73,Cubby,1,11,2019.0,Comedy/Drama,1:23,15,4.475797488182033
77,90,Mine 9,100,20,2019.0,Drama,1:23,13,6.503449126242364
12,25,Escape Plan: The Extractors,250,12,2019.0,,,13,4.725940818339814
88,88,Les misérables,1,189,2019.0,Drama/Crime,1:42,0,26.47211419497369
94,97,"The Gangster, the Cop, the Devil",1,34,2019.0,Drama/Mystery and thriller,1:50,3,9.060962294042406
90,100,Apocalypse Now: Final Cut,50,21,2019.0,,,10,6.704819013328363
89,93,Invisible Life,100,74,2019.0,Romance/Drama,2:19,4,14.732275265126917
44,10,Brahms: The Boy II,1000,58,2020.0,Horror/Mystery and thriller,1:26,-34,12.651513870765422
46,44,Bachelorettes (Solteras),1,9,2018.0,,,-2,3.9482220388574776
24,0,The Influence (La influencia),1,5,2019.0,,,-24,2.734363528521053
46,54,Burn,50,13,2019.0,Mystery and thriller,1:28,8,4.968377601139757
64,88,"Frankenstein's Monster's Monster, Frankenstein",1,17,2019.0,Drama,0:28,24,5.875307153057772
59,78,The Night Sitter,1,9,2018.0,,,19,3.9482220388574776
73,50,Ghost Killers vs. Bloody Mary (Exterminadores do Além Contra a Loira do Banheiro),1,6,2018.0,,,-23,3.064393493081416
90,100,Invader Zim: Enter the Florpus,50,21,2019.0,,,10,6.704819013328363
50,66,Lady and the Tramp,500,67,2019.0,Comedy/Adventure,1:43,16,13.8451208742507
73,50,"Live Twice, Love Once",1,8,2020.0,Comedy/Drama,,-23,3.668016172818685
33,48,Greed,1,144,2019.0,Comedy,1:44,15,22.33451661845039
57,54,Noelle,500,41,2019.0,Other/Comedy,1:40,-3,10.185677243651742
100,100,No Small Matter,1,10,2018.0,Documentary,,0,4.216965034285822
48,100,Jenny Slate: Stage Fright,100,15,2019.0,Stand up,,52,5.433216825139731
54,100,Tammy and the T-Rex: Gore Cut,1,6,2019.0,Comedy/Horror,,46,3.064393493081416
82,94,In Search of Darkness: A Journey Into Iconic 80s Horror,1,17,2019.0,Documentary,4:24,12,5.875307153057772
84,93,ANYA,1,14,2019.0,Sci fi/Drama,1:20,9,5.203912939677927
67,93,Blue Story,100,43,2019.0,Crime/Drama,1:31,26,10.493437610589469
100,79,The Banker,50,76,2020.0,Drama/History,2:00,-21,14.979885547093689
89,100,Mike Birbiglia: The New One,1,5,2019.0,Stand up/Comedy,1:25,11,2.734363528521053
59,100,Michelle Wolf: Joke Show,50,8,2019.0,Comedy/Stand up,,41,3.668016172818685
95,92,Togo,1000,39,2019.0,Drama/Adventure,1:54,-3,9.872232603526719
47,80,Legado en los huesos,1,5,2020.0,Drama/Mystery and thriller,,33,2.734363528521053
62,84,Timmy Failure: Mistakes Were Made,100,31,2020.0,Adventure/Kids and family,,22,8.552657067536824
31,100,Leslie Jones: Time Machine,50,6,2020.0,Comedy,,69,3.064393493081416
33,50,El silencio del pantano,1,6,2020.0,Mystery and thriller,,17,3.064393493081416
70,70,Stargirl,250,40,2020.0,Romance/Comedy,1:47,0,10.029689644980788
70,92,What Did Jack Do?,100,13,2020.0,Crime/Comedy,0:17,22,4.968377601139757
85,94,Beastie Boys Story,100,80,2020.0,Documentary/Music,1:59,9,15.467895945971296
82,17,Close Encounters of the Fifth Kind: Contact has Begun,100,6,2020.0,Documentary,,-65,3.064393493081416
91,100,Disneynature: Dolphin Reef,50,21,2020.0,Documentary,,9,6.704819013328363
74,81,Disneynature: Elephant,250,27,2020.0,Documentary,,7,7.845169885845621
95,61,Shooting Heroin,100,18,2019.0,Action/Drama,,-34,6.088990769440213
94,80,Sincerely Louis C.K.,1,5,2020.0,Comedy,1:00,-14,2.734363528521053
100,100,Unprescribed,1,14,2020.0,Documentary,,0,5.203912939677927
53,50,The Last Movie,500,16,1971.0,Drama,1:48,-3,5.656854249492381
68,100,The Ballad of Gregorio Cortez,250,6,1983.0,Drama/History,1:44,32,3.064393493081416
77,100,The Farmer's Daughter,500,8,1947.0,Comedy,1:37,23,3.668016172818685
92,100,Chikamatsu Monogatari,250,7,1954.0,Drama/History,1:56,8,3.374320069567275
88,67,The Truth,100,6,1960.0,Drama,2:07,-21,3.064393493081416
70,63,Desert Fury,50,8,1947.0,Western,1:35,-7,3.668016172818685
60,100,Old Ironsides,1,5,1926.0,Adventure,1:52,40,2.734363528521053
72,67,Nappily Ever After,250,15,2018.0,Romance/Comedy,,-5,5.433216825139731
100,100,CinemAbility,1,10,2012.0,Documentary,1:38,0,4.216965034285822
76,59,Then Came You,250,22,2018.0,Romance/Comedy,1:39,-17,6.9026233386080005
68,81,Chappaquiddick,1000,145,2017.0,Drama/Mystery and thriller,1:41,13,22.43132880334213
79,90,A Star Is Born,10000,524,2018.0,Romance/Drama,2:15,11,50.07051453992881
42,21,The Cloverfield Paradox,5000,153,2018.0,Sci fi/Mystery and thriller,1:42,-21,23.197017186759677
33,33,The Predator,5000,290,2018.0,Horror/Sci fi,1:46,0,34.59383810879918
91,100,Untouchable,50,9,2016.0,Documentary,1:45,9,3.9482220388574776
48,26,Mortal Engines,2500,187,2018.0,Fantasy/Action,2:08,-22,26.296684997953903
27,18,The Possession of Hannah Grace,500,56,2018.0,Horror/Mystery and thriller,1:25,-9,12.377060587439436
47,32,Extinction,1000,25,2018.0,Sci fi/Mystery and thriller,,-15,7.476743906106103
54,24,Overboard,1000,89,2018.0,Romance,1:52,-30,16.533650545237286
58,85,Ghost Stories,1000,130,2017.0,Horror/Mystery and thriller,1:37,27,20.951474621135226
41,64,The Unicorn Store,1000,86,2017.0,,,23,16.183093078793917
95,80,Kailash,50,5,2018.0,Documentary,1:32,-15,2.734363528521053
89,90,The Sentence,100,20,2018.0,,,1,6.503449126242364
92,100,Minding the Gap,500,122,2018.0,Documentary,1:33,8,20.136078432395202
66,90,Mandy,2500,246,2018.0,Horror/Mystery and thriller,2:01,24,31.212923068073856
92,96,Thunder Road,1000,83,2018.0,Comedy/Drama,1:32,4,15.827918586512368
83,13,Life Itself,1000,153,2018.0,Romance/Comedy,1:58,-70,23.197017186759677
75,80,Catwalk: Tales From The Cat Show Circuit,1,5,2018.0,,,5,2.734363528521053
98,55,Back Roads,1000,29,2018.0,Drama/Mystery and thriller,1:41,-43,8.20349180691225
43,45,Just a Breath Away (Dans la brume),50,11,2018.0,,,2,4.475797488182033
54,32,Zoe,100,25,2018.0,Romance/Sci fi,1:44,-22,7.476743906106103
12,23,Here and Now (Blue Night),50,22,2018.0,,,11,6.9026233386080005
46,88,Diane,100,8,2017.0,Horror,1:22,42,3.668016172818685
97,94,The American Meme,1000,31,2018.0,Documentary,1:30,-3,8.552657067536824
28,63,Our House,100,27,2018.0,Sci fi/Horror,1:31,35,7.845169885845621
81,92,Cold War,1000,248,2018.0,Romance/Drama,1:28,11,31.371284444297096
73,85,Girl,250,61,2018.0,Drama,1:40,12,13.056631493342596
62,95,The World Is Yours,100,20,2018.0,Crime/Comedy,,33,6.503449126242364
50,75,Alone (Solo),1,8,2018.0,,,25,3.668016172818685
66,60,Iliza: Elder Millennial,1,5,2018.0,,,-6,2.734363528521053
93,92,Crime + Punishment,50,25,2018.0,Documentary,1:52,-1,7.476743906106103
69,92,Been So Long,100,12,2018.0,Musical,,23,4.725940818339814
34,80,30 Miles From Nowhere,100,10,1970.0,,,46,4.216965034285822
91,90,Adam Sandler: 100% Fresh,500,20,2018.0,,,-1,6.503449126242364
77,100,John Leguizamo's Latin History For Morons,100,7,2018.0,,,23,3.374320069567275
73,75,Mirage (Durante la tormenta),250,8,2018.0,,,2,3.668016172818685
96,96,Springsteen on Broadway,100,24,2018.0,,,0,7.288397090280924
86,92,Fyre,500,93,2019.0,Documentary,1:37,6,16.994243740562503
35,61,Velvet Buzzsaw,1000,189,2019.0,,,26,26.47211419497369
94,92,Ask Dr. Ruth,50,83,2019.0,Documentary,1:40,-2,15.827918586512368
58,80,Fyre Fraud,100,30,2019.0,,,22,8.379165804519056
52,40,Revenger,50,5,2018.0,,,-12,2.734363528521053
57,84,The Brink,1,101,2019.0,Documentary,1:31,27,17.893729120895756
83,100,ReMastered: The Two Killings of Sam Cooke,1,5,2019.0,,,17,2.734363528521053
64,80,Kevin Hart's Guide to Black History,1,5,2019.0,,,16,2.734363528521053
46,44,The Kid,250,45,2019.0,Western/Drama,1:40,-2,10.795874345554918
19,56,Stray,1,9,2019.0,Fantasy/Mystery and thriller,1:29,37,3.9482220388574776
63,82,Juanita,100,17,2019.0,Drama,,19,5.875307153057772
43,100,Kevin Hart: Irresponsible,1,6,2019.0,Comedy/Stand up,,57,3.064393493081416
60,56,Changeland,100,9,2019.0,Comedy/Drama,,-4,3.9482220388574776
87,98,Homecoming: A Film by Beyoncé,1000,55,2019.0,,,11,12.238457412731087
75,74,Guava Island,250,42,2019.0,Comedy/Mystery and thriller,0:55,-1,10.34024446475599
25,20,A pesar de todo,1,5,2019.0,Comedy,1:18,-5,2.734363528521053
91,100,At the Heart of Gold: Inside the USA Gymnastics Scandal,50,27,2019.0,Documentary,1:31,9,7.845169885845621
60,75,Jonas Brothers: Chasing Happiness,1,8,2019.0,,,15,3.668016172818685
79,17,Chopsticks,1,6,2018.0,Drama,,-62,3.064393493081416
100,100,Cherzoso The Silent Film,1,5,2019.0,Drama,0:06,0,2.734363528521053
86,100,Funeral Parade,500,19,1969.0,Drama,1:47,14,6.298266028731006
57,33,The Reincarnation of Peter Proud,500,6,1975.0,Horror,1:44,-24,3.064393493081416
50,67,The Poughkeepsie Tapes,25000,6,2007.0,Horror/Mystery and thriller,1:26,17,3.064393493081416
50,89,The Covered Wagon,100,9,1923.0,Western,1:38,39,3.9482220388574776
79,100,Variety,50,7,1925.0,Drama,1:19,21,3.374320069567275
18,7,The Snowman,10000,197,2017.0,Crime/Drama,1:59,-11,27.166981771469644
46,56,The LEGO NINJAGO Movie,10000,135,2017.0,Comedy/Kids and family,1:41,10,21.451546410907937
86,57,The Greatest Showman,25000,263,2017.0,History/Drama,1:45,-29,32.54410577614366
94,97,Coco,25000,347,2017.0,Comedy/Kids and family,1:49,3,38.69955059619104
75,87,Sleeping Giant,250,23,2015.0,Drama,1:29,12,7.097083215743026
53,60,Murder on the Orient Express,25000,295,2017.0,Crime/Drama,1:54,7,34.96542086073288
84,81,Molly's Game,10000,299,2017.0,Drama/Biography,2:21,-3,35.260989282522566
87,90,"Three Billboards Outside Ebbing, Missouri",10000,406,2017.0,Crime/Comedy,1:55,3,42.690257164532525
67,71,Annabelle: Creation,10000,189,2017.0,Horror/Mystery and thriller,1:49,4,26.47211419497369
17,100,Everybody Knows... Elizabeth Murray,1,6,2016.0,Documentary,1:00,83,3.064393493081416
29,45,Rough Night,10000,173,2017.0,Comedy,1:36,16,25.048332202229876
71,91,Phantom Thread,5000,351,2017.0,Romance/Drama,2:10,20,38.977766337971524
41,38,Social Animals,50,8,2018.0,Romance,1:27,-3,3.668016172818685
25,47,Bushwick,500,74,2017.0,Action/Adventure,1:34,22,14.732275265126917
67,58,The New Radical,1,12,2017.0,Documentary,,-9,4.725940818339814
86,33,Dalida,50,6,2016.0,Drama/Music,2:04,-53,3.064393493081416
85,100,March of the Penguins 2: The Call,1,6,2017.0,Documentary,1:22,15,3.064393493081416
24,6,The Crucifixion,100,16,2017.0,Horror/Mystery and thriller,1:30,-18,5.656854249492381
93,100,Too Funny To Fail,100,18,2017.0,,,7,6.088990769440213
62,33,Pokémon the Movie: I Choose You!,500,9,2017.0,Fantasy/Adventure,1:38,-29,3.9482220388574776
83,93,One of Us,250,28,2017.0,,,10,8.02553087005176
68,80,Marc Maron: Too Real,1,5,2017.0,,,12,2.734363528521053
80,94,The Newspaperman: The Life and Times of Ben Bradlee,50,17,2017.0,,,14,5.875307153057772
66,88,Cargo,1000,76,2018.0,,,22,14.979885547093689
63,100,Patton Oswalt: Annihilation,100,13,2017.0,,,37,4.968377601139757
31,0,In the Absence of Good Men,50,5,2017.0,Crime/Drama,1:28,-31,2.734363528521053
65,100,Saving Capitalism,100,5,2017.0,,,35,2.734363528521053
53,17,The Competition,100,6,2018.0,Romance,1:43,-36,3.064393493081416
67,100,Notes From The Field,1,6,2018.0,,,33,3.064393493081416
12,0,Deep Blue Sea 2,250,5,2018.0,,,-12,2.734363528521053
100,100,Where's Daddy?,1,6,2018.0,,,0,3.064393493081416
79,100,Tom Segura: Disgraceful,50,5,2018.0,,,21,2.734363528521053
62,80,Katt Williams: Great America,1,5,2018.0,,,18,2.734363528521053
53,100,Todd Glass: Act Happy,1,7,2018.0,,,47,3.374320069567275
31,67,Fred Armisen: Standup For Drummers,50,6,2018.0,,,36,3.064393493081416
67,17,The Outsider,500,24,2018.0,Crime/Drama,2:00,-50,7.288397090280924
20,35,Feral,100,17,2017.0,Horror/Mystery and thriller,1:32,15,5.875307153057772
48,100,Hari Kondabolu: Warn Your Relatives,1,7,2018.0,,,52,3.374320069567275
69,100,Ali Wong: Hard Knock Wife,100,21,2018.0,,,31,6.704819013328363
71,100,Steve Martin and Martin Short: An Evening You Will Forget for the Rest of Your Life,100,10,2018.0,,,29,4.216965034285822
29,82,W. Kamau Bell: Private School Negro,1,11,2018.0,,,53,4.475797488182033
92,86,Hombre mirando al sudeste,1000,7,1986.0,Drama,1:44,-6,3.374320069567275
85,100,Only Yesterday,100,56,1991.0,Drama/Anime,1:58,15,12.377060587439436
74,69,The Savage Innocents,500,13,1959.0,Adventure,1:50,-5,4.968377601139757
43,50,Something Wild,250,8,1961.0,Drama,1:52,7,3.668016172818685
69,46,Luna,500,13,1979.0,Drama,2:24,-23,4.968377601139757
65,88,Ocean Waves,1000,17,1993.0,Anime/Adventure,1:12,23,5.875307153057772
42,83,The Battle of the Sexes,100,6,1959.0,Comedy,1:28,41,3.064393493081416
56,29,Five Miles to Midnight,100,7,1963.0,Drama,1:50,-27,3.374320069567275
73,75,Deadline U.S.A.,100,8,1952.0,Drama,1:27,2,3.668016172818685
16,65,Resistance,250,17,2011.0,Drama/Mystery and thriller,1:32,49,5.875307153057772
88,100,Three Sisters,1,6,2013.0,,,12,3.064393493081416
60,64,Miss Peregrine's Home for Peculiar Children,25000,253,2016.0,Drama/Fantasy,2:01,4,31.765107230441497
53,25,Ben-Hur,10000,191,2016.0,History/Adventure,2:05,-28,26.646848608438216
49,88,Fort Tilden,500,34,2014.0,Comedy,1:36,39,9.060962294042406
15,22,Chernaya roza,50,9,2014.0,Action/Mystery and thriller,1:23,7,3.9482220388574776
59,26,Suicide Squad,100000,384,2016.0,Action/Fantasy,2:03,-33,41.22940005214354
76,89,How to Dance in Ohio,50,9,2015.0,Documentary,1:28,13,3.9482220388574776
86,84,Rogue One: A Star Wars Story,100000,452,2016.0,Fantasy/Action,2:14,-2,45.65218008397265
80,70,Marinoni: The Fire in the Frame,1,10,2015.0,Documentary,1:30,-10,4.216965034285822
42,88,Sun Choke,500,25,2015.0,Mystery and thriller,1:23,46,7.476743906106103
25,33,StalkHer,1,6,2015.0,Romance/Comedy,1:30,8,3.064393493081416
46,58,David Brent: Life on the Road,2500,77,2016.0,Comedy/Musical,1:36,12,15.102773291691431
34,62,The Mind's Eye,250,26,2015.0,Sci fi/Action,1:27,28,7.662285721192069
74,67,The Bounce Back,1000,6,2016.0,Romance,1:44,-7,3.064393493081416
25,27,The Rocky Horror Picture Show: Let's Do the Time Warp Again,500,41,2016.0,,,2,10.185677243651742
46,53,Genius,2500,110,2016.0,,,7,18.874281508207943
68,94,Newtown,250,36,2016.0,Documentary/Drama,1:25,26,9.390507480439723
63,97,Little Men,5000,143,2016.0,Drama,1:25,34,22.237451987521194
72,96,Paterson,10000,262,2016.0,Comedy/Drama,1:58,24,32.46671188855409
55,92,Ma,1,13,2015.0,Drama,1:21,37,4.968377601139757
88,97,Burden,1,36,2016.0,Documentary,1:28,9,9.390507480439723
97,100,O.J.: Made in America,1000,53,2016.0,,,3,11.958381890942793
43,89,Three,250,28,2016.0,Action/Mystery and thriller,1:27,46,8.02553087005176
90,97,13TH,2500,104,2016.0,Documentary,1:40,7,18.22408939365073
35,14,Correspondence,50,7,2016.0,Romance/Drama,1:56,-21,3.374320069567275
28,74,We Are the Flesh,250,47,2016.0,Fantasy/Horror,1:19,46,11.093310301199846
77,75,Before the Flood,2500,32,2016.0,Documentary,1:33,-2,8.724061861322062
79,100,Justin Timberlake + The Tennessee Kids,1,14,2016.0,,,21,5.203912939677927
58,71,David Cross: Making America Great Again,1,7,2016.0,,,13,3.374320069567275
83,90,Marathon: The Patriots Day Bombing,50,10,2016.0,,,7,4.216965034285822
70,100,Michael Che Matters,1,5,2016.0,,,30,2.734363528521053
49,81,Casting JonBenét,250,54,2017.0,Documentary,1:20,32,12.098905925115496
53,75,Berlin Syndrome,2500,88,2017.0,Mystery and thriller,1:56,22,16.417297572912943
62,100,"Michael Bolton's Big, Sexy Valentine's Day Special",50,5,2017.0,,,38,2.734363528521053
72,83,Teen Titans: The Judas Contract,500,6,2017.0,Action/Animation,1:16,11,3.064393493081416
83,100,Neal Brennan: 3 Mics,1,7,2017.0,,,17,3.374320069567275
75,95,Louis C.K.: 2017,250,20,2017.0,,,20,6.503449126242364
72,83,Tracy Morgan: Staying Alive,1,6,2017.0,,,11,3.064393493081416
81,20,Danger Close,50,5,2017.0,Action,1:27,-61,2.734363528521053
4,50,Amy Schumer: The Leather Special,500,8,2017.0,,,46,3.668016172818685
56,100,Rodney King,50,9,2017.0,,,44,3.9482220388574776
50,100,Sarah Silverman: A Speck of Dust,50,10,2017.0,,,50,4.216965034285822
44,91,"Nobody Speak: Hulk Hogan, Gawker and Trials of a Free Press",250,34,2017.0,Documentary,1:36,47,9.060962294042406
80,100,Maria Bamford: Old Baby,1,14,2017.0,,,20,5.203912939677927
31,40,The Horror of H.P. Lovecraft (LovecraCked! The Movie),1000,5,2006.0,,,9,2.734363528521053
72,67,Carry on Screaming,2500,6,1966.0,Comedy,1:37,-5,3.064393493081416
89,100,Titicut Follies,1000,11,1967.0,Documentary,1:30,11,4.475797488182033
74,93,A Child Is Waiting,1000,14,1963.0,Drama,1:42,19,5.203912939677927
85,96,"Out 1, Noli Me Tangere",250,24,1971.0,,,11,7.288397090280924
62,100,Dr. Terror's House of Horrors,1000,5,1965.0,Horror,1:38,38,2.734363528521053
70,57,The Challenge,250,7,1982.0,Crime/Drama,1:52,-13,3.374320069567275
63,60,My American Cousin,100,5,1985.0,Comedy/Drama,1:35,-3,2.734363528521053
43,67,Rich Kids,50,6,1979.0,Comedy/Drama,1:41,24,3.064393493081416
42,88,The American Dreamer,1,8,1971.0,Documentary,1:21,46,3.668016172818685
48,75,SoulBoy,250,8,2010.0,Romance/Comedy,1:22,27,3.668016172818685
29,11,Point Break,10000,110,2015.0,,,-18,18.874281508207943
77,40,2 Rabbits,100,5,2012.0,Action,1:48,-37,2.734363528521053
64,39,Can't Stand Losing You: Surviving the Police,100,18,2012.0,Documentary/Drama,1:19,-25,6.088990769440213
44,64,Life,1000,61,2015.0,Drama/History,1:52,20,13.056631493342596
34,0,Hell & Back,1000,5,2015.0,,,-34,2.734363528521053
81,78,1982,250,9,2013.0,Drama,1:30,-3,3.9482220388574776
66,88,Australia's Lost Gold: The Legend of Lasseter,250,8,2012.0,Documentary,1:44,22,3.668016172818685
57,90,The Nightingale,100,10,2013.0,Comedy/Drama,1:40,33,4.216965034285822
56,40,Blackbird,500,10,2014.0,Gay and lesbian/Drama,1:42,-16,4.216965034285822
77,62,Race,10000,158,2016.0,Drama/History,2:14,-15,23.667951973591787
41,54,Triple 9,10000,184,2016.0,Crime/Action,1:55,13,26.03221601518546
48,14,Ride Along 2,25000,121,2016.0,Comedy/Action,1:41,-34,20.032763155216593
66,91,The Kidnapping of Michel Houellebecq,250,23,2014.0,Comedy/Drama,1:33,25,7.097083215743026
87,90,Bridge of Spies,50000,309,2015.0,Drama/Mystery and thriller,2:21,3,35.99349753310109
74,82,Heaven Adores You,100,17,2014.0,Documentary/Drama,1:44,8,5.875307153057772
76,66,Kahlil Gibran's The Prophet,1000,73,2014.0,Kids and family/Animation,1:25,-10,14.607530022406213
71,95,National Gallery,1000,66,2014.0,Documentary,3:00,24,13.715604699135167
78,92,Breathe,1000,53,2014.0,Drama,1:31,14,11.958381890942793
75,83,The Bélier Family,1000,24,2014.0,Drama/Comedy,1:46,8,7.288397090280924
51,67,Krampus,25000,129,2015.0,,,16,20.850600582083427
66,87,Heaven Knows What,2500,71,2014.0,Drama,1:35,21,14.356099772615265
86,100,Mr. Dynamite: The Rise of James Brown,100,11,2014.0,,,14,4.475797488182033
78,94,The Last Man on the Moon,2500,47,2014.0,Documentary/Adventure,1:35,16,11.093310301199846
82,91,Toy Story That Time Forgot,500,11,2014.0,,,9,4.475797488182033
41,89,Elf: Buddy's Musical Christmas,100,9,2014.0,,,48,3.9482220388574776
16,25,The Stranger,100,12,2014.0,Horror/Mystery and thriller,1:33,9,4.725940818339814
79,96,Jafar Panahi's Taxi,2500,106,2015.0,,,17,18.442346006574258
38,67,The Boy,500,21,2015.0,Horror/Drama,1:45,29,6.704819013328363
33,100,GTFO: Get the F&#% Out,1,5,2015.0,,,67,2.734363528521053
44,78,7 Chinese Brothers,500,36,2015.0,Comedy,1:15,34,9.390507480439723
68,92,Grease: Live!,250,36,2016.0,,,24,9.390507480439723
38,40,Love,2500,93,2015.0,,,2,16.994243740562503
33,18,Extinction,1000,11,2015.0,Sci fi/Horror,1:53,-15,4.475797488182033
93,97,Spotlight,50000,371,2015.0,Drama,2:08,4,40.35140801415813
37,20,Bound to Vengeance,250,15,2015.0,Horror/Mystery and thriller,1:20,-17,5.433216825139731
82,94,The Pearl Button,250,47,2015.0,Documentary,1:22,12,11.093310301199846
51,61,Eisenstein in Guanajuato,250,54,2015.0,Comedy/Gay and lesbian,1:46,10,12.098905925115496
35,50,Wild City,100,8,2015.0,Action/Mystery and thriller,1:44,15,3.668016172818685
34,83,Hangman,100,6,2015.0,Mystery and thriller,1:25,49,3.064393493081416
61,70,Tumbledown,1000,37,2015.0,Romance,1:43,9,9.552698646911638
10,46,#Horror,500,13,2015.0,Horror/Mystery and thriller,1:30,36,4.968377601139757
17,6,Extraction,1000,18,2015.0,Action/Mystery and thriller,1:23,-11,6.088990769440213
61,80,We Are Twisted F...ing Sister!,250,10,2014.0,Documentary/Music,2:15,19,4.216965034285822
42,9,The Do Over,1000,23,2016.0,Comedy/Action,1:48,-33,7.097083215743026
77,100,Ali Wong: Baby Cobra,1,9,2016.0,,,23,3.9482220388574776
93,100,Lemonade,100,6,2015.0,Comedy/Drama,1:50,7,3.064393493081416
58,100,Hannibal Buress: Comedy Camisado,1,7,2016.0,,,42,3.374320069567275
88,100,Make Happy,100,6,2016.0,,,12,3.064393493081416
87,94,Elmer Gantry,2500,31,1960.0,Drama,2:25,7,8.552657067536824
48,50,Nekromantik,2500,6,1987.0,Horror,1:15,2,3.064393493081416
70,67,The Masque of the Red Death,5000,15,1990.0,Horror,1:34,-3,5.433216825139731
49,67,Buffalo Bill and the Indians,1000,15,1976.0,Western,2:03,18,5.433216825139731
54,71,True Confessions,2500,14,1981.0,Crime/Drama,1:50,17,5.203912939677927
86,44,Sundays and Cybele,250,9,1962.0,Romance,1:50,-42,3.9482220388574776
32,29,Last Embrace,500,7,1979.0,Mystery and thriller,1:43,-3,3.374320069567275
67,67,Paris Blues,500,12,1961.0,Romance,1:38,0,4.725940818339814
46,10,Dangerously Close,100,10,1986.0,Mystery and thriller,1:34,-36,4.216965034285822
15,9,Accidental Love,2500,35,2015.0,Comedy,1:40,-6,9.22661773178138
54,79,Killing Kasztner: The Jew Who Dealt With Nazis,50,19,2008.0,Documentary,2:09,25,6.298266028731006
52,94,Level Five,100,18,1997.0,Romance/Documentary,1:46,42,6.088990769440213
71,86,Favourites of the Moon,50,7,1984.0,Crime/Comedy,1:41,15,3.374320069567275
74,87,La Danse -- Le Ballet de l'Opera de Paris,500,55,2009.0,,,13,12.238457412731087
40,75,Red Hollywood,1,8,2014.0,,,35,3.668016172818685
75,95,Boxing Gym,1000,42,2010.0,Documentary,1:31,20,10.34024446475599
49,67,Gone With the Pope,100,6,2010.0,Crime/Drama,1:23,18,3.064393493081416
64,92,El Sicario: Room 164,500,13,2010.0,Documentary,1:20,28,4.968377601139757
77,90,Breathing,500,21,2011.0,Drama,1:28,13,6.704819013328363
65,8,After,100,12,2014.0,Drama,1:41,-57,4.725940818339814
47,86,The Devil's Business,100,7,2011.0,Horror,1:15,39,3.374320069567275
40,40,Elza,1,5,2011.0,Drama,1:22,0,2.734363528521053
63,73,Neighbors,100000,225,2014.0,Comedy,1:37,10,29.519845068981457
58,70,"Once Upon a Time Was I, Verônica",50,10,2012.0,Drama,1:31,12,4.216965034285822
76,57,Blackbird,100,7,2012.0,Drama,1:46,-19,3.374320069567275
47,48,Honour,100,27,2013.0,Mystery and thriller,1:44,1,7.845169885845621
38,27,Jupiter Ascending,50000,270,2015.0,Action/Sci fi,2:07,-11,33.08280709664308
72,91,The Kill Team,2500,43,2013.0,Documentary,1:19,19,10.493437610589469
52,84,Expedition to the End of the World,250,19,2013.0,Documentary,1:30,32,6.298266028731006
36,24,Tammy,50000,185,2014.0,Comedy,1:37,-12,26.120550779067592
82,92,I Am Breathing,250,25,2013.0,Documentary,1:13,10,7.476743906106103
67,100,Honey,250,16,2013.0,Drama,1:36,33,5.656854249492381
78,67,Lootera,500,6,2013.0,Romance/Drama,2:16,-11,3.064393493081416
32,24,Wolves,500,21,2014.0,Horror,1:30,-8,6.704819013328363
62,51,Jersey Boys,25000,222,2014.0,Drama/Musical,2:12,-11,29.273227574963673
69,86,Violette,500,50,2013.0,Romance/Drama,2:19,17,11.530715390799685
60,69,Beyond the Edge,250,26,2013.0,Documentary/Adventure,,9,7.662285721192069
52,100,I Am Yours,50,9,2013.0,Drama,1:36,48,3.9482220388574776
52,71,Defender,1000,14,2013.0,Sci fi,2:15,19,5.203912939677927
55,86,Abuse of Weakness,250,35,2013.0,Drama,1:45,31,9.22661773178138
84,96,Burning Bush,250,23,2014.0,,,12,7.097083215743026
57,100,The Pleasures of Being Out of Step,100,16,2013.0,Documentary,1:27,43,5.656854249492381
39,48,Premature,500,21,2014.0,Comedy/Fantasy,1:33,9,6.704819013328363
84,94,Toy Story of Terror!,2500,16,2013.0,,,10,5.656854249492381
61,21,White Rabbit,250,14,2013.0,Drama,1:30,-40,5.203912939677927
31,18,Jinn,2500,11,2014.0,Mystery and thriller,1:37,-13,4.475797488182033
75,100,Levitated Mass: The Story of Michael Heizer's Monolithic Sculpture,100,6,2014.0,,,25,3.064393493081416
59,12,The Best of Me,25000,83,2014.0,Romance/Drama,1:58,-47,15.827918586512368
38,33,Anna,500,21,2013.0,Sci fi/Mystery and thriller,1:38,-5,6.704819013328363
75,83,Beyond the Lights,10000,93,2014.0,Romance/Drama,1:56,8,16.994243740562503
72,92,Frank,10000,165,2014.0,Comedy/Drama,1:35,20,24.317978218708763
94,94,Whiplash,50000,298,2014.0,Drama/Music,1:46,0,35.18723690988606
69,53,I Origins,5000,106,2014.0,Sci fi/Drama,1:57,-16,18.442346006574258
77,81,Human Capital,2500,67,2013.0,Drama,1:49,4,13.8451208742507
42,76,Life of Riley,100,29,2014.0,Comedy,1:48,34,8.20349180691225
12,8,Drive Hard,250,26,2014.0,Crime/Action,1:36,-4,7.662285721192069
77,100,The Circle,250,24,2014.0,Romance/Gay and lesbian,1:42,23,7.288397090280924
86,50,The Reckoning,100,6,2014.0,Crime/Drama,1:26,-36,3.064393493081416
33,52,The Calling,2500,46,2014.0,Mystery and thriller,1:48,19,10.945198564139895
75,94,Force majeure,10000,159,2014.0,Comedy/Drama,2:00,19,23.761464418909437
82,31,The Song,1000,13,2014.0,Drama,1:57,-51,4.968377601139757
85,95,Nightcrawler,50000,273,2014.0,Crime/Drama,1:57,10,33.3120726055166
76,75,TinkerBell and the Legend of the NeverBeast,1000,20,2014.0,,,-1,6.503449126242364
85,80,Pay 2 Play: Democracy's High Stakes,100,5,2014.0,,,-5,2.734363528521053
81,86,John Wick,50000,217,2014.0,Action/Mystery and thriller,1:41,5,28.8594023911159
70,87,The Mule,1000,31,2014.0,Crime/Comedy,1:42,17,8.552657067536824
60,50,How Murray Saved Christmas,1,6,2014.0,,,-10,3.064393493081416
15,4,Vice,1000,27,2015.0,Action/Sci fi,1:35,-11,7.845169885845621
79,100,Li'l Quinquin,250,22,2015.0,,,21,6.9026233386080005
94,100,Bill Burr: I'm Sorry You Feel That Way,50,5,2014.0,,,6,2.734363528521053
37,23,Tracers,5000,30,2014.0,Action/Mystery and thriller,1:34,-14,8.379165804519056
43,15,The Squeeze,100,13,2015.0,Drama/Mystery and thriller,1:35,-28,4.968377601139757
82,88,The Jungle Book,250000,40,1967.0,Animation/Kids and family,1:18,6,10.029689644980788
79,86,Young at Heart,2500,7,1954.0,Romance/Musical,1:57,7,3.374320069567275
75,100,Master of the House,500,7,1925.0,Comedy/Drama,1:58,25,3.374320069567275
78,100,Caught,500,9,1949.0,Drama,1:28,22,3.9482220388574776
74,89,Men in War,250,9,1957.0,War,1:44,15,3.9482220388574776
81,100,Summer Interlude,500,11,1950.0,Drama,1:34,19,4.475797488182033
83,81,Face to Face,500,16,1975.0,Drama,2:16,-2,5.656854249492381
34,40,Who Is Harry Kellerman and Why Is He Saying Those Terrible Things About Me?,250,5,1971.0,Comedy/Drama,1:48,6,2.734363528521053
72,80,Pete 'n' Tillie,100,5,1972.0,Comedy/Drama,1:40,8,2.734363528521053
41,42,Skidoo,250,12,1968.0,Comedy,1:37,1,4.725940818339814
25,29,Deadly Eyes,100,7,1982.0,Horror,1:27,4,3.374320069567275
78,83,Separate But Equal,100,6,1991.0,,,5,3.064393493081416
61,60,Good Sam,50,5,1948.0,Comedy,1:53,-1,2.734363528521053
26,67,Corruption,50,6,1968.0,Horror,1:31,41,3.064393493081416
94,100,Never Sleep Again: The Elm Street Legacy,1000,7,2010.0,,,6,3.374320069567275
10,0,The Last Seven,250,8,2010.0,Mystery and thriller,1:24,-10,3.668016172818685
43,71,Oka! Amerikee,100,14,2010.0,Drama,1:46,28,5.203912939677927
23,50,Switch,50,6,2012.0,,,27,3.064393493081416
60,87,Kawasaki's Rose,500,15,2009.0,Drama,1:40,27,5.433216825139731
59,100,Harold's Going Stiff,100,6,2010.0,Comedy/Horror,,41,3.064393493081416
67,100,The Curse Of The Gothic Symphony,1,5,2011.0,,,33,2.734363528521053
55,66,Faust,2500,38,2011.0,Drama/Mystery and thriller,2:14,11,9.713254050808038
50,56,Night Number 1,250,16,2011.0,Drama,1:31,6,5.656854249492381
80,93,Wrinkles,2500,28,2014.0,,,13,8.02553087005176
88,74,Blood Brother,1000,27,2013.0,Documentary,1:33,-14,7.845169885845621
78,94,War Witch,5000,63,2012.0,Drama/War,1:29,16,13.322564864824612
77,88,Tabu,1000,60,2012.0,Drama,1:58,11,12.922440211617326
75,100,The Waiting Room,1000,34,2012.0,Documentary,1:21,25,9.060962294042406
88,98,Ernest & Célestine,5000,81,2014.0,,,10,15.588457268119896
76,86,After Lucia,500,7,2012.0,Drama,1:33,10,3.374320069567275
36,22,Sabotage,10000,114,2014.0,,,-14,19.300365436139025
64,100,Radio Unnameable,250,13,2012.0,Documentary,1:31,36,4.968377601139757
49,25,Planes,50000,122,2013.0,Animation/Comedy,1:32,-24,20.136078432395202
64,67,Four,100,6,2013.0,,,3,3.064393493081416
46,56,The To Do List,10000,122,2013.0,Comedy,1:44,10,20.136078432395202
54,83,Leviathan,1000,54,2012.0,Documentary,1:27,29,12.098905925115496
39,82,+1,1000,11,2013.0,,,43,4.475797488182033
85,83,The Broken Circle Breakdown,5000,103,2012.0,Romance/Drama,1:52,-2,18.1143712989759
62,89,Informant,250,19,2012.0,Documentary,1:22,27,6.298266028731006
30,39,Haunt,10000,18,2014.0,Horror/Mystery and thriller,1:26,9,6.088990769440213
74,92,Inside Llewyn Davis,25000,286,2013.0,Comedy/Drama,1:44,18,34.294839184644516
17,27,Ass Backwards,250,22,2013.0,Comedy,1:23,10,6.9026233386080005
58,75,Concussion,1000,59,2013.0,Gay and lesbian/Drama,1:36,17,12.78740756158519
52,36,Salinger,5000,88,2013.0,Documentary,2:09,-16,16.417297572912943
45,45,He's Way More Famous Than You,100,11,2013.0,Comedy,1:36,0,4.475797488182033
40,33,Bottled Up,50,6,2013.0,Drama,1:24,-7,3.064393493081416
72,96,Plimpton! Starring George Plimpton as Himself,250,27,2011.0,Documentary,1:28,24,7.845169885845621
13,33,Beneath,100,15,2013.0,Mystery and thriller,1:29,20,5.433216825139731
58,16,Endless Love,25000,95,2014.0,Romance/Drama,1:45,-42,17.22174892188519
57,100,Bloody Daughter,1,5,2012.0,Documentary/Music,1:34,43,2.734363528521053
37,20,Cold Turkey,50,15,2013.0,Comedy/Drama,1:24,-17,5.433216825139731
53,31,Last Love,1000,39,2013.0,Drama,1:56,-22,9.872232603526719
75,40,How Sherlock Changed the World,100,5,2013.0,,,-35,2.734363528521053
42,100,Ninja II: Shadow of a Tear,250,5,2013.0,Action/Sports and fitness,1:34,58,2.734363528521053
91,60,Generation War,1000,30,2014.0,,,-31,8.379165804519056
24,0,Sir Billi,50,8,2013.0,,,-24,3.668016172818685
65,99,Gloria,10000,129,2013.0,Romance/Drama,1:49,34,20.850600582083427
82,88,Home,50,8,2013.0,Drama,1:52,6,3.668016172818685
57,58,Ram-Leela,1000,12,2013.0,Romance/Drama,2:30,1,4.725940818339814
51,80,Sarah Silverman: We are Miracles,50,5,2013.0,,,29,2.734363528521053
41,50,Stalingrad,5000,74,2013.0,History/War,2:11,9,14.732275265126917
22,14,Free Ride,250,7,2013.0,Drama,1:26,-8,3.374320069567275
25,22,HairBrained,100,18,2013.0,Comedy,1:37,-3,6.088990769440213
12,5,The Outsider,100,20,2014.0,Crime/Drama,1:34,-7,6.503449126242364
86,40,Peter Gabriel: Back To Front,1,5,2014.0,,,-46,2.734363528521053
82,88,The Wipers Times,50,8,2013.0,,,6,3.668016172818685
42,80,Cloak and Dagger,1000,10,1946.0,Mystery and thriller,1:46,38,4.216965034285822
53,40,Ninja III -- The Domination,1000,10,1984.0,Adventure/Sports and fitness,1:35,-13,4.216965034285822
74,78,Ivans Xtc,500,32,2002.0,,,4,8.724061861322062
26,64,Cavalcade,1000,33,1933.0,Drama,1:49,38,8.893469344897873
77,85,Macbeth,2500,27,1948.0,Drama,1:46,8,7.845169885845621
80,100,Le pont du nord,100,9,1981.0,Drama,2:09,20,3.9482220388574776
82,100,The Devil's Envoys,500,6,1942.0,Fantasy/Romance,1:58,18,3.064393493081416
56,74,The Fourth Protocol,1000,19,1987.0,Mystery and thriller,1:58,18,6.298266028731006
34,40,Prison,500,5,1987.0,Horror,1:42,6,2.734363528521053
43,33,The Lady Vanishes,500,6,1979.0,Comedy/Mystery and thriller,1:39,-10,3.064393493081416
35,40,Staircase,100,5,1969.0,Drama,1:40,5,2.734363528521053
58,29,The Athlete,1,7,2009.0,Drama/Biography,1:25,-29,3.374320069567275
33,50,Magic Town,100,6,1947.0,Comedy/Drama,1:43,17,3.064393493081416
50,58,The Revenant,1000,26,2009.0,Comedy/Horror,1:59,8,7.662285721192069
45,35,Womb,1000,20,2010.0,Sci fi,1:51,-10,6.503449126242364
51,59,Empire of Silver,250,17,2009.0,Romance/Drama,1:53,8,5.875307153057772
90,80,Hipsters,500,25,2011.0,,,-10,7.476743906106103
43,62,Beyond the Pole,100,13,2009.0,Comedy/Drama,1:27,19,4.968377601139757
63,87,Our Beloved Month of August,100,15,2008.0,Romance,2:33,24,5.433216825139731
71,64,Parked,500,14,2011.0,Drama,1:34,-7,5.203912939677927
52,77,Over Your Cities Grass Will Grow,2500,35,2010.0,Documentary,1:45,25,9.22661773178138
71,88,The Silence,500,40,2010.0,Drama,2:00,17,10.029689644980788
65,89,The Autobiography of Nicolae Ceausescu,100,18,2010.0,Documentary,3:00,24,6.088990769440213
34,46,The Details,5000,35,2011.0,Comedy,1:36,12,9.22661773178138
69,93,"Turn Me On, Dammit!",2500,45,2011.0,Comedy,1:16,24,10.795874345554918
35,44,Late Bloomers,250,16,2011.0,Romance/Comedy,1:29,9,5.656854249492381
60,84,Beauty (Skoonheid),250,19,2011.0,,,24,6.298266028731006
62,85,The Giants,250,20,2011.0,Drama,1:24,23,6.503449126242364
56,70,The Pill,1000,10,2011.0,Romance/Comedy,1:23,14,4.216965034285822
49,10,The Host,50000,133,2013.0,Romance/Sci fi,2:05,-39,21.252365464220812
34,67,Cargo,100,6,2011.0,Drama,1:26,33,3.064393493081416
54,59,Hysteria,10000,134,2011.0,Comedy,1:39,5,21.35209529135088
78,78,The Best Exotic Marigold Hotel,50000,168,2011.0,Comedy/Drama,2:04,0,24.59338457671065
22,59,The Woman in the Fifth,2500,58,2011.0,Mystery and thriller,1:23,37,12.651513870765422
90,80,The Story Of Film: An Odyssey,100,5,2011.0,,,-10,2.734363528521053
16,22,Strippers vs Werewolves,100,9,2012.0,Comedy/Horror,1:33,6,3.9482220388574776
19,63,Crawl,100,8,2011.0,Crime/Drama,1:20,44,3.668016172818685
65,47,The First Time,5000,19,2012.0,Romance,1:40,-18,6.298266028731006
86,93,Side by Side,10000,68,2012.0,Documentary,1:38,7,13.973914138485368
66,80,Quartet,10000,146,2012.0,Comedy/Drama,1:39,14,22.52789093302636
86,86,Heist: Who Stole the American Dream?,100,7,2011.0,Documentary,1:30,0,3.374320069567275
71,77,The Source Family,250,22,2012.0,Documentary/Music,1:38,6,6.9026233386080005
68,85,Eden,2500,40,2012.0,Crime/Drama,1:38,17,10.029689644980788
67,50,Bert Stern: Original Mad Man,100,20,2011.0,Documentary,1:32,-17,6.503449126242364
78,62,Secret of the Wings,1000,21,2012.0,,,-16,6.704819013328363
53,88,Not Suitable for Children,2500,17,2012.0,Romance,1:37,35,5.875307153057772
48,71,Headshot,1000,14,2011.0,Crime/Drama,1:45,23,5.203912939677927
75,77,Flight,100000,238,2012.0,Drama/Mystery and thriller,2:18,2,30.574586918379627
86,92,The Central Park Five,5000,77,2012.0,Crime/Documentary,1:59,6,15.102773291691431
48,83,In Another Country,1000,29,2012.0,Drama,1:29,35,8.20349180691225
79,67,Method to the Madness of Jerry Lewis,50,12,2012.0,,,-12,4.725940818339814
83,81,Pitch Perfect,100000,154,2012.0,Romance/Comedy,1:52,-2,23.291660464128444
41,70,The Girl,500,44,2012.0,Drama/Biography,1:31,29,10.645300436514761
84,100,A Werewolf Boy,2500,5,2012.0,Romance/Sci fi,2:02,16,2.734363528521053
80,87,What Maisie Knew,10000,112,2012.0,Drama,1:38,7,19.088036824679065
46,32,Emperor,5000,91,2012.0,Drama/History,1:46,-14,16.764896252714394
85,89,Crossfire Hurricane,250,27,2012.0,Documentary/Music,1:51,4,7.845169885845621
85,94,A Band Called Death,5000,52,2012.0,Documentary/Music,1:38,9,11.8168599865911
27,36,Code Name: Geronimo,100,11,2012.0,,,9,4.475797488182033
76,50,Between Us,1,10,2012.0,Comedy/Drama,1:30,-26,4.216965034285822
45,50,Death Race 3: Inferno,1000,6,2012.0,Action/Mystery and thriller,1:45,5,3.064393493081416
36,18,Hustlers,1000,17,2013.0,,,-18,5.875307153057772
20,29,Ghost Shark,100,7,2013.0,Horror/Mystery and thriller,1:30,9,3.374320069567275
92,78,The Moment of Truth,250,9,1965.0,Drama,1:50,-14,3.9482220388574776
88,83,Hamilton,250,6,2006.0,Drama,1:05,-5,3.064393493081416
87,90,Show People,500,10,1928.0,Comedy,1:22,3,4.216965034285822
74,80,Twilight's Last Gleaming,500,10,1977.0,Mystery and thriller,2:26,6,4.216965034285822
78,92,"I'm a Cyborg, but That's OK",10000,12,2006.0,Romance/Comedy,1:45,14,4.725940818339814
70,100,The Sky Turns,250,13,2004.0,Documentary,1:55,30,4.968377601139757
82,69,Lonesome,250,13,1928.0,Romance/Comedy,1:09,-13,4.968377601139757
72,100,The Spy in Black,250,13,1939.0,War,1:22,28,4.968377601139757
85,95,Kuroneko,500,22,1968.0,Fantasy/Horror,1:39,10,6.9026233386080005
22,0,The Awakening,250,5,1980.0,Horror,1:42,-22,2.734363528521053
75,100,Handsome Serge,500,9,1958.0,Drama,1:33,25,3.9482220388574776
43,100,Elephant Boy,100,11,1937.0,Drama/Adventure,1:20,57,4.475797488182033
27,0,The Nutcracker in 3D,2500,32,2013.0,,,-27,8.724061861322062
25,43,My Son John,50,7,1952.0,Drama,2:02,18,3.374320069567275
100,60,Where the River Runs Black,50,5,1986.0,Adventure,1:37,-40,2.734363528521053
33,33,A Previous Engagement,100,21,2008.0,Romance,1:58,0,6.704819013328363
67,71,Sleep Furiously,250,28,2008.0,Documentary,1:34,4,8.02553087005176
68,87,Night and Day (Bam gua nat),250,15,2009.0,,,19,5.433216825139731
43,100,Safe in Hell,50,6,1931.0,Drama,1:05,57,3.064393493081416
63,93,United Red Army,1000,14,2007.0,Drama,3:10,30,5.203912939677927
88,91,Love Exposure,2500,22,2008.0,Romance/Comedy,3:57,3,6.9026233386080005
83,100,Remember the Night,250,10,1940.0,Romance/Other,1:34,17,4.216965034285822
41,100,The Juche Idea,50,6,2008.0,Documentary/Comedy,1:02,59,3.064393493081416
28,30,The Tempest,10000,89,2010.0,Fantasy/Drama,1:49,2,16.533650545237286
97,100,American Harmony,100,5,2009.0,Documentary,1:25,3,2.734363528521053
14,67,The Agent,100,12,2009.0,Comedy/Drama,1:21,53,4.725940818339814
88,100,Fish Story,500,12,2009.0,Comedy,1:52,12,4.725940818339814
72,85,A Matter of Size,250,13,2009.0,Comedy/Drama,1:32,13,4.968377601139757
52,42,Mother's Day,10000,45,2010.0,Crime/Horror,1:52,-10,10.795874345554918
19,0,Monsignor,50,7,1982.0,Drama,2:02,-19,3.374320069567275
42,66,Great Directors,500,38,2009.0,Documentary,1:26,24,9.713254050808038
70,82,Nothing Personal,1000,11,2009.0,Drama,1:25,12,4.475797488182033
10,25,Splintered,100,8,2008.0,Horror/Mystery and thriller,1:31,15,3.668016172818685
76,93,Tibet in Song,50,14,2009.0,Documentary,1:26,17,5.203912939677927
83,87,The Hedgehog,5000,71,2009.0,Comedy/Drama,1:40,4,14.356099772615265
74,63,The Red Chapel,2500,8,2009.0,Documentary/Comedy,1:28,-11,3.668016172818685
60,86,The Pirates! Band of Misfits,50000,153,2012.0,,,26,23.197017186759677
77,100,Alambrista,50,6,1978.0,Drama,1:50,23,3.064393493081416
27,60,The Fields,250,5,2011.0,,,33,2.734363528521053
48,50,House of Boys,100,8,2009.0,Romance/Gay and lesbian,1:53,2,3.668016172818685
42,63,Mammuth,500,24,2010.0,Comedy,1:32,21,7.288397090280924
19,40,Easy Living,1,5,1949.0,Drama,1:17,21,2.734363528521053
49,43,Berlin 36,100,7,2009.0,History/Drama,1:43,-6,3.374320069567275
74,95,The Woodmans,500,19,2010.0,Documentary/Biography,1:22,21,6.298266028731006
55,75,October,100,16,2010.0,Drama,1:23,20,5.656854249492381
37,68,The Silent House,2500,28,2010.0,Horror/Mystery and thriller,1:19,31,8.02553087005176
78,92,Sound of Noise,1000,24,2010.0,Crime/Comedy,1:42,14,7.288397090280924
63,85,Contagion,50000,275,2011.0,Drama/Mystery and thriller,1:46,22,33.46439159473001
84,42,Burzynski: the Movie,250,12,2010.0,,,-42,4.725940818339814
70,90,Rare Exports: A Christmas Tale,10000,105,2010.0,Other/Horror,1:17,20,18.333412575379587
76,85,Honey,500,27,2010.0,Drama,1:43,9,7.845169885845621
43,47,A Serbian Film,5000,32,2010.0,Mystery and thriller,1:44,4,8.724061861322062
39,58,Film Socialisme,1000,60,2010.0,Drama,1:41,19,12.922440211617326
33,21,The Double,5000,52,2011.0,Action/Mystery and thriller,1:38,-12,11.8168599865911
56,93,Nine Nation Animation,50,14,2010.0,,,37,5.203912939677927
49,26,Wrath of the Titans,100000,174,2012.0,Action/Fantasy,1:39,-23,25.13872691364861
77,85,Beginners,25000,161,2010.0,Gay and lesbian/Drama,1:45,8,23.947830330270747
64,80,Outrage,2500,46,2010.0,Crime/Action,1:49,16,10.945198564139895
52,63,Griff the Invisible,2500,57,2010.0,Romance/Comedy,1:33,11,12.514738658402138
76,91,Point Blank,5000,79,2010.0,Crime/Action,1:24,15,15.34676814846713
60,33,Amador,100,6,2010.0,Drama,1:52,-27,3.064393493081416
37,17,Breakaway,500,6,2011.0,Comedy,1:41,-20,3.064393493081416
23,32,Intruders,5000,73,2011.0,Horror/Mystery and thriller,1:39,9,14.607530022406213
79,92,Drive,100000,266,2011.0,Drama/Action,1:40,13,32.7756280844472
79,80,Life in a Day,10000,76,2011.0,Documentary,1:35,1,14.979885547093689
73,100,The Colors of the Mountain,250,8,2010.0,Drama,1:30,27,3.668016172818685
43,50,Dum Maaro Dum,500,6,2011.0,Mystery and thriller,,7,3.064393493081416
45,50,96 Minutes,2500,18,2011.0,Drama/Mystery and thriller,1:33,5,6.088990769440213
78,64,Vincent Wants to Sea,250,22,2010.0,Drama,1:36,-14,6.9026233386080005
63,87,Miss Bala,2500,69,2011.0,Action/Drama,1:53,24,14.101999070345963
67,80,Michael,1000,40,2011.0,Drama,1:38,13,10.029689644980788
90,71,Never Stand Still,100,7,2011.0,Documentary,1:18,-19,3.374320069567275
49,10,One Fall,100,10,2011.0,Fantasy/Drama,1:30,-39,4.216965034285822
22,25,Inside Out,250,12,2011.0,Crime/Drama,1:34,3,4.725940818339814
80,88,In Darkness,10000,113,2011.0,Drama/History,2:25,8,19.194377290564812
26,20,Wrong Turn 4: Bloody Beginnings,1000,5,2011.0,Horror,1:33,-6,2.734363528521053
39,67,Extraterrestrial,1000,30,2011.0,Romance/Sci fi,1:33,28,8.379165804519056
82,20,My Way,500,15,2012.0,Documentary,2:00,-62,5.433216825139731
42,56,Treasure Island,100,9,2012.0,,,14,3.9482220388574776
85,100,Patton Oswalt: Finest Hour,1,5,2012.0,,,15,2.734363528521053
80,94,Wagner's Dream,250,16,2012.0,Documentary,1:55,14,5.656854249492381
88,90,Woody Allen: A Documentary,1000,21,2012.0,Documentary,1:53,2,6.704819013328363
31,20,Dangerous Ishhq,100,5,2012.0,Mystery and thriller,,-11,2.734363528521053
90,97,Limelight,5000,35,1952.0,Comedy/Drama,2:25,7,9.22661773178138
84,73,Jacob's Ladder,50000,66,1990.0,Horror/Mystery and thriller,1:53,-11,13.715604699135167
76,100,The Clowns,1000,18,1970.0,Fantasy,1:31,24,6.088990769440213
25,17,Destricted,1000,12,2006.0,Drama,1:56,-8,4.725940818339814
82,100,Docks of New York,500,16,1945.0,Comedy/Drama,1:03,18,5.656854249492381
90,100,The Last Command,500,19,1928.0,Romance/Drama,1:30,10,6.298266028731006
78,80,Me,500,5,1968.0,Drama,1:23,2,2.734363528521053
88,88,Underworld,1000,16,1927.0,Crime/Drama,1:20,0,5.656854249492381
55,82,S&Man,250,11,2010.0,,,27,4.475797488182033
70,94,Cinévardaphoto,100,18,2004.0,Documentary,1:36,24,6.088990769440213
54,50,Black Moon,1000,10,1975.0,Fantasy,1:40,-4,4.216965034285822
46,80,Yolanda and the Thief,250,5,1945.0,Musical,1:48,34,2.734363528521053
47,50,Patty Hearst,500,10,1988.0,Drama,1:48,3,4.216965034285822
72,87,The Wanton Contessa,500,23,1954.0,Drama,2:05,15,7.097083215743026
50,13,Far North,250,8,1988.0,Drama,1:30,-37,3.668016172818685
72,82,Pursuit of the Graf Spee,500,11,1956.0,Adventure/War,1:59,10,4.475797488182033
60,89,Bei yazi de nanhai (Taking Father Home),100,9,2006.0,,,29,3.9482220388574776
77,56,Naughty Marietta,500,9,1935.0,Comedy/Musical,1:46,-21,3.9482220388574776
78,76,Zazie in the Subway,1000,17,1960.0,Comedy,1:30,-2,5.875307153057772
86,100,Warrendale,100,5,1967.0,Documentary,1:40,14,2.734363528521053
66,71,Insignificance,500,14,1985.0,Comedy,1:50,5,5.203912939677927
82,100,There Was a Father,250,9,1942.0,Drama,1:34,18,3.9482220388574776
62,75,The Vanquished,100,8,1953.0,Drama,1:50,13,3.668016172818685
85,96,"Leon Morin, Priest",500,23,1961.0,Drama,2:10,11,7.097083215743026
86,75,The Hellstrom Chronicle,100,8,1971.0,Documentary,1:30,-11,3.668016172818685
77,95,Christmas in July,500,19,1940.0,Comedy,1:07,18,6.298266028731006
88,55,Shake Hands With the Devil,2500,11,2007.0,Drama,1:52,-33,4.475797488182033
71,78,In the City of Sylvia,500,23,2007.0,Drama,1:24,7,7.097083215743026
63,55,The Sign of the Cross,250,11,1932.0,Drama/History,1:58,-8,4.475797488182033
87,91,Forbidden Lies,1000,34,2007.0,Drama,1:44,4,9.060962294042406
75,85,Deep End,500,20,1970.0,Drama,1:30,10,6.503449126242364
58,100,Highway Patrolman,100,6,1992.0,Drama,1:31,42,3.064393493081416
86,100,The Prowler,250,18,1951.0,Mystery and thriller,1:32,14,6.088990769440213
42,28,Take Me Home Tonight,25000,114,2011.0,Romance/Drama,1:29,-14,19.300365436139025
26,44,Jackboots on Whitehall,500,18,2010.0,Comedy/Animation,,18,6.088990769440213
60,75,I Think We're Alone Now,500,8,2008.0,Documentary,1:10,15,3.668016172818685
78,100,People on Sunday,250,10,1930.0,Romance/Documentary,1:14,22,4.216965034285822
57,50,French Film,250,18,2008.0,Romance,1:28,-7,6.088990769440213
76,100,Hotel Terminus: The Life and Times of Klaus Barbie,100,7,1987.0,Documentary,4:28,24,3.374320069567275
84,85,Black Swan,100000,313,2010.0,Drama/Mystery and thriller,1:48,1,36.284004402515706
72,50,Desert Flower,2500,18,2009.0,Drama/Biography,2:04,-22,6.088990769440213
40,0,Lucky Lady,100,5,1975.0,Comedy/Drama,1:58,-40,2.734363528521053
32,45,Cactus,250,11,2008.0,Crime/Drama,,13,4.475797488182033
88,84,Prince of Broadway,500,19,2008.0,Drama,1:42,-4,6.298266028731006
80,85,Kisses,1000,53,2008.0,Drama,1:16,5,11.958381890942793
49,94,Liverpool,250,16,2008.0,Drama,1:24,45,5.656854249492381
63,27,Clubbed,1000,11,2008.0,Crime/Drama,1:35,-36,4.475797488182033
59,71,Fear Me Not,250,7,2008.0,Drama,1:35,12,3.374320069567275
72,50,Touching Home,250,14,2008.0,Drama,1:54,-22,5.203912939677927
79,84,Skin,1000,64,2008.0,Drama,1:47,5,13.454342644059432
58,63,Howl,5000,109,2010.0,Drama/Biography,1:24,5,18.76685771072333
86,65,Who Does She Think She Is?,50,17,2008.0,Documentary,1:23,-21,5.875307153057772
24,40,Pig Hunt,500,5,2008.0,Action/Horror,1:41,16,2.734363528521053
37,50,Hush,1000,8,2009.0,Mystery and thriller,1:31,13,3.668016172818685
58,43,Robin Hood,250000,251,2010.0,Action/Drama,2:19,-15,31.60793153235044
79,72,Theater of War,250,18,2008.0,Documentary,1:35,-7,6.088990769440213
40,86,Mock Up on Mu,50,7,2008.0,Comedy/Sci fi,1:54,46,3.374320069567275
80,88,Journey to Mecca in the Footsteps of Ibn Battuta,100,8,2008.0,Drama,0:40,8,3.668016172818685
74,91,Big River Man,250,33,2009.0,Documentary,1:40,17,8.893469344897873
33,29,"Carmo, Hit the Road",500,7,2008.0,Drama/Adventure,1:40,-4,3.374320069567275
69,60,Kimjongilia,250,10,2009.0,Documentary/Drama,1:16,-9,4.216965034285822
72,74,The Way Back,25000,139,2010.0,Drama,2:13,2,21.84661977512174
58,78,Shirin,1000,9,2008.0,Drama,1:32,20,3.9482220388574776
75,92,Only When I Dance,500,13,2009.0,Documentary,1:18,17,4.968377601139757
50,78,Eccentricities of a Blond Hair Girl,1000,23,2009.0,Drama,1:04,28,7.097083215743026
42,42,Dinner for Schmucks,100000,191,2010.0,Comedy,1:54,0,26.646848608438216
75,69,Letters to Father Jacob,500,13,2009.0,Drama,1:15,-6,4.968377601139757
69,100,The Makioka Sisters,500,9,1983.0,Drama,2:20,31,3.9482220388574776
47,31,The Warrior's Way,25000,42,2010.0,Western/Action,1:40,-16,10.34024446475599
76,94,Samson & Delilah,5000,52,2009.0,Romance/Drama,1:41,18,11.8168599865911
21,25,The Chameleon,500,8,2010.0,Mystery and thriller,1:46,4,3.668016172818685
62,71,Adrift,2500,14,2009.0,Drama,1:37,9,5.203912939677927
48,21,Beastly,50000,97,2011.0,Romance/Fantasy,1:26,-27,17.447464924548626
60,94,Passenger Side,500,18,2009.0,Drama,,34,6.088990769440213
41,10,Killers,100000,109,2010.0,Comedy/Action,1:40,-31,18.76685771072333
60,91,Vengeance,1000,23,2009.0,Crime/Action,1:48,31,7.097083215743026
89,78,Evangelion: 2.0 You Can (Not) Advance,2500,9,2009.0,Sci fi/Action,1:53,-11,3.9482220388574776
58,60,What's the Matter With Kansas?,100,15,2009.0,Documentary,1:30,2,5.433216825139731
48,36,Battle: Los Angeles,50000,211,2011.0,Action/Sci fi,1:56,-12,28.358061142953193
29,71,Shadow,250,7,2009.0,Horror/Mystery and thriller,1:30,42,3.374320069567275
52,73,Women Without Men,500,41,2009.0,Drama,1:35,21,10.185677243651742
16,43,Cooking With Stella,250,7,2009.0,Drama,1:44,27,3.374320069567275
30,9,Opa!,100,11,2005.0,Comedy,1:37,-21,4.475797488182033
78,85,Genius Within: The Inner Life of Glenn Gould,250,39,2009.0,Documentary/Music,1:49,7,9.872232603526719
68,50,Taqwacore: The Birth of Punk Islam,50,6,2009.0,Documentary,1:20,-18,3.064393493081416
52,85,Nénette,100,34,2010.0,Documentary,1:10,33,9.060962294042406
91,88,Araya,50,25,1959.0,Documentary,1:30,-3,7.476743906106103
55,50,Spring Fever,100,16,2009.0,Romance/Drama,1:56,-5,5.656854249492381
94,100,Teenage Paparazzo,2500,6,2010.0,Documentary,1:34,6,3.064393493081416
79,86,Me Too,2500,7,2009.0,Drama,1:43,7,3.374320069567275
88,98,Cell 211,5000,44,2009.0,Action/Drama,1:50,10,10.645300436514761
45,86,Harlan: In the Shadow of Jew Süss,100,28,2008.0,Documentary,1:39,41,8.02553087005176
67,54,The Girl Who Kicked the Hornet's Nest,25000,134,2009.0,Mystery and thriller,2:26,-13,21.35209529135088
68,67,Ward No. 6,100,6,2009.0,Drama,1:23,-1,3.064393493081416
58,86,The Refuge,10000,37,2009.0,Gay and lesbian/Drama,1:28,28,9.552698646911638
67,62,Kill the Irishman,5000,53,2011.0,Crime/Drama,1:46,-5,11.958381890942793
79,88,The Oath,250,24,2010.0,Documentary,1:30,9,7.288397090280924
76,90,The Temptation of St. Tony,250,10,2009.0,Fantasy/Drama,1:50,14,4.216965034285822
46,63,Frozen,10000,97,2010.0,Mystery and thriller/Horror,1:33,17,17.447464924548626
73,57,Kenny Chesney: Summer In 3d,500,7,2010.0,,,-16,3.374320069567275
51,78,Daddy Longlegs,500,32,2010.0,,,27,8.724061861322062
39,60,Lucky,250,5,2010.0,Documentary,1:30,21,2.734363528521053
72,72,Red,100000,211,2010.0,Comedy/Action,1:50,0,28.358061142953193
14,40,Repo Chick,100,15,2009.0,Comedy,1:32,26,5.433216825139731
36,0,The Killing Jar,500,8,2009.0,Mystery and thriller,1:30,-36,3.668016172818685
44,34,Lottery Ticket,25000,82,2010.0,Comedy,1:35,-10,15.708461709271033
26,18,Birdemic: Shock and Terror,1000,17,2008.0,Horror/Mystery and thriller,1:33,-8,5.875307153057772
44,79,The Hunter,2500,28,2010.0,Mystery and thriller,1:30,35,8.02553087005176
73,91,R,1000,11,2010.0,Crime/Drama,1:39,18,4.475797488182033
72,86,A Somewhat Gentle Man,2500,28,2010.0,Crime/Comedy,1:45,14,8.02553087005176
72,69,Brotherhood,250,13,2009.0,Drama,1:30,-3,4.968377601139757
67,79,How I Ended This Summer,1000,43,2010.0,Drama,2:04,12,10.493437610589469
80,74,When We Leave,1000,31,2010.0,Drama,1:59,-6,8.552657067536824
57,33,I Am Number Four,100000,168,2011.0,Action/Sci fi,1:50,-24,24.59338457671065
56,49,Super,10000,124,2011.0,,,-7,20.341761273786197
53,86,Psychomania,1000,7,1971.0,Horror,1:35,33,3.374320069567275
44,25,Now & Later,100,12,2007.0,Drama,1:40,-19,4.725940818339814
58,88,The Sun Behind the Clouds: Tibet's Struggle for Freedom,50,17,2010.0,Documentary/Biography,1:19,30,5.875307153057772
51,66,Two in the Wave,250,29,2009.0,Documentary,1:31,15,8.20349180691225
74,69,Limitless,100000,202,2011.0,Action/Mystery and thriller,1:45,-5,27.595902757162747
77,86,Beneath Hill 60,1000,14,2010.0,War/Action,1:57,9,5.203912939677927
32,50,The Orgasm Diaries (Brilliantlove),250,8,2010.0,,,18,3.668016172818685
73,88,Carancho,1000,48,2010.0,Crime/Romance,1:47,15,11.240244892502977
48,72,We Are What We Are,2500,47,2010.0,Horror/Drama,1:30,24,11.093310301199846
75,80,Made in Dagenham,10000,132,2010.0,Comedy/Drama,1:53,5,21.152354044022278
69,86,The Square,2500,85,2008.0,Mystery and thriller,1:45,17,16.06522559818003
21,17,The Violent Kind,500,12,2010.0,Horror,1:40,-4,4.725940818339814
75,83,Brutal Beauty: Tales of the Rose City Rollers,100,6,2010.0,Documentary,1:20,8,3.064393493081416
74,74,John Rabe,500,34,2009.0,War/Drama,2:14,0,9.060962294042406
39,46,Spoken Word,50,13,2009.0,Drama,1:56,7,4.968377601139757
24,34,Every Day,2500,32,2010.0,Comedy/Drama,1:33,10,8.724061861322062
97,85,The Two Escobars,500,13,2010.0,Drama/Crime,1:15,-12,4.968377601139757
88,91,Aftershocks (Tangshan dadizhen),2500,11,2010.0,,,3,4.475797488182033
46,71,Ticked-Off Trannies With Knives,500,7,2010.0,Mystery and thriller,1:30,25,3.374320069567275
71,83,Vision: From the Life of Hildegard von Bingen,1000,40,2009.0,Drama/Biography,1:50,12,10.029689644980788
72,77,Copacabana,250,13,2010.0,Comedy,1:47,5,4.968377601139757
18,7,Immigration Tango,100,14,2010.0,Romance,1:30,-11,5.203912939677927
100,42,GhettoPhysics: Will the Real Pimps and Hos Please Stand Up?,100,12,2010.0,Drama,1:34,-58,4.725940818339814
25,75,Primal,500,8,2010.0,Horror,1:24,50,3.668016172818685
62,100,Black Venus,250,5,2010.0,Drama,2:42,38,2.734363528521053
80,36,I Am,1000,47,2010.0,Documentary,1:16,-44,11.093310301199846
84,92,Public Speaking,1000,12,2010.0,Documentary,1:22,8,4.725940818339814
45,39,Love and Other Impossible Pursuits,10000,46,2009.0,Comedy/Drama,1:59,-6,10.945198564139895
8,10,Cuckoo,100,10,2009.0,Drama/Mystery and thriller,1:29,2,4.216965034285822
61,60,Family Guy Presents: It's a Trap,2500,5,2010.0,,,-1,2.734363528521053
89,83,Lemmy,1000,23,2010.0,Documentary,1:56,-6,7.097083215743026
86,64,Troubadours,250,11,2011.0,Documentary/Biography,1:41,-22,4.475797488182033
46,39,Beautiful Lies,500,28,2010.0,Romance/Comedy,1:45,-7,8.02553087005176
36,70,X,250,20,2011.0,Mystery and thriller,,34,6.503449126242364
70,90,Burn Notice: The Fall of Sam Axe,250,10,2011.0,Action,1:30,20,4.216965034285822
52,74,Around a Small Mountain,100,23,2009.0,Drama,1:25,22,7.097083215743026
67,40,Damn!,100,10,2011.0,Documentary,1:12,-27,4.216965034285822
68,62,39 Pounds of Love,2500,34,2005.0,Documentary,1:10,-6,9.060962294042406
25,29,Evil Toons,1000,7,1991.0,Horror,1:26,4,3.374320069567275
83,100,That Hamilton Woman,1000,11,1941.0,Drama/History,2:08,17,4.475797488182033
88,89,Devdas,10000,19,2002.0,Romance/Drama,3:01,1,6.298266028731006
91,83,As It Is in Heaven,5000,6,2004.0,Comedy/Drama,2:10,-8,3.064393493081416
78,93,The Sun,1000,42,2005.0,Drama/History,1:55,15,10.34024446475599
74,86,Homicide: The Movie,1000,7,2000.0,Drama,1:36,12,3.374320069567275
72,38,2:37,10000,8,2006.0,Drama,1:40,-34,3.668016172818685
71,53,Human Desire,500,15,1954.0,Crime/Drama,1:30,-18,5.433216825139731
30,14,Mr. Right,500,14,2006.0,Documentary,1:21,-16,5.203912939677927
86,31,A Touch of Spice,2500,13,2003.0,Comedy/Drama,1:46,-55,4.968377601139757
100,100,Edward Said: The Last Interview,250,5,2004.0,Documentary,2:00,0,2.734363528521053
89,100,Cairo Station,250,11,1958.0,Drama,1:16,11,4.475797488182033
91,96,Floating Weeds,2500,23,1959.0,Drama,1:55,5,7.097083215743026
86,85,Jack Smith and the Destruction of Atlantis,1000,20,2006.0,Documentary,1:35,-1,6.503449126242364
82,86,Son of Man,500,7,2006.0,Drama,1:26,4,3.374320069567275
76,81,Taxidermia,5000,47,2006.0,Drama,1:31,5,11.093310301199846
80,86,Colossal Youth,500,22,2006.0,Drama,2:30,6,6.9026233386080005
60,67,Alice in Wonderland,500,9,1933.0,Fantasy/Kids and family,1:16,7,3.9482220388574776
86,100,Paisan,1000,10,1946.0,Drama/War,2:14,14,4.216965034285822
91,88,Shake Hands With the Devil: The Journey of Roméo Dallaire,1000,50,2004.0,Documentary,1:31,-3,11.530715390799685
84,90,Bigger Than Life,1000,29,1956.0,Drama,1:35,6,8.20349180691225
73,89,Night Train to Munich,500,18,1940.0,Mystery and thriller,1:33,16,6.088990769440213
76,100,Nightfall,250,9,1956.0,Crime/Drama,1:18,24,3.9482220388574776
65,88,The Stepfather,2500,32,1987.0,Mystery and thriller,1:28,23,8.724061861322062
76,86,Kráska v Nesnázích (Beauty in Trouble),500,44,2006.0,,,10,10.645300436514761
43,44,Live!,10000,16,2007.0,Comedy/Drama,1:36,1,5.656854249492381
65,60,Sanshiro Sugata,1000,5,1943.0,Drama,1:19,-5,2.734363528521053
64,18,The Elephant King,250,11,2006.0,Drama,1:32,-46,4.475797488182033
47,43,My Mexican Shivah,250,7,2007.0,Comedy,1:38,-4,3.374320069567275
58,44,Vivere,250,16,2007.0,Romance/Gay and lesbian,1:37,-14,5.656854249492381
95,67,No Greater Love,500,12,1959.0,War,3:20,-28,4.725940818339814
67,100,The Tall Target,100,5,1951.0,Mystery and thriller,1:18,33,2.734363528521053
82,91,High Tide,250,11,1987.0,Comedy/Drama,1:44,9,4.475797488182033
72,66,Adam,10000,135,2009.0,Romance,1:37,-6,21.451546410907937
41,71,The Girl in the Park,1000,14,2007.0,Drama,1:49,30,5.203912939677927
64,88,The Sniper,250,8,1952.0,Mystery and thriller,1:27,24,3.668016172818685
59,55,Spiral,5000,11,2007.0,Drama/Mystery and thriller,1:30,-4,4.475797488182033
69,85,Frownland,250,20,2007.0,Comedy,1:46,16,6.503449126242364
80,100,Innocence Unprotected,100,10,1968.0,Drama,1:27,20,4.216965034285822
79,100,Man Is Not a Bird,250,6,1966.0,Drama,1:12,21,3.064393493081416
85,71,Meetings With Anna,100,7,1978.0,Drama,2:07,-14,3.374320069567275
77,60,One Deadly Summer,500,5,1983.0,Drama,2:13,-17,2.734363528521053
26,40,Cross My Heart,250,10,1987.0,Romance,1:36,14,4.216965034285822
60,80,Daughters of Wisdom,50,5,2007.0,Documentary,1:08,20,2.734363528521053
86,67,Evangerion shin gekijôban: Jo (Evangelion: 1.0 You Are (Not) Alone) (Neon Gensis: Evangelion 1.01 You Are (Not) Alone),5000,6,2007.0,,,-19,3.064393493081416
80,98,"You, the Living",5000,42,2007.0,Drama,1:35,18,10.34024446475599
80,100,Violence at Noon,250,10,1966.0,Drama,1:39,20,4.216965034285822
71,100,Variety Lights,500,11,1950.0,Drama,1:33,29,4.475797488182033
56,38,Let Them Chirp Awhile,100,8,2007.0,Comedy/Drama,1:31,-18,3.668016172818685
76,84,Import/Export,1000,32,2007.0,Drama,2:15,8,8.724061861322062
90,40,Breath,100,5,2004.0,Drama,1:47,-50,2.734363528521053
84,86,The Lineup,250,7,1958.0,Crime/Drama,1:26,2,3.374320069567275
93,100,Make Way for Tomorrow,500,19,1937.0,Drama,1:34,7,6.298266028731006
79,88,The Ister,100,8,2004.0,Documentary,3:09,9,3.668016172818685
61,85,Nightwatching,1000,27,2007.0,Drama/Mystery and thriller,2:14,24,7.845169885845621
86,63,Bliss,2500,24,2007.0,Drama,2:06,-23,7.288397090280924
85,43,Paraiso Travel,2500,7,2007.0,Drama/Romance,1:50,-42,3.374320069567275
59,38,The Time Traveler's Wife,250000,159,2009.0,Romance/Sci fi,1:47,-21,23.761464418909437
36,6,The Accidental Husband,100000,17,2008.0,Romance,1:30,-30,5.875307153057772
52,70,Fermat's Room,1000,27,2007.0,Mystery and thriller,1:30,18,7.845169885845621
85,100,Scandal Sheet,100,5,1952.0,Crime/Drama,1:22,15,2.734363528521053
64,20,Dog Eat Dog,1000,5,2008.0,Mystery and thriller,1:42,-44,2.734363528521053
82,100,Murder by Contract,100,12,1958.0,Crime/Drama,1:21,18,4.725940818339814
51,100,American Son,500,13,2008.0,Drama,1:25,49,4.968377601139757
51,33,Máncora,250,6,2008.0,Drama,1:40,-18,3.064393493081416
16,20,Pretty Bird,250,5,2008.0,Comedy/Drama,1:37,4,2.734363528521053
56,94,Secrecy,250,17,2008.0,Documentary,1:25,38,5.875307153057772
50,70,Sleep Dealer,100000,33,2008.0,Sci fi,1:29,20,8.893469344897873
59,66,The Yellow Handkerchief,10000,50,2008.0,Romance/Drama,1:36,7,11.530715390799685
26,43,Crooked Lake,100,7,2008.0,Mystery and thriller/Drama,1:27,17,3.374320069567275
50,43,The Reflecting Pool,100,7,2007.0,Drama,,-7,3.374320069567275
69,75,Dillinger Is Dead,250,12,1969.0,Crime/Drama,1:30,6,4.725940818339814
71,67,Where God Left His Shoes,250,12,2007.0,Other/Drama,1:50,-4,4.725940818339814
67,80,Dolphins and Whales: Tribes of the Ocean,250,5,2008.0,Adventure/Documentary,0:42,13,2.734363528521053
55,51,Alice in Wonderland,250000,278,2010.0,Fantasy/Kids and family,1:49,-4,33.69209351576394
98,89,The English Surgeon,2500,19,2007.0,Documentary,1:34,-9,6.298266028731006
81,79,Owl and the Sparrow,500,19,2007.0,Drama,1:37,-2,6.298266028731006
55,93,Major Barbara,100,15,1941.0,Comedy,2:15,38,5.433216825139731
66,78,Quiet Chaos,2500,37,2008.0,Drama/Romance,1:45,12,9.552698646911638
50,100,The New Year Parade,100,5,2008.0,Drama,1:25,50,2.734363528521053
24,44,The Box,250000,156,2009.0,Mystery and thriller/Sci fi,1:53,20,23.480258506151625
48,59,Eleven Minutes,10000,27,2008.0,Documentary/Gay and lesbian,1:43,11,7.845169885845621
54,80,Not Your Typical Bigfoot Movie,100,5,2008.0,Documentary,1:03,26,2.734363528521053
83,80,Throw Down Your Heart,100,25,2008.0,Documentary,1:37,-3,7.476743906106103
40,83,Left Bank,500,6,2008.0,Mystery and thriller/Drama,1:42,43,3.064393493081416
49,60,Road to Fame,500,10,2008.0,Comedy,1:46,11,4.216965034285822
35,50,Donovan's Brain,100,12,1953.0,Sci fi,1:23,15,4.725940818339814
50,43,Androcles and the Lion,50,7,1952.0,Comedy,1:38,-7,3.374320069567275
78,84,Trumbo,25000,55,2007.0,Documentary,1:36,6,12.238457412731087
67,100,"I, You, She, He",250,7,1974.0,Drama,1:30,33,3.374320069567275
20,11,The Cry of the Owl,5000,9,2009.0,Drama/Mystery and thriller,1:40,-9,3.9482220388574776
30,89,The Rashevski Tango,50,9,2003.0,Romance,1:30,59,3.9482220388574776
56,20,Duska (Dushka),100,5,2007.0,,,-36,2.734363528521053
30,80,Clive Barker's Book of Blood,1000,5,2008.0,Mystery and thriller/Drama,1:40,50,2.734363528521053
72,100,Take Out,250,23,2004.0,Drama,1:30,28,7.097083215743026
72,77,Three Monkeys,2500,62,2008.0,Drama,1:49,5,13.190000315557024
69,96,Tulpan,2500,71,2008.0,Comedy/Drama,1:40,27,14.356099772615265
100,56,As Seen Through These Eyes,50,9,2008.0,Documentary,1:10,-44,3.9482220388574776
48,44,The Amazing Truth About Queen Raquela,100,9,2008.0,Drama,1:20,-4,3.9482220388574776
75,90,The Messenger,10000,163,2009.0,Romance/Drama,1:52,15,24.13333007004028
83,100,They Killed Sister Dorothy,100,8,2008.0,Documentary,1:34,17,3.668016172818685
89,90,Moon,100000,194,2009.0,Mystery and thriller/Sci fi,1:37,1,26.907669282564235
42,60,Second Skin,250,5,2008.0,Documentary,1:34,18,2.734363528521053
67,33,Twentieth Century Boys,1000,12,2008.0,Mystery and thriller/Sci fi,2:22,-34,4.725940818339814
57,40,Passchendaele,2500,15,2008.0,History/War,,-17,5.433216825139731
49,44,Helen,500,9,2009.0,Drama,2:00,-5,3.9482220388574776
60,14,The Ugly Truth,250000,175,2009.0,Romance,1:35,-46,25.228927017388646
37,27,The Goods: Live Hard. Sell Hard.,50000,103,2009.0,Comedy,1:29,-10,18.1143712989759
36,100,Sex Addict,1000,5,2008.0,,,64,2.734363528521053
60,84,Tony Manero,5000,38,2008.0,Drama,1:38,24,9.713254050808038
53,48,Everybody's Fine,50000,143,2009.0,Comedy/Drama,1:35,-5,22.237451987521194
62,64,Brothers,100000,159,2009.0,Drama/Mystery and thriller,1:44,2,23.761464418909437
45,25,Ciao,500,12,2008.0,Gay and lesbian/Drama,1:27,-20,4.725940818339814
50,56,Enlighten Up!,5000,39,2008.0,Documentary,1:22,6,9.872232603526719
39,51,The Men Who Stare at Goats,100000,217,2009.0,Comedy,1:33,12,28.8594023911159
55,73,$9.99,5000,55,2008.0,Fantasy/Animation,1:18,18,12.238457412731087
48,40,Familiar Strangers,250,5,2008.0,Comedy/Drama,1:27,-8,2.734363528521053
65,85,Rumba,500,26,2008.0,Comedy,1:17,20,7.662285721192069
84,90,Everlasting Moments,2500,105,2008.0,Drama,2:11,6,18.333412575379587
81,93,The Maid,2500,75,2009.0,Drama,1:36,12,14.856389929209026
46,91,Fire and Ice,100,11,1961.0,Drama,1:44,45,4.475797488182033
36,50,Antarctica,100,12,2008.0,Gay and lesbian/Romance,1:50,14,4.725940818339814
90,100,Still Walking,2500,64,2008.0,Drama,1:54,10,13.454342644059432
65,97,35 Shots of Rum,1000,66,2008.0,Drama,1:40,32,13.715604699135167
48,50,Frontier of Dawn,250,6,2008.0,Drama,1:47,2,3.064393493081416
72,82,A Woman in Berlin,50000,33,2008.0,Drama/War,2:11,10,8.893469344897873
45,65,Made in Jamaica,100,17,2006.0,Documentary,2:00,20,5.875307153057772
62,83,Disgrace,1000,60,2008.0,Drama,1:58,21,12.922440211617326
32,25,Sorority Row,250000,81,2009.0,Mystery and thriller/Horror,1:41,-7,15.588457268119896
87,85,The Girl With the Dragon Tattoo,50000,191,2009.0,Crime/Drama,2:32,-2,26.646848608438216
71,89,The Exiles,250,38,1961.0,Drama,1:20,18,9.713254050808038
40,50,Sodom and Gomorrah,100,8,1963.0,Drama/History,2:34,10,3.668016172818685
67,75,The Vanished Empire,100,12,2008.0,Drama,1:45,8,4.725940818339814
56,69,Dead Snow,10000,77,2009.0,Comedy/Horror,1:28,13,15.102773291691431
40,71,The Killing Room,2500,7,2009.0,Mystery and thriller/Horror,1:33,31,3.374320069567275
72,50,Mission Street Rhapsody,5000,26,2009.0,Gay and lesbian/Drama,1:57,-22,7.662285721192069
76,83,Nollywood Babylon,100,6,2008.0,Documentary,1:14,7,3.064393493081416
75,94,The Wedding Song,250,16,2008.0,Drama/War,1:40,19,5.656854249492381
84,92,Old Partner,100,12,2009.0,Documentary,,8,4.725940818339814
81,92,"Precious: Based on the Novel ""Push"" by Sapphire",100000,238,2009.0,Drama,1:49,11,30.574586918379627
72,95,Katalin Varga,500,21,2009.0,Crime/Drama,1:22,23,6.704819013328363
40,38,Rage,250,8,2009.0,Drama,1:39,-2,3.668016172818685
27,29,Women in Trouble,1000,24,2009.0,Drama/Comedy,1:35,2,7.288397090280924
32,43,New Town Killers,500,21,2008.0,Drama,1:37,11,6.704819013328363
43,80,High Life,500,5,2009.0,Comedy/Crime,1:20,37,2.734363528521053
36,7,Beyond a Reasonable Doubt,10000,28,2009.0,Crime/Drama,1:45,-29,8.02553087005176
59,0,12 in a Box,2500,6,2006.0,Comedy,1:33,-59,3.064393493081416
37,89,Inspector Bellamy,1000,27,2009.0,Crime/Drama,1:50,52,7.845169885845621
43,76,The Girl on the Train,1000,62,2009.0,Drama,1:45,33,13.190000315557024
21,0,C Me Dance,500,6,2009.0,Drama/Mystery and thriller,1:29,-21,3.064393493081416
63,64,TiMER,2500,14,2009.0,Romance,1:39,1,5.203912939677927
48,83,Daytime Drinking,1000,6,2008.0,Comedy/Drama,1:56,35,3.064393493081416
79,79,Chasing a Dream,1000,24,2009.0,Drama,1:30,0,7.288397090280924
32,58,Greek Pete,100,12,2009.0,Drama,1:12,26,4.725940818339814
59,78,Ichi,500,9,2008.0,Action,2:00,19,3.9482220388574776
56,20,Santa Buddies,1000,5,2009.0,Kids and family/Other,1:28,-36,2.734363528521053
82,93,"Yoo-Hoo, Mrs. Goldberg",1000,68,2009.0,Documentary,1:32,11,13.973914138485368
65,71,Kinatay,250,7,2009.0,Crime/Drama,1:45,6,3.374320069567275
86,87,Welcome,1000,30,2009.0,Drama,1:49,1,8.379165804519056
57,60,Shank,500,5,2009.0,Drama,1:29,3,2.734363528521053
40,33,40 Is the New 20,1,6,2009.0,Comedy,1:33,-7,3.064393493081416
57,50,A Boy Called Dad,100,10,2009.0,Drama,1:20,-7,4.216965034285822
72,25,Falling Awake,100,8,2009.0,Drama,1:50,-47,3.668016172818685
65,97,Sweetgrass,500,64,2009.0,Documentary,1:42,32,13.454342644059432
78,100,Inside Planet Earth,50,13,2008.0,,,22,4.968377601139757
58,71,Endgame,500,7,2009.0,Drama,1:49,13,3.374320069567275
35,68,The Firm,1000,25,2009.0,Drama,1:30,33,7.476743906106103
74,100,Love Affair; Or the Case of the Missing Switchboard Operator,250,10,1967.0,Comedy/Drama,1:15,26,4.216965034285822
39,0,Stolen,2500,20,2009.0,Mystery and thriller,1:37,-39,6.503449126242364
62,60,Will Ferrell: You're Welcome America - A Final Night with George W Bush,1000,5,2009.0,,,-2,2.734363528521053
68,93,Lourdes,1000,43,2009.0,Drama,1:39,25,10.493437610589469
57,46,Ten9eight,50,13,2009.0,Documentary,1:25,-11,4.968377601139757
55,22,"Oh, My God!!",1000,18,2009.0,Comedy/Drama,2:01,-33,6.088990769440213
90,96,The Most Dangerous Man in America: Daniel Ellsberg and the Pentagon Papers,1000,56,2009.0,Documentary,1:32,6,12.377060587439436
23,20,Do Knot Disturb,250,5,2009.0,Comedy/Musical,2:06,-3,2.734363528521053
73,60,Little Nicholas,1000,10,2009.0,Comedy,1:31,-13,4.216965034285822
100,81,Prima Ballerina,1,26,2009.0,,,-19,7.662285721192069
67,50,Paa,1000,8,2009.0,Drama,2:13,-17,3.668016172818685
33,13,The Final,1000,8,2010.0,Mystery and thriller/Drama,,-20,3.668016172818685
67,57,Princess,1000,14,2006.0,,,-10,5.203912939677927
49,10,Malice in Wonderland,500,10,2009.0,Drama/Crime,1:27,-39,4.216965034285822
47,79,Bluebeard,500,38,2009.0,Mystery and thriller/Fantasy,1:20,32,9.713254050808038
46,54,I Love You Too,1000,13,2010.0,Comedy,1:47,8,4.968377601139757
94,90,Rush: Beyond the Lighted Stage,1000,10,2010.0,Music/Documentary,1:47,-4,4.216965034285822
13,0,Pimp,100,13,2010.0,Mystery and thriller,1:31,-13,4.968377601139757
81,22,Alice,100,9,2010.0,,,-59,3.9482220388574776
