audience_percent,critic_percent,poster_src,title,audience_number,critic_number,release_year,genre,runtime,differential
90,42,https://resizing.flixster.com/2IjhDnb7e-4mqiE6tXecpG9OF_4=/206x305/v2/https://flxt.tmsimg.com/assets/p9161_p_v10_aa.jpg,Rad,5000,12,1986.0,Adventure,0 days 01:31:00.000000000,-48
81,100,https://resizing.flixster.com/MNGqrcUR4orSU7Fh9l3vm1i8v2A=/206x305/v2/https://resizing.flixster.com/1s3bwmA72HB2vLK1zacQCa2NKWM=/ems.ZW1zLXByZC1hc3NldHMvbW92aWVzLzdjNzk1N2ZkLTc3OTQtNDlhZC1hZTA0LWNjNjQxNjc3Yjg5MS53ZWJw,Jazz on a Summer's Day,500,29,1959.0,Documentary/Music,0 days 01:25:00.000000000,19
91,89,,The Trial of the Chicago 7,1000,312,2020.0,History/Drama,0 days 02:09:00.000000000,-2
42,100,https://resizing.flixster.com/NFH6G-E-3Ggay6uJmKG3lqVYvlQ=/206x305/v2/https://flxt.tmsimg.com/assets/p101431_p_v10_aa.jpg,Buddies,1,8,1985.0,Gay and lesbian/Drama,0 days 01:21:00.000000000,58
36,50,,Lost Girls & Love Hotels,50,24,2020.0,Romance/Drama,0 days 01:37:00.000000000,14
56,89,,The Weekend,5000,154,2013.0,Comedy/Drama,0 days 01:33:00.000000000,33
71,83,,Console Wars,1,12,2020.0,Documentary,0 days 01:32:00.000000000,12
89,100,,The American Nurse,100,11,2013.0,Documentary,0 days 01:21:00.000000000,11
55,82,,Hill of Freedom,50,17,2014.0,Drama,0 days 01:06:00.000000000,27
0,25,,The Price of Desire,1,12,2015.0,Drama,0 days 01:48:00.000000000,25
85,85,,Sweet Bean,250,60,2015.0,Comedy/Drama,0 days 01:53:00.000000000,0
79,64,https://resizing.flixster.com/1KOJ-SIyu8pCMuD-i0N9F8cfFoU=/206x305/v2/https://resizing.flixster.com/5Yoa7sjCU8hYR6_XkPp90WgkkQs=/ems.ZW1zLXByZC1hc3NldHMvbW92aWVzL2Y0Yzc5NzEzLWI4OGQtNDNiMS04ZGYyLWYzZmQyZTZmOGRkNS5qcGc=,Animal Crackers,250,22,2017.0,Animation/Adventure,0 days 01:34:00.000000000,-15
54,47,,SCOOB!,1000,148,2020.0,Animation/Comedy,0 days 01:34:00.000000000,-7
53,67,https://resizing.flixster.com/5ZLmvLCHBv9DH5qbV4lg5C-uIVo=/206x305/v2/https://resizing.flixster.com/mWaMsrPZT1L1R88MqFOUijmBl3k=/ems.ZW1zLXByZC1hc3NldHMvbW92aWVzLzE4MTMwNmQ2LWZhMWMtNDRlMy05YjBlLTEzYWU0OTczZmU4ZC5qcGc=,The SpongeBob Movie: Sponge on the Run,500,69,2020.0,Animation/Comedy,0 days 01:31:00.000000000,14
91,97,,Sound of Metal,1000,234,2019.0,Music/Drama,0 days 02:00:00.000000000,6
22,20,,Viena and the Fantomes,1,5,2020.0,Romance/Drama,0 days 01:45:00.000000000,-2
52,94,,Yourself and Yours,50,32,2016.0,Drama,0 days 01:26:00.000000000,42
49,72,https://resizing.flixster.com/NYYqEd75tTym74goxixQDNIAEr0=/206x305/v2/https://resizing.flixster.com/PCBQuVsstzrvxgYD7WoPnpyFrNk=/ems.ZW1zLXByZC1hc3NldHMvbW92aWVzL2U4YjZlZGM4LTA1MWEtNDU0MS1iN2Q3LWY0MWM4MjYxOWU3OS53ZWJw,Mulan,10000,307,2020.0,Action/Adventure,0 days 01:56:00.000000000,23
51,87,,On the Rocks,500,264,2020.0,Comedy,0 days 01:36:00.000000000,36
95,86,,American Street Kid,1,7,2016.0,Documentary,0 days 01:44:00.000000000,-9
28,57,,Game of Death,50,30,2017.0,Horror/Mystery and thriller,0 days 01:13:00.000000000,29
66,70,https://resizing.flixster.com/EEfNnFet2kMqeqcico9wFbllteM=/206x305/v2/https://resizing.flixster.com/w1dlNrJWOhbqHAC2v--lCXLav4Y=/ems.ZW1zLXByZC1hc3NldHMvbW92aWVzLzA4ZWVjYWIyLTBiZTItNGFlOS04MDJiLWIzNzE0NTlmNGMwYi53ZWJw,The One and Only Ivan,250,116,2020.0,Comedy/Kids and family,0 days 01:33:00.000000000,4
48,38,https://resizing.flixster.com/4qs69qx89Ge8YtE5IWEFEQhfnC0=/206x305/v2/https://resizing.flixster.com/5DgPlNmfmvScgeOZ3XSMT_l_vEo=/ems.ZW1zLXByZC1hc3NldHMvbW92aWVzL2Y1OGQwYWEyLWI2NTEtNDE3MS1iMDJiLThhNjU0MDQ5MDRjMi53ZWJw,Magic Camp,100,13,2018.0,Comedy/Kids and family,,-10
57,50,,That Good Night,1,22,2017.0,Drama,0 days 01:32:00.000000000,-7
83,98,,Ryuichi Sakamoto: Coda,100,47,2017.0,Documentary/Music,0 days 01:41:00.000000000,15
33,59,https://resizing.flixster.com/TgnSjnCJYYFuYU32mQLSf42Iia4=/206x305/v2/https://resizing.flixster.com/WaFGSA0aCqVCESOKEQ_VaotVle0=/ems.ZW1zLXByZC1hc3NldHMvbW92aWVzLzMwNmM2MjYxLTE1Y2EtNDgyMy1hOWI4LTUwZTk1Yzg1YmIxYi53ZWJw,Caniba,1,32,2017.0,Documentary,0 days 01:30:00.000000000,26
19,8,,Artemis Fowl,1000,171,2020.0,Fantasy/Adventure,0 days 01:33:00.000000000,-11
83,58,,Valley Girl,250,52,2020.0,Romance/Musical,0 days 01:43:00.000000000,-25
29,57,,Ravage,1,7,2019.0,Action/Horror,0 days 01:17:00.000000000,28
76,78,,The More You Ignore Me,1,9,2018.0,Comedy,0 days 01:38:00.000000000,2
97,50,,Burden,1,72,2018.0,Drama,0 days 02:09:00.000000000,-47
53,33,,The Devil Has a Name,1,24,2020.0,Comedy/Drama,0 days 01:37:00.000000000,-20
27,13,,MILF,50,8,2018.0,,,-14
75,79,,Greyhound,1000,224,2020.0,Drama/History,0 days 01:32:00.000000000,4
78,93,,Howard,1,44,2018.0,,,15
69,82,,Bill & Ted Face the Music,2500,256,2020.0,Comedy/Fantasy,0 days 01:31:00.000000000,13
61,89,,Eva and Lola,1,19,2010.0,Romance/Drama,0 days 01:27:00.000000000,28
80,87,https://resizing.flixster.com/sFyJYwLaHzYZRryAdTVo5fH53WM=/206x305/v2/https://resizing.flixster.com/FcQZscqQPrS-VI2KbIYtzMNWpuo=/ems.ZW1zLXByZC1hc3NldHMvbW92aWVzL2EyMGI3NzNiLWU3ZmYtNGZjMy1hMjEwLWRmNjVhMDlmOWY1OC5qcGc=,The Dead and the Others,1,15,2018.0,Documentary,0 days 01:54:00.000000000,7
65,100,,Wolfman's Got Nards,50,22,2018.0,Documentary/Horror,0 days 01:31:00.000000000,35
68,100,,Crystal Swan,1,13,2018.0,Drama,0 days 01:33:00.000000000,32
56,88,,What She Said: The Art of Pauline Kael,1,67,2018.0,Documentary,0 days 01:35:00.000000000,32
66,95,,The Ghost of Peter Sellers,1,43,2018.0,Documentary,0 days 01:33:00.000000000,29
33,43,,The Lie,250,74,2018.0,Mystery and thriller,0 days 01:37:00.000000000,10
33,45,,Open 24 Hours,50,11,2018.0,Horror,0 days 01:37:00.000000000,12
53,60,https://resizing.flixster.com/CkOAd-lLJmI87hkHmSGUN7ZyMus=/206x305/v2/https://resizing.flixster.com/vvMU_p_lwq-seynxyg8xkXRgM5E=/ems.ZW1zLXByZC1hc3NldHMvbW92aWVzL2I0NTNjOTJjLWQ3NDMtNDc4ZS1iZDdmLTY0YzQwODYxNWE0MC53ZWJw,Daddy's Girl,1,5,2018.0,Horror,0 days 01:21:00.000000000,7
85,60,https://resizing.flixster.com/7jX_5aVDp-kiW0uLuizEI9H25KA=/206x305/v2/https://resizing.flixster.com/hlywudjZq87lHFnwqSxAW1S39ek=/ems.ZW1zLXByZC1hc3NldHMvbW92aWVzL2MzYzkxM2EzLTAyYjgtNGMzMC1iYjdhLTEyZjIxZTZmY2MyMS53ZWJw,You Go To My Head,1,10,2017.0,Romance/Fantasy,0 days 01:56:00.000000000,-25
100,100,,Small Group,1,5,2018.0,Drama/Comedy,0 days 02:01:00.000000000,0
67,100,,House of Hummingbird,50,46,2018.0,Drama,0 days 02:18:00.000000000,33
68,82,,Sometimes Always Never,50,95,2018.0,Comedy/Drama,0 days 01:31:00.000000000,14
76,89,,Benjamin,50,38,2018.0,Romance/Gay and lesbian,0 days 01:25:00.000000000,13
72,89,,Jingle Jangle: A Christmas Journey,500,73,2020.0,Musical/Fantasy,0 days 02:00:00.000000000,17
64,62,,The Informer,100,53,2019.0,Crime/Drama,0 days 01:53:00.000000000,-2
58,100,,Bellingcat: Truth in a Post-Truth World,1,6,2018.0,Documentary,0 days 01:35:00.000000000,42
73,68,https://resizing.flixster.com/fYRss-k494AcbUsCl-mjUdDe_f8=/206x305/v2/https://resizing.flixster.com/Cl4zE-FQmZ9ajTi0EA2hNAfwpzc=/ems.ZW1zLXByZC1hc3NldHMvbW92aWVzL2RjMTc5N2U3LWY0NTctNGRkZC1iYzNmLTIyZWFmZmM4ZjZlNi53ZWJw,Fisherman's Friends,100,56,2019.0,Comedy/Drama,0 days 01:52:00.000000000,-5
50,50,,StarDog and TurboCat,1,10,2019.0,Comedy/Animation,0 days 01:31:00.000000000,0
44,61,,Radioactive,100,148,2019.0,Biography/History,0 days 01:43:00.000000000,17
92,97,https://resizing.flixster.com/51Q8Wm5zvrn0VcEv7fRhuf6DXgY=/206x305/v2/https://resizing.flixster.com/mxWCkewT0pWYekfI7x9Y8QKPh14=/ems.ZW1zLXByZC1hc3NldHMvbW92aWVzLzVlNDRiYTk4LTNmYjAtNDdlYi04ZGU0LTZiYjU3ODVjNWRkNi53ZWJw,Knives Out,25000,462,2019.0,Crime/Comedy,0 days 02:10:00.000000000,5
83,97,,Midnight Family,50,72,2019.0,Crime/Documentary,0 days 01:21:00.000000000,14
64,98,,The Last Tree,50,43,2019.0,Drama,0 days 01:40:00.000000000,34
38,100,,Cane River,1,16,1982.0,Romance,0 days 01:30:00.000000000,62
57,80,,Koko-di Koko-da,50,61,2019.0,Comedy/Horror,0 days 01:26:00.000000000,23
69,93,,Premature,50,55,2019.0,Drama/Romance,0 days 01:26:00.000000000,24
69,93,https://resizing.flixster.com/pnY74QluhcxB9tUvDYz67g5EEq0=/206x305/v2/https://resizing.flixster.com/XVeDxIZK3g7k3_ZhGAjgVZE0y6o=/ems.ZW1zLXByZC1hc3NldHMvbW92aWVzLzBjMmI5M2Q5LTExZjItNGRjNi1hYWIwLWJjMDI4NTU5ZjIzZi53ZWJw,We Are Little Zombies,1,54,2019.0,Drama,0 days 02:00:00.000000000,24
52,33,,The Sunlit Night,1,54,2019.0,Romance,0 days 01:49:00.000000000,-19
56,98,,Fourteen,1,46,2019.0,Drama,0 days 01:34:00.000000000,42
60,77,,Judy & Punch,50,138,2019.0,Comedy,0 days 01:45:00.000000000,17
50,65,,The Lovebirds,500,172,2020.0,Romance,0 days 01:26:00.000000000,15
78,98,,Beats,50,62,2019.0,Comedy/Drama,0 days 01:41:00.000000000,20
78,100,https://resizing.flixster.com/Iz2qpBcoJeFg1M8KgMpwvHhs0ss=/206x305/v2/https://resizing.flixster.com/q6Uw6Mb3AdgwqwO9S2GefvCwHEk=/ems.ZW1zLXByZC1hc3NldHMvbW92aWVzLzRkNWZjZTczLWVhMmQtNGEyYS04ZjFiLWZmMTIyOTdjYWI2NS53ZWJw,Take Me Somewhere Nice,1,14,2019.0,Drama,0 days 01:31:00.000000000,22
66,92,,The Vast of Night,1000,243,2019.0,Fantasy/Mystery and thriller,0 days 01:30:00.000000000,26
71,63,,Skyman,1,16,2020.0,Sci fi,0 days 01:33:00.000000000,-8
33,48,,Roald Dahl's The Witches,500,176,2020.0,Comedy/Fantasy,0 days 01:45:00.000000000,15
79,89,https://resizing.flixster.com/74bEY_E6DtGOGncqj2w1Li83MpM=/206x305/v2/https://resizing.flixster.com/eY3UvPSECQJ7Lhl0jvYgmWevI2s=/ems.ZW1zLXByZC1hc3NldHMvbW92aWVzLzU3YzM2M2Q0LTMwNmQtNGFhZS1iZDVhLTg1NzdiY2Q4MTgyOC53ZWJw,Zombie for Sale,1,28,2019.0,,,10
49,85,https://resizing.flixster.com/-nfM5y0uD09w31i-3VlJOoCNo9k=/206x305/v2/https://resizing.flixster.com/0fmyjEbdnMeGCmsB3Yq4K5moRNE=/ems.ZW1zLXByZC1hc3NldHMvbW92aWVzLzk0MTMwZDZlLTdlYTEtNGU4My05OWMwLTBmODQwOTQyNTMxNy5qcGc=,Parallel,1,13,2018.0,Drama/Mystery and thriller,0 days 01:44:00.000000000,36
97,97,,Buoyancy,50,34,2019.0,Drama,0 days 01:35:00.000000000,0
62,74,,Out Stealing Horses,1,35,2019.0,Drama,0 days 02:03:00.000000000,12
88,69,,Babysplitters,100,16,2019.0,Comedy,0 days 01:59:00.000000000,-19
81,94,,Nomadland,250,359,2020.0,Drama,0 days 01:48:00.000000000,13
100,96,,Creem: America's Only Rock 'n' Roll Magazine,1,28,2019.0,Documentary/Music,0 days 01:15:00.000000000,-4
66,87,https://resizing.flixster.com/5UKns_446AxYwfMkv6TUH4BDnyU=/206x305/v2/https://resizing.flixster.com/ChDwL0th3Ego-lS1S9AwUN4tvw8=/ems.ZW1zLXByZC1hc3NldHMvbW92aWVzLzhjMjk5OWI0LWU2ODAtNGViNS05NzY3LWZkOGY1YzRiNzcxMi53ZWJw,Get Duked!,250,92,2019.0,Comedy/Mystery and thriller,0 days 01:27:00.000000000,21
42,100,,2040,50,33,2019.0,Documentary/Drama,0 days 01:32:00.000000000,58
35,100,https://resizing.flixster.com/YcfPhhe3JCtDeSBEafwncJUoNFg=/206x305/v2/https://resizing.flixster.com/CCwlRSEVCDFxWOfWi9RfsSafb64=/ems.ZW1zLXByZC1hc3NldHMvbW92aWVzL2QxYzE1YTlmLTNkY2YtNDUwZC1hOGRkLTYwMGY2NTdiOTQwOS5qcGc=,"J.R. ""Bob"" Dobbs & The Church of the SubGenius",1,12,2019.0,Documentary/Comedy,0 days 01:20:00.000000000,65
40,49,https://resizing.flixster.com/lSSrnkvhkBGx0p5GhhByWnQ1W44=/206x305/v2/https://resizing.flixster.com/fBlNrmHSM2bRtDKmorWb-5SAgZE=/ems.ZW1zLXByZC1hc3NldHMvbW92aWVzL2I4OTc1ZjJhLTQzN2UtNGVkOC1hNDczLTk4ZjI4MTQ3YzUzZi5qcGc=,Coming 2 America,2500,232,2021.0,Comedy,0 days 01:49:00.000000000,9
71,77,,Eternal Beauty,1,53,2019.0,Romance/Comedy,0 days 01:35:00.000000000,6
80,57,,Ms. White Light,1,7,2019.0,Comedy,0 days 01:37:00.000000000,-23
67,93,,"Yes, God, Yes",500,123,2019.0,Comedy,0 days 01:18:00.000000000,26
56,70,,Olympic Dreams,1,47,2019.0,Romance,0 days 01:23:00.000000000,14
39,80,https://resizing.flixster.com/UE53UCuU0Nvb2Mu6TaBQ1MrLjJo=/206x305/v2/https://resizing.flixster.com/VT-HQQcKtLTUqX_KbCLaBG3H_DY=/ems.ZW1zLXByZC1hc3NldHMvbW92aWVzLzU0OGJhNTE0LTU4MDYtNDAwYi04ZGNlLWZhOWU1NTYyZDZjNi53ZWJw,Porno,50,50,2019.0,Comedy/Horror,0 days 01:38:00.000000000,41
88,92,,The Garden Left Behind,100,64,2019.0,Drama,0 days 01:28:00.000000000,4
95,88,,Princess of the Row,1,17,2019.0,Drama,0 days 01:25:00.000000000,-7
33,63,https://resizing.flixster.com/eM0hUeNov4N5rbTL_E2YgNJwlog=/206x305/v2/https://resizing.flixster.com/RBrfTvnHcdHNjt8LgOadhmLMHg8=/ems.ZW1zLXByZC1hc3NldHMvbW92aWVzLzRlMmE2ZmU2LWY1NDQtNGVkYi04MjhmLTJmMGVjNDY0NmZkNS5qcGc=,Guest Artist,1,8,2019.0,Drama,0 days 01:14:00.000000000,30
60,75,,CRSHD,1,20,2019.0,Comedy,0 days 01:20:00.000000000,15
60,64,https://resizing.flixster.com/6_tWNwnIT1VZMvlT9sE99OY9PW4=/206x305/v2/https://resizing.flixster.com/hFJR0P5oj99xvtwBdW0zygJt3s8=/ems.ZW1zLXByZC1hc3NldHMvbW92aWVzLzBiZTU3NjQ0LTQ3ZWYtNDRlOC1hNDk4LWQzMjk5MzJiNDFlMS5qcGc=,Clementine,1,50,2019.0,Drama,0 days 01:34:00.000000000,4
85,91,/assets/pizza-pie/images/poster_default.c8c896e70c3.gif,The Short History of the Long Road,50,35,2019.0,Drama,0 days 01:30:00.000000000,6
43,91,,The Emoji Story,1,11,2019.0,Documentary,0 days 01:21:00.000000000,48
88,90,,Promising Young Woman,500,345,2020.0,Mystery and thriller/Comedy,0 days 01:53:00.000000000,2
97,100,,Rewind,50,44,2019.0,Documentary/Drama,0 days 01:26:00.000000000,3
63,89,,You Don't Nomi,1,79,2019.0,Documentary,0 days 01:32:00.000000000,26
38,48,https://resizing.flixster.com/P2eikLmZgqqXgQw2taLRULwOEog=/206x305/v2/https://resizing.flixster.com/88ROGIPaGF0h8d6BrQRnHAdCZUU=/ems.ZW1zLXByZC1hc3NldHMvbW92aWVzLzg2ZGFkZWQyLTIyYTYtNGE4OS1iZDNlLTc4NmY5YjQwNGE4Zi53ZWJw,My Spy,1000,122,2020.0,Comedy/Action,0 days 01:39:00.000000000,10
70,95,,Lucky Grandma,50,61,2019.0,Drama,0 days 01:40:00.000000000,25
89,81,,All I Can Say,1,16,2019.0,Documentary,0 days 01:42:00.000000000,-8
47,92,/assets/pizza-pie/images/poster_default.c8c896e70c3.gif,Nomad: In the Footsteps of Bruce Chatwin,1,38,2019.0,Documentary,0 days 01:29:00.000000000,45
88,100,https://resizing.flixster.com/XqlZ7FG2Pzz7Ua2UXwTzzuEk_X0=/206x305/v2/https://resizing.flixster.com/FZ9GTvvgeM2-y6ePCuW_5kDn1Sc=/ems.ZW1zLXByZC1hc3NldHMvbW92aWVzLzQ0YzJhYjFlLTAwMDUtNGZlOC1hZmE0LWZiOWNiZjAxM2YyOS5qcGc=,Terra Willy,1,11,2019.0,Comedy/Sci fi,0 days 01:29:00.000000000,12
71,17,,Buddy Games,1,24,2019.0,Comedy,0 days 01:30:00.000000000,-54
33,56,,Sibyl,1,52,2019.0,Comedy/Drama,0 days 01:40:00.000000000,23
50,95,https://resizing.flixster.com/G_7Um8lleImRiQt9ntRWOQhlLIk=/206x305/v2/https://resizing.flixster.com/C2dlv64YzGkiOfjlOXUklyBqOJI=/ems.ZW1zLXByZC1hc3NldHMvbW92aWVzLzI3NzYzNjg4LTBmYzAtNDczMS1iMWFmLWNkNTk1ZmRmMGYwYS53ZWJw,An Easy Girl,50,22,2019.0,Comedy/Drama,0 days 01:28:00.000000000,45
95,93,,And Then We Danced,1,84,2019.0,Romance/Drama,0 days 01:45:00.000000000,-2
83,80,,The Pickup Game,1,5,2019.0,Documentary,0 days 01:36:00.000000000,-3
71,84,,The Traitor,100,103,2019.0,Drama/Biography,0 days 02:25:00.000000000,13
65,73,,"Family Romance, LLC",1,55,2019.0,Drama,0 days 01:29:00.000000000,8
100,100,https://resizing.flixster.com/PUrbnlsotNW9ttLQrsDaol60EYk=/206x305/v2/https://resizing.flixster.com/3MpQT805xBf3EP8mwTpvWzECw1Q=/ems.ZW1zLXByZC1hc3NldHMvbW92aWVzL2U4ZDM1NzY2LTBiZDktNDVhYS05NzliLTQwNDAwMTBhZWQyMy53ZWJw,Pariah Dog,1,10,2019.0,Documentary,0 days 01:17:00.000000000,0
38,76,,Tommaso,1,72,2019.0,Drama,0 days 01:55:00.000000000,38
93,97,,Promare,100,29,2019.0,Sci fi/Adventure,0 days 01:51:00.000000000,4
59,100,,Cut off,1,7,2018.0,Crime/Horror,0 days 02:12:00.000000000,41
80,87,,Yellow Rose,100,54,2019.0,Drama/Music,0 days 01:35:00.000000000,7
54,97,https://resizing.flixster.com/orJdiUWI3brXfe04hc8IeHIYIxQ=/206x305/v2/https://resizing.flixster.com/XTohTV086kgTjlq3RCcAc1XVk-U=/ems.ZW1zLXByZC1hc3NldHMvbW92aWVzLzI1Mzg0ZWE0LWQxY2MtNGFkZC04ZThhLTgzNGYxMmM2Mzk4NS53ZWJw,Z,50,32,2019.0,Horror/Mystery and thriller,0 days 01:23:00.000000000,43
89,96,,Marona's Fantastic Tale,1,23,2019.0,Drama/Animation,0 days 01:32:00.000000000,7
62,62,,Children of the Sea,1,29,2019.0,Animation/Fantasy,0 days 01:50:00.000000000,0
93,83,,Psych 2: Lassie Come Home,100,12,2020.0,Comedy/Mystery and thriller,0 days 01:30:00.000000000,-10
57,81,,Hearts and Bones,1,27,2019.0,Drama,0 days 01:51:00.000000000,24
89,93,,Ride Your Wave,1,28,2019.0,Comedy/Anime,0 days 01:34:00.000000000,4
67,75,https://resizing.flixster.com/NFaIY2RiUZty4nU9hgNiLUHvo0A=/206x305/v2/https://resizing.flixster.com/wYyORsxvi_faK8mvyNPme6Rcjek=/ems.ZW1zLXByZC1hc3NldHMvbW92aWVzLzljNTA1MzU2LTg3YjAtNDUyYi05NmM1LWI1N2FiZDQyNzM5Yi53ZWJw,Samurai Marathon 1855,1,8,2019.0,Drama/History,0 days 01:43:00.000000000,8
89,93,,End of Sentence,100,57,2019.0,Drama,0 days 01:36:00.000000000,4
67,80,https://resizing.flixster.com/Hd1ILNezF34tXy_eeh62tpFUZFE=/206x305/v2/https://resizing.flixster.com/3ENwmP02vLOxD5wprKJADyVwrnE=/ems.ZW1zLXByZC1hc3NldHMvbW92aWVzLzFhNjBkY2Y4LWEwOWEtNDMzOC05M2VmLWI2YmIyYjY1MDkxNy5qcGc=,The True Adventures of Wolfboy,1,49,2019.0,Drama,0 days 01:28:00.000000000,13
57,94,,The Deeper You Dig,1,32,2019.0,Horror/Drama,0 days 01:32:00.000000000,37
67,92,https://resizing.flixster.com/UZocvTB_FVLKGCaPdZFfkTK4UOU=/206x305/v2/https://resizing.flixster.com/KoC-q__V9vAzo0urhRi8mhG7XdI=/ems.ZW1zLXByZC1hc3NldHMvbW92aWVzLzg5ZDEyMmNhLTExOTgtNGE5Zi1hN2ZmLTU5OTE0YmYyMTkxYy53ZWJw,A Good Woman Is Hard to Find,100,51,2019.0,Mystery and thriller/Drama,0 days 01:37:00.000000000,25
63,88,,The Truth,50,155,2019.0,Drama,0 days 01:46:00.000000000,25
51,36,https://resizing.flixster.com/trIOvpm8aQEhAvNjteN_3-djAZc=/206x305/v2/https://resizing.flixster.com/ilY49ikAurk-XjirtkcWUwicCOQ=/ems.ZW1zLXByZC1hc3NldHMvbW92aWVzLzE2YzFkM2Q1LTM2OGQtNGZlZC1iYTdkLWM5YTA1YzBkM2I2Ny53ZWJw,Seberg,250,132,2019.0,Biography/History,0 days 01:43:00.000000000,-15
71,70,,The High Note,250,184,2020.0,Drama/Music,0 days 01:53:00.000000000,-1
79,64,,The Devil All the Time,2500,207,2020.0,Mystery and thriller/Crime,0 days 02:18:00.000000000,-15
39,100,,Dead Dicks,1,11,2020.0,Horror,,61
56,47,https://resizing.flixster.com/ZGwKRR-fLH-U0mRoWpBTplJX1Do=/206x305/v2/https://resizing.flixster.com/9pefxSSIwPGqEiOKUy0jkWEFYb0=/ems.ZW1zLXByZC1hc3NldHMvbW92aWVzL2QzZDU5ZjIzLTBjY2EtNGQzZi04ZDIwLTVlMzk5MGE4ODNjMC53ZWJw,A Rainy Day in New York,250,106,2019.0,Comedy,0 days 01:32:00.000000000,-9
83,84,,Lake Michigan Monster,1,19,2018.0,Comedy/Adventure,0 days 01:18:00.000000000,1
50,42,,Guest of Honour,1,65,2019.0,Drama,0 days 01:45:00.000000000,-8
71,93,,Jesus Shows You the Way to the Highway,1,15,2019.0,Comedy/Sci fi,0 days 01:23:00.000000000,22
86,33,,Measure for Measure,1,27,2019.0,Drama,0 days 01:47:00.000000000,-53
82,92,,Leap of Faith: William Friedkin on The Exorcist,1,50,2019.0,Documentary/Mystery and thriller,0 days 01:44:00.000000000,10
83,93,,Babyteeth,100,147,2019.0,Comedy/Drama,0 days 01:57:00.000000000,10
62,82,,The Painted Bird,50,106,2019.0,Drama,0 days 02:49:00.000000000,20
82,93,,The Outpost,500,96,2020.0,Drama/War,0 days 02:03:00.000000000,11
52,71,,7500,250,152,2019.0,Drama/Mystery and thriller,0 days 01:32:00.000000000,19
64,53,,Waiting for the Barbarians,100,90,2019.0,Drama/History,0 days 01:52:00.000000000,-11
95,37,https://resizing.flixster.com/ViP62ZvtJ1BhphL3hIFMg6Rs37A=/206x305/v2/https://flxt.tmsimg.com/assets/p19200255_p_v8_aa.jpg,American Skin,500,19,2019.0,Drama,0 days 01:29:00.000000000,-58
71,100,,Echo,1,10,2019.0,Drama,0 days 01:19:00.000000000,29
79,100,,Chameleon,100,11,2019.0,Mystery and thriller,0 days 01:20:00.000000000,21
60,90,,The August Virgin,1,21,2019.0,Drama,0 days 02:05:00.000000000,30
88,100,,Fagara,1,8,2019.0,Drama,0 days 02:00:00.000000000,12
46,72,https://resizing.flixster.com/l01Ji9cOn2fXyzvvMHtxBPJwQAs=/206x305/v2/https://resizing.flixster.com/fQtEwBVDLR3lkGHr4OLtElkC9O0=/ems.ZW1zLXByZC1hc3NldHMvbW92aWVzL2ZkYTYyZWMyLTYzNTctNGRjNC1iOWM5LWMyNWU1ZGZiYjE5ZS53ZWJw,An American Pickle,500,163,2020.0,Comedy,0 days 01:28:00.000000000,26
91,99,,Collective,50,114,2019.0,Documentary,0 days 01:49:00.000000000,8
86,91,https://resizing.flixster.com/-a2EWvjjtqq6CZnkLRzyX3hUZ2s=/206x305/v2/https://resizing.flixster.com/POWhmdJkb5zh63WZfzsusPUpQTQ=/ems.ZW1zLXByZC1hc3NldHMvbW92aWVzLzE5YzczMTFhLTU0OTgtNGQxZS1iYWVjLTJhYzQ3MjY2ZjQyNS53ZWJw,Don't Be Nice,1,11,2018.0,Documentary,0 days 01:36:00.000000000,5
86,100,,Phineas and Ferb the Movie: Candace Against the Universe,250,19,2020.0,Animation/Adventure,0 days 01:27:00.000000000,14
88,95,,Soul,5000,331,2020.0,Animation/Comedy,0 days 01:40:00.000000000,7
87,94,/assets/pizza-pie/images/poster_default.c8c896e70c3.gif,Raya and the Last Dragon,2500,269,2021.0,Animation/Adventure,0 days 01:48:00.000000000,7
58,67,https://resizing.flixster.com/1OJ8KOPe8EWmNY6cEYu8hVc5VKc=/206x305/v2/https://resizing.flixster.com/7Y_8rPi70CWulWkf2PRlIztAbHg=/ems.ZW1zLXByZC1hc3NldHMvbW92aWVzL2Y3ZWRlZjIzLWM3OTMtNDlkZC05N2QyLWNjYjVlYmU4NzVlNi53ZWJw,Castle in the Ground,1,39,2019.0,Drama,0 days 01:45:00.000000000,9
60,98,https://resizing.flixster.com/zAEs1yYKzrjrgTxTeHClTH4tyd0=/206x305/v2/https://resizing.flixster.com/3xWYhfYfRQWMx5NzpBX8VmCvYW4=/ems.ZW1zLXByZC1hc3NldHMvbW92aWVzL2Y2Y2ViODliLTJlNmItNGQyNS1iMTE3LWU3OTAzZjI5Yjg2ZC53ZWJw,La llorona,100,82,2019.0,Crime/Horror,0 days 01:37:00.000000000,38
91,96,,Red Penguins,1,46,2019.0,Documentary,0 days 01:20:00.000000000,5
67,68,,I Am Woman,50,80,2019.0,Drama/Music,0 days 01:57:00.000000000,1
49,75,https://resizing.flixster.com/LDNDpzvKGtTqK93UxuT6LuEYiZw=/206x305/v2/https://resizing.flixster.com/aSFMvj10_HcOuH-UPCr8pFeOqVU=/ems.ZW1zLXByZC1hc3NldHMvbW92aWVzL2RjNDk1ZjY5LTE1YTgtNGIwMi1iMDAwLWI2YzFiZTMzMTYzZS5qcGc=,Jungleland,50,55,2019.0,Drama,0 days 01:30:00.000000000,26
97,94,,Dads,1,34,2019.0,Documentary,0 days 01:27:00.000000000,-3
74,88,https://resizing.flixster.com/s_bfMGXmkZrE5T5FEG6HyjkmKHA=/206x305/v2/https://resizing.flixster.com/978rSMEY2WbHVt0EEnoJwvIf4Uo=/ems.ZW1zLXByZC1hc3NldHMvbW92aWVzLzFiZDRmYTU3LTE2OTktNDkzZC1hZjNjLTdhYzFmMDEzOWM1OS53ZWJw,Volition,50,26,2019.0,Sci fi/Mystery and thriller,0 days 01:31:00.000000000,14
57,77,,Military Wives,50,122,2019.0,Comedy/Drama,0 days 01:52:00.000000000,20
50,30,https://resizing.flixster.com/lEdj2U34PCKg98iMcxwQmP0bnyA=/206x305/v2/https://resizing.flixster.com/IS6rLo88DxLteN9PdnmyMTbopjQ=/ems.ZW1zLXByZC1hc3NldHMvbW92aWVzL2U5NzY1MDllLTU5YjItNDFjNC1iNWFjLWJkZDAzY2JiN2E3YS53ZWJw,Dirt Music,1,44,2019.0,Romance,0 days 01:45:00.000000000,-20
75,83,,Gundala,50,6,2019.0,Adventure/Action,0 days 02:03:00.000000000,8
57,71,https://resizing.flixster.com/uSxmP7TAhdmLzHQgil-AWOH82Zk=/206x305/v2/https://resizing.flixster.com/eboU5032vjOgdmz4eN6JJwqRyb0=/ems.ZW1zLXByZC1hc3NldHMvbW92aWVzLzdhZWQ4ODgxLTllNWQtNDUwMC1hMTIzLTNkOWJkM2YyMjVlZi53ZWJw,Driven,1,7,2020.0,Comedy/Horror,0 days 01:30:00.000000000,14
78,97,,Billie,1,34,2020.0,Documentary/Music,0 days 01:36:00.000000000,19
61,95,,First Cow,250,169,2019.0,Western/Drama,0 days 02:02:00.000000000,34
50,86,,Lingua Franca,1,51,2019.0,Drama,0 days 01:29:00.000000000,36
82,93,,The Prince,1,14,2019.0,Drama,,11
55,79,,How to Build a Girl,100,135,2019.0,Comedy,0 days 01:42:00.000000000,24
67,40,,Sweetness in the Belly,1,10,2019.0,Drama,0 days 01:50:00.000000000,-27
14,50,,The Giant,1,16,2019.0,Mystery and thriller,0 days 01:40:00.000000000,36
20,22,,Iron Mask,50,32,2019.0,Action/Fantasy,0 days 02:10:00.000000000,2
76,97,,Two of Us,1,74,2019.0,Romance/Gay and lesbian,0 days 01:35:00.000000000,21
70,94,,The Shadow of Violence,50,67,2019.0,Crime/Drama,0 days 01:41:00.000000000,24
100,88,,Desert One,1,50,2019.0,Documentary,0 days 01:47:00.000000000,-12
40,79,,Das Vorspiel,1,34,2020.0,Drama,,39
67,100,,Nail in the Coffin: The Fall and Rise of Vampiro,1,12,2019.0,Documentary,0 days 01:28:00.000000000,33
20,40,,Intrigo: Dear Agnes,1,5,2019.0,Mystery and thriller,0 days 01:40:00.000000000,20
74,95,https://resizing.flixster.com/BkMlr8ccpOpwLOM_HhxCfI5wlhY=/206x305/v2/https://resizing.flixster.com/VS8VLvh0EMN6d5xuV-asnURr5X0=/ems.ZW1zLXByZC1hc3NldHMvbW92aWVzLzUyMmI3NjcyLTBmMzQtNDYwYS05YmRiLTA2YWY3MWJiMzNlNi5qcGc=,The Mortuary Collection,100,59,2019.0,Horror/Fantasy,0 days 01:50:00.000000000,21
66,78,,Blood Machines,50,18,2019.0,Adventure/Musical,,12
80,100,,Song Lang,1,7,2018.0,Drama,0 days 01:30:00.000000000,20
72,100,,Luz: The Flower of Evil,1,10,2019.0,Western/Horror,0 days 01:44:00.000000000,28
56,74,,Bully. Coward. Victim. The Story of Roy Cohn,1,35,2019.0,Documentary,0 days 01:37:00.000000000,18
66,98,https://resizing.flixster.com/vpQ8HYqmJq7tLxV5dtYV-5iHPp0=/206x305/v2/https://resizing.flixster.com/A9nYwD6cNkg5RlbkevW12xILuaI=/ems.ZW1zLXByZC1hc3NldHMvbW92aWVzL2JjOWYwYTk1LTFlYzQtNGMzOC1iMjJmLTcyZWVlMGIzZWM2MS53ZWJw,The Swerve,1,52,2018.0,Drama,0 days 01:35:00.000000000,32
93,100,,Suzi Q,1,29,2019.0,Documentary/Music,0 days 01:38:00.000000000,7
73,77,,Summerland,1,124,2020.0,Drama,0 days 01:39:00.000000000,4
86,100,,White Riot,1,49,2019.0,Documentary/Music,0 days 01:20:00.000000000,14
66,76,https://resizing.flixster.com/wgSsm8hO5g-1NXVFhVBuOHGMabg=/206x305/v2/https://resizing.flixster.com/Ud6DGov1gPis0BCV-l9xy_zI0-I=/ems.ZW1zLXByZC1hc3NldHMvbW92aWVzL2YyZmQwMTQxLWUwMDYtNDEwOS1hZThjLTI3ODczMjViM2ExNC5qcGc=,Savage,50,29,2019.0,Drama/Crime,0 days 01:40:00.000000000,10
83,80,https://resizing.flixster.com/cwJes-KGv05RISAHtgJA1L2tIOA=/206x305/v2/https://resizing.flixster.com/CnTZImUKpQ0rxjqs9QwG7lX7Xlo=/ems.ZW1zLXByZC1hc3NldHMvbW92aWVzLzI5ZDM5MmQ5LTY3ZjQtNDgyNy05NzYzLTA5NDhjMDQwODcwYi53ZWJw,Scare Package,100,35,2019.0,Comedy/Horror,0 days 01:43:00.000000000,-3
50,94,,The Delivered,1,31,2019.0,Horror/Drama,0 days 01:52:00.000000000,44
45,67,,The Secret Garden,100,94,2020.0,Fantasy/Drama,0 days 01:39:00.000000000,22
87,98,,I'm No Longer Here,100,41,2019.0,Drama,0 days 01:52:00.000000000,11
86,75,,Pieces of a Woman,1000,222,2020.0,Drama,0 days 02:06:00.000000000,-11
49,81,,I'm Your Woman,250,149,2020.0,Drama/Mystery and thriller,0 days 02:00:00.000000000,32
96,100,https://resizing.flixster.com/HInQpDcsttvPiZBAbeKHx5Fys70=/206x305/v2/https://resizing.flixster.com/WOgHb2guuFXzdKnbVZ1QZ2Jufe8=/ems.ZW1zLXByZC1hc3NldHMvbW92aWVzLzM0ZGQ5ODkyLTZjNDAtNDYwMS1iNzRmLTI3YmQwNjc0ZGRiMy53ZWJw,Inmate #1: The Rise of Danny Trejo,1,32,2019.0,Documentary,0 days 01:50:00.000000000,4
69,95,,The Planters,1,20,2019.0,Comedy,0 days 01:18:00.000000000,26
52,29,,Antebellum,500,191,2020.0,Mystery and thriller,0 days 01:46:00.000000000,-23
74,28,,The Secret: Dare to Dream,250,53,2020.0,Romance/Drama,0 days 01:47:00.000000000,-46
43,68,,The Christmas Chronicles 2,500,57,2020.0,Fantasy/Comedy,0 days 01:55:00.000000000,25
93,100,,Mucho Mucho Amor: The Legend of Walter Mercado,100,60,2020.0,Documentary,0 days 01:36:00.000000000,7
70,94,,John Lewis: Good Trouble,50,70,2020.0,Documentary,0 days 01:36:00.000000000,24
88,95,,Lupin III: The First,50,21,2019.0,Comedy/Anime,0 days 01:33:00.000000000,7
76,66,,Matthias & Maxime,50,70,2019.0,Drama,0 days 01:59:00.000000000,-10
57,90,,We Are Freestyle Love Supreme,1,21,2020.0,Documentary/Music,0 days 01:30:00.000000000,33
39,62,,Bad Hair,100,77,2020.0,Comedy/Horror,0 days 01:42:00.000000000,23
58,66,,Spree,100,76,2020.0,Comedy/Mystery and thriller,0 days 01:32:00.000000000,8
85,77,https://resizing.flixster.com/jCGR7IKQ52UHYhPb28eoMDchGHc=/206x305/v2/https://flxt.tmsimg.com/assets/p18738566_p_v8_aa.jpg,Uncle Frank,250,117,2020.0,Gay and lesbian/Drama,0 days 01:35:00.000000000,-8
51,89,,The Nest,250,155,2020.0,Drama/Mystery and thriller,0 days 01:47:00.000000000,38
94,83,,Happy Happy Joy Joy: The Ren & Stimpy Story,1,30,2020.0,Documentary,0 days 01:44:00.000000000,-11
74,70,,Ashfall,1,10,2019.0,Action/Drama,0 days 02:08:00.000000000,-4
65,67,https://resizing.flixster.com/0Q_RWpr_q_w4YyM-TQFqLDdBOwI=/206x305/v2/https://resizing.flixster.com/6H4OXNBiZSyWry0GR8gt4yeUn1k=/ems.ZW1zLXByZC1hc3NldHMvbW92aWVzL2UxNTQ2YjBkLWY5MDAtNDRkOS05ZjJkLTk3MjExYjc3ZDdlMy53ZWJw,The Glorias,50,127,2020.0,Drama/Biography,0 days 02:19:00.000000000,2
43,58,,Tesla,1,174,2020.0,Drama/History,0 days 01:42:00.000000000,15
100,98,https://resizing.flixster.com/p4jEFzj4vNntS-ncenCQOJ4m8EU=/206x305/v2/https://resizing.flixster.com/hGjHnrN6Sca7MYpqT3ArAYoWEtI=/ems.ZW1zLXByZC1hc3NldHMvbW92aWVzLzZjMzc2NWQ3LTdjMTAtNGQ4Ni05YTZjLTZhNmQyNzA4ZDc3OS5qcGc=,Assassins,1,42,2020.0,Documentary,0 days 01:44:00.000000000,-2
40,90,https://resizing.flixster.com/CJbSxnEeAZ5vhG4b5pVBZC6xYjg=/206x305/v2/https://resizing.flixster.com/eud9Jqwfl12sGN2uKmjyMFjUc6s=/ems.ZW1zLXByZC1hc3NldHMvbW92aWVzLzk0ZTgxY2MzLTA0ZWMtNDcwMS1hMDEzLTYwZDJmODE3MDRjNC5qcGc=,Luxor,1,61,2020.0,Romance/Drama,0 days 01:25:00.000000000,50
86,98,,Disclosure,100,52,2020.0,Documentary,0 days 01:40:00.000000000,12
66,84,,Scare Me,100,55,2020.0,Horror,0 days 01:44:00.000000000,18
49,92,,Relic,500,224,2020.0,Horror/Drama,0 days 01:29:00.000000000,43
75,100,,His House,500,112,2020.0,Horror/Mystery and thriller,0 days 01:33:00.000000000,25
41,71,https://resizing.flixster.com/EGIam4DMalIe4D18Rt3CyapbpN8=/206x305/v2/https://resizing.flixster.com/l56hzwF4ZbIT-KjXn83BuVTRq4k=/ems.ZW1zLXByZC1hc3NldHMvbW92aWVzLzgyNjM4NGFkLWZkNDctNDRkMS04NGM2LTI2MGM3ODllMzg4Yi53ZWJw,Amulet,100,75,2020.0,Horror/Mystery and thriller,0 days 01:39:00.000000000,30
79,92,,Rebuilding Paradise,1,65,2020.0,Documentary,0 days 01:35:00.000000000,13
94,98,https://resizing.flixster.com/p9GR4zGadzDOxZQDJnxvmkyHyxY=/206x305/v2/https://resizing.flixster.com/31s7e3dESjRc4wD398pKXimNS3I=/ems.ZW1zLXByZC1hc3NldHMvbW92aWVzLzVhYWMyOWVmLThiOGYtNDIzZS1hZTE2LTc4YzEyZjgwNjczNi53ZWJw,The Go-Go's,1,44,2020.0,Documentary/Music,0 days 01:38:00.000000000,4
81,99,,On the Record,50,71,2020.0,Documentary,0 days 01:35:00.000000000,18
88,100,https://resizing.flixster.com/Fqzrfhl1Iz5an6gVEfjvP0f9yfI=/206x305/v2/https://resizing.flixster.com/pzLe6fQd2J35JoF69CDvEW57ETU=/ems.ZW1zLXByZC1hc3NldHMvbW92aWVzLzQzOTliNDJjLWE4NmItNGYzYy05ZmNmLWM1ODRiYzljNWM4NS5qcGc=,A Thousand Cuts,1,39,2020.0,Documentary,0 days 01:50:00.000000000,12
68,93,https://resizing.flixster.com/DnEmMP69Q9FlobnIokIqobb5Ins=/206x305/v2/https://resizing.flixster.com/34FnZuTmrr3NvnRcqIM6q5oePys=/ems.ZW1zLXByZC1hc3NldHMvbW92aWVzL2JlMmUyNWIwLTU2YWMtNDgzYi05NjgyLWI4ZmVlZWU1YmVhNi53ZWJw,"Bloody Nose, Empty Pockets",1,81,2020.0,Documentary,0 days 01:38:00.000000000,25
91,94,,Boys State,100,141,2020.0,Documentary,0 days 01:49:00.000000000,3
78,100,,Dick Johnson Is Dead,100,90,2020.0,Documentary,0 days 01:29:00.000000000,22
84,96,,Feels Good Man,50,80,2020.0,Documentary,0 days 01:32:00.000000000,12
60,87,,Spaceship Earth,50,110,2020.0,Documentary,0 days 01:54:00.000000000,27
71,99,https://resizing.flixster.com/TSipZ1ptrHwtIjl4jTiasDl1b-g=/206x305/v2/https://resizing.flixster.com/SbgIxBdYnsVdw41YVvOY6fmbn3Y=/ems.ZW1zLXByZC1hc3NldHMvbW92aWVzLzc2MDc0MDYwLWRkNDctNDAwNC1iNzEzLWUxNGRiNzU1YzIxMC53ZWJw,The Fight,1,67,2020.0,Documentary,0 days 01:36:00.000000000,28
69,75,,Wander Darkly,1,96,2020.0,Drama,0 days 01:37:00.000000000,6
50,98,,Time,100,116,2020.0,Documentary,0 days 01:21:00.000000000,48
85,100,,Welcome to Chechnya,50,69,2020.0,Documentary/Gay and lesbian,0 days 01:47:00.000000000,15
69,98,,The Forty-Year-Old Version,100,126,2020.0,Comedy/Drama,0 days 02:03:00.000000000,29
67,82,,Charm City Kings,50,55,2020.0,Drama,0 days 02:05:00.000000000,15
78,93,,Sylvie's Love,100,120,2020.0,Romance/Drama,0 days 01:54:00.000000000,15
55,87,https://resizing.flixster.com/vJQSWoy5LkK8OKWFF7Tfb4hAZMQ=/206x305/v2/https://resizing.flixster.com/d1VoiftwEUEFpYVtGjcpHFOYVxM=/ems.ZW1zLXByZC1hc3NldHMvbW92aWVzLzNmMTYwY2ZlLWI2MTktNDgwMy04ZDUyLWQxYzYxNDU0MWQ1NS53ZWJw,Shirley,250,245,2020.0,Drama/Mystery and thriller,0 days 01:47:00.000000000,32
60,89,,Save Yourselves!,1,89,2020.0,Sci fi/Comedy,0 days 01:33:00.000000000,29
88,95,,Palm Springs,1000,220,2020.0,Romance,0 days 01:30:00.000000000,7
58,99,,Miss Juneteenth,100,134,2020.0,Drama,0 days 01:43:00.000000000,41
89,95,https://resizing.flixster.com/qV2FG3r-Fhu2eus-Jv2HKS-a0Wo=/206x305/v2/https://resizing.flixster.com/nbSKIJ3iDI3HfsFObJ85DQY1BSk=/ems.ZW1zLXByZC1hc3NldHMvbW92aWVzLzQwN2Y1ZGI5LTE5YzEtNDM3Zi1iNGJiLTY2NTM3MjIzMDhlNC53ZWJw,The Mole Agent,50,58,2020.0,Documentary/Drama,0 days 01:30:00.000000000,6
86,96,,The Painter and the Thief,50,108,2020.0,Documentary,0 days 01:42:00.000000000,10
16,87,,Cuties,1000,79,2020.0,Drama/Comedy,0 days 01:36:00.000000000,71
83,86,,The Social Dilemma,500,65,2020.0,Documentary/Drama,0 days 01:34:00.000000000,3
63,40,,Irresistible,500,224,2020.0,Comedy,0 days 01:41:00.000000000,-23
48,82,,I'm Thinking of Ending Things,1000,258,2020.0,Horror/Mystery and thriller,0 days 02:14:00.000000000,34
60,83,https://resizing.flixster.com/Ow9b1-k9fWGxDD2j9q1XYGGE_n4=/206x305/v2/https://flxt.tmsimg.com/assets/p18858963_p_v8_ab.jpg,Mank,1000,325,2020.0,Biography/Drama,0 days 02:12:00.000000000,23
89,92,,Love and Monsters,50,77,2020.0,Comedy/Fantasy,0 days 01:49:00.000000000,3
54,100,https://resizing.flixster.com/xu7J_OrfbiD5SYLzGjAB9jAvSgU=/206x305/v2/https://resizing.flixster.com/SgbflmgLrKGt6a3G99kgy8uv6Uk=/ems.ZW1zLXByZC1hc3NldHMvbW92aWVzLzRlNjdlN2RiLWFjZGItNDU3ZC1iZDEwLTJmYWJiMmUxYzU2OS5qcGc=,Breaking Surface,1,6,2020.0,Drama/Action,0 days 01:35:00.000000000,46
90,100,https://resizing.flixster.com/DFxl1XcBh6Gejfn0ktatmUHq9jM=/206x305/v2/https://resizing.flixster.com/j-JXhKocxY9dWBtQqL7DPBKLdIw=/ems.ZW1zLXByZC1hc3NldHMvbW92aWVzLzdkNDNlOWE3LWY2MDAtNGFkMy1iNjJmLTU3ODdmMTVkYjEzMi53ZWJw,Lost in America,1,7,2020.0,Documentary,0 days 01:34:00.000000000,10
65,67,https://resizing.flixster.com/vaCxMLG6fj0aUhXDvQ5hwmGFGjs=/206x305/v2/https://resizing.flixster.com/uXn5PxfmZ2gmQostVNcxZYUYGSA=/ems.ZW1zLXByZC1hc3NldHMvbW92aWVzL2ExYzQ2NzliLTQ0OWEtNGY4NS04OTJkLTljYTYzNzE4NmVhMC53ZWJw,She's in Portland,1,15,2020.0,Comedy/Drama,0 days 01:41:00.000000000,2
82,72,,A Call to Spy,100,47,2019.0,Drama/History,0 days 02:04:00.000000000,-10
58,89,https://resizing.flixster.com/vmN3qX1TZ8hSDepMOVWoBMgCoDc=/206x305/v2/https://resizing.flixster.com/hvEQh8yn9iFM-Ca6QqZwZJ2_yUk=/ems.ZW1zLXByZC1hc3NldHMvbW92aWVzLzliOTBhZTIwLTdjYTMtNDM4ZS1iNWU4LTIxNzliY2NiMjZkMC5qcGc=,Black Bear,100,122,2020.0,Drama,0 days 01:44:00.000000000,31
64,63,https://resizing.flixster.com/6v3CQhHliLNv_kfvPrjbmtw2V2Y=/206x305/v2/https://resizing.flixster.com/5gb4JEjEfihKblNW4B0Tv_idnus=/ems.ZW1zLXByZC1hc3NldHMvbW92aWVzL2MwZGY5OWIxLTMxZjAtNGYzNS05NDdkLWI0MWEzMDk5YTMxNS53ZWJw,"I Love You, Stupid",1,8,2020.0,Romance,0 days 01:27:00.000000000,-1
90,64,,Enter the Fat Dragon,1,11,2020.0,Sports and fitness/Comedy,0 days 01:37:00.000000000,-26
83,75,,The King of Staten Island,1000,280,2020.0,Comedy/Drama,0 days 02:17:00.000000000,-8
78,80,,Safety,100,41,2020.0,Drama/Biography,0 days 02:02:00.000000000,2
100,87,,The Man Standing Next,1,15,2020.0,Drama,0 days 01:54:00.000000000,-13
91,97,https://resizing.flixster.com/yt3g9VMwgl5HeAGCwVx5KaAECh4=/206x305/v2/https://resizing.flixster.com/TG3EK6Okg_mcXeWOhOqbS7jp1yM=/ems.ZW1zLXByZC1hc3NldHMvbW92aWVzLzMyZGQyZDhhLTliZTktNGRlNi04ZGI1LWYwM2VlMTRlNDA0My5qcGc=,Beasts Clawing at Straws,1,29,2020.0,Crime/Drama,0 days 01:49:00.000000000,6
86,100,,Ask No Questions,1,7,2020.0,Documentary,0 days 01:19:00.000000000,14
73,83,,Adú,50,6,2020.0,Drama,0 days 01:59:00.000000000,10
94,59,,Fatima,50,44,2020.0,Drama/History,0 days 01:53:00.000000000,-35
23,100,https://resizing.flixster.com/qonku-0YqGAuiVWBqriw8nWwQPE=/206x305/v2/https://resizing.flixster.com/iG93KqD7Aeu_OMLtzlOgO48IRKA=/ems.ZW1zLXByZC1hc3NldHMvbW92aWVzLzU5YTVkNDhlLWY2YmUtNDdhMy05YjM1LWE2ZTM1NTFiODQ0Ny53ZWJw,Gunjan Saxena: The Kargil Girl,250,15,2020.0,Drama/Biography,0 days 01:52:00.000000000,77
56,93,,Residue,1,30,2020.0,Drama,0 days 01:30:00.000000000,37
67,58,,Love Sarah,1,33,2020.0,Romance,0 days 01:37:00.000000000,-9
100,89,,The Dalai Lama: Scientist,1,27,2019.0,Documentary,0 days 01:34:00.000000000,-11
61,67,,Emperor,1,15,2020.0,Drama/History,0 days 01:39:00.000000000,6
67,78,,Archive,250,32,2020.0,Sci fi,0 days 01:45:00.000000000,11
96,95,,David Attenborough: A Life on Our Planet,100,20,2020.0,Documentary,0 days 01:23:00.000000000,-1
84,26,,Hillbilly Elegy,1000,245,2020.0,Drama,0 days 01:56:00.000000000,-58
78,65,,The Artist's Wife,1,40,2019.0,Drama,0 days 01:35:00.000000000,-13
44,73,,Followed,50,22,2018.0,Horror,0 days 01:37:00.000000000,29
100,100,,I Will Make You Mine,1,21,2020.0,Drama,0 days 01:20:00.000000000,0
93,14,,After We Collided,50,14,2020.0,Romance/Drama,0 days 01:47:00.000000000,-79
76,54,,Train to Busan Presents: Peninsula,100,119,2020.0,Action/Horror,0 days 01:56:00.000000000,-22
41,39,https://resizing.flixster.com/FJEUxSUthrpQ6hM-q4tmOoEdwio=/206x305/v2/https://resizing.flixster.com/UK2LI8qmEE6JpxtG3YXKmYx8QSg=/ems.ZW1zLXByZC1hc3NldHMvbW92aWVzLzgyYTBlYTU1LTFhNDQtNDQzZS1hMGM5LTQxZTRlMGIyM2EyNS53ZWJw,Ghosts of War,100,41,2020.0,Horror/Mystery and thriller,0 days 01:35:00.000000000,-2
100,67,,Teenage Badass,1,12,2020.0,Comedy,,-33
73,88,,AKA Jane Roe,1,16,2020.0,Documentary,,15
28,49,,The Craft: Legacy,250,111,2020.0,Mystery and thriller/Fantasy,0 days 01:37:00.000000000,21
43,86,,I Used to Go Here,100,76,2020.0,Comedy,0 days 01:20:00.000000000,43
33,0,,The Legion,1,5,2020.0,Action/Adventure,0 days 01:36:00.000000000,-33
79,78,https://resizing.flixster.com/IVhWZ2KKqYTziH_3L_K9cvnjHkk=/206x305/v2/https://resizing.flixster.com/eaw4D5UcvbpVV63Zs4Nuub_l2ko=/ems.ZW1zLXByZC1hc3NldHMvbW92aWVzLzgxNDg1ZjA3LWIwYTMtNDJjYS1iYTFiLWFlZjBkNjJjMmVmOC53ZWJw,The 24th,1,27,2020.0,Drama/History,0 days 01:53:00.000000000,-1
53,85,,Misbehaviour,100,94,2020.0,Comedy/Drama,0 days 01:46:00.000000000,32
20,44,,I Am Vengeance: Retaliation,1,9,2020.0,Action,0 days 01:30:00.000000000,24
94,95,,My Darling Vivian,1,44,2020.0,Documentary,0 days 01:30:00.000000000,1
23,83,,She Dies Tomorrow,250,182,2020.0,Drama/Mystery and thriller,0 days 01:24:00.000000000,60
86,97,,The Donut King,1,31,2020.0,Documentary,0 days 01:30:00.000000000,11
59,14,,Survive the Night,250,14,2020.0,Action/Mystery and thriller,0 days 01:20:00.000000000,-45
35,25,,Inheritance,100,53,2020.0,Mystery and thriller,0 days 01:51:00.000000000,-10
100,100,,Return to Hardwick,1,5,2019.0,Documentary,0 days 01:13:00.000000000,0
51,33,,The Wrong Missy,1000,58,2020.0,Comedy,0 days 01:29:00.000000000,-18
77,63,,Eurovision Song Contest: The Story of Fire Saga,2500,175,2020.0,Comedy/Musical,0 days 02:00:00.000000000,-14
91,83,,You Cannot Kill David Arquette,50,54,2020.0,Documentary,0 days 01:30:00.000000000,-8
0,50,,Evil Little Things,1,6,2019.0,Horror,0 days 01:20:00.000000000,50
23,49,https://resizing.flixster.com/R3_Mkytwt4OhjqnOJqv3AS2aOm4=/206x305/v2/https://resizing.flixster.com/c6Apb7u3QQ0aLuRxc44gMtTXhdo=/ems.ZW1zLXByZC1hc3NldHMvbW92aWVzL2IyYzNmNGIxLTdiZDctNGY4ZS1iM2EzLWY3MzRlZTUzNmU5Ni53ZWJw,Four Kids and It,1,41,2019.0,Fantasy,0 days 01:50:00.000000000,26
68,90,https://resizing.flixster.com/MLVIne8bn1raKBHLu0G2n-e53h8=/206x305/v2/https://resizing.flixster.com/6sskxSYrXmkCYOLxPzlSKxxecX4=/ems.ZW1zLXByZC1hc3NldHMvbW92aWVzL2FhMGNjNTJkLTg1MWUtNGJiMi1iOTQzLWFhMmVlYzg4YjAzZS53ZWJw,Two Heads Creek,1,21,2019.0,Comedy/Horror,0 days 01:25:00.000000000,22
0,60,,Skin Walker,1,5,2019.0,Horror/Mystery and thriller,0 days 01:30:00.000000000,60
60,92,,The Surrogate,1,26,2020.0,Gay and lesbian/Drama,0 days 01:33:00.000000000,32
23,73,https://resizing.flixster.com/cIwaIXMm1XdE74ASmsXW8XLuYTw=/206x305/v2/https://resizing.flixster.com/EFBNzW6vI-n6usGw-wwa6i3o4XU=/ems.ZW1zLXByZC1hc3NldHMvbW92aWVzLzAzNzAxYzkzLTIyNGEtNGRiNy1hNjVlLWRjMGJiOGFlZTdlMy53ZWJw,Blood Vessel,1,15,2019.0,Horror,0 days 01:33:00.000000000,50
50,70,,Think Like a Dog,1,10,2020.0,Comedy/Fantasy,0 days 01:31:00.000000000,20
51,87,,The Trip to Greece,100,117,2020.0,Comedy,0 days 01:52:00.000000000,36
76,91,,Father Soldier Son,1,34,2020.0,Documentary,0 days 01:39:00.000000000,15
32,42,,Proximity,50,24,2019.0,Sci fi,0 days 01:59:00.000000000,10
25,41,,Centigrade,50,46,2020.0,Drama/Mystery and thriller,0 days 02:07:00.000000000,16
71,88,,Sputnik,250,113,2020.0,Horror/Mystery and thriller,0 days 01:47:00.000000000,17
39,44,https://resizing.flixster.com/q8tEYaCwt2dNwJVW6P9xAHUOPCc=/206x305/v2/https://resizing.flixster.com/BO6WZLRqmoQWR4Ab3-t2fwwkoyM=/ems.ZW1zLXByZC1hc3NldHMvbW92aWVzL2FlZmJhZjE1LTUzNWQtNDc1MC05ODEwLTM0OGEyZmRmODE1Zi53ZWJw,Made in Italy,100,81,2020.0,Comedy/Drama,0 days 01:34:00.000000000,5
44,75,,The Rental,500,192,2020.0,Horror/Mystery and thriller,0 days 01:28:00.000000000,31
70,92,,Hannah Gadsby: Douglas,100,26,2020.0,Comedy/Stand up,0 days 01:12:00.000000000,22
82,96,,Stray,1,55,2021.0,Documentary,0 days 01:13:00.000000000,14
29,19,,Stardust,50,68,2020.0,Drama/Music,0 days 01:49:00.000000000,-10
48,69,https://resizing.flixster.com/94AfwQkHh8mxL7Ibx9hwcKF6sxc=/206x305/v2/https://resizing.flixster.com/vgxOjBpQ7fI94zGRWbnuofBn2E4=/ems.ZW1zLXByZC1hc3NldHMvbW92aWVzLzgxOGExYjliLTBmNWQtNGJjYi05MGYwLWM3MjIyMjZjYWU5NS53ZWJw,Most Wanted,50,39,2020.0,Crime/Drama,0 days 02:05:00.000000000,21
72,58,,Have a Good Trip: Adventures in Psychedelics,100,26,2020.0,Documentary,,-14
56,46,,Spell,100,48,2020.0,Horror/Mystery and thriller,0 days 01:31:00.000000000,-10
64,60,/assets/pizza-pie/images/poster_default.c8c896e70c3.gif,18 Presents,1,5,2020.0,Drama,0 days 01:55:00.000000000,-4
96,67,,Tijuana Jackson: Purpose Over Prison,50,6,2020.0,Comedy,0 days 01:36:00.000000000,-29
71,83,https://resizing.flixster.com/GreTFTdonRT-dfuPnw2DHQ322UQ=/206x305/v2/https://resizing.flixster.com/57xxUaFCbSBZfJlLDxuB9OFpZLI=/ems.ZW1zLXByZC1hc3NldHMvbW92aWVzLzE3M2I1ODM4LTBlYWUtNDlmNS04NTZkLWE3ZDk3NDY2YzY0MC53ZWJw,The Collini Case,1,12,2019.0,Crime/Drama,0 days 02:03:00.000000000,12
43,78,,12 Hour Shift,100,74,2020.0,Comedy/Horror,0 days 01:28:00.000000000,35
70,60,,Chemical Hearts,250,90,2020.0,Romance/Drama,0 days 01:33:00.000000000,-10
68,93,/assets/pizza-pie/images/poster_default.c8c896e70c3.gif,Cowboys,1,40,2020.0,Drama,0 days 01:23:00.000000000,25
76,91,,Little Fish,50,68,2020.0,Romance/Sci fi,0 days 01:41:00.000000000,15
40,57,,Broil,1,7,2020.0,Horror/Mystery and thriller,0 days 01:30:00.000000000,17
81,36,,The Dinner Party,100,14,2020.0,Horror,0 days 01:55:00.000000000,-45
80,44,,Money Machine,1,9,2020.0,Documentary,0 days 01:14:00.000000000,-36
70,80,https://resizing.flixster.com/8CUDQLijL2mZYsoShV2awLT6Beg=/206x305/v2/https://resizing.flixster.com/qqluM-2Vtapd1I7oIXllDbOixk4=/ems.ZW1zLXByZC1hc3NldHMvbW92aWVzL2ZkNDk0Nzg1LTI0OTAtNDRiMS1hZWU1LWMwMjhmOTcwZWMwMi53ZWJw,The Old Guard,2500,268,2020.0,Action/Fantasy,0 days 02:05:00.000000000,10
64,80,https://resizing.flixster.com/cNYaYGwff90qB-WdWtyJgLJDZM8=/206x305/v2/https://resizing.flixster.com/mahIYfapjaqILpLhyxn8DIAr2GU=/ems.ZW1zLXByZC1hc3NldHMvbW92aWVzLzU2OGQ5NDJjLWZjM2YtNDgwYS04NDFkLWJlNTljOTczYjdkOS53ZWJw,Hammer,1,30,2019.0,Crime/Drama,0 days 01:22:00.000000000,16
54,92,,Da 5 Bloods,1000,295,2020.0,Drama/War,0 days 02:35:00.000000000,38
78,93,,A Whisker Away,100,14,2020.0,Fantasy/Adventure,0 days 01:44:00.000000000,15
56,71,,Becky,250,119,2020.0,Mystery and thriller,0 days 01:33:00.000000000,15
93,100,https://resizing.flixster.com/LAC93kdVZZN2sjol_19D7xmpDaU=/206x305/v2/https://resizing.flixster.com/Q_praMJsqd4owevdBWy2eli1uWY=/ems.ZW1zLXByZC1hc3NldHMvbW92aWVzLzVhZjM5NGEwLWJhOWQtNDA1YS1hMTAwLTE5MGM3MDYzNTZlMS53ZWJw,Athlete A,100,56,2020.0,Documentary,0 days 01:43:00.000000000,7
37,46,,Body Cam,50,26,2020.0,Horror/Mystery and thriller,0 days 01:37:00.000000000,9
90,98,,Hamilton,1000,198,2020.0,Musical,0 days 02:40:00.000000000,8
86,100,,Manchild: The Schea Cotton Story,1,5,2016.0,Documentary,0 days 01:18:00.000000000,14
67,57,https://resizing.flixster.com/bLBC6bZ14vokJ4DOagw_lspEfqI=/206x305/v2/https://resizing.flixster.com/y7Xrq38S0WUlIVjpdAN9XXh52Lw=/ems.ZW1zLXByZC1hc3NldHMvbW92aWVzL2E1OTVlZDJlLTliNWYtNDYwZC1iNzdhLTgyMzFmOTJhZmNmZS53ZWJw,The Blackout,1,7,2019.0,Action/Sci fi,0 days 02:33:00.000000000,-10
77,73,https://resizing.flixster.com/AKXBuHPbK0HP9NKNKPrjVwA7z94=/206x305/v2/https://resizing.flixster.com/_AhLgxqY5jj7v18H-G5KvnnFoBk=/ems.ZW1zLXByZC1hc3NldHMvbW92aWVzLzBhMzhiNWFiLTA0MDEtNDVkNC04ZDkyLTI0YmYwNGU1MTZmZC53ZWJw,The Soul Collector,1,11,2019.0,Horror,0 days 01:40:00.000000000,-4
54,73,,Gulabo Sitabo,1,15,2020.0,Drama/Comedy,0 days 02:04:00.000000000,19
69,69,,Rent-a-Pal,100,51,2020.0,Mystery and thriller,0 days 01:48:00.000000000,0
23,0,,The Last Days of American Crime,250,43,2020.0,Action/Mystery and thriller,0 days 02:29:00.000000000,-23
18,9,,Force of Nature,100,35,2020.0,Action/Mystery and thriller,0 days 01:31:00.000000000,-9
79,75,https://resizing.flixster.com/HEyVCrtvgCLTiIW3Mk0ZA7-n-HA=/206x305/v2/https://resizing.flixster.com/qcd4uy1LzPhUUloAz9bmNasSR7k=/ems.ZW1zLXByZC1hc3NldHMvbW92aWVzLzI0MThlN2UzLTJjYTAtNDE0OS1iYTNhLTM2NzQxMGJlYjExYy53ZWJw,"I, Pastafari",1,8,2019.0,Documentary,0 days 00:56:00.000000000,-4
39,28,,The Kissing Booth 2,500,40,2020.0,Romance,0 days 02:12:00.000000000,-11
100,84,,Aviva,1,25,2020.0,Romance/Drama,0 days 01:56:00.000000000,-16
92,92,,Spelling the Dream,1,26,2020.0,Documentary,,0
49,86,https://resizing.flixster.com/zKbOFu9IRmux0o6E45NUupQtJEk=/206x305/v2/https://resizing.flixster.com/WqvDmSlCgZWLJY6FY1WYcJFWdRg=/ems.ZW1zLXByZC1hc3NldHMvbW92aWVzLzgyMDUwYmVhLTRhZDItNDgzYy1iNWI3LTExODMxYTEzNDAzMy53ZWJw,Legacy of Lies,50,7,2020.0,Mystery and thriller/Action,0 days 01:41:00.000000000,37
45,54,,Choked: Paisa Bolta Hai,1,13,2020.0,Drama,0 days 01:54:00.000000000,9
37,57,,Secret Society of Second Born Royals,50,30,2020.0,Action/Fantasy,0 days 01:39:00.000000000,20
38,0,,Run With the Hunted,1,11,2020.0,Mystery and thriller/Drama,0 days 01:33:00.000000000,-38
92,91,,Parkland Rising,1,11,2019.0,Documentary,0 days 01:32:00.000000000,-1
92,100,,Runner,1,15,2019.0,Documentary,0 days 01:28:00.000000000,8
85,96,https://resizing.flixster.com/w-sFe9xmLmaHgOHDBKFPlaBbwBo=/206x305/v2/https://resizing.flixster.com/n-exeZGX0Tw_XmfD5-kD6XHHG9E=/ems.ZW1zLXByZC1hc3NldHMvbW92aWVzLzNjYmI0ZTBiLTRiZDctNDdjZi04MDIzLTZlNWRiZTk3MzE3My5qcGc=,Dating Amber,100,48,2020.0,Comedy/Drama,0 days 01:32:00.000000000,11
56,47,,Feel the Beat,100,15,2020.0,Drama,0 days 01:49:00.000000000,-9
53,75,,Lost Bullet,50,8,2020.0,Action/Mystery and thriller,,22
75,81,https://resizing.flixster.com/9oO72IX53qi3PYIcJLV0xMZIz7k=/206x305/v2/https://resizing.flixster.com/BRovIZ9531tMKz5GUu-nuRbslgY=/ems.ZW1zLXByZC1hc3NldHMvbW92aWVzLzQ4ZmY5MjBmLTg4YzAtNDhhZi1iNjY5LTIwZmViOTNjZWYwYS53ZWJw,Nobody Knows I'm Here,100,16,2020.0,Drama,0 days 01:31:00.000000000,6
23,86,https://resizing.flixster.com/YikGSxBe4OoWZPV4WCJ6PyH3IAk=/206x305/v2/https://resizing.flixster.com/ScA2Fcr9fVPG-jfa_dZ7aX_LOpo=/ems.ZW1zLXByZC1hc3NldHMvbW92aWVzL2NjNjA1YWZjLTlmNGItNGMyOS04MjQxLWMzNzcyNWIwOWY3ZS5qcGc=,Transhood,1,7,2020.0,Documentary,0 days 01:40:00.000000000,63
84,61,,Mighty Oak,50,18,2020.0,Comedy/Drama,0 days 01:42:00.000000000,-23
33,25,,Aquaslash,1,8,2019.0,Horror,0 days 01:11:00.000000000,-8
100,74,,Flannery,1,34,2019.0,Documentary,0 days 01:37:00.000000000,-26
24,41,,You Should Have Left,250,111,2020.0,Horror/Mystery and thriller,0 days 01:33:00.000000000,17
29,0,,365 Days,1000,16,2020.0,Drama,0 days 01:56:00.000000000,-29
99,33,,Ode to Passion,100,6,2020.0,Romance/Drama,0 days 02:08:00.000000000,-66
64,87,,Survival Skills,1,23,2020.0,Comedy,0 days 01:24:00.000000000,23
38,23,,Money Plane,50,13,2020.0,Action/Mystery and thriller,0 days 01:22:00.000000000,-15
100,100,,A Most Beautiful Thing,1,17,2020.0,Documentary,0 days 01:25:00.000000000,0
93,40,,Useless Humans,100,10,2020.0,Comedy/Sci fi,0 days 01:17:00.000000000,-53
98,100,https://resizing.flixster.com/4QFTWd9k5jhqhb4EHO8xE_kCZpw=/206x305/v2/https://resizing.flixster.com/1G-SJ88a5CPGf0OIJBSUEMSm-yk=/ems.ZW1zLXByZC1hc3NldHMvbW92aWVzLzZhODJjNDMxLWY2YTgtNDQzNC04OGNhLTE1ODVlMWU0NTJkMy53ZWJw,Never Be Done: The Richard Glen Lett Story,50,6,2020.0,Biography/Comedy,0 days 01:20:00.000000000,2
86,41,https://resizing.flixster.com/j6ha5UZBFDGCyXlCh-yu12OV3qI=/206x305/v2/https://resizing.flixster.com/Wta2jHr8h3SVtmN-QCJskJaQ7iA=/ems.ZW1zLXByZC1hc3NldHMvbW92aWVzLzhmNjcxNGFlLWQ4NDQtNGE1Mi1iY2M4LTE2M2M5Njk3M2U0My53ZWJw,The Big Ugly,100,22,2020.0,Crime/Drama,0 days 01:46:00.000000000,-45
50,55,,Never Too Late,1,20,2020.0,Comedy/Drama,0 days 01:38:00.000000000,5
76,90,,Dave Chappelle: 8:46,1,10,2020.0,Comedy,,14
100,100,,Man in Camo,1,5,2018.0,Documentary,0 days 01:25:00.000000000,0
60,82,,Max Reload and the Nether Blasters,1,11,2020.0,Fantasy/Adventure,0 days 01:41:00.000000000,22
99,95,,The Ringmaster,250,21,2019.0,Documentary,0 days 01:28:00.000000000,-4
29,15,,Desperados,100,34,2020.0,Romance,0 days 01:45:00.000000000,-14
27,80,,The Beach House,100,106,2019.0,Horror,0 days 01:28:00.000000000,53
83,95,https://resizing.flixster.com/uFDZl6EL4fT9oXN59z2Kt_MsunE=/206x305/v2/https://resizing.flixster.com/Wkz_R9ycskJhtl50EkZEwlHSQ1c=/ems.ZW1zLXByZC1hc3NldHMvbW92aWVzL2QxZmYxNWYzLWFlMjQtNGUxZS05ZjZiLWY3ZDU0OTE2NGJkYi53ZWJw,Jimmy Carter: Rock & Roll President,1,39,2020.0,Documentary/Music,0 days 01:35:00.000000000,12
80,29,,Easy Does It,1,7,2020.0,Comedy/Adventure,0 days 01:37:00.000000000,-51
73,81,,Over the Moon,500,99,2020.0,Fantasy/Comedy,0 days 01:35:00.000000000,8
44,10,,A Nice Girl Like You,50,10,2020.0,Romance,0 days 01:34:00.000000000,-34
90,17,https://resizing.flixster.com/ZhrD2OTBbqb_obUJqWPwbNldLA8=/206x305/v2/https://resizing.flixster.com/wz-GoqLPkhbQYbOVFrZYnRklXX8=/ems.ZW1zLXByZC1hc3NldHMvbW92aWVzLzRhMjk2ZDliLWE5YzYtNGY0My1iOWYyLWU2MDc0M2NiOWQyMi53ZWJw,The Silencing,1,24,2020.0,Mystery and thriller,0 days 01:33:00.000000000,-73
74,87,,White Noise,1,30,2020.0,Documentary,0 days 01:34:00.000000000,13
47,61,,Project Power,1000,175,2020.0,Action/Fantasy,0 days 01:53:00.000000000,14
23,20,,Paydirt,1,10,2020.0,Crime/Action,0 days 01:25:00.000000000,-3
85,82,,The Hater,100,22,2020.0,Drama,0 days 02:15:00.000000000,-3
15,20,,Fatal Affair,100,35,2020.0,Mystery and thriller,0 days 01:29:00.000000000,5
24,67,,Seriously Single,1,6,2020.0,Romance,0 days 01:46:00.000000000,43
43,50,,Offering to the Storm,1,6,2020.0,Mystery and thriller,0 days 02:18:00.000000000,7
90,95,https://resizing.flixster.com/DCnwK-2556Ew_CfAdNnMT9aBA4c=/206x305/v2/https://resizing.flixster.com/5o2aoO-cqoda7Guw9Ji3RCpJPDU=/ems.ZW1zLXByZC1hc3NldHMvbW92aWVzLzIwMDU5ZDY1LTFlMDItNGViYy04ZDQyLWFhMDgzOWYyZjZmYS53ZWJw,Black Is King,2500,61,2020.0,Music,0 days 01:25:00.000000000,5
70,83,https://resizing.flixster.com/JnuVe1i7_eqNH6IvDSGt0DGq_78=/206x305/v2/https://resizing.flixster.com/9xrd6a2PSJf1BEUr4Gejccrq_5E=/ems.ZW1zLXByZC1hc3NldHMvbW92aWVzL2M3ODQzOTlhLTExN2YtNDA5YS1hZmM1LWQ4YWYzNjUzZDJjMy53ZWJw,Bulbbul,1,18,2020.0,,,13
75,92,,Showbiz Kids,1,24,2020.0,Documentary,0 days 01:35:00.000000000,17
92,94,,The Weight of Gold,1,16,2020.0,Documentary/Sports and fitness,,2
50,33,https://resizing.flixster.com/mGgVMXleNNBJ4pA1nTO3vjdhOLA=/206x305/v2/https://resizing.flixster.com/nJiOqJ5PkiLU2Nf11AdsNgFhLzU=/ems.ZW1zLXByZC1hc3NldHMvbW92aWVzLzc3ZGNjMTcwLWM4NWQtNGVhYy1hZmY5LWNkOWRkNTViNzQ0My53ZWJw,Metamorphosis,1,9,2019.0,Horror/Mystery and thriller,0 days 01:53:00.000000000,-17
82,40,https://resizing.flixster.com/SNzGp-G5UAVdKbaD8f6Rmh6r8nQ=/206x305/v2/https://resizing.flixster.com/nGVleYaAfYEg48nfhHUWo5KSW6k=/ems.ZW1zLXByZC1hc3NldHMvbW92aWVzL2Y2NDZmNmNhLTQ2ZmYtNDJiNi1iM2IzLWJmNzIzZjI0ZGEzOC53ZWJw,Red Shoes and the Seven Dwarfs,50,5,2019.0,Action/Animation,0 days 01:32:00.000000000,-42
85,69,,Ammonite,1,234,2020.0,Romance/Gay and lesbian,0 days 02:00:00.000000000,-16
36,62,,The Secrets We Keep,50,53,2020.0,Mystery and thriller,0 days 01:38:00.000000000,26
72,20,,The Tax Collector,50,71,2020.0,Mystery and thriller/Drama,0 days 01:35:00.000000000,-52
83,83,,Baby Frankenstein,1,6,2018.0,Fantasy/Sci fi,0 days 01:23:00.000000000,0
100,99,,Wolfwalkers,1,156,2020.0,Animation/Fantasy,0 days 01:43:00.000000000,-1
71,82,https://resizing.flixster.com/vLOff7OZGeF0qeLCJEx-3fAsqcg=/206x305/v2/https://resizing.flixster.com/lBLqS8uhnddBkHaXxaDgLEZVxu0=/ems.ZW1zLXByZC1hc3NldHMvbW92aWVzLzM3MDZlY2ZlLTkzMDItNDUxOS05NGNhLThhOWIxZWEyOWFjYS53ZWJw,From the Vine,1,17,2019.0,Comedy/Drama,0 days 01:34:00.000000000,11
72,100,,Uncle Peckerhead,50,13,2020.0,Comedy/Horror,0 days 01:37:00.000000000,28
36,71,,Deep Blue Sea 3,100,14,2020.0,Sci fi/Action,0 days 01:39:00.000000000,35
40,33,https://resizing.flixster.com/VaLo8oa2nmyfROSHyhZv4cdXQRU=/206x305/v2/https://flxt.tmsimg.com/assets/p18342391_p_v13_aa.jpg,One Night in Bangkok,1,6,2020.0,Action/Mystery and thriller,0 days 01:45:00.000000000,-7
94,80,,Deathstroke: Knights & Dragons,500,10,2020.0,Animation/Action,0 days 01:27:00.000000000,-14
55,52,,The Bay of Silence,50,31,2020.0,Mystery and thriller,0 days 01:20:00.000000000,-3
67,50,,The Pale Door,100,40,2020.0,Western/Horror,0 days 01:36:00.000000000,-17
53,72,,The Argument,1,18,2020.0,Comedy,0 days 01:21:00.000000000,19
100,50,https://resizing.flixster.com/RNHBCMd2tpaVRfIY-Wuz9Uso9l4=/206x305/v2/https://flxt.tmsimg.com/assets/p18636235_p_v7_aa.jpg,Up on the Glass,1,8,2020.0,Drama/Mystery and thriller,0 days 01:36:00.000000000,-50
62,67,,Tom of Your Life,1,6,2020.0,Sci fi/Comedy,0 days 01:33:00.000000000,5
62,0,,Hard Kill,500,21,2020.0,Mystery and thriller/Action,0 days 01:35:00.000000000,-62
70,56,,What We Found,1,9,2020.0,Mystery and thriller,0 days 01:50:00.000000000,-14
55,92,,Alone,500,59,2020.0,Mystery and thriller,0 days 01:38:00.000000000,37
10,0,,The 2nd,100,5,2020.0,Mystery and thriller/Action,0 days 01:33:00.000000000,-10
60,85,,Work It,100,27,2020.0,Comedy/Musical,0 days 01:33:00.000000000,25
33,60,,Monstrous,1,5,2020.0,Horror/Mystery and thriller,0 days 01:26:00.000000000,27
62,67,https://resizing.flixster.com/zc8_BsRZ1nfBInw48im9OdyvLKg=/206x305/v2/https://resizing.flixster.com/8CMOQish0XePmv5XWczFL19igys=/ems.ZW1zLXByZC1hc3NldHMvbW92aWVzLzY0ODI2ZGExLTA3NTAtNGQ3Mi05NmVkLTY0NTQ5ZTEyOTU4Zi53ZWJw,The Swamp,1,15,2020.0,Documentary,,5
61,88,https://resizing.flixster.com/tr_9o-6IpgJ-KPOGeD3Yz6eC1oQ=/206x305/v2/https://resizing.flixster.com/HitXPp9xHs0B38zQnUmHppHOU-0=/ems.ZW1zLXByZC1hc3NldHMvbW92aWVzL2E0NDAzNzQ0LWMyNzgtNDRiNC1hOWI4LTI3MDlhOTBiNzMzYS53ZWJw,#Alive,500,24,2020.0,Drama/Horror,0 days 01:38:00.000000000,27
83,23,,The Binge,250,26,2020.0,Comedy,0 days 01:38:00.000000000,-60
82,20,,Range Runners,1,5,2019.0,Mystery and thriller,0 days 01:51:00.000000000,-62
26,56,https://resizing.flixster.com/4Qn2Ifxy8VGgJyntC5EegQ74Z0o=/206x305/v2/https://resizing.flixster.com/txDxpwNimoApR5o0NqEWuNRE4fg=/ems.ZW1zLXByZC1hc3NldHMvbW92aWVzLzkyNzJhYjdjLTAyNTItNGZiZi1iNTMyLWUzMGNhMjgxYTQ1My53ZWJw,Random Acts of Violence,1,72,2019.0,Horror,0 days 01:20:00.000000000,30
30,63,,The Owners,100,49,2020.0,Mystery and thriller,0 days 01:32:00.000000000,33
80,96,,Class Action Park,100,50,2020.0,Documentary,0 days 01:30:00.000000000,16
60,87,,Yusuf Hawkins: Storm Over Brooklyn,1,15,2020.0,Documentary,0 days 01:40:00.000000000,27
47,27,,No Escape,100,11,2020.0,Horror/Mystery and thriller,0 days 01:31:00.000000000,-20
71,71,https://resizing.flixster.com/Q8KjuHMqRsxHGv-9fVh6YuiwZMA=/206x305/v2/https://resizing.flixster.com/eWYnoKKCWVcFAsEg6yCg_IlfMjI=/ems.ZW1zLXByZC1hc3NldHMvbW92aWVzL2U2MDQ2ZWYyLTdmOWQtNDhmMy1iYzU0LWQ1MWU1ZDJkZWNhNy53ZWJw,All Together Now,50,24,2020.0,Drama,0 days 01:32:00.000000000,0
72,100,,All In: The Fight for Democracy,50,65,2020.0,Documentary,0 days 01:42:00.000000000,28
27,11,,Cats & Dogs 3: Paws Unite!,1,9,2020.0,Comedy/Kids and family,0 days 01:24:00.000000000,-16
88,29,,Still Here,50,7,2020.0,Drama/Mystery and thriller,0 days 01:39:00.000000000,-59
65,67,,The Crimes That Bind,1,6,2020.0,Mystery and thriller,0 days 01:30:00.000000000,2
50,70,,The Sleepover,100,20,2020.0,Action/Adventure,0 days 01:40:00.000000000,20
73,100,https://resizing.flixster.com/4_eiFnqOX-KqpsusiOluLfBDkaw=/206x305/v2/https://resizing.flixster.com/3GLydrAIhpPTX569yjHc74GAtuw=/ems.ZW1zLXByZC1hc3NldHMvbW92aWVzL2E3MzliYTY2LTk4ZDctNGU2Ny1hNjJmLTVjYWY1NjYyMWI0Zi53ZWJw,Host,500,86,2020.0,Horror/Mystery and thriller,0 days 00:57:00.000000000,27
99,25,,Sno Babies,50,12,2020.0,Drama,0 days 01:49:00.000000000,-74
82,98,,One Night in Miami,500,320,2020.0,Drama,0 days 01:50:00.000000000,16
36,60,,Latte & the Magic Waterstone,1,5,2019.0,Animation/Comedy,0 days 01:29:00.000000000,24
88,93,,Northwood Pie,1,14,2020.0,Romance/Drama,0 days 01:15:00.000000000,5
65,100,,John Was Trying to Contact Aliens,1,7,2019.0,Biography/Documentary,0 days 00:16:00.000000000,35
89,100,,The Speed Cubers,1,13,2020.0,Documentary,0 days 00:40:00.000000000,11
67,64,,Unknown Origins,50,11,2020.0,Drama/Comedy,0 days 01:36:00.000000000,-3
98,86,,Rising Phoenix,50,21,2020.0,Documentary,0 days 01:46:00.000000000,-12
80,93,,Pretending I'm a Superman: The Tony Hawk Video Game Story,1,15,2020.0,Documentary,0 days 01:20:00.000000000,13
75,100,https://resizing.flixster.com/gOSWZhOlva0X-_tIO0MTd0ZiqPM=/206x305/v2/https://resizing.flixster.com/4iD0SCruRsytlkL9GNxz5J2qvqg=/ems.ZW1zLXByZC1hc3NldHMvbW92aWVzL2NiYmQ4NTRlLTMzODctNDZjNi04NGM1LTU3MTBiMGU5OTY5ZS53ZWJw,Raat Akeli Hai,1,8,2020.0,Drama/Mystery and thriller,0 days 02:30:00.000000000,25
72,56,,Mortal,100,34,2020.0,Fantasy/Mystery and thriller,0 days 01:44:00.000000000,-16
71,83,,Black Boys,1,6,2020.0,Documentary,0 days 01:35:00.000000000,12
86,98,,David Byrne's American Utopia,50,131,2020.0,Musical,0 days 02:15:00.000000000,12
72,99,,MLK/FBI,50,117,2020.0,Documentary,0 days 01:42:00.000000000,27
76,94,,"Crazy, Not Insane",1,32,2020.0,Documentary,0 days 01:58:00.000000000,18
47,70,,Kindred,1,70,2020.0,Mystery and thriller,0 days 01:41:00.000000000,23
65,82,,Murder in the Woods,1,11,2019.0,Horror/Mystery and thriller,0 days 01:30:00.000000000,17
40,39,,Rebecca,500,220,2020.0,Mystery and thriller/Drama,0 days 02:01:00.000000000,-1
70,91,,Enola Holmes,2500,201,2020.0,Mystery and thriller,0 days 02:03:00.000000000,21
85,89,,Robin's Wish,1,57,2020.0,Documentary,0 days 01:17:00.000000000,4
36,80,,I Care a Lot,2500,203,2020.0,Comedy/Mystery and thriller,0 days 01:58:00.000000000,44
97,88,,Immortal,100,8,2020.0,Drama/Mystery and thriller,,-9
14,90,,Unpregnant,2500,42,2020.0,Drama/Comedy,0 days 01:43:00.000000000,76
30,23,,Books of Blood,50,26,2020.0,Horror/Mystery and thriller,,-7
35,77,,Shadow in the Cloud,1,115,2020.0,Horror/War,0 days 01:23:00.000000000,42
25,0,https://resizing.flixster.com/iwkGEckjzhwh5YHRptbOIdKY86A=/206x305/v2/https://resizing.flixster.com/IfnOQh6Y5_cfnIF9YWDafa_Dlsk=/ems.ZW1zLXByZC1hc3NldHMvbW92aWVzL2NiZGU5NDI4LWE3MjAtNDRkZC1iOTViLTkyNGI0MDk5OWU4Zi53ZWJw,Freaks: You're One of Us,50,5,2020.0,Action/Fantasy,0 days 01:32:00.000000000,-25
66,72,https://resizing.flixster.com/3ScNY1q0qYc3hGxZ5dWTAU7WMXA=/206x305/v2/https://resizing.flixster.com/EbNpEYFNi2SpBQ-ip7Yj73cUGJE=/ems.ZW1zLXByZC1hc3NldHMvbW92aWVzL2EyM2NiMGMxLTMzM2QtNGZlMS1iZTU0LWZlMDI3MTNhNTFlZC5qcGc=,Black Box,250,61,2020.0,Mystery and thriller,0 days 01:40:00.000000000,6
29,47,,Evil Eye,50,51,2020.0,Horror/Mystery and thriller,0 days 01:30:00.000000000,18
76,90,,Run,500,124,2020.0,Mystery and thriller,0 days 01:30:00.000000000,14
81,94,,Dear Comrades!,1,52,2020.0,Drama/History,0 days 02:00:00.000000000,13
14,90,https://resizing.flixster.com/uRqpp8M5ogOLL4oP8Upt0jyiEDw=/206x305/v2/https://resizing.flixster.com/k2aHinINQmPWe_fOFuYBuSMjr7Y=/ems.ZW1zLXByZC1hc3NldHMvbW92aWVzL2ZlMTEwNzdjLTNhMGMtNDA1ZC05YzUzLTc1OThjNjEwM2U1NC53ZWJw,Stars and Strife,1,10,2020.0,Documentary,,76
46,85,,Ten Minutes to Midnight,1,20,2020.0,Horror/Mystery and thriller,0 days 01:13:00.000000000,39
25,33,,Death of Me,100,42,2020.0,Horror/Mystery and thriller,0 days 01:34:00.000000000,8
36,79,https://resizing.flixster.com/HyZ5ZBwtdfmUV3i8Nv_t_KNo7OY=/206x305/v2/https://resizing.flixster.com/AlFs245NTV9EPelKakB7b6OnelQ=/ems.ZW1zLXByZC1hc3NldHMvbW92aWVzLzBlZWIwYzIyLTcxYTYtNDk5Ni05YjExLWFkYjg1ZmIxMmExZC53ZWJw,I Am Greta,100,81,2020.0,Documentary,0 days 01:38:00.000000000,43
35,56,,"Love, Guaranteed",250,25,2020.0,Romance,0 days 01:30:00.000000000,21
80,100,,First One In,1,6,2020.0,Comedy,0 days 01:38:00.000000000,20
61,48,,The Babysitter: Killer Queen,500,40,2020.0,Comedy/Horror,0 days 01:41:00.000000000,-13
44,17,,Class of '83,1,12,2020.0,Drama/Crime,0 days 01:38:00.000000000,-27
73,33,,The Rising Hawk,1,6,2019.0,Drama/History,0 days 02:15:00.000000000,-40
56,72,https://resizing.flixster.com/Eu4oA4E7T_2nNYLlY272ubkArkQ=/206x305/v2/https://resizing.flixster.com/LW1kd2abO_Yp6zjf2pMSjxXglK0=/ems.ZW1zLXByZC1hc3NldHMvbW92aWVzLzk3YzY3ODdhLWFhOTMtNGQ4OS05ZTU3LTAyYjhhMjg3MzliMy5qcGc=,LEGO Star Wars Holiday Special,100,54,2020.0,Action/Adventure,,16
70,98,,Spontaneous,250,58,2020.0,Comedy/Horror,0 days 01:42:00.000000000,28
63,92,,The Dark and the Wicked,250,101,2020.0,Horror/Mystery and thriller,0 days 01:34:00.000000000,29
87,88,,I Am Lisa,100,16,2020.0,Horror/Mystery and thriller,0 days 01:32:00.000000000,1
78,93,https://resizing.flixster.com/BM-aDytX2iuxcXejQpa4-3gz8AQ=/206x305/v2/https://flxt.tmsimg.com/assets/p18984983_p_v8_aa.jpg,Minor Premise,50,41,2020.0,Mystery and thriller/Sci fi,0 days 01:34:00.000000000,15
43,83,https://resizing.flixster.com/94crD_bEW4cAO3giy8tVGB69nMQ=/206x305/v2/https://resizing.flixster.com/pfjhOEKaolhFOZmnrGIHmXQItUE=/ems.ZW1zLXByZC1hc3NldHMvbW92aWVzLzcxYzg4YTg5LTY4ZjQtNDQ1ZS1iOTM3LTY2M2NlNzVkMTI0MC53ZWJw,Hosts,1,12,2020.0,Horror,0 days 01:29:00.000000000,40
25,26,,The Doorman,50,27,2020.0,Action/Mystery and thriller,0 days 01:36:00.000000000,1
100,100,https://resizing.flixster.com/2yCsZQHTUlbecQplqefEynt5FJM=/206x305/v2/https://resizing.flixster.com/_sypyrRW8wrWgd9p3Ya-HAOHhSc=/ems.ZW1zLXByZC1hc3NldHMvbW92aWVzLzM3MWM0MmU0LTBjYTEtNGQyMS1iMTcyLTY5NDc0MjRiOWJhMy53ZWJw,Resisterhood,1,5,2020.0,Documentary,0 days 01:36:00.000000000,0
74,82,https://resizing.flixster.com/aiSdK5gI6dzRoI-PH3MKFUZqo-M=/206x305/v2/https://resizing.flixster.com/xDTogrAFGS8a_78Y8Ou2TiZuCU0=/ems.ZW1zLXByZC1hc3NldHMvbW92aWVzLzQ2MjZlY2MwLTRiODEtNGFiNy1iZGI1LThjYjQzY2MxMzI1ZS53ZWJw,The Boys in the Band,250,90,2020.0,Gay and lesbian/Drama,0 days 02:02:00.000000000,8
71,45,https://resizing.flixster.com/2k6h-fXusjVjNMDGwhJZD_Tk9bE=/206x305/v2/https://resizing.flixster.com/49FLzDvuQdWhdQSrLTcUTV2B2Fw=/ems.ZW1zLXByZC1hc3NldHMvbW92aWVzLzY1NmUzMGRkLWY2NDItNGFkZi04ZmFmLWIwZTFiNDliYzNlNy53ZWJw,LX 2048,1,31,2020.0,Sci fi,0 days 01:44:00.000000000,-26
100,80,,Cut and Chop,1,5,2020.0,Horror/Mystery and thriller,0 days 01:30:00.000000000,-20
24,59,https://resizing.flixster.com/IeprNK-kVMRfj2rr7epBbMBXkNA=/206x305/v2/https://resizing.flixster.com/IGYGXdepC3jc8wCUXsjf5aTxvtE=/ems.ZW1zLXByZC1hc3NldHMvbW92aWVzL2M0Y2Y2OWFkLWI4NzMtNGRmNC1iNDkxLTEyYmExZTExM2E4NS53ZWJw,Shortcut,50,27,2020.0,Horror/Mystery and thriller,0 days 01:20:00.000000000,35
21,39,,Chick Fight,50,28,2020.0,Comedy/Action,0 days 01:37:00.000000000,18
86,82,https://resizing.flixster.com/4AxNwq5iVWgZDFGPAt3cgGFZLgY=/206x305/v2/https://resizing.flixster.com/VXN9q8oAskkYThe1BG2HAQMmVRk=/ems.ZW1zLXByZC1hc3NldHMvbW92aWVzLzc2NTY0ZTJmLWQ1NDMtNGI4OS1hODU4LWQwZmU4ZTYxZTJlOC53ZWJw,The Opening Act,100,22,2020.0,Comedy,0 days 01:30:00.000000000,-4
68,92,https://resizing.flixster.com/JuDeGhTID8CiovLHi_6w3TYih8Y=/206x305/v2/https://resizing.flixster.com/MCeqhLZxdOJPE5PHJk1rzKb87N4=/ems.ZW1zLXByZC1hc3NldHMvbW92aWVzLzlkMzEyNjMwLTA5YjAtNGEyMC1iZTMzLTc2YjVhOGIwMmY4Ny53ZWJw,The Dark Divide,1,13,2020.0,Drama/Adventure,0 days 01:47:00.000000000,24
82,88,,Summerland,1,17,2020.0,Comedy,,6
86,63,,This Is Paris,1,8,2020.0,Documentary,,-23
26,19,,Friendsgiving,50,26,2020.0,Comedy/Other,0 days 01:35:00.000000000,-7
91,76,https://resizing.flixster.com/9JwA1kKjOL2aLe8cfxjc13eTQDI=/206x305/v2/https://resizing.flixster.com/Fo1tKrMOaACt94vXjOVoa5y39Ck=/ems.ZW1zLXByZC1hc3NldHMvbW92aWVzLzZjYzc5ZmFlLWMxMTMtNDcxOC1hZDQyLWE5ZWMzYTk0MDRmMC53ZWJw,Clouds,100,25,2020.0,Drama/Music,0 days 02:01:00.000000000,-15
86,25,,Tar,1,8,2020.0,Horror/Mystery and thriller,0 days 01:36:00.000000000,-61
31,44,,The Paramedic,50,9,2020.0,Drama/Mystery and thriller,0 days 01:34:00.000000000,13
43,90,,Vampires vs. The Bronx,250,40,2019.0,Comedy/Horror,0 days 01:25:00.000000000,47
44,53,,Hubie Halloween,1000,80,2020.0,Other/Comedy,0 days 01:43:00.000000000,9
27,38,https://resizing.flixster.com/v0k2t4Q8GRWirJD36befRsaAW_c=/206x305/v2/https://resizing.flixster.com/MnyrJ-o8o-ssOA9NY0Zug_-j2I8=/ems.ZW1zLXByZC1hc3NldHMvbW92aWVzL2RmY2NhZWRiLWJhNDktNDI3MS04ZGY0LTQ0M2VkNTEwNmMyZS53ZWJw,Cadaver,50,8,2020.0,Drama/Horror,0 days 01:26:00.000000000,11
33,67,,W Lesie Dzis nie Zasnie Nikt,100,6,2020.0,Horror/Mystery and thriller,0 days 01:42:00.000000000,34
52,56,,Then Came You,50,16,2020.0,Romance,0 days 01:37:00.000000000,4
85,99,,Totally Under Control,100,101,2020.0,Documentary,0 days 02:03:00.000000000,14
100,100,,"Harry Chapin: When in Doubt, Do Something",1,20,2020.0,Documentary/Music,,0
41,32,,2067,100,31,2020.0,Sci fi/Mystery and thriller,0 days 01:54:00.000000000,-9
71,100,https://resizing.flixster.com/LsrZO6YxSjO8Fv6wIHxOA94YKB8=/206x305/v2/https://resizing.flixster.com/TcjG0l4azG4izYVjiZiMRYZqSeY=/ems.ZW1zLXByZC1hc3NldHMvbW92aWVzL2YwOTI0MjI4LWM4YWYtNDNjMS04Y2ExLTlmZjZhNzdjZGE1NC5qcGc=,The Devil to Pay,1,7,2019.0,Mystery and thriller,0 days 01:27:00.000000000,29
75,85,,American Murder: The Family Next Door,100,20,2020.0,Crime/Documentary,,10
93,88,,The Phenomenon,100,8,2020.0,Documentary,0 days 01:41:00.000000000,-5
68,89,,The Wolf of Snow Hollow,250,73,2020.0,Horror/Mystery and thriller,0 days 01:23:00.000000000,21
96,38,https://resizing.flixster.com/1gaCCU0jOX5dYrsEZg3OwB-O3JA=/206x305/v2/https://resizing.flixster.com/gGmLyyTds2RKT0EhIkSk_kDYT64=/ems.ZW1zLXByZC1hc3NldHMvbW92aWVzLzJiMWQzZmQxLTk3MWMtNDE4NS1iNzczLTYwMTVhZmMyYmNkNS5qcGc=,Echo Boomers,500,32,2020.0,Crime/Drama,0 days 01:34:00.000000000,-58
61,48,https://resizing.flixster.com/eoUi3b7ZkIZVKIrF-5mfmHI4-Fg=/206x305/v2/https://resizing.flixster.com/kmIHFJZBwXVCkwAvsJmWtyDhUX8=/ems.ZW1zLXByZC1hc3NldHMvbW92aWVzL2I0OTI0ZWQyLWQ0NTktNDBiMC04YWMyLTYyMTlhNzJmMjc1YS5qcGc=,Black Beauty,50,46,2020.0,Drama,0 days 01:50:00.000000000,-13
94,100,,My Octopus Teacher,250,21,2020.0,Documentary,0 days 01:25:00.000000000,6
77,70,https://resizing.flixster.com/TXVDdZBgP68eoSfNKVDzSxh7eYk=/206x305/v2/https://resizing.flixster.com/867MPHLo3khx6TYB8IetaEWYnD4=/ems.ZW1zLXByZC1hc3NldHMvbW92aWVzL2NmYzVlYjE2LWE4YWUtNGVhNy05NzhjLTkxOTgzMjc4NjcyYi5qcGc=,Embattled,50,20,2020.0,Drama,0 days 01:57:00.000000000,-7
99,86,,Kiss the Ground,500,7,2020.0,Documentary,0 days 01:25:00.000000000,-13
95,96,https://resizing.flixster.com/zJ1mda8fJgWoeUXOcIqhuj_kfiE=/206x305/v2/https://resizing.flixster.com/ttqi4goJUvxbvK_8CAdQqLGf1mE=/ems.ZW1zLXByZC1hc3NldHMvbW92aWVzLzk3NzA0YzJkLWVjYWYtNDllZi1iZTdhLTY1YzU2ZDRjMTc4ZS5qcGc=,Crock of Gold: A Few Rounds With Shane MacGowan,50,48,2020.0,Documentary/Music,0 days 02:04:00.000000000,1
69,87,,Supernova,50,159,2020.0,Romance/Drama,0 days 01:33:00.000000000,18
76,93,https://resizing.flixster.com/Q245NfCSBrH7ZGOkXI0esGH9Ziw=/206x305/v2/https://resizing.flixster.com/wyGuUKIJn_nHnlGnSkXaPU2QFv0=/ems.ZW1zLXByZC1hc3NldHMvbW92aWVzLzU3N2FlZDQ0LTcwYTktNDkyZS1iYzQ4LTRjNGMxOTBkZDFmNy5qcGc=,40 Years a Prisoner,100,14,2020.0,Documentary,0 days 01:50:00.000000000,17
56,45,,Let's Scare Julie,1,11,2020.0,Horror/Mystery and thriller,0 days 01:23:00.000000000,-11
26,50,,The Midnight Sky,1000,243,2020.0,Drama/Sci fi,0 days 01:58:00.000000000,24
40,44,,Holidate,500,55,2020.0,Romance,0 days 01:43:00.000000000,4
72,97,,What the Constitution Means to Me,1,30,2020.0,Documentary,,25
96,87,,BLACKPINK: Light Up the Sky,500,15,2020.0,Documentary/Music,,-9
64,85,,Borat Subsequent Moviefilm,2500,295,2020.0,Comedy,0 days 01:36:00.000000000,21
75,98,,Ma Rainey's Black Bottom,500,284,2020.0,Music/Drama,0 days 01:34:00.000000000,23
84,45,,Fatman,1,113,2020.0,Other/Fantasy,0 days 01:40:00.000000000,-39
69,27,,Jiu Jitsu,250,45,2020.0,Fantasy/Action,0 days 01:42:00.000000000,-42
100,100,,Rom Boys: 40 Years of Rad,1,12,2020.0,Documentary,,0
50,75,https://resizing.flixster.com/v9RzXt1S3cOmreB8cSo0Nk_cj0s=/206x305/v2/https://resizing.flixster.com/0BXczitWlwOk9ybUgAmw9MFHEPE=/ems.ZW1zLXByZC1hc3NldHMvbW92aWVzLzgwODJkZTIxLThhMzQtNDAzOC1iODNlLWU4NzVhNGM1OWQ3ZC5qcGc=,Archenemy,100,55,2020.0,Mystery and thriller/Action,0 days 01:30:00.000000000,25
75,85,,Skin: A History of Nudity in the Movies,1,39,2020.0,Documentary,0 days 02:10:00.000000000,10
36,38,,Tremors: Shrieker Island,50,8,2020.0,Horror/Adventure,0 days 01:43:00.000000000,2
55,75,,Batman: Death in the Family,50,8,2020.0,Action/Animation,,20
76,83,,Happiest Season,500,200,2020.0,Romance/Other,0 days 01:42:00.000000000,7
32,4,,"Love, Weddings & Other Disasters",1,26,2020.0,Romance,0 days 01:36:00.000000000,-28
83,100,,537 Votes,1,8,2020.0,Documentary,,17
40,52,https://resizing.flixster.com/Zs33u9dQWarHnY_60JoSpfOLwBI=/206x305/v2/https://resizing.flixster.com/wFFLgzhdzTv7bVtZlA5G3q0uQBw=/ems.ZW1zLXByZC1hc3NldHMvbW92aWVzLzQwNTdjMmNiLTY5ODktNDg2Yy1hNDg4LWQxMTFjNjg2NmNiYy5qcGc=,Skylines,100,25,2020.0,Action/Sci fi,0 days 01:50:00.000000000,12
50,67,,The Retreat,1,6,2020.0,Horror,0 days 01:28:00.000000000,17
92,98,,Billie Eilish: The World's a Little Blurry,250,95,2021.0,Documentary/Music,0 days 02:21:00.000000000,6
55,64,,What Lies Below,100,11,2020.0,Mystery and thriller,0 days 01:27:00.000000000,9
78,94,https://resizing.flixster.com/-vlqpCd43lm64ArZNSKzo8KBR3Y=/206x305/v2/https://resizing.flixster.com/JTF0XAc1lbaiOu7ylcfZdPYuroQ=/ems.ZW1zLXByZC1hc3NldHMvbW92aWVzL2RlMWNiYjg3LTIyYTAtNGY0ZS05OTY4LWJhM2ZhNWJhMWE0OS5wbmc=,Bruce Springsteen's Letter to You,1,36,2020.0,Documentary/Music,,16
35,63,,Sarah Cooper: Everything's Fine,50,19,2020.0,Comedy,,28
100,80,https://resizing.flixster.com/79qRhxZudKunTXjBzkGWI_anKr8=/206x305/v2/https://resizing.flixster.com/AQeZEks3gFOpv1yi-NJaFAn5afw=/ems.ZW1zLXByZC1hc3NldHMvbW92aWVzLzhiZGI1OTcxLTg2OWUtNDliYy1iODEyLTU1MGFmNDJmNTNjNy5qcGc=,John Bronco,1,5,2020.0,Comedy,,-20
40,67,,Knuckledust,1,6,2020.0,Action/Mystery and thriller,0 days 01:45:00.000000000,27
92,88,,The Orange Years: The Nickelodeon Story,1,8,2020.0,Documentary,0 days 01:42:00.000000000,-4
78,38,,Smiley Face Killers,50,8,2020.0,Mystery and thriller,0 days 01:36:00.000000000,-40
39,47,,Operation Christmas Drop,100,17,2020.0,Romance/Other,0 days 01:35:00.000000000,8
70,94,,Hunter Hunter,100,49,2020.0,Horror/Mystery and thriller,0 days 01:33:00.000000000,24
100,89,,Nasrin,1,9,2020.0,Documentary/Biography,0 days 01:32:00.000000000,-11
89,92,,A West Wing Special to Benefit When We All Vote,1,13,2020.0,Drama,,3
61,91,,PG: Psycho Goreman,250,64,2020.0,Comedy/Horror,0 days 01:35:00.000000000,30
40,92,,Baby Done,50,38,2020.0,Comedy,0 days 01:31:00.000000000,52
52,64,,Dolly Parton's Christmas on the Square,100,33,2020.0,Musical/Other,0 days 01:38:00.000000000,12
63,55,,The Prom,1000,200,2020.0,Comedy/Musical,0 days 02:11:00.000000000,-8
94,50,,Greatland,1,6,2020.0,Adventure/Fantasy,,-44
52,30,,Wild Mountain Thyme,100,108,2020.0,Romance,0 days 01:42:00.000000000,-22
75,78,,King of Knives,1,9,2020.0,Comedy/Drama,0 days 01:35:00.000000000,3
77,78,,L'Incredibile storia dell'Isola Delle Rose,100,9,2020.0,Comedy/Drama,0 days 01:57:00.000000000,1
25,50,,Elyse,1,6,2020.0,Drama,0 days 01:35:00.000000000,25
14,31,https://resizing.flixster.com/VVJyeMDtH5xebIdpnACiW6-4OR8=/206x305/v2/https://resizing.flixster.com/yGH4Gpb2bpe_RRZXPg8DRBpSuS8=/ems.ZW1zLXByZC1hc3NldHMvbW92aWVzL2Q5MGRhZjE3LTBkMGYtNDY1MC05MmU1LTgwMjY2YjA1N2RmOS5qcGc=,The Stand In,1,36,2020.0,Romance,0 days 01:41:00.000000000,17
25,50,,Kaali Khuhi,1,8,2020.0,Horror,0 days 01:30:00.000000000,25
35,58,,The Princess Switch: Switched Again,100,24,2020.0,Other/Romance,0 days 01:37:00.000000000,23
35,47,,Sister of the Groom,1,17,2020.0,Romance/Drama,0 days 01:32:00.000000000,12
92,64,https://resizing.flixster.com/a-SpFbCBBoUdFswL8XIzuttSUXw=/206x305/v2/https://resizing.flixster.com/jrBjzqHbMeWHMAwAJaDsfSZHrVI=/ems.ZW1zLXByZC1hc3NldHMvbW92aWVzL2NmMDliM2YxLWE0NTctNDFlYi04M2JkLTdiMDI4YmM1YzYwOC5qcGc=,Cup of Cheer,1,14,2020.0,Other/Comedy,0 days 01:35:00.000000000,-28
39,40,,Sightless,50,5,2020.0,Drama,0 days 01:29:00.000000000,1
71,43,,They Reach,1,7,2020.0,Horror/Mystery and thriller,0 days 01:27:00.000000000,-28
0,82,,Reunion,1,11,2020.0,Mystery and thriller/Horror,0 days 01:35:00.000000000,82
100,67,,Love in Dangerous Times,100,6,2020.0,Comedy/Romance,,-33
43,57,https://resizing.flixster.com/6hJC1aHsuUCjGNWykz_0I0HYF-Y=/206x305/v2/https://resizing.flixster.com/DgHRtWG3BzhW0qtLPAt7gU-sn20=/ems.ZW1zLXByZC1hc3NldHMvbW92aWVzLzVjMzVkNjkxLWNlN2EtNDE0YS1iY2RiLTc2ODkwMWI3ODRmMS5qcGc=,Max Cloud,1,21,2020.0,Comedy/Sci fi,0 days 01:28:00.000000000,14
70,21,https://resizing.flixster.com/4olhc9U8B0ISegr3sEHPbGhFi6Y=/206x305/v2/https://resizing.flixster.com/ymA5wQh971QbZLttuYNeFsaAlX8=/ems.ZW1zLXByZC1hc3NldHMvbW92aWVzLzhlMWQ3NzZjLTBkNmYtNDY3NC05MjdkLTRlMThkZjA0Y2NiZC5qcGc=,Breach,500,14,2020.0,Action/Sci fi,0 days 01:29:00.000000000,-49
31,44,,Ip Man: Kung Fu Master,1,9,2019.0,Action/Sports and fitness,0 days 01:24:00.000000000,13
85,100,,The Fresh Prince of Bel-Air Reunion,50,8,2020.0,Documentary,,15
78,40,,Trail of Ashes,1,5,2020.0,Mystery and thriller,0 days 01:38:00.000000000,-38
57,70,,Godmothered,250,70,2020.0,Fantasy/Comedy,0 days 01:50:00.000000000,13
43,73,,We Can Be Heroes,500,45,2020.0,Action/Fantasy,0 days 01:40:00.000000000,30
57,69,,Don't Tell a Soul,100,13,2020.0,Mystery and thriller,0 days 01:24:00.000000000,12
59,14,,Redemption Day,100,21,2021.0,Action/Mystery and thriller,0 days 01:40:00.000000000,-45
98,88,,Paint,1,8,2020.0,Comedy,0 days 01:35:00.000000000,-10
97,100,,Folklore: The Long Pond Studio Sessions,500,13,2020.0,Documentary/Music,,3
60,80,,Yearly Departed,1,5,2020.0,Comedy/Stand up,,20
80,80,https://resizing.flixster.com/KwaRVpz6hCRBz2XQWKSSJxwIFUQ=/206x305/v2/https://resizing.flixster.com/qi3NQE7peYfE9k_-ealhvZauZQU=/ems.ZW1zLXByZC1hc3NldHMvbW92aWVzL2U3N2U4Y2IwLTJjMGEtNDE1My1hMmM2LTZiMmE4ODQ5YTg4Ni5qcGc=,Mariah Carey's Magical Christmas Special,100,5,2020.0,Music/Variety,,0
59,58,,Stars Fell on Alabama,1,12,2021.0,Romance,0 days 01:43:00.000000000,-1
90,57,,Gun and a Hotel Bible,1,7,2019.0,Drama,0 days 00:57:00.000000000,-33
20,53,,"If Not Now, When?",1,17,2021.0,Drama,0 days 01:51:00.000000000,33
90,50,,"ariana grande: excuse me, i love you",500,6,2020.0,Documentary/Music,,-40
27,69,https://resizing.flixster.com/up_1bNwlb6Nhb6N3L9YirrO6yeE=/206x305/v2/https://resizing.flixster.com/KYuAE2hI5NLdYxoXuEjlttEXwf0=/ems.ZW1zLXByZC1hc3NldHMvbW92aWVzLzZjYTQ1YTJhLWU4ZjUtNDc5OC1iOTJlLWVkMzgxMzE4MmE0ZC5qcGc=,Happily,50,45,2021.0,Romance/Comedy,0 days 01:36:00.000000000,42
40,43,,Caged,1,7,2021.0,Mystery and thriller,0 days 01:21:00.000000000,3
85,84,,Finding 'Ohana,250,19,2021.0,Adventure/Action,0 days 02:03:00.000000000,-1
16,0,,The Minimalists: Less Is Now,1,5,2021.0,Documentary,,-16
30,43,,Locked Down,100,105,2021.0,Comedy/Romance,,13
43,27,,Bliss,250,96,2021.0,Sci fi,0 days 01:44:00.000000000,-16
78,88,,The Dig,500,147,2021.0,Drama,0 days 01:52:00.000000000,10
79,54,https://resizing.flixster.com/synJ7_Wwx7KThVe2z4T_8NT-2Z0=/206x305/v2/https://resizing.flixster.com/Z7Ne-81m13JYzLtqo4GoHoqTvv8=/ems.ZW1zLXByZC1hc3NldHMvbW92aWVzLzFiM2ZmNzE2LWNkZmMtNGY4My1hY2NjLWIyNzMwZWM4MGRiMi5qcGc=,Son of the South,1,13,2021.0,Drama,0 days 01:45:00.000000000,-25
71,69,https://resizing.flixster.com/TZ6HfPQ9l9S4vkS8ImOYCpIVsZs=/206x305/v2/https://resizing.flixster.com/5jUdc31y09hiB_6-oVoaq5Qjk3w=/ems.ZW1zLXByZC1hc3NldHMvbW92aWVzLzYyM2Y2Y2NiLWUzOWMtNGI1ZC1hMjQyLWFlZDA4Nzk1YTJhZi5qcGc=,Moxie,250,104,2021.0,Drama/Comedy,0 days 01:51:00.000000000,-2
92,29,,Long Live Rock... Celebrate the Chaos,1,7,2021.0,Documentary/Music,0 days 01:20:00.000000000,-63
32,44,,Quartet,100,16,1981.0,Drama,0 days 01:41:00.000000000,12
80,100,https://resizing.flixster.com/xeLlEQKKnXfAsEq0RZFh6u8tGqE=/206x305/v2/https://resizing.flixster.com/GPxZZD0SB_6cGGUIgKCJ0tcPlxU=/ems.ZW1zLXByZC1hc3NldHMvbW92aWVzLzRkMDIyNzMzLTg2ZWMtNDA2OS1hM2RjLTc3NzgyYjExYzQzNC53ZWJw,The Return of Martin Guerre,2500,16,1982.0,Drama/History,0 days 02:02:00.000000000,20
75,100,,The Garden,500,6,1990.0,Gay and lesbian/Drama,0 days 01:35:00.000000000,25
58,86,,The Story of Temple Drake,250,7,1933.0,Drama,0 days 01:10:00.000000000,28
86,86,https://resizing.flixster.com/mCAxxKGK9o-_EO4gWLsyWJHOCa4=/206x305/v2/https://flxt.tmsimg.com/assets/p168846_p_v8_aa.jpg,Joan the Maid: The Battles,250,7,1994.0,Drama/History,0 days 01:52:00.000000000,0
79,94,,Cluny Brown,500,16,1946.0,Comedy,0 days 01:40:00.000000000,15
71,100,,Seven Days to Noon,250,5,1950.0,Mystery and thriller,0 days 01:33:00.000000000,29
82,90,,Shazam!,10000,409,2019.0,Action/Fantasy,0 days 02:12:00.000000000,8
43,37,,The Edge of Love,50000,59,2008.0,Romance/Drama,0 days 01:51:00.000000000,-6
64,88,,It Always Rains on Sunday,100,17,1947.0,Crime/Drama,0 days 01:32:00.000000000,24
28,13,https://resizing.flixster.com/FE7kB34HFNtW5p6tstELdb9wCis=/206x305/v2/https://resizing.flixster.com/qTqTwMNknFeTD3rbCcO6TlNbsc4=/ems.ZW1zLXByZC1hc3NldHMvbW92aWVzL2QzYzc5NjZmLTc1N2QtNGNlMC1iNmZiLTMxMjMxODZhZGU0Yi53ZWJw,Love Ranch,1000,52,2010.0,Drama,0 days 01:58:00.000000000,-15
96,77,,Bad Boys for Life,25000,262,2020.0,Action/Comedy,0 days 02:04:00.000000000,-19
86,95,,The Irishman,1000,450,2019.0,Crime/Drama,0 days 03:29:00.000000000,9
50,100,,Gebo and the Shadow,100,9,2012.0,Drama,0 days 01:35:00.000000000,50
71,100,https://resizing.flixster.com/rIB2a1eu-ea0rx6HUlD1W1yg9io=/206x305/v2/https://resizing.flixster.com/rhmvdhSwagKe_GvGMtwEBW3BTpM=/ems.ZW1zLXByZC1hc3NldHMvbW92aWVzLzY0ODQ2YjE2LWE4ZTEtNDk0MS1iMzczLTFiNzZmZjQ2YTNhMC53ZWJw,Olivia,1,10,1951.0,Gay and lesbian/Drama,0 days 01:36:00.000000000,29
72,77,https://resizing.flixster.com/N5z8xYUF3JiytrYVPxb1lF9q0gM=/206x305/v2/https://resizing.flixster.com/s5FlC44_AuMRImbowv_byVmxb0M=/ems.ZW1zLXByZC1hc3NldHMvbW92aWVzLzVjYWI3ODk1LTU2ZWItNGE1OS1hMDE2LWVmZjUyY2Y1NDIzMC53ZWJw,Scary Stories to Tell in the Dark,5000,231,2019.0,Horror/Mystery and thriller,0 days 01:51:00.000000000,5
83,100,,D-Day: Normandy 1944,250,6,2014.0,Documentary,0 days 00:43:00.000000000,17
83,42,https://resizing.flixster.com/cQcaeq5ME3jIu7UJqkxA4CTVa3E=/206x305/v2/https://resizing.flixster.com/0Z4m16xjwGm80FJv9BzHkxjtpwo=/ems.ZW1zLXByZC1hc3NldHMvbW92aWVzLzlhNjk4MzYyLTVjMjMtNDE2MS04OTA2LWExMDIzNGUwNTgwOC53ZWJw,Godzilla: King of the Monsters,25000,347,2019.0,Adventure/Sci fi,0 days 02:12:00.000000000,-41
71,50,,Freetown,1000,12,2015.0,Drama,0 days 01:56:00.000000000,-21
86,51,,Star Wars: The Rise of Skywalker,50000,507,2019.0,Fantasy/Action,0 days 02:22:00.000000000,-35
94,97,,Toy Story 4,50000,450,2019.0,Comedy/Kids and family,0 days 01:40:00.000000000,3
54,92,,The Grief of Others,50,12,2015.0,Drama,0 days 01:43:00.000000000,38
92,78,/assets/pizza-pie/images/poster_default.c8c896e70c3.gif,Frozen II,25000,330,2019.0,Comedy/Kids and family,0 days 01:43:00.000000000,-14
75,90,https://resizing.flixster.com/vudgFSSJxpbcbYJSN5SiRo6QYOM=/206x305/v2/https://flxt.tmsimg.com/assets/p11804231_p_v8_aa.jpg,Dude Bro Party Massacre III,100,10,2015.0,Comedy/Horror,0 days 01:43:00.000000000,15
90,94,/assets/pizza-pie/images/poster_default.c8c896e70c3.gif,Avengers: Endgame,50000,538,2019.0,Sci fi/Action,0 days 03:01:00.000000000,4
90,60,,The Secret Life of Pets 2,10000,163,2019.0,Animation/Comedy,0 days 01:26:00.000000000,-30
44,34,,Wonder Park,500,108,2019.0,Comedy/Kids and family,0 days 01:25:00.000000000,-10
35,27,,Phil,1,26,2019.0,Comedy/Drama,0 days 01:41:00.000000000,-8
60,60,,Ophelia,1,131,2018.0,Romance/Drama,0 days 01:54:00.000000000,0
55,59,https://resizing.flixster.com/LTQktji9Qk2UH953jKcVYOsXp50=/206x305/v2/https://resizing.flixster.com/FKSS1RtV2lUOB3qPQ_vshLnMPss=/ems.ZW1zLXByZC1hc3NldHMvbW92aWVzL2U0MTY3ZjA3LTlkMzItNDI2Ni05NzAxLTIwYTAzNjQ3OTI3Ni53ZWJw,Under the Silver Lake,500,152,2018.0,Comedy/Mystery and thriller,0 days 02:19:00.000000000,4
92,61,,Alita: Battle Angel,25000,327,2019.0,Sci fi/Animation,0 days 02:02:00.000000000,-31
67,44,,Three Christs,50,48,2017.0,Drama,0 days 01:59:00.000000000,-23
37,19,https://resizing.flixster.com/X-NAoBs3Z5cHSFYPMWyF7HVB4vY=/206x305/v2/https://resizing.flixster.com/ce-Its9rf2E2LjVmLb2EdxIPao4=/ems.ZW1zLXByZC1hc3NldHMvbW92aWVzL2U3YTBhOTUzLTg3ZGEtNGZmMy05ZjU3LTliZjNhOTFhZjNhYS53ZWJw,Euphoria,1,27,2017.0,Drama,0 days 01:38:00.000000000,-18
80,41,,The Professor and the Madman,500,32,2019.0,Drama/Biography,0 days 02:05:00.000000000,-39
81,67,,Burn Your Maps,50,15,2016.0,Comedy/Drama,0 days 01:42:00.000000000,-14
45,83,,My Hindu Friend,1,6,2020.0,Drama,,38
50,58,https://resizing.flixster.com/BhkkGx1IRWRNOicLR99RHZlhtAw=/206x305/v2/https://resizing.flixster.com/O33zypoSH-VNoYm_9xmnKPOrwn0=/ems.ZW1zLXByZC1hc3NldHMvbW92aWVzL2I4OTEwMjAyLTFiYTgtNDhmZS04NjQ5LWE2MTkyZWU5ZGE2Zi53ZWJw,Crosscurrent,1,12,2016.0,Drama,0 days 01:56:00.000000000,8
62,18,,Playmobil: The Movie,100,62,2019.0,Comedy/Kids and family,0 days 01:39:00.000000000,-44
93,63,https://resizing.flixster.com/KlcT35A3b-y5DItq7FpkkP2YU1U=/206x305/v2/https://resizing.flixster.com/QnQQnPJcU9atiY8pA7rzZkjJLt8=/ems.ZW1zLXByZC1hc3NldHMvbW92aWVzLzY2NGIyNDY3LTM5N2ItNGVjMy05MWE4LWI5YzNhZGUxYmJhMi53ZWJw,Sonic the Hedgehog,10000,240,2020.0,Adventure/Comedy,0 days 01:40:00.000000000,-30
38,20,https://resizing.flixster.com/IfFYCi8iDlcny_nm8NGpP4PPrbI=/206x305/v2/https://resizing.flixster.com/TbM7UhLHstL-mWwYin1Asmfo3qE=/ems.ZW1zLXByZC1hc3NldHMvbW92aWVzL2NlZDE4ODllLWU4YmItNGMzYi1iNTgzLWFkOTliNzU1NDMxYi53ZWJw,The Pretenders,1,10,2018.0,,,-18
95,81,,Abominable,5000,166,2019.0,Animation/Comedy,0 days 01:37:00.000000000,-14
95,90,,Spider-Man: Far From Home,50000,448,2019.0,Action/Fantasy,0 days 02:09:00.000000000,-5
59,100,,Snatchers,100,16,2019.0,Sci fi/Comedy,0 days 01:36:00.000000000,41
29,0,,Polaroid,2500,5,2019.0,Horror/Mystery and thriller,0 days 01:28:00.000000000,-29
50,27,,The Aftermath,250,155,2019.0,Romance/Drama,0 days 01:49:00.000000000,-23
98,89,,May It Last: A Portrait of the Avett Brothers,250,9,2017.0,Documentary/Music,0 days 01:44:00.000000000,-9
54,27,,UglyDolls,1000,86,2019.0,Comedy/Kids and family,0 days 01:27:00.000000000,-27
69,50,https://resizing.flixster.com/h_iWEupp0iJO9-F-Xmj-5CwSFss=/206x305/v2/https://resizing.flixster.com/daq9Ha29PpItrfr_1vPvgvAeVCI=/ems.ZW1zLXByZC1hc3NldHMvbW92aWVzLzhhN2JjZWI4LWNiN2UtNDlhMi05YTQwLWViMDk0OGI1NWZiMy53ZWJw,Who Killed Cock Robin?,1,6,2017.0,Crime/Drama,0 days 01:58:00.000000000,-19
76,14,https://resizing.flixster.com/M36Iydu9GjpyZ-eyi0QI3geXH1I=/206x305/v2/https://resizing.flixster.com/RCU10wNfi3bPIouEauj8cbwcJMs=/ems.ZW1zLXByZC1hc3NldHMvbW92aWVzL2E1OWIwMTdhLWI2MmMtNDY2OC05ZTgyLWQ1YjQ1ZDE2M2FkNi53ZWJw,Dolittle,10000,236,2020.0,Fantasy/Comedy,0 days 01:40:00.000000000,-62
64,91,https://resizing.flixster.com/lRB0qNYnGnu2hdt0VcXWrynm5_Q=/206x305/v2/https://resizing.flixster.com/d5bVUGaBwvPWQimEfkwP1e3abhs=/ems.ZW1zLXByZC1hc3NldHMvbW92aWVzL2FmMjMxMWNkLTc0YTYtNGMyNi1hYjRjLTAyNThlMTNlNzA5My53ZWJw,The Willoughbys,500,65,2020.0,Comedy/Kids and family,0 days 01:32:00.000000000,27
88,52,,The Lion King,50000,429,2019.0,Kids and family/Adventure,0 days 01:58:00.000000000,-36
64,22,/assets/pizza-pie/images/poster_default.c8c896e70c3.gif,Dark Phoenix,10000,377,2019.0,Fantasy/Action,0 days 01:54:00.000000000,-42
84,73,,The Angry Birds Movie 2,2500,110,2019.0,Adventure/Comedy,0 days 01:36:00.000000000,-11
78,29,https://resizing.flixster.com/P_SjIrldGmsKnkqLOyf0zUt19D0=/206x305/v2/https://resizing.flixster.com/6f_Mykzm_EtP5eo8WTtVilcgqG0=/ems.ZW1zLXByZC1hc3NldHMvbW92aWVzLzI1Yjg3YjQyLThhZmQtNDEyNi1iZWIzLTZjNjdhMWI0Y2JlMy53ZWJw,The Red Sea Diving Resort,500,41,2018.0,,,-49
80,78,,Until the Birds Return,1,9,2017.0,Drama,0 days 01:53:00.000000000,-2
78,52,,Charlie's Angels,2500,230,2019.0,Comedy/Action,0 days 01:58:00.000000000,-26
67,92,/assets/pizza-pie/images/poster_default.c8c896e70c3.gif,Rocko's Modern Life: Static Cling,250,24,2018.0,,,25
57,75,,The Last Photograph,1,8,2017.0,Drama,0 days 01:25:00.000000000,18
74,97,https://resizing.flixster.com/TO-EX0tl6gsTWrIRy94_2-C5G0s=/206x305/v2/https://resizing.flixster.com/3Zf7Opqq8qw_Plbn6RrkN28ceEk=/ems.ZW1zLXByZC1hc3NldHMvbW92aWVzL2NlMmIzOWNiLTM3NmUtNDgyZi04OWFmLTdmODBhMDk2ZDIyMS53ZWJw,Liyana,50,36,2017.0,Documentary,0 days 01:17:00.000000000,23
83,26,,Gemini Man,5000,315,2019.0,Mystery and thriller/Sci fi,0 days 01:57:00.000000000,-57
74,49,,"Where'd You Go, Bernadette",1000,188,2019.0,Comedy,0 days 01:44:00.000000000,-25
48,46,,Dumbo,2500,367,2019.0,Fantasy/Kids and family,0 days 01:52:00.000000000,-2
98,11,,Against the Night,250,9,2017.0,Horror,0 days 01:25:00.000000000,-87
75,74,,Super Size Me 2: Holy Chicken!,100,35,2017.0,Documentary,0 days 01:33:00.000000000,-1
86,89,https://resizing.flixster.com/ECOnH944qrij-4MALY6G8KZ1wwM=/206x305/v2/https://resizing.flixster.com/qeFoJv7Gq4Ap1KISeNSDu6piARQ=/ems.ZW1zLXByZC1hc3NldHMvbW92aWVzLzkwYTAzY2RhLTgzZDEtNDNjMC04OTc4LTFlM2U4NjlmMzViZC53ZWJw,Bodied,500,82,2017.0,Comedy,0 days 02:01:00.000000000,3
94,57,,Aladdin,50000,379,2019.0,Comedy/Kids and family,0 days 02:08:00.000000000,-37
49,92,,Maze,50,13,2017.0,Drama/Mystery and thriller,0 days 01:32:00.000000000,43
40,83,,Ad Astra,10000,384,2019.0,Mystery and thriller/Sci fi,0 days 02:04:00.000000000,43
86,89,https://resizing.flixster.com/-ypH3U5hg9135WtTAWRx5DnfN38=/206x305/v2/https://resizing.flixster.com/zCMUkiWZ0mQAc_xhuHW7oxR7Lpg=/ems.ZW1zLXByZC1hc3NldHMvbW92aWVzL2VjN2RlNDY3LWI3NGMtNDU1ZS1iMDllLTQ1N2Q3OTBkNjM4MC53ZWJw,John Wick: Chapter 3 -- Parabellum,25000,349,2019.0,Action/Mystery and thriller,0 days 02:11:00.000000000,3
83,91,,The Other Side of Everything,1,11,2017.0,Documentary/Biography,0 days 01:40:00.000000000,8
58,71,,Trolls World Tour,1000,160,2020.0,Comedy/Kids and family,0 days 01:31:00.000000000,13
19,63,https://resizing.flixster.com/4Qnlzwh4DFzdPCluYmHfscoQKm0=/206x305/v2/https://resizing.flixster.com/3p7f2R2yIuauY0fvpPMhF1vQLs8=/ems.ZW1zLXByZC1hc3NldHMvbW92aWVzLzlmMTIzNWZiLWFmY2YtNGUzYS04ZTM3LTYxYzQ0NDJkZDZjZC53ZWJw,My Son,1,24,2017.0,Drama,0 days 01:24:00.000000000,44
82,70,,Terminator: Dark Fate,10000,343,2019.0,Sci fi/Action,0 days 02:08:00.000000000,-12
78,62,,It: Chapter Two,25000,376,2019.0,Horror/Mystery and thriller,0 days 02:49:00.000000000,-16
66,23,https://resizing.flixster.com/eL7TOOGvlZQvNy4Nr72fkbTxDso=/206x305/v2/https://resizing.flixster.com/hTYdiao4bCqZ8B_4VwjeEWRt9Rk=/ems.ZW1zLXByZC1hc3NldHMvbW92aWVzLzFhNDhmNDIyLTAzZjEtNDFhNC1iOWM0LTdkYzkwMWYxMjRmZC53ZWJw,Men in Black: International,10000,318,2019.0,Comedy/Sci fi,0 days 01:55:00.000000000,-43
74,81,,Long Shot,2500,299,2019.0,Romance,0 days 02:03:00.000000000,7
92,76,,Spies in Disguise,5000,123,2019.0,Comedy/Kids and family,0 days 01:42:00.000000000,-16
37,48,,Eli,500,25,2019.0,Horror/Mystery and thriller,0 days 01:38:00.000000000,11
68,45,,47 Meters Down: Uncaged,1000,89,2019.0,Adventure/Horror,0 days 01:29:00.000000000,-23
44,28,,The Rhythm Section,1000,180,2020.0,Action/Mystery and thriller,0 days 01:49:00.000000000,-16
44,66,,Peterloo,100,160,2018.0,Drama/History,0 days 02:34:00.000000000,22
96,60,,The Last Full Measure,1000,75,2019.0,Drama/War,0 days 01:56:00.000000000,-36
49,45,,Inherit the Viper,1,20,2019.0,Crime/Drama,0 days 01:30:00.000000000,-4
94,33,,Shaft,5000,129,2019.0,Action/Comedy,0 days 01:51:00.000000000,-61
38,83,,Four Hands,1,12,2017.0,Drama/Mystery and thriller,0 days 01:34:00.000000000,45
48,18,https://resizing.flixster.com/uxjj3QLHd-5ZupD0UGAvrq7hvA0=/206x305/v2/https://resizing.flixster.com/usZ2X78JRdh_xu6HpYqVMburdDQ=/ems.ZW1zLXByZC1hc3NldHMvbW92aWVzLzQ1MWVjOTc1LWVlNjItNDE5ZC1hMWYwLTJjYzNjZDM0NjZkMi53ZWJw,Hellboy,2500,217,2019.0,Action/Fantasy,0 days 02:00:00.000000000,-30
33,57,https://resizing.flixster.com/xnas9b5BlIP_w0_DlUa8mLQYcoc=/206x305/v2/https://resizing.flixster.com/6wKQz5kg65ngMKW2vKMQFGN1XFo=/ems.ZW1zLXByZC1hc3NldHMvbW92aWVzL2ZmZDhiYjVlLTY0MTgtNDY4MS05MGFjLTlhM2Y1MTc4YTY5My53ZWJw,Pet Sematary,2500,278,2019.0,Horror/Mystery and thriller,0 days 01:41:00.000000000,24
79,67,https://resizing.flixster.com/QXDj1__44AqoLyBSLEop3YgwtUY=/206x305/v2/https://resizing.flixster.com/ZB3429-sqRYFKpwwIcEroI3d-eg=/ems.ZW1zLXByZC1hc3NldHMvbW92aWVzLzNjODBkMzQxLWEyMTMtNDEyMi05Yjc4LWQxZjIwMGVhMDIwNi53ZWJw,Pokémon Detective Pikachu,10000,310,2019.0,Adventure/Comedy,0 days 01:44:00.000000000,-12
51,75,https://resizing.flixster.com/2oUFgVbinf0N32nIwKorroYOcGA=/206x305/v2/https://resizing.flixster.com/ylihr5kRqIAqRsRDtlVTIKjfa6c=/ems.ZW1zLXByZC1hc3NldHMvbW92aWVzL2ZiYWU5MTVhLTA2YmYtNDg4NS1iYjZjLWEyOWY2MGVjZWE4OS53ZWJw,,100,28,,,,24
43,13,,The Hustle,2500,168,2019.0,Comedy,0 days 01:34:00.000000000,-30
80,96,,A Shaun the Sheep Movie: Farmageddon,250,75,2019.0,Kids and family/Animation,0 days 01:27:00.000000000,16
69,45,,The Addams Family,10000,157,2019.0,Comedy/Kids and family,0 days 01:27:00.000000000,-24
41,91,,Legend of the Demon Cat,50,11,2017.0,Fantasy/Mystery and thriller,0 days 02:09:00.000000000,50
93,92,https://resizing.flixster.com/DeuyGI-G5CPeKa0YECVZKw8Mb6s=/206x305/v2/https://resizing.flixster.com/sxvRSLcoLt3uvbA3UJNZId91BUI=/ems.ZW1zLXByZC1hc3NldHMvbW92aWVzLzMyYzczMzk0LTE4YTItNDRhYS04YjM4LTQwZDE2ZWJmNmEwOC53ZWJw,The Price of Everything,100,53,2018.0,Documentary,0 days 01:45:00.000000000,-1
74,82,,Light of My Life,250,55,2019.0,Drama,0 days 01:59:00.000000000,8
67,93,,Styx,50,42,2018.0,Drama/Mystery and thriller,0 days 01:34:00.000000000,26
62,94,https://resizing.flixster.com/HcV6wg_w4-1wnjh0i9vRN8nndWg=/206x305/v2/https://resizing.flixster.com/fuLC_psJNKDSk80jPIKxWTVBhwk=/ems.ZW1zLXByZC1hc3NldHMvbW92aWVzLzVhYTNiNTc2LTdjYjgtNDhhMy1iMTg0LWY5YzZiMDBlODFlZS53ZWJw,Transit,100,178,2018.0,History/Drama,0 days 01:41:00.000000000,32
42,82,https://resizing.flixster.com/SzHnmPgLQP-TjFUOHtpZoRe8QYU=/206x305/v2/https://resizing.flixster.com/tkxq2Y07m94vGt3Qhveub0-ujqU=/ems.ZW1zLXByZC1hc3NldHMvbW92aWVzL2JkYWFmMTZlLTQxZjUtNDdkZS04MWMxLTFkMDk1NDE1MzU4ZS53ZWJw,High Life,1000,234,2018.0,Sci fi/Mystery and thriller,0 days 01:53:00.000000000,40
72,90,https://resizing.flixster.com/4BjgBOXwtIJPba4DmH8-ZBDUkiY=/206x305/v2/https://resizing.flixster.com/QbtWmKxQR1fp2AnlgyxU4HxzBjY=/ems.ZW1zLXByZC1hc3NldHMvbW92aWVzL2Y5NjdiNWQxLTExZjEtNGMyNS1iZDY3LTg0ZjIzMGRjZjY2Ny53ZWJw,The Lighthouse,1000,381,2019.0,Mystery and thriller/Drama,0 days 01:50:00.000000000,18
68,90,,In the Aisles,1,39,2018.0,Romance/Drama,0 days 02:05:00.000000000,22
88,85,,Dora and the Lost City of Gold,5000,153,2019.0,Mystery and thriller/Comedy,0 days 01:42:00.000000000,-3
59,46,,Little,1000,158,2019.0,Comedy/Fantasy,0 days 01:49:00.000000000,-13
70,85,,Once Upon a Time... In Hollywood,25000,562,2019.0,Drama/Comedy,0 days 02:39:00.000000000,15
69,24,,The Kitchen,2500,228,2019.0,Crime/Drama,0 days 01:42:00.000000000,-45
61,52,,The Sun Is Also a Star,500,102,2019.0,Romance/Drama,0 days 01:40:00.000000000,-9
59,81,https://resizing.flixster.com/ZpV3ZfQCBEqfnGRJoMvOzbGoGwM=/206x305/v2/https://resizing.flixster.com/sL4aAAgDalKw3alYBv_7-lD2z8w=/ems.ZW1zLXByZC1hc3NldHMvbW92aWVzLzVhZjhjYzNlLTBiMmUtNDFhMS05Mzc0LTM3MzRiZGJjZmQ5NC53ZWJw,Fast Color,250,86,2018.0,Sci fi/Mystery and thriller,0 days 01:40:00.000000000,22
47,21,https://resizing.flixster.com/m3GIEG9npY4woC6gwf74c2A36D8=/206x305/v2/https://resizing.flixster.com/jDB5WULtohPMTl_GlfIVE22iLbY=/ems.ZW1zLXByZC1hc3NldHMvbW92aWVzL2ZkZWI5N2U4LWMwNDUtNDY2ZC05NWY4LWRkMGZlMzRhMDJmNi53ZWJw,Perfect,1,14,2018.0,Horror/Sci fi,0 days 01:25:00.000000000,-26
63,34,,Being Frank,50,41,2018.0,Comedy,0 days 01:49:00.000000000,-29
31,29,https://resizing.flixster.com/PwozC27-D6GoGQCp9B5RJkt8_p8=/206x305/v2/https://resizing.flixster.com/7QIEadZBdUo4PSkyyL9SsuOkKPI=/ems.ZW1zLXByZC1hc3NldHMvbW92aWVzLzM1OTYzYmI2LTM3YTktNGY3ZS1iMDJmLWU4MjRjZTdlY2Q4ZC53ZWJw,Iron Sky: The Coming Race,100,7,2019.0,Fantasy/Action,0 days 01:32:00.000000000,-2
83,50,https://resizing.flixster.com/0RdspNMptnmuK7GdR95vbaL9jW8=/206x305/v2/https://resizing.flixster.com/WiK0_89RM0gIub_TTlX_e6NNczM=/ems.ZW1zLXByZC1hc3NldHMvbW92aWVzLzY2NzAwNjczLTc5ZDEtNDdhNC1iMzg3LTI0MjkyNzgxMjc0Yi53ZWJw,High Strung Free Dance,100,6,2018.0,Romance,0 days 01:43:00.000000000,-33
79,63,,Breakthrough,1000,64,2019.0,Drama,0 days 01:56:00.000000000,-16
73,62,,Edie,100,42,2017.0,Drama,0 days 01:42:00.000000000,-11
23,21,,The Grudge,2500,125,2020.0,Horror/Mystery and thriller,0 days 01:34:00.000000000,-2
88,46,https://resizing.flixster.com/BevSi7H1gKqDmvZc4m8pCoe0fcU=/206x305/v2/https://resizing.flixster.com/peVuBxxI7sg7RwF42rB-3iYBbzQ=/ems.ZW1zLXByZC1hc3NldHMvbW92aWVzLzIxZDU0MzRlLTYyMzQtNGMzNy04YzE5LWNkZGI3MmNlNDAzZC53ZWJw,Girls of the Sun,1,50,2018.0,War/Drama,0 days 01:55:00.000000000,-42
54,95,,Little Woods,100,96,2018.0,Drama,0 days 01:45:00.000000000,41
64,92,https://resizing.flixster.com/1imGfJVLvBBluD0P1Cs64lNY25Q=/206x305/v2/https://resizing.flixster.com/-GUg5TXsiis1e9kFNuI0umEy6Zk=/ems.ZW1zLXByZC1hc3NldHMvbW92aWVzL2U1M2Y1NWI0LWUyNzktNDRiMi1iODI1LWFiNzVjOTQ1ZDFkYy53ZWJw,Netizens,1,13,2018.0,Documentary,0 days 01:36:00.000000000,28
99,85,,Just Mercy,10000,301,2019.0,Drama,0 days 02:16:00.000000000,-14
33,44,https://resizing.flixster.com/msXIACQf5e_viLWn6Y_MN2M9_tQ=/206x305/v2/https://resizing.flixster.com/qJXvt_IRPfzOG9jULwEgum8c9vM=/ems.ZW1zLXByZC1hc3NldHMvbW92aWVzL2VkZTRjN2VkLTdlNWQtNDE2NC04MTI2LTNkNWE1N2E4N2IzMy53ZWJw,Tone-Deaf,50,32,2019.0,Comedy/Horror,0 days 01:27:00.000000000,11
46,0,,Welcome to Curiosity,100,6,2018.0,Mystery and thriller,0 days 01:35:00.000000000,-46
95,60,,Surviving Confession,1,5,2018.0,,,-35
77,90,,Luce,250,162,2019.0,Drama,0 days 01:49:00.000000000,13
52,65,,Seven Stages to Achieve Eternal Bliss by Passing Through the Gateway Chosen by the Holy Storsh,1,17,2018.0,Comedy,0 days 01:36:00.000000000,13
86,80,https://resizing.flixster.com/MJfiWkyvYdMpb-S7yQDk09UchyE=/206x305/v2/https://resizing.flixster.com/C2UhHpKR34rYgEVEl3tRxPYcsV4=/ems.ZW1zLXByZC1hc3NldHMvbW92aWVzL2MzODU0ZTJkLWQyM2QtNDk4My1hNmIyLTI2OWRlMDVmMjQ4ZC53ZWJw,Good Boys,10000,245,2019.0,Comedy,0 days 01:35:00.000000000,-6
52,44,https://resizing.flixster.com/F-_UM2b1UmrI0zfairhMBuZbV34=/206x305/v2/https://resizing.flixster.com/ZySJOHVwDU4E2NIKKbZUYDHeV6I=/ems.ZW1zLXByZC1hc3NldHMvbW92aWVzL2YyNGVmYmRhLWJlYmYtNDhmMC1hNDFmLThhMWJlYWZiYzQ4Yi53ZWJw,The Wedding Year,50,9,2019.0,Romance,0 days 01:30:00.000000000,-8
73,71,,Danger Close: The Battle of Long Tan,100,35,2019.0,History/War,0 days 01:58:00.000000000,-2
91,50,,A Dog's Journey,2500,84,2019.0,Drama/Comedy,0 days 01:48:00.000000000,-41
67,88,https://resizing.flixster.com/cxB5Zu183vJhoW_Io2-RaumaWUg=/206x305/v2/https://resizing.flixster.com/c7mLhK0VaPBPciIl-8GnF9eWii8=/ems.ZW1zLXByZC1hc3NldHMvbW92aWVzL2Q5MWNmYTVjLTczYzAtNDAxMS1iMGQ4LTA0NmFmN2Y3ZjlhZS53ZWJw,Missing Link,500,171,2019.0,Animation/Comedy,0 days 01:34:00.000000000,21
69,99,,Ash Is Purest White,100,153,2018.0,Romance/Drama,0 days 02:21:00.000000000,30
97,95,/assets/pizza-pie/images/poster_default.c8c896e70c3.gif,Be Natural: The Untold Story of Alice Guy-Blaché,100,86,2018.0,Documentary,0 days 01:43:00.000000000,-2
65,77,https://resizing.flixster.com/RkcfheHKtIq9VkYHVeDA_jpW1OE=/206x305/v2/https://flxt.tmsimg.com/assets/p16319662_p_v10_ad.jpg,The Trouble With You,1,13,2018.0,Crime/Comedy,0 days 01:48:00.000000000,12
77,96,,Booksmart,2500,372,2019.0,Comedy/Gay and lesbian,0 days 01:42:00.000000000,19
31,36,,The Night Clerk,250,45,2020.0,Mystery and thriller,0 days 01:30:00.000000000,5
88,89,https://resizing.flixster.com/55AZFB1xj90R_i_FhrZta0bNte8=/206x305/v2/https://resizing.flixster.com/RHOQb7FbHKlJjumqOtjtC8BqIpA=/ems.ZW1zLXByZC1hc3NldHMvbW92aWVzL2JkNjlhM2U0LTIyY2YtNDUxMi1iMTY5LTc4MzdmZWZiZDk2Mi53ZWJw,Rocketman,10000,383,2019.0,Gay and lesbian/Drama,0 days 02:01:00.000000000,1
98,53,,Overcomer,5000,17,2019.0,Drama,0 days 01:55:00.000000000,-45
55,30,https://resizing.flixster.com/yxgZ05eUWlYq-BlDX0KhkztLncs=/206x305/v2/https://resizing.flixster.com/DOh_aET_NLmzcDsVkGVgvrTPZbo=/ems.ZW1zLXByZC1hc3NldHMvbW92aWVzLzYwMmIxZTFhLTdmYWMtNDQ2Zi04OWFmLTZkYzZmMTgxNDNjYi53ZWJw,Red Joan,100,151,2018.0,Crime/Drama,0 days 01:50:00.000000000,-25
60,37,,6 Underground,2500,93,2019.0,Action/Mystery and thriller,0 days 02:07:00.000000000,-23
87,71,https://resizing.flixster.com/KlkRlovVTOYugpqkqsiYNxrwO1s=/206x305/v2/https://resizing.flixster.com/9WoQhjmwV81hvOM_JAC2ho6sWcY=/ems.ZW1zLXByZC1hc3NldHMvbW92aWVzLzIxNGY4ZWM5LTYyYzAtNDYxZS04MDAyLWJhNzRmY2Y4MmJjZS53ZWJw,Jumanji: The Next Level,25000,246,2019.0,Action/Fantasy,0 days 02:03:00.000000000,-16
38,4,,Jacob's Ladder,100,23,2019.0,Mystery and thriller,0 days 01:29:00.000000000,-34
79,42,,Stuber,5000,227,2019.0,Comedy/Action,0 days 01:33:00.000000000,-37
88,88,,The Witch: Part 1. The Subversion (Manyeo),100,17,2018.0,,,0
57,89,https://resizing.flixster.com/xv38TZnCLzGlOGlj0-X8c657qRE=/206x305/v2/https://resizing.flixster.com/dralRqXausd41XhPbPR0SFg51hg=/ems.ZW1zLXByZC1hc3NldHMvbW92aWVzL2Y0NDc3NThiLWQ3OWItNDExNi1hM2MwLWViNTNmMzI0ZjBmOS53ZWJw,Beats,100,9,2019.0,Drama,0 days 01:49:00.000000000,32
54,23,https://resizing.flixster.com/AKwjRKz8nmOIZu6n4pc59o8IGVU=/206x305/v2/https://resizing.flixster.com/5mtT0ioarmnPsY7OR2rxwGqMMJE=/ems.ZW1zLXByZC1hc3NldHMvbW92aWVzLzI2ZWI0MDFmLWM2N2YtNGU5MC1iMjQ3LTdjODBiZjQ2ZmVlNi53ZWJw,Otherhood,100,26,2019.0,Comedy,0 days 01:40:00.000000000,-31
79,66,,The Public,100,97,2018.0,Drama,0 days 01:59:00.000000000,-13
40,90,https://resizing.flixster.com/gPcZ8vMZyNnDmbHwDN6mgcMrQUU=/206x305/v2/https://resizing.flixster.com/Fiv3uP4nGv49aopyNzz33V99WL8=/ems.ZW1zLXByZC1hc3NldHMvbW92aWVzLzMwNTFkZTBjLTlkZmMtNGZlYi1hNjJiLTc4MmMwNDI2ZGE4NS53ZWJw,Bit,1,10,2019.0,Comedy/Horror,0 days 01:30:00.000000000,50
95,39,,Maleficent: Mistress of Evil,10000,255,2019.0,Fantasy/Adventure,0 days 01:58:00.000000000,-56
44,77,,Nightmare Cinema,100,44,2018.0,Horror,0 days 01:59:00.000000000,33
94,84,https://resizing.flixster.com/mH14Gp19Nah2yrMd2tSebfCfcC0=/206x305/v2/https://resizing.flixster.com/oU-FMjDarmwRdoLM9VY0wslSc10=/ems.ZW1zLXByZC1hc3NldHMvbW92aWVzLzU5NzI2OTlhLWZlZmUtNDU5YS1iYzQ1LWYwOGQxNmVhMDYxMS53ZWJw,Downton Abbey,10000,253,2019.0,Drama,0 days 02:02:00.000000000,-10
38,54,,The Dead Don't Die,1000,306,2019.0,Comedy/Horror,0 days 01:43:00.000000000,16
38,58,,In the Shadow of the Moon,250,52,2019.0,Mystery and thriller,0 days 01:55:00.000000000,20
36,28,https://resizing.flixster.com/9gNgcSob-bA7MPxC5VRFwTj_WYY=/206x305/v2/https://resizing.flixster.com/eA-M-ruXAVxfRDL-m8UKn3N3wOI=/ems.ZW1zLXByZC1hc3NldHMvbW92aWVzLzRjNTViZjgzLThiMWItNDZiMC05NzliLWVmNTFhYmU0YjdiYi53ZWJw,The Curse of La Llorona,1000,186,2019.0,Horror/Mystery and thriller,0 days 01:33:00.000000000,-8
78,30,,Bloodshot,1000,161,2020.0,Action/Fantasy,0 days 01:49:00.000000000,-48
88,68,https://resizing.flixster.com/VdjwuTJx8svM9dlZrY_TagJAmf0=/206x305/v2/https://resizing.flixster.com/ES9ZDzXKtGZR9WyKaMuqhNHURJo=/ems.ZW1zLXByZC1hc3NldHMvbW92aWVzLzIzNjM3NmRhLWZiOWUtNGFjNC1hMTViLTM1ZWEzNWRkMzI1Zi53ZWJw,Joker,50000,584,2019.0,Crime/Drama,0 days 02:02:00.000000000,-20
88,69,,Zombieland: Double Tap,10000,251,2019.0,Horror/Action,0 days 01:39:00.000000000,-19
62,100,,Stray,1,9,2018.0,Drama,0 days 01:44:00.000000000,38
92,83,,Queen & Slim,10000,221,2019.0,Crime/Romance,0 days 02:12:00.000000000,-9
79,94,,Shadow,250,102,2018.0,Action/Adventure,0 days 01:56:00.000000000,15
59,79,,Loro,100,75,2018.0,Drama/Biography,0 days 02:38:00.000000000,20
68,18,,After,2500,38,2019.0,Drama/Romance,0 days 01:46:00.000000000,-50
57,83,,Daniel Isn't Real,100,80,2019.0,Horror/Mystery and thriller,0 days 01:36:00.000000000,26
44,86,,The Weekend,50,22,2018.0,Comedy,0 days 01:26:00.000000000,42
87,92,,Wild Rose,100,192,2018.0,Comedy/Drama,0 days 01:41:00.000000000,5
100,92,,The Most Dangerous Year,1,12,2018.0,Documentary,0 days 01:30:00.000000000,-8
76,65,,The Riot Act,50,20,2018.0,Western/Mystery and thriller,0 days 01:41:00.000000000,-11
81,67,https://resizing.flixster.com/e0Lk6JZoEhvTYuWVX9VpX7i2ChQ=/206x305/v2/https://resizing.flixster.com/J9uRSMDLOaj-WhajESz_h6KtGzc=/ems.ZW1zLXByZC1hc3NldHMvbW92aWVzLzliZGQ0NmU0LTI5ZTMtNGIyNi04YjdiLWZhZWQyOTZiM2IzYi5qcGc=,The White Crow,250,133,2018.0,Drama/History,0 days 02:07:00.000000000,-14
52,91,https://resizing.flixster.com/cLGiJoxf3CW5YrU6U_ndjFeEwwE=/206x305/v2/https://resizing.flixster.com/KHrojhpYvGT5-fssKMhb-PqxINs=/ems.ZW1zLXByZC1hc3NldHMvbW92aWVzLzBkYjM5NGU2LWQ3NzMtNGFjMi05NDMwLWY2YTc5N2M0N2E3Yi53ZWJw,Uncut Gems,10000,338,2019.0,Comedy/Mystery and thriller,0 days 02:15:00.000000000,39
95,72,,The Aeronauts,1,187,2019.0,Drama/Adventure,0 days 01:41:00.000000000,-23
93,60,,The Pilgrim's Progress,1,5,2019.0,Adventure/Animation,0 days 01:48:00.000000000,-33
62,100,https://resizing.flixster.com/Df7WU_oyXHKNh9rkKgvaMApVSBQ=/206x305/v2/https://resizing.flixster.com/mHXgoIbkSOTS794yu8Fzmb9_5oU=/ems.ZW1zLXByZC1hc3NldHMvbW92aWVzL2JmNWZiODIyLTEyMmItNDQyMi04MjYwLWZiYjI1MzQ5MDQzMi53ZWJw,"A Bread Factory, Part One: For the Sake of Gold",50,30,2018.0,,,38
56,100,https://resizing.flixster.com/sq3fuLs0J3MQEFRzMgp3c_IpxcM=/206x305/v2/https://resizing.flixster.com/bfFNDP4VaKE6xTvUetXXWA50Q2A=/ems.ZW1zLXByZC1hc3NldHMvbW92aWVzLzkzYWJhODkyLTQwMDgtNDc0Yi1hZGM0LTcwMmE3NzU2OWMwOS53ZWJw,"A Bread Factory, Part Two: Walk with Me a While",1,22,2018.0,,,44
81,90,,Trust Machine: The Story of Blockchain,50,10,2018.0,Documentary,0 days 01:24:00.000000000,9
82,89,,Wayne,1,9,2018.0,Documentary/Biography,0 days 01:37:00.000000000,7
66,72,https://resizing.flixster.com/cXQoEOV10HmgrpdlG_Jzp2_XrpI=/206x305/v2/https://resizing.flixster.com/cih0BX5hFNZwehUcGV96NTc1JcQ=/ems.ZW1zLXByZC1hc3NldHMvbW92aWVzL2VlNWE5NTBkLTlhMDgtNGViMC1hZWYyLTRhNGU5MmQyNDRkZi53ZWJw,Low Tide,50,32,2019.0,Drama,0 days 01:26:00.000000000,6
62,87,https://resizing.flixster.com/AQlvdehpePxLiEO9rk5vLUCVnvs=/206x305/v2/https://resizing.flixster.com/Yr3nK-Mj-xw1phgkWTbrRXMU9uY=/ems.ZW1zLXByZC1hc3NldHMvbW92aWVzL2I1MDE1ODIxLTBhYTctNGQxNi04ZjY2LTMwMDk4NWVkY2I4NC53ZWJw,What You Gonna Do When The World's On Fire?,1,47,2018.0,Documentary,0 days 02:03:00.000000000,25
86,90,https://resizing.flixster.com/rg1emCVYw-8lT1KK-zY72ahf2ps=/206x305/v2/https://resizing.flixster.com/ZrDQ6t-TMTm2eDsfg9O4I4REFPI=/ems.ZW1zLXByZC1hc3NldHMvbW92aWVzL2E1YWYwMzE2LWZhODctNDcyNS05OTFlLWViYzYxNWIyZTMyZC53ZWJw,Tel Aviv on Fire,1,61,2018.0,Comedy/Drama,0 days 01:37:00.000000000,4
74,61,,Trial by Fire,100,70,2018.0,Drama/Biography,0 days 02:07:00.000000000,-13
50,58,,Close Enemies (Freres Ennemis),1,12,2018.0,,,8
71,59,,Charlie Says,100,74,2018.0,Drama,0 days 01:50:00.000000000,-12
53,19,https://resizing.flixster.com/AccIu9t0wJB_2u4jAZMG2PFpgmo=/206x305/v2/https://resizing.flixster.com/V9VT4k6lmo7ChSme60no5AVtBjE=/ems.ZW1zLXByZC1hc3NldHMvbW92aWVzLzhkNmJmZWRkLWQxNDQtNGM4Zi1iZjFhLTRhYThkZTQxNzBhMC53ZWJw,Cats,5000,326,2019.0,Comedy/Drama,0 days 01:50:00.000000000,-34
22,42,https://resizing.flixster.com/NItrNm8cuxP6vwBH2fCQIGIsAkA=/206x305/v2/https://resizing.flixster.com/eK5g4dZtHmFHt9SWXIJC6-88-Pk=/ems.ZW1zLXByZC1hc3NldHMvbW92aWVzLzA5ODJhNTQ3LWE1MGQtNGI3Yy04NzI2LWFmNDdmMGY3YTU2NC53ZWJw,Seeds,1,12,2018.0,Horror/Mystery and thriller,0 days 01:30:00.000000000,20
48,27,,A Million Little Pieces,50,48,2018.0,Drama,0 days 01:53:00.000000000,-21
55,20,,The Death and Life of John F. Donovan,100,30,2018.0,Drama,0 days 02:03:00.000000000,-35
47,57,,The Hummingbird Project,100,122,2018.0,Drama,0 days 01:51:00.000000000,10
57,69,,The Command,100,51,2018.0,Drama,0 days 01:57:00.000000000,12
83,76,https://resizing.flixster.com/t2ckNaFP7WwzHUvpGpDiQVzyT3k=/206x305/v2/https://resizing.flixster.com/u8eawqUZ7T-b9A0sdApAOrvBUmo=/ems.ZW1zLXByZC1hc3NldHMvbW92aWVzLzRjNjBiYTg2LWZhNDctNGY5My05MWZlLWYzODk1MzFjZTVlNC53ZWJw,Skin,250,80,2018.0,Drama/Biography,0 days 01:58:00.000000000,-7
58,71,,Teen Spirit,250,130,2018.0,Drama/Music,0 days 01:32:00.000000000,13
60,42,,Vita & Virginia,50,91,2018.0,Romance/Gay and lesbian,0 days 01:50:00.000000000,-18
37,44,,The Wedding Guest,50,73,2018.0,Mystery and thriller,0 days 01:34:00.000000000,7
50,91,,In Fabric,250,159,2018.0,Comedy/Horror,0 days 01:58:00.000000000,41
70,39,,Nekrotronic,50,23,2018.0,Sci fi/Comedy,0 days 01:39:00.000000000,-31
65,63,https://resizing.flixster.com/-DRxcVO0mljKP44rQRpdT8V5z-A=/206x305/v2/https://resizing.flixster.com/KO8TZU9ho1l-s_kv-BzgXk4u9Wc=/ems.ZW1zLXByZC1hc3NldHMvbW92aWVzLzQ4ZjcyZThiLTczNTctNDExNi1hMjczLTFhNzMyMTJmYTIxOS53ZWJw,Driven,100,51,2018.0,Drama/Comedy,0 days 01:48:00.000000000,-2
86,88,/assets/pizza-pie/images/poster_default.c8c896e70c3.gif,Freaks,100,84,2018.0,Sci fi/Mystery and thriller,0 days 01:45:00.000000000,2
78,72,,Gwen,100,64,2018.0,Horror/Drama,0 days 01:24:00.000000000,-6
97,98,,Maiden,100,118,2018.0,Documentary,0 days 01:33:00.000000000,1
91,91,,The Elephant Queen,50,22,2018.0,Documentary/Drama,0 days 01:36:00.000000000,0
60,78,https://resizing.flixster.com/lF8pxkXWmBRtWaApECAwA4MOIOw=/206x305/v2/https://flxt.tmsimg.com/assets/p17106479_p_v13_af.jpg,The Boat,50,9,2018.0,Drama/Mystery and thriller,0 days 01:40:00.000000000,18
33,36,https://resizing.flixster.com/oqeOLderbRuq-bV8a3_VGdVC2U4=/206x305/v2/https://resizing.flixster.com/8cthHXeicWqxMdZ46Wk1AWHC9x0=/ems.ZW1zLXByZC1hc3NldHMvbW92aWVzLzMwNDZiNzgwLWI3MWYtNDI0YS04ZjdiLWY3MWZmNWRlOGU4Yy53ZWJw,In the Tall Grass,500,73,2019.0,Horror/Drama,0 days 01:30:00.000000000,3
38,14,,Sextuplets,50,14,2019.0,Comedy,0 days 01:39:00.000000000,-24
67,67,https://resizing.flixster.com/lW4Jrqn24h6o0QchGDUJBKQ09uQ=/206x305/v2/https://resizing.flixster.com/UpYUJQY31gHy41mjISueA0pEFyw=/ems.ZW1zLXByZC1hc3NldHMvbW92aWVzLzRkMzIxNTc4LTI5Y2UtNGRhNC1hOTE1LTI3YTJkMzc5ZjhkNi53ZWJw,Skin in the Game,1,6,2018.0,Drama/Mystery and thriller,0 days 01:30:00.000000000,0
47,33,,Look Away,1,6,2019.0,Comedy/Drama,0 days 01:30:00.000000000,-14
97,63,https://resizing.flixster.com/KjGACHugr7PQp-xRtsXxhY_wMO0=/206x305/v2/https://resizing.flixster.com/Zog386UNBYXBeLXUempMgpzb3G8=/ems.ZW1zLXByZC1hc3NldHMvbW92aWVzLzJkYzA4MTQyLTFjZTEtNDY4ZS1hZGVhLTM3NjljMzMxMzRjOC53ZWJw,Brian Banks,1000,72,2018.0,Drama/Biography,0 days 01:39:00.000000000,-34
23,84,,Girl on the Third Floor,250,37,2019.0,Horror/Mystery and thriller,0 days 01:33:00.000000000,61
50,94,,The Dead Center,50,18,2018.0,Mystery and thriller,0 days 01:33:00.000000000,44
80,100,https://resizing.flixster.com/qwzBKRHuigJBlQyc2Y3s_trsOfQ=/206x305/v2/https://flxt.tmsimg.com/assets/p16194307_p_v8_aa.jpg,Making Montgomery Clift,1,15,2018.0,Documentary,0 days 01:28:00.000000000,20
78,78,https://resizing.flixster.com/Z2wwW0uGDmBLYr1_HN3ZAd-jPXk=/206x305/v2/https://resizing.flixster.com/AvapwqD9kdFHB3mmFfFKKOn5Xbs=/ems.ZW1zLXByZC1hc3NldHMvbW92aWVzL2ZkNjI0NWUzLWVlOGEtNGM3Yi05MjQzLTVjMzE4NWYzZmI5Mi53ZWJw,Birds of Prey (and the Fantabulous Emancipation of One Harley Quinn),10000,427,2020.0,Action/Comedy,0 days 01:49:00.000000000,0
29,52,,Ladyworld,1,21,2018.0,Mystery and thriller,0 days 01:33:00.000000000,23
70,80,,A Simple Wedding,50,15,2018.0,Romance,0 days 01:28:00.000000000,10
76,53,,American Dreamer,50,15,2018.0,Mystery and thriller,0 days 01:32:00.000000000,-23
52,14,https://resizing.flixster.com/CxUF0kfz9les1h2EI24QmvwoeZQ=/206x305/v2/https://resizing.flixster.com/LNm4BUBFeOoQgijHE1EAEds8-o0=/ems.ZW1zLXByZC1hc3NldHMvbW92aWVzLzc0NzdmMjk2LTJkYjEtNDRlOS1hMzI1LWQ4ZGMzM2Y1ZDlmMC53ZWJw,Nomis,250,35,2018.0,Action/Mystery and thriller,0 days 01:38:00.000000000,-38
61,89,,Banana Split,100,54,2018.0,Comedy,0 days 01:28:00.000000000,28
49,63,,Wolkenbruchs wunderliche Reise in die Arme einer Schickse,1,8,2018.0,,,14
76,54,,The Best of Enemies,500,78,2019.0,Drama/History,0 days 02:13:00.000000000,-22
67,58,https://resizing.flixster.com/Ba9PSIJyGslLzSNw73qIGw9r8zE=/206x305/v2/https://resizing.flixster.com/ErbKpzbbUWE_7_32QLOuPriDepo=/ems.ZW1zLXByZC1hc3NldHMvbW92aWVzL2MwNzY2YThmLWM5ZDEtNDE3Yy1hYzcyLTQyOGQyYTBiYTFmNy53ZWJw,Brightburn,2500,205,2019.0,Sci fi/Horror,0 days 01:31:00.000000000,-9
68,33,,The Intruder,1000,101,2019.0,Drama/Mystery and thriller,0 days 01:42:00.000000000,-35
55,40,,El Chicano,100,25,2018.0,Action/Mystery and thriller,0 days 01:47:00.000000000,-15
52,89,,Master Z: Ip Man Legacy,250,37,2018.0,Action/Sports and fitness,0 days 01:48:00.000000000,37
87,85,https://resizing.flixster.com/xqGPRQBcYQpZPlPMWJCchk-F5qo=/206x305/v2/https://resizing.flixster.com/cJ9sNjGv2jhrCjHdt5WqONttkWE=/ems.ZW1zLXByZC1hc3NldHMvbW92aWVzLzJlNjFhNTM5LWEyMjItNDliYi05NzVkLTAxYjU0ZWFmYjM0OS53ZWJw,"Empathy, Inc.",50,27,2018.0,Sci fi/Drama,,-2
20,13,https://resizing.flixster.com/fWxM9_yMcJ4LsjOT_sPJ8qnPDWo=/206x305/v2/https://resizing.flixster.com/TOK8L4kWpWcuprk9fMYC-QDiDnc=/ems.ZW1zLXByZC1hc3NldHMvbW92aWVzLzBiZmYwNzUwLTMzYmQtNDQxYi05MmNmLTYwMjYxYjRhZGE2Ny53ZWJw,Prey,1,8,2019.0,Horror/Mystery and thriller,0 days 01:25:00.000000000,-7
48,10,,Intrigo: Death of an Author,1,10,2018.0,Crime/Drama,0 days 01:45:00.000000000,-38
17,28,https://resizing.flixster.com/SFQqeBcVE2g3F-oZ17pdW9TjAX4=/206x305/v2/https://flxt.tmsimg.com/assets/p17485090_p_v13_aa.jpg,Rattlesnake,100,18,2019.0,Horror/Drama,0 days 01:25:00.000000000,11
83,100,,Evelyn,1,7,2018.0,Documentary,0 days 01:40:00.000000000,17
90,98,https://resizing.flixster.com/enYPx96luLq0FWTdEpiWqX6rxMk=/206x305/v2/https://resizing.flixster.com/OCnoNZ2b2Z_Bpa0RX35IwYN1lLQ=/ems.ZW1zLXByZC1hc3NldHMvbW92aWVzLzZlZWEwMmY4LTk1OWUtNGEyOS04ODRmLTA0OWRjMzhlYWZkNi53ZWJw,Parasite,5000,458,2019.0,Drama/Mystery and thriller,0 days 02:12:00.000000000,8
58,67,https://resizing.flixster.com/v4VOrAcy4KZScAM_B6ATdf4bSQM=/206x305/v2/https://resizing.flixster.com/QQRwxojcVwG9ogacwlgP-PhHBDo=/ems.ZW1zLXByZC1hc3NldHMvbW92aWVzL2RmOTAyZjFkLWVmOGEtNDU4YS04YmFkLWE4OWY0OThjYjBmZC53ZWJw,The Parts You Lose,50,18,2019.0,Mystery and thriller/Drama,0 days 01:34:00.000000000,9
80,99,,Amazing Grace,250,158,2018.0,Documentary/Music,0 days 01:27:00.000000000,19
57,63,https://resizing.flixster.com/GQ-qIEkfggADVUQx1CR-o6kkkdA=/206x305/v2/https://resizing.flixster.com/6EVmqAP4a-HHbBNf_c-LtU62D1I=/ems.ZW1zLXByZC1hc3NldHMvbW92aWVzLzVhM2VhZDM5LTFiNTMtNDg2Zi1iZTVmLWY3NWJiZGJiMDNhZS53ZWJw,Child's Play,5000,205,2019.0,Horror/Mystery and thriller,0 days 01:30:00.000000000,6
71,12,,An Acceptable Loss,100,33,2018.0,Mystery and thriller,0 days 01:42:00.000000000,-59
83,100,,Boys,50,5,2018.0,Romance/Drama,0 days 01:22:00.000000000,17
67,71,https://resizing.flixster.com/rjTIC9RBRdIuNTvtvi5akzmOHTA=/206x305/v2/https://resizing.flixster.com/OcSv5jgqzy8WaHZi-Jp0tqDITZ0=/ems.ZW1zLXByZC1hc3NldHMvbW92aWVzLzU4MDU2OGU1LTI0YWItNDJhOC05MDVlLWM0YzAyMThiODcwYS53ZWJw,All Is True,250,139,2018.0,Drama/History,0 days 01:41:00.000000000,4
70,65,,Annabelle Comes Home,5000,206,2019.0,Horror/Mystery and thriller,0 days 01:46:00.000000000,-5
50,86,https://resizing.flixster.com/YV5lKykVFxtV13XHksr98thuENQ=/206x305/v2/https://resizing.flixster.com/AdWqtM-4F1QK2XpmxTTnPHR2ouk=/ems.ZW1zLXByZC1hc3NldHMvbW92aWVzLzBhNTBkOWQ4LWY4ZGYtNDQwYi05OGJkLWNjNjY4MTQ5NTIwOS53ZWJw,Plagues of Breslau,50,7,2018.0,Crime/Drama,0 days 01:33:00.000000000,36
82,86,https://resizing.flixster.com/__LrEzZ77UpxzZa0uD7cpUqBq44=/206x305/v2/https://resizing.flixster.com/REiWwBreAAAdkfnJAtM95OmDoDs=/ems.ZW1zLXByZC1hc3NldHMvbW92aWVzL2Q5NTY2ODNlLTQwODYtNDNiMi1iYTlkLTdjZWJhMjJhZDRmMy53ZWJw,Big Time Adolescence,250,83,2019.0,Comedy,0 days 01:30:00.000000000,4
87,88,,Brittany Runs a Marathon,1000,185,2019.0,Comedy/Drama,0 days 01:43:00.000000000,1
65,92,,Clemency,50,149,2019.0,Drama,0 days 01:53:00.000000000,27
87,97,https://resizing.flixster.com/6o-mUmCmNOcK7Aem2E6Tu6unrLU=/206x305/v2/https://resizing.flixster.com/KkoOfLvrPv5GfLT0OV06Z8t-YDw=/ems.ZW1zLXByZC1hc3NldHMvbW92aWVzLzQwMjExNjhjLWMzZWEtNGQ2ZC04MDE2LWJjMzM1YjBlZmVmZi53ZWJw,The Farewell,1000,341,2019.0,Comedy/Drama,0 days 01:40:00.000000000,10
93,38,,Angel Has Fallen,10000,186,2019.0,Mystery and thriller/Action,0 days 02:01:00.000000000,-55
92,94,,Honey Boy,500,231,2019.0,Drama,0 days 01:33:00.000000000,2
57,64,,Imaginary Order,1,14,2019.0,Comedy/Drama,0 days 01:41:00.000000000,7
84,92,,The Last Black Man in San Francisco,500,206,2019.0,Drama,0 days 02:01:00.000000000,8
65,79,,Photograph,100,90,2019.0,Romance/Drama,0 days 01:48:00.000000000,14
81,89,,Socrates,1,28,2018.0,Drama,0 days 01:11:00.000000000,8
45,59,https://resizing.flixster.com/xikWKMYLPa0OIjzK--s3mCgn47E=/206x305/v2/https://resizing.flixster.com/83h1qlYCZRxEZ0NBX-qCfZW6QYc=/ems.ZW1zLXByZC1hc3NldHMvbW92aWVzLzJlZTRjZTc5LTg2YzgtNDhkYi1iZjJjLTBjYzNmODg1YjU0NS53ZWJw,Them That Follow,100,93,2019.0,Drama/Mystery and thriller,0 days 01:38:00.000000000,14
76,82,https://resizing.flixster.com/6NnM7HY8-WUNCRq3E0uK--lR0dM=/206x305/v2/https://resizing.flixster.com/q1a4t5p4HfeWiSuB8L0OiaZ0MqE=/ems.ZW1zLXByZC1hc3NldHMvbW92aWVzL2ZkOTA4NmFlLWNjNDEtNDFmOS04ZjZkLTcyOGQzNzIzNTkyNC53ZWJw,To the Stars,50,60,2019.0,Gay and lesbian/Drama,0 days 01:51:00.000000000,6
95,88,https://resizing.flixster.com/8vx9j9M8D0W5d7RPuZ0jdygSgY4=/206x305/v2/https://resizing.flixster.com/ZgVj471KIHEOSinhSxF_AoQSk4g=/ems.ZW1zLXByZC1hc3NldHMvbW92aWVzL2U4NjlkOTJjLTZlM2EtNDdhMi1hNDIzLTEwYmU2NDY1MjEyOC53ZWJw,Onward,5000,333,2020.0,Fantasy/Comedy,0 days 01:43:00.000000000,-7
27,42,,Girls With Balls,50,12,2018.0,Comedy,0 days 01:17:00.000000000,15
85,81,,Judy,5000,334,2019.0,Music/Drama,0 days 01:58:00.000000000,-4
88,89,/assets/pizza-pie/images/poster_default.c8c896e70c3.gif,1917,25000,454,2019.0,Drama/History,0 days 01:59:00.000000000,1
48,7,,Blumhouse's Fantasy Island,2500,108,2020.0,Horror/Mystery and thriller,0 days 01:49:00.000000000,-41
76,45,,After the Wedding,100,155,2019.0,Drama,0 days 01:52:00.000000000,-31
80,96,,American Factory,500,90,2019.0,Documentary,0 days 01:49:00.000000000,16
48,96,,Jawline,1,28,2019.0,Documentary,0 days 01:39:00.000000000,48
85,98,https://resizing.flixster.com/8xeQPiOkHbAQFbZtK9-HOO8AvRA=/206x305/v2/https://resizing.flixster.com/zWJTU9PeCY_X4FbTzU0ROWBlh9k=/ems.ZW1zLXByZC1hc3NldHMvbW92aWVzLzI4ZjZhN2E3LTQ1MjEtNGZhNy05OTEwLWZiNTBhMThmYzQ1ZS53ZWJw,One Child Nation,100,100,2019.0,Documentary,0 days 01:25:00.000000000,13
77,87,https://resizing.flixster.com/uCQWJ4TrFFtWTqZxinovTXyspos=/206x305/v2/https://resizing.flixster.com/HpfDQVSqNuxPl8FCeWTdRI82dY4=/ems.ZW1zLXByZC1hc3NldHMvbW92aWVzL2NjY2Y2NDNmLWM5N2ItNDc4My04NTFiLTM3MWI0NTBjOWU2MS53ZWJw,Where's My Roy Cohn?,50,82,2019.0,Documentary,0 days 01:37:00.000000000,10
96,43,,The Art of Racing in the Rain,5000,118,2019.0,Comedy/Drama,0 days 01:49:00.000000000,-53
69,88,,Batman: Hush,100,17,2019.0,Animation/Action,0 days 01:22:00.000000000,19
83,88,,Wonder Woman: Bloodlines,250,8,2019.0,Animation/Action,0 days 01:23:00.000000000,5
75,78,https://resizing.flixster.com/F45kVqkfj8HnbEwO_ehNdwOVyRA=/206x305/v2/https://resizing.flixster.com/WKKJ1Q7pO-M3HFWzkRx9NUks-h4=/ems.ZW1zLXByZC1hc3NldHMvbW92aWVzLzg2ODg4YjQyLTE2NzItNDJjZC04ZmVhLTY5ZWJhZjk3ZWI3NC53ZWJw,The Inventor: Out for Blood in Silicon Valley,100,60,2019.0,Documentary,0 days 01:59:00.000000000,3
77,79,,Late Night,2500,292,2019.0,Drama/Comedy,0 days 01:42:00.000000000,2
72,89,,Give Me Liberty,100,37,2019.0,Comedy/Drama,0 days 01:50:00.000000000,17
75,87,,Untouchable,1,53,2019.0,Documentary,0 days 01:38:00.000000000,12
44,41,,The Tomorrow Man,1,56,2019.0,Romance/Drama,0 days 01:34:00.000000000,-3
89,82,https://resizing.flixster.com/oBxr-k-FcAO5XEjsWenLgXbo8EE=/206x305/v2/https://resizing.flixster.com/79YHfK9tSxOQEaJd1S4IS2UQ4DM=/ems.ZW1zLXByZC1hc3NldHMvbW92aWVzLzAwZWMwODQ2LWFlMDctNDFjOC04NjdhLTY0NjllYzIwZTcxZi53ZWJw,Official Secrets,250,165,2019.0,Mystery and thriller/Drama,0 days 01:52:00.000000000,-7
83,82,,The Report,1000,239,2019.0,Drama/Mystery and thriller,0 days 01:58:00.000000000,-1
79,42,,Don't Let Go,1000,92,2019.0,Drama/Mystery and thriller,0 days 01:43:00.000000000,-37
73,36,https://resizing.flixster.com/5YyHuv0R5i0hq1CzXPqTHaBk2lo=/206x305/v2/https://resizing.flixster.com/Nw3egMfjRrT_i-riJk_xbDTLbcg=/ems.ZW1zLXByZC1hc3NldHMvbW92aWVzLzIxMDE3NGE1LTMwY2EtNDhiNS04ZTUyLTdjNzk3ZWVlNTRmYS53ZWJw,Poms,500,86,2019.0,Comedy,0 days 01:31:00.000000000,-37
66,79,,Belzebuth,50,14,2019.0,Horror,0 days 01:54:00.000000000,13
17,74,,Adam,1,23,2019.0,Comedy/Gay and lesbian,0 days 01:35:00.000000000,57
58,75,,Shooting the Mafia,1,44,2019.0,Documentary,0 days 01:40:00.000000000,17
96,94,,The Peanut Butter Falcon,2500,217,2019.0,Comedy/Drama,0 days 01:36:00.000000000,-2
68,97,,The Edge of Democracy,500,36,2019.0,Documentary/Drama,0 days 01:53:00.000000000,29
59,80,https://resizing.flixster.com/mDni0T8xRBaxKrUmAM2KS7lAM2U=/206x305/v2/https://resizing.flixster.com/9mxXsduJD3Vi4jGhFyhXz-LMyR0=/ems.ZW1zLXByZC1hc3NldHMvbW92aWVzL2VlNDJiYjEzLTE0YmMtNDQxZS05YzBmLTllYWVhZTY1ODg5NC53ZWJw,The Amazing Johnathan Documentary,100,41,2019.0,Documentary,0 days 01:31:00.000000000,21
76,89,https://resizing.flixster.com/SyOjhGwdOmnh9ph96jqF1_s7_9A=/206x305/v2/https://resizing.flixster.com/jQqCmDrx5_USFQBlMDezsDvLENg=/ems.ZW1zLXByZC1hc3NldHMvbW92aWVzL2JiNjBhZTM5LWE1MWItNDAxOS04OGJlLWU4MTY5MWY2MDJmZS53ZWJw,Top End Wedding,50,38,2019.0,Romance/Comedy,0 days 01:53:00.000000000,13
68,82,https://resizing.flixster.com/zpyz7BJWQfVtH52s5PzC21SFZjU=/206x305/v2/https://resizing.flixster.com/KhoVhz_0ZdZnlaZtQ1IfvYwbHXQ=/ems.ZW1zLXByZC1hc3NldHMvbW92aWVzL2NhYzBhMDhmLWQ0M2ItNDEyMi05NGFkLWMzNTNhOGU1ODViMC53ZWJw,Esto no es Berlín,1,50,2019.0,Drama,0 days 01:55:00.000000000,14
36,89,,The Souvenir,500,174,2019.0,Romance/Drama,0 days 01:59:00.000000000,53
66,87,https://resizing.flixster.com/FWIROsMybFQIbaBmpD3aYcKLYPU=/206x305/v2/https://resizing.flixster.com/xUyt6H5O5I5JAWaO7bPDrqvAmww=/ems.ZW1zLXByZC1hc3NldHMvbW92aWVzLzQxZDIzYTIwLTA5ZTEtNGMwMy05MTQ4LWFmNGU3ZGE4MGU2Yy53ZWJw,The Great Hack,250,53,2019.0,Documentary,0 days 02:15:00.000000000,21
70,70,,Abe,100,33,2019.0,Comedy/Drama,0 days 01:25:00.000000000,0
86,74,https://resizing.flixster.com/oqFXHtSOU0y0caFgPwUor8EYljQ=/206x305/v2/https://resizing.flixster.com/K6YVqhOGvgzzdFNHX96ZRkf3Qkc=/ems.ZW1zLXByZC1hc3NldHMvbW92aWVzL2Y3MTVhNWRlLTgwNGYtNGIxZi04MTI3LTRlNjYzMDI3ODQxZi53ZWJw,The Death of Dick Long,1,77,2019.0,Comedy/Drama,0 days 01:40:00.000000000,-12
51,95,,Sweetheart,250,39,2019.0,Horror/Mystery and thriller,0 days 01:22:00.000000000,44
67,65,https://resizing.flixster.com/J9T_kERq6VHLeBKiUTpgF_UcKmM=/206x305/v2/https://resizing.flixster.com/H8lzHGIugm9tspfot5Fy9tJybpU=/ems.ZW1zLXByZC1hc3NldHMvbW92aWVzLzQ3ZGZhZDAwLTViZDktNDBlNC05ZTkzLTc4YTdmNTUxNWRkZS53ZWJw,Sister Aimee,1,20,2019.0,Biography,0 days 01:27:00.000000000,-2
52,87,https://resizing.flixster.com/dTDsWF-aLRxHMlGdOn51WVbwKAk=/206x305/v2/https://resizing.flixster.com/f64ii7r6a_mVDLyfB54dZpOn6LY=/ems.ZW1zLXByZC1hc3NldHMvbW92aWVzLzIyYjNhZjAxLTJiNDktNDMzMi1hMjg5LTQwNGMwMmY5ZTU5NS53ZWJw,Selah and the Spades,50,107,2019.0,Drama,0 days 01:37:00.000000000,35
71,50,https://resizing.flixster.com/AUYbKfy6NvEQ1A3F9PdQX7r7k-8=/206x305/v2/https://resizing.flixster.com/VjD0WlCB-P_PbeoyoO984xjRtQM=/ems.ZW1zLXByZC1hc3NldHMvbW92aWVzL2I2NGI4ZTU2LWM2MDEtNDk4Yy05MWRjLWY1MDhiODk4MzBmNS53ZWJw,Tolkien,1000,197,2019.0,Drama/History,0 days 01:52:00.000000000,-21
91,89,,Blinded by the Light,2500,258,2019.0,Comedy/Drama,0 days 01:54:00.000000000,-2
84,97,,Queen of Hearts,50,30,2019.0,Drama,0 days 01:40:00.000000000,13
71,63,,Paradise Hills,250,63,2019.0,Mystery and thriller,0 days 01:35:00.000000000,-8
83,92,https://resizing.flixster.com/YPffH4EbRqSc6v1PY-ra2lU85Qo=/206x305/v2/https://resizing.flixster.com/zASvSxg_ovQCClz8x0kBUxlnORQ=/ems.ZW1zLXByZC1hc3NldHMvbW92aWVzL2Y3ZTAxODBjLTUyODQtNGU1NS04NTU1LWE5OGU4YTJkYjRmZi53ZWJw,Miles Davis: Birth of the Cool,100,59,2019.0,Music/Documentary,0 days 01:55:00.000000000,9
75,84,https://resizing.flixster.com/PRXtArhryVW1bi2JP9jbApXvS4k=/206x305/v2/https://resizing.flixster.com/usoZmzmD3kI7Y8HXVfsU-YBAZoc=/ems.ZW1zLXByZC1hc3NldHMvbW92aWVzLzViNDM0NTQzLTY4NDktNDI3Zi1hMDVhLWRlNWE1ZjczNDg5Mi53ZWJw,Crawl,5000,202,2019.0,Horror/Mystery and thriller,0 days 01:27:00.000000000,9
77,68,,Troop Zero,250,65,2019.0,Comedy,0 days 01:37:00.000000000,-9
88,67,,Fast & Furious Presents: Hobbs & Shaw,25000,342,2019.0,Action/Comedy,0 days 02:18:00.000000000,-21
92,81,https://resizing.flixster.com/mDaJukS8FeyTOd2pfj5neMhHcXY=/206x305/v2/https://resizing.flixster.com/AvQOU9S3FGbtCkVzddpEzi9jOuA=/ems.ZW1zLXByZC1hc3NldHMvbW92aWVzL2NlN2Q3MmJlLTE1YWYtNGZmYy05MDlkLTE4YWRjYzAxMTcwMC53ZWJw,Memory: The Origins of Alien,1,80,2019.0,Documentary,0 days 01:35:00.000000000,-11
85,79,,Marianne & Leonard: Words of Love,1,116,2019.0,Documentary/Biography,0 days 01:37:00.000000000,-6
100,80,https://resizing.flixster.com/mICCXI9OC68uWQk6a2i68qzkXiE=/206x305/v2/https://resizing.flixster.com/5Xi9dt8uotnPCK2-EwLWtD7NEWE=/ems.ZW1zLXByZC1hc3NldHMvbW92aWVzL2NhNzQ3Mjk0LTQwOTQtNDZkMS1iMWYwLWE0MzUxMWE5ZmVkOS53ZWJw,Little Monsters,1,130,2019.0,Horror/Comedy,0 days 01:34:00.000000000,-20
63,83,,Midsommar,5000,395,2019.0,Horror/Mystery and thriller,0 days 02:25:00.000000000,20
31,68,,Human Capital,50,62,2019.0,Drama,0 days 01:37:00.000000000,37
70,73,https://resizing.flixster.com/3ThRAmbeD-uONKqT1k_FBgeKWpY=/206x305/v2/https://resizing.flixster.com/xZ9Noho29P51jjt7RdT_quKjmXc=/ems.ZW1zLXByZC1hc3NldHMvbW92aWVzLzc1NTgxYmE5LThmNDktNGYxOS1iZTI4LTA2OTVlYmRjZDcxMy53ZWJw,Bad Trip,250,56,2021.0,Comedy,0 days 01:24:00.000000000,3
16,25,,Corporate Animals,50,51,2019.0,Comedy,0 days 01:26:00.000000000,9
58,97,https://resizing.flixster.com/Nepr90qKLXK4zx4gRJRGjjKvlHc=/206x305/v2/https://resizing.flixster.com/SvyJT8QFsPiccD0kXhjAAn5iIs8=/ems.ZW1zLXByZC1hc3NldHMvbW92aWVzLzJkMTRjOWQ5LWFiYWItNGE1Yi04MTU2LWYyMTZjMmU5ZmQ5ZC53ZWJw,Harpoon,100,61,2019.0,Comedy/Mystery and thriller,0 days 01:23:00.000000000,39
74,96,https://resizing.flixster.com/JA1dQiUqkqRVA7hHI394sMydokY=/206x305/v2/https://resizing.flixster.com/8e-b-qA-bPzx7-0lQrkgdfgWYXE=/ems.ZW1zLXByZC1hc3NldHMvbW92aWVzLzI0OTY1ODBiLTE5ODgtNGEzNi04MzhjLTZlMTBjMGUyODMyOC53ZWJw,By the Grace of God,50,96,2018.0,Drama,0 days 02:17:00.000000000,22
94,42,https://resizing.flixster.com/vsweUDJOe7N2wAY9LI24wYW32Xg=/206x305/v2/https://resizing.flixster.com/jS4ZpnNkjP3kj9RKF1JSJ-YoXjY=/ems.ZW1zLXByZC1hc3NldHMvbW92aWVzL2U4MGZlMDA1LTJlYzQtNDFjMS05OTAzLTM1NmJkYzk4YjNjMi53ZWJw,Unplanned,5000,26,2019.0,Drama/Biography,0 days 01:46:00.000000000,-52
58,58,,3 From Hell,500,38,2019.0,Horror,0 days 02:02:00.000000000,0
66,17,,The Kindness of Strangers,50,29,2019.0,Drama,0 days 01:52:00.000000000,-49
98,52,https://resizing.flixster.com/C3bc_FzLvYAH40AhY9qPeCOn3r8=/206x305/v2/https://resizing.flixster.com/nB0MWl-e-ywrxoCk5qRazNA36jk=/ems.ZW1zLXByZC1hc3NldHMvbW92aWVzLzQ3N2Y4OTFmLTY2NDItNGFlYy1iYTg5LTIxOWM1OGQ3NmQzZi53ZWJw,I Still Believe,1000,46,2020.0,Biography/Romance,0 days 01:55:00.000000000,-46
79,93,,Working Man,1,45,2019.0,Drama,0 days 01:49:00.000000000,14
100,94,https://resizing.flixster.com/lRRtUc6x4FyKr9l9F9S-mfgBPI8=/206x305/v2/https://flxt.tmsimg.com/assets/p16952863_p_v10_ac.jpg,System Crasher,1,35,2019.0,Drama,0 days 01:50:00.000000000,-6
97,87,,Pavarotti,500,86,2019.0,Documentary/Music,0 days 01:54:00.000000000,-10
71,69,https://resizing.flixster.com/Mjr7_J8w0KK31iAJmxmnz3jyuOw=/206x305/v2/https://resizing.flixster.com/ALLYJx_TB_tLvFjIGicH9UjcP-8=/ems.ZW1zLXByZC1hc3NldHMvbW92aWVzLzAzNmJmZTM0LTkzMWYtNDc3ZC1iMjFhLTIxYzU5MjEzNmUyZS53ZWJw,Adopt a Highway,100,32,2019.0,Drama,0 days 01:21:00.000000000,-2
60,95,,Goldie,1,22,2020.0,Drama,0 days 01:28:00.000000000,35
85,100,,Driveways,100,74,2019.0,Drama,0 days 01:23:00.000000000,15
32,69,https://resizing.flixster.com/_5dwapfKBsIW8YSvyrgPyKCh-58=/206x305/v2/https://resizing.flixster.com/OQtgdQEZqyyAYlrGYLodhrjMCmA=/ems.ZW1zLXByZC1hc3NldHMvbW92aWVzL2QyZjEyMDVmLTljOTEtNDkwYi1iMjFhLWVhMmJmYjkyOTYwYi53ZWJw,Knives and Skin,1,74,2019.0,Drama/Mystery and thriller,0 days 01:52:00.000000000,37
51,25,,Making Babies,1,8,2018.0,Comedy,0 days 01:26:00.000000000,-26
89,63,https://resizing.flixster.com/RebEuLdXlTkxU4VB4zRVdAC1Lcc=/206x305/v2/https://resizing.flixster.com/IgK2vhniVun-9SSKnLTxie9sObs=/ems.ZW1zLXByZC1hc3NldHMvbW92aWVzL2I3MGM4NmU3LWIzMzAtNDFkMi1iNjdmLWRhMDkzYjZmZDQ4MC53ZWJw,Yesterday,10000,356,2019.0,Romance/Music,0 days 01:56:00.000000000,-26
64,56,https://resizing.flixster.com/nHWR5v-XSDsBSsgIC517ljjCZmU=/206x305/v2/https://resizing.flixster.com/8zwWEGp6ptImFNuTrRkPu-yPos4=/ems.ZW1zLXByZC1hc3NldHMvbW92aWVzLzI4YTRlYmIyLTczNTctNDFkMS1iNDIzLTNkYWQwNjc3MjYzMS53ZWJw,Ma,5000,208,2019.0,Horror/Mystery and thriller,0 days 01:39:00.000000000,-8
54,60,https://resizing.flixster.com/bsZfS9wvttfVfQpqJxYDfdp1gI8=/206x305/v2/https://resizing.flixster.com/cLLqAS_aTgCbRIEftx2NOVt40Rc=/ems.ZW1zLXByZC1hc3NldHMvbW92aWVzLzZmYTg1MGVhLTllMmEtNGY1ZS1hOGI2LTBhOTBlMzVhNGQ1My53ZWJw,Piranhas,1,35,2019.0,Crime/Drama,0 days 01:51:00.000000000,6
78,95,,Come as You Are,50,55,2019.0,Drama/Comedy,0 days 01:47:00.000000000,17
49,68,https://resizing.flixster.com/gKi_XTo6K6w6DZWIMveJvP4cyfk=/206x305/v2/https://resizing.flixster.com/pswIqH11P-KBwShropYA4EEB_0s=/ems.ZW1zLXByZC1hc3NldHMvbW92aWVzL2U3ZjNlMjhhLTRiNzYtNDZkYS1iOTRmLTNjNzIzODkyMTZkYy53ZWJw,Darlin',1,31,2019.0,Horror,0 days 01:40:00.000000000,19
74,79,https://resizing.flixster.com/rug1UlIhuNU9kp8GUQkISxxAWEU=/206x305/v2/https://resizing.flixster.com/k7LvQsa9OScPKfN797lG5jIMCe8=/ems.ZW1zLXByZC1hc3NldHMvbW92aWVzL2NjYTJjNTIxLTY1ZWYtNDlmNC1hNDgyLTE4YzJkODI1MmYzMi53ZWJw,I See You,500,42,2019.0,Mystery and thriller,0 days 01:36:00.000000000,5
83,100,,It Started as a Joke,1,10,2019.0,Documentary,0 days 01:16:00.000000000,17
98,100,https://resizing.flixster.com/hGGqYReDDF43Mguxh197yymR3gY=/206x305/v2/https://resizing.flixster.com/h5Phbk4GClEMZrqsWmTMAOsbrII=/ems.ZW1zLXByZC1hc3NldHMvbW92aWVzLzNiMTQ4MTAwLTZmODEtNGE4NC1iNDU5LTgwMWRjMWJiZWZhYi53ZWJw,Jump Shot: The Kenny Sailors Story,100,14,2019.0,Documentary/Biography,0 days 01:13:00.000000000,2
93,93,https://resizing.flixster.com/qSKZtUOLXe4RIXahoftNSs1pMsA=/206x305/v2/https://resizing.flixster.com/AYc5WYVoJaPO6kgOFRk8SiH3pL4=/ems.ZW1zLXByZC1hc3NldHMvbW92aWVzLzJjMDYzNDUxLWQ0OGUtNDIxOS05ZmUxLTE2NTAwYTlmMDBmOS53ZWJw,If the Dancer Dances,1,15,2018.0,Documentary,0 days 01:23:00.000000000,0
98,100,https://resizing.flixster.com/x4w9e-NxoPaYHagMjW1pz_FXPmY=/206x305/v2/https://resizing.flixster.com/V2XLgyVh0hv6flgWLCsF72kjTc8=/ems.ZW1zLXByZC1hc3NldHMvbW92aWVzLzA5MjE3N2VmLTE3MDMtNDUwNy04NTQzLTI4YjdmOWM3ZWY1OS53ZWJw,Emanuel,250,19,2019.0,Documentary,0 days 01:20:00.000000000,2
92,40,,Rag Doll,1,5,2019.0,Action/Drama,0 days 01:43:00.000000000,-52
25,46,https://resizing.flixster.com/pXwiAeJ82TVjdEjqEQZrFJuDuEg=/206x305/v2/https://resizing.flixster.com/GbjdZZyC01fKm5hF4PodVfsmS3Q=/ems.ZW1zLXByZC1hc3NldHMvbW92aWVzLzg5ZDQyZTMyLWEwMGYtNGU2Yy05NDA2LTM2NzIxNDAwY2MzNy53ZWJw,Run This Town,1,37,2019.0,Mystery and thriller,0 days 01:38:00.000000000,21
79,99,,Saint Frances,100,100,2019.0,Comedy/Drama,0 days 01:46:00.000000000,20
63,93,,Sword of Trust,100,91,2019.0,Comedy,0 days 01:29:00.000000000,30
63,84,,The Art of Self-Defense,500,165,2019.0,Comedy,0 days 01:44:00.000000000,21
52,64,,The Day Shall Come,100,91,2019.0,Comedy,0 days 01:28:00.000000000,12
86,90,,Tread,50,10,2019.0,Documentary,0 days 01:29:00.000000000,4
56,88,https://resizing.flixster.com/fm-aNTk40RBkrIEQUFPQzIVTIcc=/206x305/v2/https://resizing.flixster.com/SWWQ9S0lYmNZHomQx4v980nVBks=/ems.ZW1zLXByZC1hc3NldHMvbW92aWVzLzliMTBmNzM3LWIyNDAtNGMxZC1hYmI4LTZiNDAxYmVhNWZjYi53ZWJw,Mia and the White Lion,50,17,2018.0,Kids and family/Adventure,0 days 01:38:00.000000000,32
56,100,https://resizing.flixster.com/dBTUXaAJq35fr84NeGXuQffeSUg=/206x305/v2/https://resizing.flixster.com/rp26x5SeqQTlm9fS5m-0vtki9-o=/ems.ZW1zLXByZC1hc3NldHMvbW92aWVzL2UzMjBmYWIxLTM2MDQtNDgyZi04ZTZiLWNkM2U2MGZiOWI0ZC53ZWJw,La Misma Sangre,1,5,2019.0,Drama,0 days 01:20:00.000000000,44
82,26,,Rambo: Last Blood,5000,172,2019.0,Action,0 days 01:29:00.000000000,-56
33,67,https://resizing.flixster.com/DBKGplUwbSgSc3KvPG8VFHPAVKo=/206x305/v2/https://resizing.flixster.com/xhWuy2KwZXvPE4AI7_pJnHPAwDc=/ems.ZW1zLXByZC1hc3NldHMvbW92aWVzL2I3YzQ5ZGQyLTQ0MmYtNDY2Mi05NDljLWMwNzFkMzc1MzA2OS53ZWJw,She's Missing,1,15,2019.0,Drama/Mystery and thriller,0 days 01:40:00.000000000,34
15,56,https://resizing.flixster.com/RI-wY5h0OBeW28ld7XBU_Suo9OU=/206x305/v2/https://resizing.flixster.com/KuUhmxqZMkfGguTS9bnyXux7eTE=/ems.ZW1zLXByZC1hc3NldHMvbW92aWVzL2VkNDliNzQ0LThlMGYtNGI5OS04NGFmLWZjN2ViY2MyMTQxOS53ZWJw,The Silent War,1,9,2018.0,War/Mystery and thriller,0 days 02:06:00.000000000,41
45,42,,William,1,12,2019.0,Drama,0 days 01:42:00.000000000,-3
45,84,,Depraved,50,57,2019.0,Horror/Mystery and thriller,0 days 01:54:00.000000000,39
63,45,,Ode to Joy,50,29,2019.0,Romance,0 days 01:38:00.000000000,-18
71,85,https://resizing.flixster.com/xl-HuTKvneb6fkLT17rn4acLIFM=/206x305/v2/https://resizing.flixster.com/HH-LPTR2pxgjxf63PFl8NjOT7mk=/ems.ZW1zLXByZC1hc3NldHMvbW92aWVzL2I0Mjk2ZDQwLTViODUtNDc0Ny1iMzhlLTYwMGE4ZmYxZThjZS53ZWJw,The Wolf's Call,100,13,2019.0,Drama/Mystery and thriller,0 days 01:55:00.000000000,14
86,88,https://resizing.flixster.com/K6ZXxJmYA_EdYanwNoLcOrKMKmQ=/206x305/v2/https://resizing.flixster.com/-ipo4kXTM5g2tkdZ6eG2Usd9k0s=/ems.ZW1zLXByZC1hc3NldHMvbW92aWVzL2MzOTdlODEwLTNjOWEtNDk1ZC1hMWYwLTUxYjc5ZmQyYWZhYi53ZWJw,37 Seconds,1,17,2019.0,Drama,0 days 01:55:00.000000000,2
93,50,,Impossible Monsters,50,6,2019.0,Mystery and thriller,0 days 01:24:00.000000000,-43
74,98,https://resizing.flixster.com/wXFDjCFMrNJtsOgeGzosnJoTGig=/206x305/v2/https://resizing.flixster.com/BtwPABqExyjLSOL34g3X4xtpq7w=/ems.ZW1zLXByZC1hc3NldHMvbW92aWVzLzU5N2E2ZWJlLWU1MGEtNDQ3YS1iYjg5LWM5ZWVmYWZiMmFmNi53ZWJw,Blow the Man Down,250,120,2019.0,Comedy/Drama,0 days 01:30:00.000000000,24
92,65,https://resizing.flixster.com/YvIs5ombAfAax65t6herd3s4aQg=/206x305/v2/https://resizing.flixster.com/7eCh7GSQzkrTK28m8VVjwrw58CI=/ems.ZW1zLXByZC1hc3NldHMvbW92aWVzL2JjNjExMjM3LWUxYmEtNDY2NS05ZjY3LTg0MmQ4ZDlmNTNmYy53ZWJw,The Quiet One,1,34,2019.0,Documentary/Music,0 days 01:45:00.000000000,-27
91,96,https://resizing.flixster.com/MW4Mxi4Zt1ZQ-m51B-poEdN_PS4=/206x305/v2/https://resizing.flixster.com/NZF8vqQ3xiohEVLA6eddLdsU4eA=/ems.ZW1zLXByZC1hc3NldHMvbW92aWVzLzI4ZTcxZDkzLWFmNDctNDZmMC05NTk4LWU1ZTk0YzIyMjczMy53ZWJw,Pain and Glory,250,293,2019.0,Drama,0 days 01:53:00.000000000,5
77,83,https://resizing.flixster.com/aojGm-HYKO5g0X_a4aVGTHO6tjU=/206x305/v2/https://resizing.flixster.com/YONstalBggG9LVTwh1XZ1Bntrzw=/ems.ZW1zLXByZC1hc3NldHMvbW92aWVzLzJhMWJjYzlhLWM0Y2UtNDgwMC04OGFhLWJjMjk2ZTYwMTUyMC53ZWJw,Strike,1,6,2019.0,Animation/Comedy,0 days 01:40:00.000000000,6
31,21,,Lucy in the Sky,50,125,2019.0,Drama,0 days 02:04:00.000000000,-10
75,86,,Come to Daddy,1,103,2019.0,Comedy/Mystery and thriller,0 days 01:33:00.000000000,11
13,4,https://resizing.flixster.com/1JGBXucwIESRXgQ0Czysmk9m_90=/206x305/v2/https://resizing.flixster.com/USwHhmRLPmyXGedLki8n9VYVA4w=/ems.ZW1zLXByZC1hc3NldHMvbW92aWVzLzIyZjdkNDhlLTNlYjItNDBlNy04Y2U3LTY5NGZhMjMzYzFmOS53ZWJw,Mary,50,27,2019.0,Horror/Mystery and thriller,0 days 01:24:00.000000000,-9
72,87,https://resizing.flixster.com/a5yMfGDNB1u5RQb0wuKgfPvXNVY=/206x305/v2/https://resizing.flixster.com/0wGqCJOjJF7WipE3UMTNfOiIkSg=/ems.ZW1zLXByZC1hc3NldHMvbW92aWVzL2E0NTgzYjRjLTMyNDgtNDg2ZC1iY2I4LTFhOTc2MTM2ZmM3Mi53ZWJw,EMMA.,1000,253,2020.0,Romance/Comedy,0 days 02:05:00.000000000,15
84,98,https://resizing.flixster.com/MEfPHkbmp965_oE4Ix_6azeq3y0=/206x305/v2/https://resizing.flixster.com/4V5eJ-_2HL9PFWRPRbu_-eQ3yHs=/ems.ZW1zLXByZC1hc3NldHMvbW92aWVzLzUxNjJlM2Y5LTkzMDUtNDNiOC1hM2EyLTJhMzM5N2RhM2IyMi53ZWJw,Deadwood: The Movie,100,87,2019.0,Western,0 days 01:49:00.000000000,14
60,71,https://resizing.flixster.com/hG1CgSugyG3Akeqdd0YJrxvZlVg=/206x305/v2/https://resizing.flixster.com/z6u2B2E6-sXLMM1El-sfO2VdXrU=/ems.ZW1zLXByZC1hc3NldHMvbW92aWVzLzJjY2VlMGQ2LTc5M2ItNGY1ZS05NTQ2LTVjMjdmOWUxODM3MS53ZWJw,Stray Dolls,1,24,2019.0,Crime/Drama,0 days 01:37:00.000000000,11
72,87,https://resizing.flixster.com/zRYbWFYQpdLC73ACV1krIp-g6ug=/206x305/v2/https://resizing.flixster.com/CptFXvlCwabnC19Tn4VxydLlEmk=/ems.ZW1zLXByZC1hc3NldHMvbW92aWVzLzQ0NWEwZDBmLTkyOTktNDcxOS1iMDNlLTRlYTUyYTJkNWRmOS53ZWJw,Swallow,500,130,2019.0,Mystery and thriller,0 days 01:35:00.000000000,15
74,58,/assets/pizza-pie/images/poster_default.c8c896e70c3.gif,Crown Vic,100,26,2019.0,Mystery and thriller/Action,0 days 01:40:00.000000000,-16
16,0,https://resizing.flixster.com/ZLw0sdtrFvhFM5DrS8Ai7l_c6LE=/206x305/v2/https://resizing.flixster.com/z7jynCuOoiGnL2NQwFwsAcmu-QE=/ems.ZW1zLXByZC1hc3NldHMvbW92aWVzL2I3MTBlNmRmLWNhMjEtNGM2NC1iMTNjLTY5YjUyMGRmMjUxZS53ZWJw,Killers Anonymous,50,9,2019.0,Action/Mystery and thriller,0 days 01:36:00.000000000,-16
35,44,https://resizing.flixster.com/33a4kMIqdboRSyCFZR6TW-24Rdg=/206x305/v2/https://resizing.flixster.com/ltL00dP4BB_OWNrcKH2Rb-1P6GI=/ems.ZW1zLXByZC1hc3NldHMvbW92aWVzLzU3NDc0YTQyLTA4NjUtNDFkYS05NWVhLTcyZGVlY2VkMGUzMC53ZWJw,Supervized,1,9,2019.0,Comedy,0 days 01:24:00.000000000,9
80,100,,Two in the Bush: A Love Story,1,5,2018.0,Comedy/Drama,0 days 01:37:00.000000000,20
65,87,,Hustlers,10000,347,2019.0,Comedy/Drama,0 days 01:50:00.000000000,22
48,54,https://resizing.flixster.com/wHGkpWgjAlHWv3FDrHrevVFb5Os=/206x305/v2/https://resizing.flixster.com/RgTSPFdTvvC5SAHl67Blo2QKDMo=/ems.ZW1zLXByZC1hc3NldHMvbW92aWVzLzMzMzIyMTE2LTNmNGEtNDBhMC04NTRhLTgyNTM0YTE4NTRjNy53ZWJw,Lost Transmissions,1,28,2019.0,Drama,0 days 01:45:00.000000000,6
31,40,,Only,100,20,2019.0,Mystery and thriller,0 days 01:38:00.000000000,9
48,86,https://resizing.flixster.com/JotO_pZT32VRt1SmC1eXSOqRFyM=/206x305/v2/https://resizing.flixster.com/5JVLGSUfXAmdSx-jJoNofLErhBc=/ems.ZW1zLXByZC1hc3NldHMvbW92aWVzLzQ0MGUwZWEwLTQ5ODAtNDA1My05ZWU4LThhZmFmMjg3NzNkYi53ZWJw,Safe Spaces,1,14,2019.0,Comedy,0 days 01:33:00.000000000,38
86,87,,"Standing Up, Falling Down",1,60,2019.0,Comedy/Drama,0 days 01:31:00.000000000,1
42,70,https://resizing.flixster.com/ZPw7zyRwODNE8fHU64hEHf44kNw=/206x305/v2/https://resizing.flixster.com/62O7nyk6lRf2zMKiwZvuaWa02dU=/ems.ZW1zLXByZC1hc3NldHMvbW92aWVzL2UwYmIwOTc3LTc4NDEtNGJkNS1hMWM5LTBmMTBiNDgxNWUwOS53ZWJw,The Kill Team,50,50,2019.0,Drama/War,0 days 01:27:00.000000000,28
60,87,,Bliss,100,45,2019.0,Horror,0 days 01:20:00.000000000,27
48,89,https://resizing.flixster.com/msN0t88pm8u4RnorTH3LHiGAXNk=/206x305/v2/https://resizing.flixster.com/UURHzXGBEalag4w86TjYjBkju9Q=/ems.ZW1zLXByZC1hc3NldHMvbW92aWVzLzc3NjUyZjVjLTgzYzQtNDNmNC04YmY3LTk3MzQ5NTlkNTU0ZC53ZWJw,After Midnight,100,36,2019.0,Horror,0 days 01:23:00.000000000,41
22,0,https://resizing.flixster.com/d99iAxD4uiq7ViswfNRiHQJkEsc=/206x305/v2/https://resizing.flixster.com/xMEHxnYgnoOw2PY1Z77qJ_b-v_k=/ems.ZW1zLXByZC1hc3NldHMvbW92aWVzL2VjMzVjNjIwLTM0ZGEtNGIyYi05MTY3LWU1YjJiZGJjNDA0My53ZWJw,The Poison Rose,100,9,2019.0,Mystery and thriller,0 days 01:38:00.000000000,-22
81,98,https://resizing.flixster.com/z7Ksb1WUNqzk2scfJHbanmgICWY=/206x305/v2/https://resizing.flixster.com/oKQVRfEswnrYd7_R-QlVC_-k-Lk=/ems.ZW1zLXByZC1hc3NldHMvbW92aWVzL2Q3MDA2ODQ3LTE5NGMtNDUyOS1iMDRjLTkxZmNiNzAxNzEzZi53ZWJw,Circus of Books,100,57,2019.0,Documentary/Gay and lesbian,0 days 01:32:00.000000000,17
29,56,https://resizing.flixster.com/HmRemUg9yXm6IKmOhM7gOmfPU3Q=/206x305/v2/https://resizing.flixster.com/HD2rEaW0tkZcZ1j_YMkqA_Z0g-E=/ems.ZW1zLXByZC1hc3NldHMvbW92aWVzL2VmOGE5Njg4LTUyZjktNDVjZC05ODQ0LTc5MDA4MzdmYzg2NC53ZWJw,Two/One,1,9,2019.0,Sci fi/Drama,0 days 01:40:00.000000000,27
18,62,,Lying and Stealing,50,13,2019.0,Crime/Drama,0 days 01:40:00.000000000,44
72,100,,Slay the Dragon,1,48,2019.0,Documentary,0 days 01:41:00.000000000,28
99,89,https://resizing.flixster.com/jcaSoCH4HT1lvlxZpD7-ad_i35I=/206x305/v2/https://resizing.flixster.com/558sa59KlLpPSYTXmXliqJCtJcw=/ems.ZW1zLXByZC1hc3NldHMvbW92aWVzLzI2MTg3YTIwLTgxNTYtNDJhZC1hOWQ5LWZmMTljMThhNDM5OC53ZWJw,Linda Ronstadt: The Sound of My Voice,500,94,2019.0,Documentary/Music,0 days 01:35:00.000000000,-10
32,30,https://resizing.flixster.com/E7aWWeJC1uz3j5xj_wHgF9g6n9o=/206x305/v2/https://resizing.flixster.com/5g-PTDwPfpWlNkmFP6fLLZ8IwU4=/ems.ZW1zLXByZC1hc3NldHMvbW92aWVzL2FmOGY0OWJiLTU4YWQtNDFjZi1iOWI0LTA5NDBmNDkzYzI3MC53ZWJw,The Corrupted,1,10,2019.0,Mystery and thriller/Crime,0 days 01:43:00.000000000,-2
58,73,https://resizing.flixster.com/h_j_GDnWRE3u1FTTnpjfMKVSkBw=/206x305/v2/https://flxt.tmsimg.com/assets/p17439740_p_v8_ab.jpg,Cubby,1,11,2019.0,Comedy/Drama,0 days 01:23:00.000000000,15
81,33,https://resizing.flixster.com/Nikjug_i6_au99vW7Rs4_wl1Z5s=/206x305/v2/https://resizing.flixster.com/1pi0o2NFLK2mGHwqVRpxqugpDUE=/ems.ZW1zLXByZC1hc3NldHMvbW92aWVzLzM4YTljMjIzLWZhYzEtNGM4Yi1iYjg1LTg0OWE5NzVkZDYwNC53ZWJw,Anna,1000,69,2019.0,Action/Mystery and thriller,0 days 01:59:00.000000000,-48
77,90,https://resizing.flixster.com/kWDR3emu4eOtx2RXJfTuHx-YLmo=/206x305/v2/https://resizing.flixster.com/-I66nvmrwPgPYz5DzIfNcFjrb6o=/ems.ZW1zLXByZC1hc3NldHMvbW92aWVzLzMxNjYzMTk4LWZmYmEtNDVkOS04ZGFkLTI5YjFkZmFjZmQxOS53ZWJw,Mine 9,100,20,2019.0,Drama,0 days 01:23:00.000000000,13
85,91,https://resizing.flixster.com/5zsmB61-egNuc_FM7vVFa-qpyKs=/206x305/v2/https://resizing.flixster.com/bILyJBuQZi3PPXRXE5DCEv6yrdM=/ems.ZW1zLXByZC1hc3NldHMvbW92aWVzLzAzYzAxNmIyLTRmNzgtNGI4Ny05MjMwLTU5MTc3YTU5MTg3MC53ZWJw,We Believe In Dinosaurs,1,11,2019.0,Documentary,0 days 01:45:00.000000000,6
83,80,https://resizing.flixster.com/jc860yMTKb5vb1pt2nvj6Tw1eoY=/206x305/v2/https://resizing.flixster.com/ZNouYAqGhNXGzo5xgY1-NunKfNE=/ems.ZW1zLXByZC1hc3NldHMvbW92aWVzL2YwYzg0NGYzLWVlMzAtNDdmMi1hNDc3LTM3MmIyNTE2Mjc5OC53ZWJw,Escape and Evasion,1,5,2019.0,Drama/War,0 days 01:32:00.000000000,-3
100,100,,Waldo on Weed,1,7,2019.0,Documentary,0 days 01:27:00.000000000,0
83,86,https://resizing.flixster.com/QEM9Bq_OqzV4LLPrzrauqzw4Gcs=/206x305/v2/https://resizing.flixster.com/7A3HKiztXmeO-oQmLHTDAVKAF1Y=/ems.ZW1zLXByZC1hc3NldHMvbW92aWVzL2UyZTRjZDYzLTdhMmQtNDhkMS04MzAzLTQ2NGVlMjVhNDIxNC53ZWJw,Woodstock: Three Days That Defined a Generation,50,29,2019.0,Documentary/Music,0 days 01:36:00.000000000,3
67,96,https://resizing.flixster.com/g0npb-6RPnbcKvTAruTairwGvF8=/206x305/v2/https://resizing.flixster.com/VA-Jk6_wlZtgb1mb-Y-S4xiaUiI=/ems.ZW1zLXByZC1hc3NldHMvbW92aWVzLzllYzM3YmFhLTM2MWItNGFmYy1hYjhjLThlN2YyYWM3NTVhOS53ZWJw,Atlantics,100,152,2019.0,Drama,0 days 01:45:00.000000000,29
12,25,/assets/pizza-pie/images/poster_default.c8c896e70c3.gif,Escape Plan: The Extractors,250,12,2019.0,,,13
26,52,,Summer Night,1,21,2019.0,Comedy/Drama,0 days 01:38:00.000000000,26
86,75,,Loopers: The Caddie's Long Walk,1,12,2019.0,Documentary,0 days 01:20:00.000000000,-11
88,88,https://resizing.flixster.com/-UxehSsTlopU4uecKv1WtrWuhKs=/206x305/v2/https://resizing.flixster.com/fNvKIlmAtFJEekEriwWxR6t7ExU=/ems.ZW1zLXByZC1hc3NldHMvbW92aWVzLzQ0NzQ3ZWNkLTEzOWEtNDM5NS05OTk1LTkxNThkZGU5NjQxZi53ZWJw,Les misérables,1,189,2019.0,Drama/Crime,0 days 01:42:00.000000000,0
88,97,https://resizing.flixster.com/r79iiaTFCeiigsEt6Zx89M1rbQk=/206x305/v2/https://resizing.flixster.com/BLF6bAIit5IWTQt-2zAgmaRjVNA=/ems.ZW1zLXByZC1hc3NldHMvbW92aWVzLzI1N2I3ZjNjLWJkYzEtNGUwZC04ZDliLTM1NjNhNWE3NTcwZS53ZWJw,First Love,1,116,2019.0,Crime/Comedy,0 days 01:48:00.000000000,9
63,90,https://resizing.flixster.com/Oy2RgzVQI-RMdoz8wsux8Vt0PSU=/206x305/v2/https://resizing.flixster.com/6QlNQH5Wd34cjf65U0BZEQ8pqNU=/ems.ZW1zLXByZC1hc3NldHMvbW92aWVzLzNjYTcxMDc4LTAxYTMtNDBlZS1iYzBiLTc0YjY0MTBlOGU0Ny53ZWJw,Bull,1,87,2019.0,Drama,0 days 01:48:00.000000000,27
43,68,,Little Joe,100,116,2019.0,Sci fi/Horror,0 days 01:45:00.000000000,25
94,97,https://resizing.flixster.com/mQVhBs5MgrvCOAl8EG9R8SIz6eE=/206x305/v2/https://resizing.flixster.com/W-GfHduY7Ja4fVPqyLDsU7apmDg=/ems.ZW1zLXByZC1hc3NldHMvbW92aWVzL2YyMDlmZTczLTRmMzctNDc1YS04NDJmLWFiYTZlNzUzM2MxYi53ZWJw,"The Gangster, the Cop, the Devil",1,34,2019.0,Drama/Mystery and thriller,0 days 01:50:00.000000000,3
90,100,https://resizing.flixster.com/JO-h83efvxkqEt8G4ClSEEHEamY=/206x305/v2/https://resizing.flixster.com/MawIOUlMaErwEl5R3Hn7huBM6Qw=/ems.ZW1zLXByZC1hc3NldHMvbW92aWVzLzk1ZDU0ZmQyLWE0YTUtNGEzYy1iMWIxLWQxNjFkOGFkNjJmYS53ZWJw,Apocalypse Now: Final Cut,50,21,2019.0,,,10
47,75,,Antrum: The Deadliest Film Ever Made,50,16,2018.0,Horror,0 days 01:35:00.000000000,28
62,44,https://resizing.flixster.com/2axQN9OEIs10j3mgpUFV5ypjQ34=/206x305/v2/https://resizing.flixster.com/yEdvojp5892i6cOFpoU24j6_IM4=/ems.ZW1zLXByZC1hc3NldHMvbW92aWVzLzc2MjAzNTc1LWQ2ODYtNDc5Zi05NmFmLWVhNzQ1YjEwYTY1My53ZWJw,Curtiz,1,9,2018.0,Drama/History,0 days 01:40:00.000000000,-18
92,98,,Portrait of a Lady on Fire,250,314,2019.0,Romance/Gay and lesbian,0 days 02:01:00.000000000,6
60,47,/assets/pizza-pie/images/poster_default.c8c896e70c3.gif,Underwater,2500,215,2020.0,Horror/Action,0 days 01:35:00.000000000,-13
89,93,https://resizing.flixster.com/7zabHbyfDVgNn5XpOjFLsGM6_p8=/206x305/v2/https://resizing.flixster.com/XZ0Gi88QlOW5Seg2k-zTKB1M0RI=/ems.ZW1zLXByZC1hc3NldHMvbW92aWVzL2VjZDA5MzRhLWZiZmQtNDczYS1hOGNhLTRhODc4YzdjYjJkNC53ZWJw,Invisible Life,100,74,2019.0,Romance/Drama,0 days 02:19:00.000000000,4
75,92,https://resizing.flixster.com/-Rg4R8jqBQk7VpK8ctoyCSvPayc=/206x305/v2/https://resizing.flixster.com/yjoC1LvZ18iIb1nv3JiLekpds8w=/ems.ZW1zLXByZC1hc3NldHMvbW92aWVzLzg0M2NjZjY5LTJhNDktNDM1NS1hYWIwLWNhOTQxYWNiYWJhYy53ZWJw,Beanpole,100,102,2019.0,Drama,0 days 02:17:00.000000000,17
83,96,https://resizing.flixster.com/YcSCma9-IXcv9-pOuJwSM0Ybs3A=/206x305/v2/https://resizing.flixster.com/O8aJDlq8duZJoYaJ3_yfDydNm_c=/ems.ZW1zLXByZC1hc3NldHMvbW92aWVzL2NjZDQ0NGY5LTdiZmYtNDMyNC05ZDQ4LWVjOGIzYzM3NDQ4NS53ZWJw,I Lost My Body,500,82,2019.0,Fantasy/Animation,0 days 01:21:00.000000000,13
44,10,https://resizing.flixster.com/ljOubKiIaibKEHSI3bDkj8FjDZ8=/206x305/v2/https://resizing.flixster.com/MeGItUsDcLJ7mZFrBFyBm_tOuEY=/ems.ZW1zLXByZC1hc3NldHMvbW92aWVzLzg2MTM0YjY2LTVkMzItNGFjOC1iNTFjLTI4YTE5NGIyZjkzZi53ZWJw,Brahms: The Boy II,1000,58,2020.0,Horror/Mystery and thriller,0 days 01:26:00.000000000,-34
97,100,,5B,1,20,2018.0,Documentary,0 days 01:35:00.000000000,3
39,72,https://resizing.flixster.com/lg8qI5addWfNCZGbJG3Ku4K5TJw=/206x305/v2/https://resizing.flixster.com/8hltoFo8b1B5eIuF_DCNO6BLpD0=/ems.ZW1zLXByZC1hc3NldHMvbW92aWVzLzFlYWZkZmFkLTYxODUtNGNhYS1hMzYxLTcwNjlhZDg4NGZmMy53ZWJw,Vivarium,1000,147,2020.0,Mystery and thriller/Sci fi,0 days 01:37:00.000000000,33
46,44,,Bachelorettes (Solteras),1,9,2018.0,,,-2
26,60,https://resizing.flixster.com/P1kbb_rP0UWrWKaD8WWtOQDLaxg=/206x305/v2/https://resizing.flixster.com/lBXmQh7Uwzj7sZ253BdcZjj59zY=/ems.ZW1zLXByZC1hc3NldHMvbW92aWVzL2E5OTI3ZjI2LTk3NmUtNGE2Ni04MzVmLTIyMmI4MzQxZDE3YS53ZWJw,Trespassers,1,30,2018.0,Horror/Mystery and thriller,0 days 01:28:00.000000000,34
71,90,,Ice on Fire,1,10,2019.0,Documentary,0 days 01:38:00.000000000,19
49,0,/assets/pizza-pie/images/poster_default.c8c896e70c3.gif,Saving Zoë,50,6,2019.0,Mystery and thriller,0 days 01:35:00.000000000,-49
69,88,,Deerskin,50,105,2019.0,Comedy,0 days 01:17:00.000000000,19
71,86,,Use Me,1,7,2019.0,Mystery and thriller,0 days 01:31:00.000000000,15
64,65,https://resizing.flixster.com/o27ISd3SWqzeYtZN6_0l2IMyB2w=/206x305/v2/https://resizing.flixster.com/8CnpwlTYWmAJPrp7pdRBarE9l-A=/ems.ZW1zLXByZC1hc3NldHMvbW92aWVzLzQ0NjY2NmMxLThiN2ItNDkzNy1hZTVmLWI4MzhhNjQzNWMwOC53ZWJw,Astronaut,1,55,2019.0,Drama,0 days 01:37:00.000000000,1
40,17,https://resizing.flixster.com/7IpCM3tlUuOkhm6nowCCk-eHLjw=/206x305/v2/https://resizing.flixster.com/KkXcg_QqlDOmm57GcrbEuBwAHGA=/ems.ZW1zLXByZC1hc3NldHMvbW92aWVzLzEwZDc2ZGZkLWM3ZTctNDJhYy1iODEzLWI3YTYxNDYzYWZlMS53ZWJw,She's Just a Shadow,1,6,2019.0,Crime/Drama,0 days 01:57:00.000000000,-23
93,100,https://resizing.flixster.com/PwGJUOfzyohdhHpQVmYEM-NWGvY=/206x305/v2/https://resizing.flixster.com/_8dgIa34flah0g2knyR2Lp5yeQk=/ems.ZW1zLXByZC1hc3NldHMvbW92aWVzLzA4MzA0YzM4LTU4YTQtNDJjNy1hMDJkLTM2Njg3ZDdiZDFiMC53ZWJw,Queen of Paradis,1,10,2020.0,Documentary,0 days 01:25:00.000000000,7
71,57,,Above the Shadows,1,7,2019.0,Fantasy/Drama,0 days 01:45:00.000000000,-14
17,44,,Critters Attack!,1,16,2019.0,Comedy/Horror,0 days 01:29:00.000000000,27
86,43,https://resizing.flixster.com/jeUh6OoJix4DElhYXR_B4-fp_pk=/206x305/v2/https://resizing.flixster.com/42LdryqMBPgcMassMMSkZZLC9C8=/ems.ZW1zLXByZC1hc3NldHMvbW92aWVzL2ZlMGY4MmQ0LThjOGUtNGVkMi04OGVkLTUyOTZkMTQzYmYxYi53ZWJw,15 Minutes of War,1,7,2019.0,Drama/Mystery and thriller,0 days 01:38:00.000000000,-43
69,80,,Auggie,1,15,2019.0,Sci fi/Drama,0 days 01:21:00.000000000,11
66,58,,Liam Gallagher: As It Was,1,31,2019.0,Music/Documentary,0 days 01:25:00.000000000,-8
39,83,,After We Leave,1,6,2019.0,Sci fi/Drama,0 days 01:22:00.000000000,44
74,75,https://resizing.flixster.com/e62umHHum_-Vwuq4o0za-dDfv7w=/206x305/v2/https://resizing.flixster.com/ECDlzeuGYKuYbKe_HoCEZ-MyxWc=/ems.ZW1zLXByZC1hc3NldHMvbW92aWVzL2U1MTI1YWZhLTcxMzItNGJmOS04NzA4LWQ0ZWY2MjFhOTY0Ny53ZWJw,Armstrong,1,20,2019.0,Documentary,0 days 01:40:00.000000000,1
43,74,https://resizing.flixster.com/D41twWEBm1HU3gJVVpxidSPugfk=/206x305/v2/https://resizing.flixster.com/G39b5Jcszjn30uRbX2EQroBWPoc=/ems.ZW1zLXByZC1hc3NldHMvbW92aWVzLzk4NjFhOWM3LWRkZjAtNGIwYy1hNjNlLTAxZjVlZDkxMjQzYS53ZWJw,Between Two Ferns: The Movie,250,58,2019.0,Comedy,0 days 01:22:00.000000000,31
68,69,/assets/pizza-pie/images/poster_default.c8c896e70c3.gif,Bottom of the 9th,1,13,2019.0,Drama,0 days 01:51:00.000000000,1
16,0,,Drive,1,8,2018.0,Action,0 days 02:27:00.000000000,-16
45,62,https://resizing.flixster.com/QWkgwQaJzXOdcKFOxha85JZwyPY=/206x305/v2/https://resizing.flixster.com/6O87N3eNi-4FrFV7uaK6cn_4SKA=/ems.ZW1zLXByZC1hc3NldHMvbW92aWVzLzMwMDg2YWRhLTAzMzUtNDYwZi1hZDljLTM1YzljNzViMmQ3Mi53ZWJw,Satanic Panic,100,61,2019.0,Comedy/Horror,0 days 01:28:00.000000000,17
63,63,,DeadTectives,1,8,2018.0,Comedy/Horror,0 days 01:32:00.000000000,0
97,100,,Better Days,100,23,2019.0,Drama,0 days 02:15:00.000000000,3
62,33,https://resizing.flixster.com/L1bVswF8Oi1VR3wyRIZxHcpPAII=/206x305/v2/https://resizing.flixster.com/3VJ_omZ1lJ3fSorD4lydYKlHuS4=/ems.ZW1zLXByZC1hc3NldHMvbW92aWVzLzcyZjQ4ZjE3LTlkMDAtNDRlNi04NWJmLTA1YTY2MjEwNjIwOS53ZWJw,See You Soon,1,6,2019.0,Romance/Drama,0 days 01:37:00.000000000,-29
0,17,https://resizing.flixster.com/AlsVL3ycdDu3YM4gYI0BzoOOP-Q=/206x305/v2/https://resizing.flixster.com/bmDZISjccN3DHLB6UqSt9dcSS40=/ems.ZW1zLXByZC1hc3NldHMvbW92aWVzLzVkNmM0OGY3LWQxODUtNDYwYS05YzlmLTljYzgxMDgyNTg2MC53ZWJw,They're Inside,1,6,2019.0,Horror/Mystery and thriller,0 days 01:23:00.000000000,17
31,38,https://resizing.flixster.com/xNS7HPmWu1pAf2f_6K_Bd-dgXy0=/206x305/v2/https://resizing.flixster.com/KAJcIO_O7Tv4roNoRBMc6jmg4Ew=/ems.ZW1zLXByZC1hc3NldHMvbW92aWVzL2I5MmFlMTI0LWMwMTAtNDc0ZS1iYzYyLWM1ODA5ODdmOGNlOS53ZWJw,Black Christmas,1000,110,2019.0,Other/Horror,0 days 01:32:00.000000000,7
18,22,https://resizing.flixster.com/d6AaE12c56SCe6fSUL-krTeClY8=/206x305/v2/https://resizing.flixster.com/NynMYE7g4IzIAMaN3yd6cK2g270=/ems.ZW1zLXByZC1hc3NldHMvbW92aWVzLzdjZGY3MmExLTMyMDItNDQ1Zi1hMjE1LTk5OWNjNzkyYjg2Ni53ZWJw,Verotika,1,18,2019.0,Horror,0 days 01:30:00.000000000,4
30,30,,Into the Ashes,1,20,2019.0,Action/Mystery and thriller,0 days 01:37:00.000000000,0
24,0,https://resizing.flixster.com/KSBBjZD6l0VG7fzMLkbOIjlZkJI=/206x305/v2/https://resizing.flixster.com/UMc_0rKQu34n_CIv6J3xI7llbSA=/ems.ZW1zLXByZC1hc3NldHMvbW92aWVzLzNhYWNkNzZjLWU3ZGMtNDA2Yy04NjVjLTFhZDMyNDYxNzYyZS53ZWJw,The Influence (La influencia),1,5,2019.0,,,-24
12,29,https://resizing.flixster.com/WPH6lVsFIPIxODZcs2H0Q1rmKqA=/206x305/v2/https://resizing.flixster.com/FNOOvoLbkaNNrBo2i2MLGx4f9Bk=/ems.ZW1zLXByZC1hc3NldHMvbW92aWVzLzJlZjg1ODJhLWE3YjktNDZlZS1hYjYwLTUzYmQxM2Q4MGM4My53ZWJw,Secret Obsession,100,17,2019.0,Drama/Mystery and thriller,0 days 01:37:00.000000000,17
30,38,,Point Blank,100,34,2019.0,Action/Mystery and thriller,0 days 01:26:00.000000000,8
63,26,https://resizing.flixster.com/yfxTRtITkf5PstgcbmDsy3wX_bM=/206x305/v2/https://resizing.flixster.com/K7yQNoV8osYdSp7nltP0-lHV9vQ=/ems.ZW1zLXByZC1hc3NldHMvbW92aWVzLzgwMWI0MDM3LWYzMTctNDZmNy04ZDVlLTQwYTkzZThlZmQ4ZC53ZWJw,Killerman,50,19,2019.0,Crime/Action,0 days 01:52:00.000000000,-37
50,63,https://resizing.flixster.com/YP-YU28jNJxXmq6rsF5XoHTM3Ek=/206x305/v2/https://flxt.tmsimg.com/assets/p17090364_p_v13_aa.jpg,The Banana Splits Movie,100,19,2019.0,Horror,0 days 01:26:00.000000000,13
49,66,https://resizing.flixster.com/NWsyvsioQGwhMgs7feUNvRqTeiw=/206x305/v2/https://resizing.flixster.com/nfIfMCdLA7LkJGWuEp39t06rh3k=/ems.ZW1zLXByZC1hc3NldHMvbW92aWVzL2ZmZDFiNDI4LWMyNmUtNDYwOS1hZjVjLTllOGMyZWFiNDk1NC53ZWJw,The Furies,1,29,2019.0,Action/Mystery and thriller,0 days 01:22:00.000000000,17
58,100,https://resizing.flixster.com/xxODanXffiSoaE3shZEUs9i_czE=/206x305/v2/https://flxt.tmsimg.com/assets/p17080793_p_v10_aa.jpg,Teacher,50,7,2019.0,Drama,0 days 01:40:00.000000000,42
83,55,,Strange but True,1,29,2019.0,Mystery and thriller,0 days 01:36:00.000000000,-28
65,44,https://resizing.flixster.com/C63_PtPmNedVCIwOS5oTuJ-B6Wk=/206x305/v2/https://resizing.flixster.com/xwefLdAU_qO1orYlAkSw-G1teiA=/ems.ZW1zLXByZC1hc3NldHMvbW92aWVzLzI0NWY3MmVhLTZkY2EtNDFhNS1hNzU0LTVhMjcyNTdmMzJlOS53ZWJw,Robert the Bruce,100,52,2019.0,War/Drama,0 days 02:04:00.000000000,-21
58,50,,Miss Arizona,1,6,2018.0,Comedy/Drama,0 days 01:34:00.000000000,-8
39,75,https://resizing.flixster.com/niT84qLr8D4DcY-Yb6_zhLJb6zE=/206x305/v2/https://resizing.flixster.com/LJeyypw0KfemHhPnYItzhUmHuzk=/ems.ZW1zLXByZC1hc3NldHMvbW92aWVzL2I3NmY5Y2EwLWViYWUtNDk0MC1iOWE1LWI0Njg4YzFhMjA4MC53ZWJw,Spider in the Web,1,8,2019.0,Mystery and thriller,0 days 01:54:00.000000000,36
88,73,https://resizing.flixster.com/_T3K_fXEcv7LzVNniEV-XMAaIrQ=/206x305/v2/https://resizing.flixster.com/BaHUwAIH7SuoWwW3joitp72qvng=/ems.ZW1zLXByZC1hc3NldHMvbW92aWVzLzUyNDQxMzZmLWFiNjAtNDRkMi1iNDZkLTI2NmQ1YzlmMDExOC53ZWJw,Angel of Mine,250,22,2019.0,Drama/Mystery and thriller,0 days 01:38:00.000000000,-15
60,17,https://resizing.flixster.com/a7ZnPd-D40G4pw0120Iv4OnoxZU=/206x305/v2/https://resizing.flixster.com/nkW9oCXkP_Y6HvzyizfY0Z0wXH8=/ems.ZW1zLXByZC1hc3NldHMvbW92aWVzL2Y5ODZhMjI0LWU4NTUtNGIzMi04ZjMxLWVlNjQ5OTVkYTBkYi53ZWJw,Hot Air,1,18,2018.0,Drama,0 days 01:43:00.000000000,-43
46,54,,Burn,50,13,2019.0,Mystery and thriller,0 days 01:28:00.000000000,8
72,84,https://resizing.flixster.com/Xs-21rHbVkECzCFUi0MTa378LoA=/206x305/v2/https://resizing.flixster.com/geLvhd520iEb8BDfF1lntmlO8wg=/ems.ZW1zLXByZC1hc3NldHMvbW92aWVzLzJlNzk0Yjc4LTFiMGUtNDk5MS05MTBiLTE4MGMwZDdmYjg0OC53ZWJw,Aziz Ansari: Right Now,50,31,2019.0,Comedy/Stand up,0 days 01:05:00.000000000,12
78,62,,Mrs. Lowry & Son,1,37,2019.0,Biography/Drama,0 days 01:32:00.000000000,-16
73,67,https://resizing.flixster.com/LcAWu0_Bdlcw3RHQWwlDY2e3lCU=/206x305/v2/https://resizing.flixster.com/6GwqHjsI1BNwkH-SYK8zZ_TA2Ho=/ems.ZW1zLXByZC1hc3NldHMvbW92aWVzL2EzZGJjMjlkLTI0YWMtNDQzZi04ZTllLTJjNmM1NjkzYWFkNS53ZWJw,Almost Love,1,30,2019.0,Romance/Gay and lesbian,0 days 01:32:00.000000000,-6
64,88,https://resizing.flixster.com/EQzPbi4LHV6PdyedYsjRgCcAhr0=/206x305/v2/https://resizing.flixster.com/xVmxhE7YYuHLfuAtUaCh0y9kruI=/ems.ZW1zLXByZC1hc3NldHMvbW92aWVzL2RkM2YzNjVmLWI1OWUtNDAyYy04NDg0LTEzNDQ0YzU2ZmE1YS53ZWJw,"Frankenstein's Monster's Monster, Frankenstein",1,17,2019.0,Drama,0 days 00:28:00.000000000,24
58,100,https://resizing.flixster.com/Xa0uYM7QRBA-CFKxT91YpN9Uw_s=/206x305/v2/https://resizing.flixster.com/8hSgYGATWbm5jB5f28lPxlmwfks=/ems.ZW1zLXByZC1hc3NldHMvbW92aWVzLzlkMzU3NzM4LWYwNzctNDZkMC05Mjg5LTE1OTliOWUxYWZkZi53ZWJw,Every Time I Die,50,10,2019.0,Horror/Mystery and thriller,0 days 01:38:00.000000000,42
59,78,https://resizing.flixster.com/MiYfZ0UbwAPUY9WwvPTIGo0vAhU=/206x305/v2/https://resizing.flixster.com/TYhasnVaghyzSoLMhyrJGsZCuPM=/ems.ZW1zLXByZC1hc3NldHMvbW92aWVzLzQzODdkYTY4LWZkYjQtNGIzNy1iODZiLTdmZmU5OGNlYjAzNi53ZWJw,The Night Sitter,1,9,2018.0,,,19
20,15,,A Score to Settle,50,20,2019.0,Action/Mystery and thriller,0 days 01:44:00.000000000,-5
77,83,https://resizing.flixster.com/_JRJIX4u5cP0Afh4KCoJd6414Lg=/206x305/v2/https://resizing.flixster.com/9ADs-4kAwcB2tmsOelcURWW1dnY=/ems.ZW1zLXByZC1hc3NldHMvbW92aWVzLzgzMjhjNGZjLTBlZDAtNDQ0Zi05OGVhLTk3Mzc4ZTQzZWUyMi53ZWJw,Coyote Lake,1,6,2019.0,Mystery and thriller,0 days 01:33:00.000000000,6
90,44,https://resizing.flixster.com/vgx8FdeLhCbdc2yPt4kIMutQu30=/206x305/v2/https://resizing.flixster.com/Zqp5X3qLsadzmndDCMCnCq_3C7Y=/ems.ZW1zLXByZC1hc3NldHMvbW92aWVzLzhmNGRmMzRkLTZkMjQtNDBkOS04M2M1LWJjMzZkMTFiY2VlYi53ZWJw,The Divine Fury,1,18,2019.0,Action/Horror,0 days 02:09:00.000000000,-46
23,17,https://resizing.flixster.com/u8XCN0INU3ENhv9RDWf60ZNqfv8=/206x305/v2/https://flxt.tmsimg.com/assets/p17035513_p_v13_ab.jpg,Dead Water,1,6,2019.0,Mystery and thriller,0 days 01:29:00.000000000,-6
48,86,https://resizing.flixster.com/DkoorKCel5vCnLxetOst7l8h0ic=/206x305/v2/https://flxt.tmsimg.com/assets/p17260576_p_v13_aa.jpg,The Black String,1,7,2019.0,Horror/Mystery and thriller,0 days 01:32:00.000000000,38
27,60,https://resizing.flixster.com/OPMCN-8prc4SvyZl3zJUSv4ZYuI=/206x305/v2/https://resizing.flixster.com/mFUlu79hvGAqFg9Q5naBsvq1OAY=/ems.ZW1zLXByZC1hc3NldHMvbW92aWVzLzJmMTliYTVhLWQ2MzQtNDEyOS1iYWM4LTM5ODlhMmEyODVjNC53ZWJw,Itsy Bitsy,50,10,2019.0,Horror/Mystery and thriller,0 days 01:35:00.000000000,33
40,64,https://resizing.flixster.com/Q9hfAp90fDK92ZE-UgVUIFZ6qik=/206x305/v2/https://resizing.flixster.com/MHaXjdmhaY2yilZ_DnlMu9GQlkk=/ems.ZW1zLXByZC1hc3NldHMvbW92aWVzLzY5NzI0ZmI3LWZhZTItNDZlNC1hZjQ1LTkzOThjZTk3M2JkOS53ZWJw,Union,1,11,2018.0,Drama/History,0 days 02:15:00.000000000,24
73,50,https://resizing.flixster.com/aoU5L9arC1_UYmLQLcGE9rJWINY=/206x305/v2/https://resizing.flixster.com/4xyW8cHpUNtjF1rUPNmY_7BLJIw=/ems.ZW1zLXByZC1hc3NldHMvbW92aWVzL2FhOGYwNTEyLWEwZGUtNGY0MC04ZmVkLTJlY2M3YjQ1MmQ0Yi53ZWJw,Ghost Killers vs. Bloody Mary (Exterminadores do Além Contra a Loira do Banheiro),1,6,2018.0,,,-23
15,43,,Doom: Annihilation,250,7,2019.0,Sci fi/Action,0 days 01:37:00.000000000,28
83,60,https://resizing.flixster.com/5wXEu3MkaBXfrr1NZx_SbxAnu-k=/206x305/v2/https://resizing.flixster.com/Rk37DqeysGzCyf8a9nwj3XYfMvo=/ems.ZW1zLXByZC1hc3NldHMvbW92aWVzLzNmZDc5OTFkLTZmYzEtNDJjOS1hYTk1LTlhYjMxNWFhMjZkMi53ZWJw,One Last Night,1,5,2018.0,Romance,0 days 01:17:00.000000000,-23
93,65,https://resizing.flixster.com/SRzBR6TDZSdzaUAONxg39KS7yN0=/206x305/v2/https://resizing.flixster.com/23bTQDBO6pIeSnWdv7XDgys_LJk=/ems.ZW1zLXByZC1hc3NldHMvbW92aWVzL2MyYjBkN2MwLTEzNWYtNGQ0Yy04NWQxLWE4MjU2ZmRhMDAxNS53ZWJw,Jay and Silent Bob Reboot,500,40,2019.0,Comedy,0 days 01:35:00.000000000,-28
53,96,https://resizing.flixster.com/CkfpsaV5K1FAcJiT54PriyTKG3E=/206x305/v2/https://resizing.flixster.com/kyiobRsIXJBVNMCQYlYXY339RRQ=/ems.ZW1zLXByZC1hc3NldHMvbW92aWVzL2ZjNmIxYzE5LWZiYTgtNGZhMi1hOGM0LTMxYTM4ODNiMTQ1Ni53ZWJw,Blood on Her Name,50,56,2019.0,Crime/Drama,0 days 01:25:00.000000000,43
52,87,,1BR,250,77,2019.0,Horror/Mystery and thriller,0 days 01:30:00.000000000,35
92,100,https://resizing.flixster.com/L_PjB0yu2MC-xRwgc6qfdE_qu3U=/206x305/v2/https://flxt.tmsimg.com/assets/p17237436_p_v13_aa.jpg,Teen Titans Go! Vs. Teen Titans,250,5,2019.0,Action/Animation,0 days 01:16:00.000000000,8
46,75,https://resizing.flixster.com/rZ6qxVN3l9nkJ-j2fFo-fqwfSBw=/206x305/v2/https://resizing.flixster.com/QFbNhHtbm7rUIAc8eV9ezVf7U4o=/ems.ZW1zLXByZC1hc3NldHMvbW92aWVzL2VmZDI0NjY5LTIzZDgtNGFmYy1iNTFiLTZmZWZiOGE2Y2Q1YS53ZWJw,The Wretched,250,110,2019.0,Horror/Mystery and thriller,0 days 01:35:00.000000000,29
90,100,,Invader Zim: Enter the Florpus,50,21,2019.0,,,10
41,90,https://resizing.flixster.com/Ze71Le4X1LALWgl2m_MDFGtWDYg=/206x305/v2/https://resizing.flixster.com/Cgouf3cLA3VSEs0t5IQVqyEbu-k=/ems.ZW1zLXByZC1hc3NldHMvbW92aWVzLzA5MzJhMmRkLTNjZmMtNDVhNi05ZDgzLTk2OTU2ODFhMTAwZS53ZWJw,Riot Girls,1,21,2019.0,Action,0 days 01:22:00.000000000,49
100,70,https://resizing.flixster.com/LyNADI2AkccJ5gFxyv2XjAthSAo=/206x305/v2/https://resizing.flixster.com/X2zjz26OtVXjIUN_tVqNCMR0ve4=/ems.ZW1zLXByZC1hc3NldHMvbW92aWVzLzAyNWQ0YWVmLWQwOTMtNGQ0Ny1hZjlhLTRhM2YzNGRiYjczNC53ZWJw,Haunt,1,47,2019.0,Other/Horror,0 days 01:32:00.000000000,-30
29,16,https://resizing.flixster.com/5q1QkO8t2MFcNqXrlU7NniYObYg=/206x305/v2/https://resizing.flixster.com/dVnBC8p4lMDoRNkIbRCmpruDToI=/ems.ZW1zLXByZC1hc3NldHMvbW92aWVzLzM1MjQ3ZDY4LWMyYWMtNDAxNC1hOTY0LTZmNjQ0YTIzN2RiOC53ZWJw,The Fanatic,250,68,2019.0,Mystery and thriller,0 days 01:28:00.000000000,-13
83,94,,Bad Education,500,148,2019.0,Comedy/Drama,0 days 01:43:00.000000000,11
42,45,,"Endings, Beginnings",100,74,2019.0,Drama,0 days 01:50:00.000000000,3
18,67,https://resizing.flixster.com/dzqTAkXh4UhB1nNsbo9toagDmYk=/206x305/v2/https://flxt.tmsimg.com/assets/p17095648_p_v13_aa.jpg,Candy Corn,1,6,2019.0,Other/Horror,0 days 01:25:00.000000000,49
64,44,https://resizing.flixster.com/Jc7VwiwttzGlwvVk2friQZbC2so=/206x305/v2/https://resizing.flixster.com/lIgkxIiyn87W000x0D0oXMuEHNo=/ems.ZW1zLXByZC1hc3NldHMvbW92aWVzLzIxMjlmNzVjLTJkZWItNGEzOC1iNTgzLWM0NzU3OTRiZTMzYS53ZWJw,Cuck,250,16,2019.0,Drama,0 days 01:55:00.000000000,-20
61,30,https://resizing.flixster.com/87SaYSvDC2o48dpQyVmt15nh69k=/206x305/v2/https://resizing.flixster.com/ZDo8lxYBvCYi-SCdEKTeBmKf2vw=/ems.ZW1zLXByZC1hc3NldHMvbW92aWVzL2IzZDdhNTFhLTI1ZTQtNDk5MC1iMzU4LTY5ZmRlYzI1NjEwYi53ZWJw,Madness in the Method,50,10,2019.0,Comedy,0 days 01:39:00.000000000,-31
83,71,https://resizing.flixster.com/u9ydBHtEuObC3jAwFWInmhUyYIY=/206x305/v2/https://resizing.flixster.com/2CJiTJOefWQTqN_yQ6odTucXXRM=/ems.ZW1zLXByZC1hc3NldHMvbW92aWVzL2Y5MzFiMmZmLTM2NGQtNDQwYy04NTA0LTU3YmY2MTU4ZjZiYy53ZWJw,The King,1000,142,2019.0,Drama/History,0 days 02:20:00.000000000,-12
91,97,https://resizing.flixster.com/k8OZj4bQfthy6jL_m2076aBZR5M=/206x305/v2/https://resizing.flixster.com/nwm01Z6kpU90cbI1AxfUX-EwaBI=/ems.ZW1zLXByZC1hc3NldHMvbW92aWVzLzIzNWM0ZmU2LTQ0ZjktNGUxNy1hZjE4LTU0OGRmZDcwNTk1Zi53ZWJw,Dolemite Is My Name,100,232,2019.0,Comedy/Drama,0 days 01:58:00.000000000,6
40,41,https://resizing.flixster.com/JiLBjGFWpfbPHRLkmm6rahLWG3Q=/206x305/v2/https://resizing.flixster.com/cbUAlu-xCShIbDISEAo8zWdWDnY=/ems.ZW1zLXByZC1hc3NldHMvbW92aWVzL2QzZmYzZGQ0LWFlODktNGNlNS1hODYzLWMyNGE0MjI1ZTBjYS53ZWJw,The Laundromat,500,170,2019.0,Comedy,0 days 01:36:00.000000000,1
97,94,,Klaus,1000,68,2019.0,Other/Kids and family,0 days 01:38:00.000000000,-3
85,94,https://resizing.flixster.com/hZvIETxe00FYl5g-h-RrxAKjNDo=/206x305/v2/https://resizing.flixster.com/wrh6CHfG4lCTzh5GLlaLBYHUwGQ=/ems.ZW1zLXByZC1hc3NldHMvbW92aWVzL2YyODE2NjBkLWM3ZTYtNDNjMi05NzM0LTZjN2QyZjhiYTY0MC53ZWJw,Marriage Story,100,387,2019.0,Drama/Comedy,0 days 02:16:00.000000000,9
88,89,https://resizing.flixster.com/rJ2cqG1zO8n3iSfh9t1FIQxIdCk=/206x305/v2/https://resizing.flixster.com/zo1erNSXXhb5a2fGaQV3E4o1Jcs=/ems.ZW1zLXByZC1hc3NldHMvbW92aWVzLzZhNDRiNjdjLWFkM2ItNGNlOC04Y2U3LTYzZGY0MDIwZDUwNi53ZWJw,The Two Popes,1000,223,2019.0,Drama,0 days 02:06:00.000000000,1
71,57,https://resizing.flixster.com/AVaBtVfNkqhBVIK8jipHIZ0vCpU=/206x305/v2/https://resizing.flixster.com/oai8Q3PqMhRgNRZ2nOZddw7ovkA=/ems.ZW1zLXByZC1hc3NldHMvbW92aWVzL2ViOTZmZmE1LTMwZjktNDIxYi04NWRiLTI0ZjJmMWE0ZTVlMC53ZWJw,The VelociPastor,100,14,2018.0,Action/Adventure,0 days 01:15:00.000000000,-14
50,20,https://resizing.flixster.com/pcsshRu4uePZ1MmQNwaA-7QsVZ8=/206x305/v2/https://resizing.flixster.com/Pf8pUmXfxILNivXseXx732LqL4s=/ems.ZW1zLXByZC1hc3NldHMvbW92aWVzLzRhZTdiMjc4LWNhNDYtNDZkMS1iYzQwLTJhMmI0Y2VmMjMxYi53ZWJw,The Jack in the Box,1,5,2019.0,Horror,0 days 01:27:00.000000000,-30
73,38,https://resizing.flixster.com/fWBHjEXYhUBVj0uzapB5KqVmg7g=/206x305/v2/https://resizing.flixster.com/QsKmeiBMcIWp9tfcY0Wgv3FW1qs=/ems.ZW1zLXByZC1hc3NldHMvbW92aWVzLzJjMzNjN2M1LWI3MGMtNDA5NC04ODYwLTM0ZDcwMWYzY2JmOS53ZWJw,Inside Game,1,8,2019.0,Drama,0 days 01:37:00.000000000,-35
57,53,https://resizing.flixster.com/Fm5hsB05Y9M-r43yqqVcYOUAmcM=/206x305/v2/https://resizing.flixster.com/KZ14nO90a14EeP-Qkjc7tJpSp-I=/ems.ZW1zLXByZC1hc3NldHMvbW92aWVzLzUxMGJhZmQ5LWE1YzctNGU4OS1hYTgzLTNhZWU4YTA3ODg4Yy53ZWJw,Bloodline,100,19,2018.0,Horror/Mystery and thriller,0 days 01:38:00.000000000,-4
55,50,,Earthquake Bird,100,40,2019.0,Crime/Drama,0 days 01:47:00.000000000,-5
39,24,https://resizing.flixster.com/UHTygFKqhEq2z4aJi16QrBf8wHY=/206x305/v2/https://resizing.flixster.com/xLa5RmOuBf5qAb9v6yt7WmIoI8Q=/ems.ZW1zLXByZC1hc3NldHMvbW92aWVzL2VkZTdlYmM3LTY1YzktNDc4YS05ZTk5LTc5ODk1YzgyM2VhNy53ZWJw,Running With the Devil,100,25,2019.0,Crime/Action,0 days 01:40:00.000000000,-15
38,29,https://resizing.flixster.com/dkiGNPfxjmGAqzeXYXuwRlJF4cQ=/206x305/v2/https://resizing.flixster.com/8RZJqvukFeJxysCQtRDasHeMMNc=/ems.ZW1zLXByZC1hc3NldHMvbW92aWVzLzI5Y2YxYjg4LWI4NzUtNDBjNS1iNDRlLTkzMzM2ZmYyYWJiMS53ZWJw,Can You Keep a Secret?,100,17,2019.0,Romance,0 days 01:34:00.000000000,-9
19,0,,10 Minutes Gone,50,7,2019.0,Crime/Action,0 days 01:28:00.000000000,-19
43,44,https://resizing.flixster.com/RcuK3Apc9OPfth2PWeMACHR1FT4=/206x305/v2/https://resizing.flixster.com/liph7HiNcsdcX6kou-WB3v2sbTg=/ems.ZW1zLXByZC1hc3NldHMvbW92aWVzL2EwYjFhZmM2LTA4ZmItNGE0Ny04YWY0LTNlNDNiMmFlZTc4NC53ZWJw,Pokémon the Movie: Mewtwo Strikes Back Evolution,100,9,2019.0,Action/Kids and family,0 days 01:38:00.000000000,1
33,65,https://resizing.flixster.com/_BhGl2O_iiRn-509weuGlS5c6n4=/206x305/v2/https://resizing.flixster.com/F06s-ZAhwjskQm7QhrIKElYHVGw=/ems.ZW1zLXByZC1hc3NldHMvbW92aWVzLzVmNDBhYTljLWQ3ZWQtNDJhZC04ZWU5LWViMGRkNTUyODhmOC53ZWJw,Falling Inn Love,100,20,2019.0,Romance,0 days 01:38:00.000000000,32
50,48,,American Son,250,25,2019.0,Drama,0 days 01:30:00.000000000,-2
63,86,https://resizing.flixster.com/FYq6YLSnLhP4O7Gn8ybOF5Bmhpk=/206x305/v2/https://resizing.flixster.com/CKW2oJBm4E4lqU8avsSt-owPR2s=/ems.ZW1zLXByZC1hc3NldHMvbW92aWVzLzVmN2VkYzhhLTNmMjYtNDA2My05Yjc2LWU1YjY4OGNlYzU0YS53ZWJw,Iron Fists and Kung Fu Kicks,1,7,2019.0,Documentary,0 days 01:40:00.000000000,23
98,88,,Ne Zha,250,17,2019.0,Animation/Fantasy,0 days 01:50:00.000000000,-10
99,35,https://resizing.flixster.com/zVELvdZafFFihtEgi8gD1L2bWPM=/206x305/v2/https://resizing.flixster.com/b4BK0CX4M6k5tcHfHLW89Ug8i_s=/ems.ZW1zLXByZC1hc3NldHMvbW92aWVzL2ViYjI4NzA0LTUzNTktNDViYi1hY2NiLTU3MmFmYTM3MTg0MS53ZWJw,Dave Chappelle: Sticks & Stones,25000,17,2019.0,Comedy/Stand up,0 days 01:05:00.000000000,-64
50,66,https://resizing.flixster.com/LrsWjq5gRfANhTgxiLNzczUR-Tg=/206x305/v2/https://resizing.flixster.com/3o8bJ_75vQN_X5kzP43wvOYpjjY=/ems.ZW1zLXByZC1hc3NldHMvbW92aWVzLzQwYjU4NzRiLTBhNTEtNGQ4OS1hOGUxLTBlNDU0OWU0MzU5MS53ZWJw,Lady and the Tramp,500,67,2019.0,Comedy/Adventure,0 days 01:43:00.000000000,16
84,68,https://resizing.flixster.com/ZC9Mu19hkWgiZgdmVHM1O7b1zxg=/206x305/v2/https://resizing.flixster.com/NiYFHiBr5cXEfOFSEltMRif9x5k=/ems.ZW1zLXByZC1hc3NldHMvbW92aWVzL2NhNjUwMzM4LWRmM2YtNDkyMS05M2I1LWY4OWM2MDRhOTQwZi53ZWJw,Bombshell,5000,329,2019.0,Drama,0 days 01:48:00.000000000,-16
82,86,https://resizing.flixster.com/MtCVCk6c-CMsQrBJN8F-wbDQaYM=/206x305/v2/https://resizing.flixster.com/LxyEGVTF4UOP2v6M3LZvhRUb8VI=/ems.ZW1zLXByZC1hc3NldHMvbW92aWVzLzAwOTdlNTUyLTYzYmUtNGYzNi04YzUyLThmYTcyZTk3OTEzYy53ZWJw,Color Out of Space,50,206,2019.0,Sci fi/Horror,0 days 01:51:00.000000000,4
71,19,https://resizing.flixster.com/iE08VQCl1IQYkQdyoWW0XH4O9LA=/206x305/v2/https://resizing.flixster.com/YmTPAFUe647DuJVQJKFAzxMvIoc=/ems.ZW1zLXByZC1hc3NldHMvbW92aWVzLzIzNTZkYzNjLTRjMTMtNDQ2ZC05YTMxLTFiYWYyMWIwMDNlOS53ZWJw,Jexi,1000,31,2019.0,Comedy,0 days 01:24:00.000000000,-52
81,91,https://resizing.flixster.com/GBkGPQuMWQs8WknHY4gUGLSM-pM=/206x305/v2/https://resizing.flixster.com/FFu9FDkiyTnl5h02ZdbPMu2kDik=/ems.ZW1zLXByZC1hc3NldHMvbW92aWVzL2Y0NjA1MTk4LThkNDctNDNjYy05MGQxLTlkM2I3OTY0M2E1NC53ZWJw,El Camino: A Breaking Bad Movie,2500,129,2019.0,Crime/Drama,0 days 02:02:00.000000000,10
95,76,https://resizing.flixster.com/AEA80HMroZOzATpvLSW95e3DS8I=/206x305/v2/https://resizing.flixster.com/vxhXi2LNBMmNSFd_aH_xTxE0dlU=/ems.ZW1zLXByZC1hc3NldHMvbW92aWVzL2FjZGE5OWIzLTQ2MzktNGZkMS04NDdiLTNhMDRlYTI5MzVjYy53ZWJw,Tammy's Always Dying,1,33,2019.0,Drama,0 days 01:25:00.000000000,-19
95,89,https://resizing.flixster.com/Aajrdng2dLHTM6gl97yBmYYjXfI=/206x305/v2/https://resizing.flixster.com/vYAXEjpi8j1JgMcV6UmItV4VZd4=/ems.ZW1zLXByZC1hc3NldHMvbW92aWVzLzZkNTdkYjY4LTFhOTAtNGE1MC04NTllLTExZTM1NDgzZmJmYy53ZWJw,Dark Waters,2500,225,2019.0,Drama/Mystery and thriller,0 days 02:06:00.000000000,-6
40,90,https://resizing.flixster.com/vRZ2AnyoEDRgOyZr4EyeeCVqxXM=/206x305/v2/https://resizing.flixster.com/Yph6Av34C1kB-t_dkRj1TTT-y_I=/ems.ZW1zLXByZC1hc3NldHMvbW92aWVzLzViNzMyOTk2LWExM2EtNDZiYS04M2I5LTc2MjQ1MWRkMmM0OC53ZWJw,Blood Quantum,100,93,2019.0,Horror,0 days 01:36:00.000000000,50
47,87,https://resizing.flixster.com/HIZnoMP-OqYIvfyzvhr5IXfIpLk=/206x305/v2/https://resizing.flixster.com/HEU1R8NX-_m_vIf8phF5lZ316SQ=/ems.ZW1zLXByZC1hc3NldHMvbW92aWVzLzdlYmYxY2Q5LTE0N2MtNDc5Ni04MmNmLThjYzkwODhmN2RkZC53ZWJw,Sea Fever,100,106,2019.0,Horror/Mystery and thriller,0 days 01:30:00.000000000,40
20,71,https://resizing.flixster.com/wTk8ok-cYzKYOsPVJ-qJ-MlPa74=/206x305/v2/https://resizing.flixster.com/EV8EgTpDkZQMb7yN2oWBYpwvklA=/ems.ZW1zLXByZC1hc3NldHMvbW92aWVzLzM1MjllODcyLWMxNGYtNDZhZi05N2EyLTBiNjMzYmJjY2NiYi5qcGc=,Dark Encounter,1,7,2019.0,Sci fi/Mystery and thriller,0 days 01:38:00.000000000,51
62,78,https://resizing.flixster.com/FbrYuMAays0vufNqgwynlJRqNSg=/206x305/v2/https://resizing.flixster.com/dXuZlpfr9gJJRtyDa_0AuWSWBlc=/ems.ZW1zLXByZC1hc3NldHMvbW92aWVzLzM0MzEyMWNmLThlMjEtNDljNS1iMDc3LWY0OTc5Mzk1Nzk5Zi53ZWJw,The Dark Red,1,9,2018.0,Horror/Mystery and thriller,0 days 01:41:00.000000000,16
62,89,/assets/pizza-pie/images/poster_default.c8c896e70c3.gif,Eye for an Eye,50,9,2019.0,Mystery and thriller,0 days 01:47:00.000000000,27
80,69,,To Your Last Death,1,16,2019.0,Horror/Animation,0 days 01:31:00.000000000,-11
39,75,https://resizing.flixster.com/OVCPDd90QKpRHL9HL_DeHVNbj7I=/206x305/v2/https://flxt.tmsimg.com/assets/p17829062_p_v8_aa.jpg,To All the Boys: P.S. I Still Love You,500,73,2020.0,Romance/Comedy,0 days 01:41:00.000000000,36
59,50,,The Sonata,1,26,2018.0,Horror/Mystery and thriller,0 days 01:28:00.000000000,-9
72,80,https://resizing.flixster.com/d5NVTJeYi0zp7FKZTeOtUpf58RY=/206x305/v2/https://resizing.flixster.com/fr76H9ZwO7jEXkv13ZEIhnEylUM=/ems.ZW1zLXByZC1hc3NldHMvbW92aWVzLzUzMzNmMjRjLTc2YzgtNGRhMS1hMDJkLTM1MjZmYzQ4OGFjZi53ZWJw,The Platform,1000,93,2019.0,Sci fi/Mystery and thriller,0 days 01:34:00.000000000,8
73,19,https://resizing.flixster.com/bB4O_BVjG29efqDytKJejT4p55Y=/206x305/v2/https://resizing.flixster.com/f5AiJYDKiFtYwPEmz2XTa1nzdcc=/ems.ZW1zLXByZC1hc3NldHMvbW92aWVzLzU0YmJhOWYwLWFkMGQtNGM0ZS05ZDJjLWU5MDIxODRlNzRjMC53ZWJw,Semper Fi,50,16,2019.0,Mystery and thriller,0 days 01:39:00.000000000,-54
34,75,https://resizing.flixster.com/cgpeBvUIomZB6ESzcazBWVm3W_E=/206x305/v2/https://resizing.flixster.com/0fXaDZx7iyqsjvlapxfshrI6MoE=/ems.ZW1zLXByZC1hc3NldHMvbW92aWVzLzkzNWY5MWY4LTljNTktNGU1NC05NzljLWE2YjM5ZGRiY2Y5Zi53ZWJw,The Other Lamb,100,105,2019.0,Horror/Drama,0 days 01:37:00.000000000,41
40,79,https://resizing.flixster.com/VnDPYPJNMksv4fMa9zC59hcGUgI=/206x305/v2/https://resizing.flixster.com/2s-aPo2UG_1Ip4pf2HYTCPiOkH4=/ems.ZW1zLXByZC1hc3NldHMvbW92aWVzLzhhNTAyYjk5LWU5NzQtNGY5MS1iNjdhLWQ3YjhjZWM5NjFiOC53ZWJw,True History of the Kelly Gang,100,162,2019.0,Crime/Drama,0 days 02:04:00.000000000,39
79,91,https://resizing.flixster.com/fr2wC-YlJHkExw3od3UVm8oY34I=/206x305/v2/https://resizing.flixster.com/8DLOuxhkfMAQE3zs5AZWNxVlbuE=/ems.ZW1zLXByZC1hc3NldHMvbW92aWVzL2E3ZGYwNTkxLWZjNTMtNGQyZC1hMDY3LTY0MzU0ZWQzMjk3OC53ZWJw,The Rest of Us,1,11,2019.0,Drama,0 days 01:20:00.000000000,12
55,57,https://resizing.flixster.com/m83Cq3Owb1QdXxTnIK3F2Lap10Q=/206x305/v2/https://resizing.flixster.com/PoZTqNnedYNP4xRbetYELDQ4VOo=/ems.ZW1zLXByZC1hc3NldHMvbW92aWVzLzgxYWJiMGNkLTliMjUtNDEyOS1iYTAzLWRlYTA4Njg2NTY1Mi53ZWJw,Witches in the Woods,1,7,2019.0,Horror/Mystery and thriller,0 days 01:30:00.000000000,2
31,56,https://resizing.flixster.com/Y49CQxAhWywPhKIvWCKOVyDN5bQ=/206x305/v2/https://resizing.flixster.com/5BSuDrxlNTEyHmNaU-I41dpJdoM=/ems.ZW1zLXByZC1hc3NldHMvbW92aWVzL2E0MTFhZDBjLThhMmUtNDc2Yy05ZmMwLTI4MTkzNGY1YmJjNS53ZWJw,Rabid,50,32,2019.0,Horror,0 days 01:48:00.000000000,25
81,84,https://resizing.flixster.com/asK3CbXEGIhEd804DcKC5p3SmRk=/206x305/v2/https://resizing.flixster.com/RimBHsHEb7xhvjrhtvZnUuX0Rh0=/ems.ZW1zLXByZC1hc3NldHMvbW92aWVzLzYyZTI5YzQyLTY5MjItNDcwMC1iOGY3LTJiZjg4MjhiMjQ1Yi53ZWJw,Waves,250,249,2019.0,Drama,0 days 02:15:00.000000000,3
88,97,,Tell Me Who I Am,100,36,2019.0,Drama,0 days 01:25:00.000000000,9
96,86,,Bill Burr: Paper Tiger,1000,7,2019.0,Comedy/Stand up,0 days 01:07:00.000000000,-10
83,50,https://resizing.flixster.com/67GREIKZj_qT6KKlg8I_yGD3fKc=/206x305/v2/https://resizing.flixster.com/64Fto3z36Ume1VuhUCmHVKLKn2s=/ems.ZW1zLXByZC1hc3NldHMvbW92aWVzL2U3ZmNlMzZlLWI0YzQtNDU1Yy05NWYxLWM2ZWQ4YTE5MDliZS53ZWJw,Miss Virginia,50,14,2019.0,Drama,0 days 01:42:00.000000000,-33
43,9,https://resizing.flixster.com/EKKX_Y0LVH0wSixwsGjgFx-9jWU=/206x305/v2/https://resizing.flixster.com/UkLJSMH862Xr-7Jyoh-hlA8Pb7I=/ems.ZW1zLXByZC1hc3NldHMvbW92aWVzL2I3ZjhkMGMzLWE2ZDgtNGNmOS1hODg2LTEyODQ4YmRlZTQ5MC53ZWJw,Lucky Day,50,11,2019.0,Action/Mystery and thriller,0 days 01:40:00.000000000,-34
73,50,https://resizing.flixster.com/X5rtkm9aw_oH8EsFFQiM58sZSXE=/206x305/v2/https://resizing.flixster.com/YwDJ_vaIkoY4-GWIyX8f989MbfE=/ems.ZW1zLXByZC1hc3NldHMvbW92aWVzLzVlYmNkYWE1LTFjYTctNDMyMy1iZTE2LWY0MTk5NjM4ZTJjOS53ZWJw,"Live Twice, Love Once",1,8,2020.0,Comedy/Drama,,-23
83,20,https://resizing.flixster.com/v7KPTMC5ShYcgsft4EyVAKTRHHA=/206x305/v2/https://resizing.flixster.com/Hf9kz3omFD6qMJ-qTAVoNvgYhDE=/ems.ZW1zLXByZC1hc3NldHMvbW92aWVzLzQ4ODJkNTZhLTg3MjAtNDc1ZS1hYjI4LTdlODMxYTg2MzIxNC5qcGc=,The Great Alaskan Race,50,10,2019.0,Drama/Adventure,0 days 01:27:00.000000000,-63
83,89,https://resizing.flixster.com/RPjnSBTowwcGJ_I-BVm7omw0K9w=/206x305/v2/https://resizing.flixster.com/sOy_4Ghd6Gc3gPsNpSTh7kjkReA=/ems.ZW1zLXByZC1hc3NldHMvbW92aWVzLzNlYWM4OWY2LWI4MTQtNDAxMi1hM2NjLTE4NTRkMzgwY2M1MS53ZWJw,Cunningham,1,61,2019.0,Biography/Documentary,0 days 01:33:00.000000000,6
33,48,https://resizing.flixster.com/jPJbSs07QA3ltfRByfjky22Z5jU=/206x305/v2/https://resizing.flixster.com/C5FVZRgasZloL2tOmSan0s4FsIk=/ems.ZW1zLXByZC1hc3NldHMvbW92aWVzL2ZhZTg2YmJkLTUzYWMtNDcwYy05NDMxLTcxNDlmMTRlZjI4MS53ZWJw,Greed,1,144,2019.0,Comedy,0 days 01:44:00.000000000,15
90,39,https://resizing.flixster.com/iQn9BdN0tLENawmlpY9tCc7CZiA=/206x305/v2/https://resizing.flixster.com/E56y_JQxt2zuroSWpJ6Xc8B8CkI=/ems.ZW1zLXByZC1hc3NldHMvbW92aWVzL2M5Y2E2MmZkLTc4MWEtNDkzNi05OTk3LWU2NzViZTk5YjNiNS53ZWJw,The Song of Names,50,56,2019.0,Drama/Mystery and thriller,0 days 01:53:00.000000000,-51
40,51,https://resizing.flixster.com/TffWrb93omopyBlKoIvmEXi4RTQ=/206x305/v2/https://resizing.flixster.com/lx8-_w2SewfaYeJ042EDBxn8VAQ=/ems.ZW1zLXByZC1hc3NldHMvbW92aWVzLzlhNGMxYzVjLTAwM2YtNDVjZC1hNzI2LTk0N2FkNTI5OTE5ZC53ZWJw,Guns Akimbo,1,68,2019.0,Comedy/Action,0 days 01:35:00.000000000,11
83,79,https://resizing.flixster.com/JyfJid91CKuBlllSjBLyZZUJwOo=/206x305/v2/https://flxt.tmsimg.com/assets/p18142192_p_v13_aa.jpg,There's Something in the Water,1,14,2019.0,Documentary,0 days 01:13:00.000000000,-4
59,97,https://resizing.flixster.com/a6XhXaRikoTaTLJ7V1PRDCVkKM8=/206x305/v2/https://resizing.flixster.com/KxXxWmgU49flDBaLXUQCX1yvsmE=/ems.ZW1zLXByZC1hc3NldHMvbW92aWVzL2I2ZDJlOGYwLWNmMmEtNGQ1OS1hM2JkLWZlMTMwNWM1NjY3ZS53ZWJw,The Body Remembers When the World Broke Open,1,36,2019.0,Drama,0 days 01:45:00.000000000,38
71,96,https://resizing.flixster.com/nIJYcqc-PpLVMiIHI1s9ndh1vDE=/206x305/v2/https://resizing.flixster.com/VRvvgFgAKfrMYFCZoZYM23cNUPM=/ems.ZW1zLXByZC1hc3NldHMvbW92aWVzLzRkYjAwNmIzLTAyNTItNGZjNC04YjA4LTJjYjVlMjhjYzE1ZS53ZWJw,"Bikram: Yogi, Guru, Predator",100,23,2019.0,Crime/Documentary,0 days 01:26:00.000000000,25
57,54,/assets/pizza-pie/images/poster_default.c8c896e70c3.gif,Noelle,500,41,2019.0,Other/Comedy,0 days 01:40:00.000000000,-3
100,100,,No Small Matter,1,10,2018.0,Documentary,,0
70,81,https://resizing.flixster.com/dJj_-WDDs-BVtqczqDjeI8-502A=/206x305/v2/https://resizing.flixster.com/cmUs_4ZKYgEgTcRD5N-BV2qlYnI=/ems.ZW1zLXByZC1hc3NldHMvbW92aWVzLzA5YjUzNWM2LWRkZWMtNDJkZC1hZWM5LTBhNjMzMDc4NWE1MC53ZWJw,VHYes,1,42,2019.0,Comedy,0 days 01:12:00.000000000,11
59,81,https://resizing.flixster.com/I2YrmBmpal3FUHpFvI-fIe6z2m8=/206x305/v2/https://resizing.flixster.com/O5IhD50mmITmT15rxPbCvcCUUY8=/ems.ZW1zLXByZC1hc3NldHMvbW92aWVzL2EzYWIwMzFhLTY5MGItNDRlNC05YjU1LTA5ZDcwMmE4YTY3Yy53ZWJw,VFW,100,54,2019.0,Action/Mystery and thriller,0 days 01:32:00.000000000,22
64,67,,The Wave,50,36,2019.0,Sci fi,0 days 01:27:00.000000000,3
94,100,https://resizing.flixster.com/8Y542McDzXVTMYuG8KFt34dTWfM=/206x305/v2/https://resizing.flixster.com/PQvM1cWQhFR-fqlsU8vVLTxUyUI=/ems.ZW1zLXByZC1hc3NldHMvbW92aWVzLzU4YzJkMDM0LTIzZDUtNDlmZS05NTEwLWM0NTExNGY4ZGVjMC53ZWJw,"Scream, Queen! My Nightmare on Elm Street",50,42,2019.0,Documentary/Gay and lesbian,0 days 01:39:00.000000000,6
14,0,,Portals,1,11,2019.0,Horror/Action,0 days 01:25:00.000000000,-14
75,100,https://resizing.flixster.com/XBgRu-exY7ClnoN39lSW6ZeGfeY=/206x305/v2/https://resizing.flixster.com/fn0sXn0ZlcDdJXfmx-ALMtuXkhE=/ems.ZW1zLXByZC1hc3NldHMvbW92aWVzLzk5ZjM2NzRlLTdkNWQtNDgxMy05N2QxLTIzMDViNjA4ZTJiMC53ZWJw,Philophobia: or the Fear of Falling in Love,1,11,2019.0,Comedy/Horror,0 days 01:25:00.000000000,25
79,61,,The Current War: Director's Cut,1000,104,2019.0,Drama/History,0 days 01:41:00.000000000,-18
49,0,https://resizing.flixster.com/vLp-oapr56XI49HI3KkTjA8O-gk=/206x305/v2/https://resizing.flixster.com/3ljm6sZgLRkORGY0AtwW15ejSpY=/ems.ZW1zLXByZC1hc3NldHMvbW92aWVzL2YyNjEyMzlhLWYyZTgtNDA5My04ZDljLTNhMmQ3YTQ0MzVlYS53ZWJw,Radioflash,1,12,2019.0,Adventure/Mystery and thriller,0 days 01:43:00.000000000,-49
65,21,https://resizing.flixster.com/gx_xc06s1z_2vLBaxRjz8-664bU=/206x305/v2/https://resizing.flixster.com/zTppp2ZsF7Xxvbqj-snQ9oT71aw=/ems.ZW1zLXByZC1hc3NldHMvbW92aWVzLzBhNDFkMGYwLTFiYTQtNGFkMi1iYmVjLWQ1ZmJjM2VlZjZhYS53ZWJw,Like a Boss,2500,152,2020.0,Comedy,0 days 01:23:00.000000000,-44
85,82,https://resizing.flixster.com/Ev3sE4yUSRnwnQ0OI2ZWkx8KJj8=/206x305/v2/https://resizing.flixster.com/5Ve9MARVL1ztb7m9d8WehM0lqM8=/ems.ZW1zLXByZC1hc3NldHMvbW92aWVzL2QzZTI0YjQ3LWIxNzAtNDMxZS05Y2NiLTZjMzg2OTAzYWY4Mi53ZWJw,Seventeen,1,11,2019.0,Drama,0 days 01:40:00.000000000,-3
23,36,https://resizing.flixster.com/LYe1OFOi_xaxm25tthxdFB4m_X4=/206x305/v2/https://resizing.flixster.com/PeXviPPtJ5RXUT9kHL-MKJ0V9eg=/ems.ZW1zLXByZC1hc3NldHMvbW92aWVzLzgzNmRjODAwLTJiMTktNGZhMi05OTlkLTMxY2ZlNmZlZTM4MS53ZWJw,Primal,100,44,2019.0,Action,0 days 01:37:00.000000000,13
25,5,https://resizing.flixster.com/rjH4A5m-ckwp4clOEgamVIefkTU=/206x305/v2/https://resizing.flixster.com/casgu13z8bNrSy817zuyH6n8a6s=/ems.ZW1zLXByZC1hc3NldHMvbW92aWVzL2M2Yzk3M2VjLTMyNmEtNGY4Yy1hMTU3LTFhYmNmN2QwYWJkOS53ZWJw,The Courier,100,19,2019.0,Action,0 days 01:37:00.000000000,-20
83,80,https://resizing.flixster.com/s7MRArk1kUjSqCV99A9etRZKjgs=/206x305/v2/https://resizing.flixster.com/o1hNDcSA1zOctXugllN0lpgBeIk=/ems.ZW1zLXByZC1hc3NldHMvbW92aWVzL2QwZmY3MDY0LTI1ZjktNGY5Mi05ZTdlLWU4YWFjOTVhYTNlOC53ZWJw,Cold Brook,1,10,2018.0,Comedy/Drama,0 days 01:42:00.000000000,-3
72,26,https://resizing.flixster.com/RN_vzI_ffJX-Gzjx8g-p7-sYaHs=/206x305/v2/https://resizing.flixster.com/ZduAgSIml5iPfDUuWB2rqDmeeuk=/ems.ZW1zLXByZC1hc3NldHMvbW92aWVzLzI3YjdlNGU4LWM5MDUtNGZlNi05ZWJiLWYzMTczODY5ODlmNy53ZWJw,Countdown,1000,70,2019.0,Comedy/Horror,0 days 01:30:00.000000000,-46
33,69,,We Summon the Darkness,250,70,2019.0,Horror/Mystery and thriller,0 days 01:23:00.000000000,36
34,0,,The Gallows Act II,50,13,2019.0,Horror/Mystery and thriller,0 days 01:39:00.000000000,-34
96,75,,The Captain,50,8,2019.0,Drama,0 days 01:51:00.000000000,-21
49,59,https://resizing.flixster.com/iGP0aAZo1AgqZ0HIDnR8G5oZxao=/206x305/v2/https://resizing.flixster.com/e6dlTGcGr1jDzgjCH30MMn-BnfQ=/ems.ZW1zLXByZC1hc3NldHMvbW92aWVzL2UwZjNmNjM5LWFmZTQtNGY2ZC05NmU5LTgwNGU5MzUwM2JmNi53ZWJw,Fractured,500,29,2019.0,Mystery and thriller,0 days 01:40:00.000000000,10
48,100,https://resizing.flixster.com/X1Gf_EbK9SPfKYpsY0jZbl8u8V0=/206x305/v2/https://resizing.flixster.com/KRjiyIE8uPeDnn99rDFaUFbYDZM=/ems.ZW1zLXByZC1hc3NldHMvbW92aWVzLzZjYWZkYWJlLWI5YTEtNDM1Zi1hMTg5LTY4YmJkZGYzYWRjZC53ZWJw,Jenny Slate: Stage Fright,100,15,2019.0,Stand up,,52
89,88,https://resizing.flixster.com/2pitbi4J-jIMGOM1qRIjmQchHqI=/206x305/v2/https://resizing.flixster.com/BI-52RxKlWWgKjcTaSay-gZNz8I=/ems.ZW1zLXByZC1hc3NldHMvbW92aWVzL2E3MjY3MjliLWQzYTQtNDBlZi1iZDRiLTIxMjllNzI2MzBhYS53ZWJw,Feast of the Seven Fishes,50,17,2019.0,Other/Comedy,0 days 01:39:00.000000000,-1
66,70,https://resizing.flixster.com/xLdI0zoWDVm_vkqK7khO7LcQUlo=/206x305/v2/https://resizing.flixster.com/O_5SYT4p0Q1SBWjNQVgB39igtz0=/ems.ZW1zLXByZC1hc3NldHMvbW92aWVzLzNkNjg2NjlkLWM5ZDEtNGMyMi1iYmU2LWE5ZmU4YjU5YTg4MC53ZWJw,Butt Boy,50,57,2019.0,Comedy/Mystery and thriller,0 days 01:39:00.000000000,4
54,100,https://resizing.flixster.com/F-dA4rvPktZshbkRROGGtcLENMg=/206x305/v2/https://resizing.flixster.com/HyA5Uj0MZz48aaRlX6h261HxCAs=/ems.ZW1zLXByZC1hc3NldHMvbW92aWVzLzFlNTcwMTJiLTZmYjEtNGIxNC1hYTdmLWNjMDlkMTM1Zjc5Yy53ZWJw,Tammy and the T-Rex: Gore Cut,1,6,2019.0,Comedy/Horror,,46
45,50,https://resizing.flixster.com/q1X19EGl9OweySUPskSGh-ESToA=/206x305/v2/https://resizing.flixster.com/1GUJezU0crA1JIuEoA-lXjxunYA=/ems.ZW1zLXByZC1hc3NldHMvbW92aWVzLzIyZDY5YzMyLWVlZWEtNGZkYy1hZWUyLTJlMzI4MjlkMzVhNS53ZWJw,Badland,50,8,2019.0,Western,0 days 01:57:00.000000000,5
80,33,https://resizing.flixster.com/e2YAeF4RwFKflXnjSVe6RTFIR8Q=/206x305/v2/https://resizing.flixster.com/3ltwwhZYC0fB0nmMoj_7G-WUoWc=/ems.ZW1zLXByZC1hc3NldHMvbW92aWVzLzliMmIwZDc4LTg1YjItNDQxOS04ODgzLWUwYjhhMTQxMTZlMi53ZWJw,The Climbers,1,6,2019.0,Drama/Adventure,0 days 02:05:00.000000000,-47
80,44,https://resizing.flixster.com/pWPzVDKeKDWhQ2-nYiuyCg1V5r8=/206x305/v2/https://resizing.flixster.com/K7IobLXCSE-vs8uSQxtNdHs45o0=/ems.ZW1zLXByZC1hc3NldHMvbW92aWVzL2RmNDM2NTA1LTZmOGYtNGJhOC05MGVlLWNmMTI3M2M3Nzk4NC53ZWJw,The Battle of Jangsari,1,9,2019.0,War,0 days 01:48:00.000000000,-36
84,75,,The Gentlemen,5000,271,2020.0,Drama/Comedy,0 days 01:53:00.000000000,-9
31,33,https://resizing.flixster.com/4dXvT5abCoDPhIeNy75ihbBBumc=/206x305/v2/https://resizing.flixster.com/PdX9PKeL2KR5GTh3Pge6Ox8UWF8=/ems.ZW1zLXByZC1hc3NldHMvbW92aWVzL2M4ZDRmODRmLTAzNzMtNDM1Mi04NWI1LTc1MzJhNDZkYTRmNi53ZWJw,Trick,50,27,2019.0,Other/Horror,0 days 01:37:00.000000000,2
96,77,https://resizing.flixster.com/AV8QlUjHoyXaIPcNOSdjfgFVnwE=/206x305/v2/https://resizing.flixster.com/42pKG_2bDEpqmklOr1yj-tzcL74=/ems.ZW1zLXByZC1hc3NldHMvbW92aWVzLzAyYzdkNDQ0LWMzNzEtNDk3NS1hMDFjLWQ4MGQ3N2QxZjkxZS53ZWJw,Richard Jewell,5000,292,2019.0,Drama,0 days 02:11:00.000000000,-19
62,100,https://resizing.flixster.com/xhl__8tqZBH08L0GEsayn6Cey2c=/206x305/v2/https://resizing.flixster.com/muEFATzIxyruzUJUE9cIMuse0XA=/ems.ZW1zLXByZC1hc3NldHMvbW92aWVzL2NjMjMyMjY5LTMxMjgtNDg1ZC1hYWMwLTg5MmFmN2E4YmI2Yy53ZWJw,The Forest of Love,1,11,2019.0,Horror/Drama,0 days 02:31:00.000000000,38
52,100,https://resizing.flixster.com/8dIN43N-N_vVOwVFyq7Hx84dZ20=/206x305/v2/https://resizing.flixster.com/uktRfNdjwKUHNFZRNhdGs9elQAg=/ems.ZW1zLXByZC1hc3NldHMvbW92aWVzLzVhODk4OTg0LWRlZjctNGQ2Ni1hYjllLTU2YWUwMDZkNWY4NC53ZWJw,Ghosts of Sugar Land,1,6,2019.0,Documentary,0 days 00:21:00.000000000,48
27,0,https://resizing.flixster.com/8SLONYE4YbRH0SiCSkhPh5p22VA=/206x305/v2/https://resizing.flixster.com/BdmaK-wz1SpTIPr7GuZv6VauO88=/ems.ZW1zLXByZC1hc3NldHMvbW92aWVzLzAwMGM1ZmZkLTU5YzEtNDgyNS05YjdmLTc4OTJjNjZmNzM5Zi53ZWJw,Mob Town,1,9,2019.0,Crime/Drama,0 days 01:29:00.000000000,-27
18,0,,Acceleration,1,6,2019.0,Action,0 days 01:25:00.000000000,-18
20,40,https://resizing.flixster.com/czzilUPqXT_J3AUyrYDNvzcw3yc=/206x305/v2/https://resizing.flixster.com/hqKDbGFXWvy7pMAiymWjVqt30MU=/ems.ZW1zLXByZC1hc3NldHMvbW92aWVzLzE4ZjRlNjJmLWY0MGEtNGRkZC05MGMzLWRkYWJkNmMwOGI0YS53ZWJw,Twin Murders: The Silence of the White City,1,5,2019.0,Mystery and thriller,0 days 01:50:00.000000000,20
84,83,https://resizing.flixster.com/6ji6AsHhA-1PxIyRA_AYdb9Wg9I=/206x305/v2/https://resizing.flixster.com/WHCtufpBtGmEZrSuoXvsdE2vWBQ=/ems.ZW1zLXByZC1hc3NldHMvbW92aWVzL2FlYjUzOWU3LTYxMjQtNDkxZS1hMmIyLWE4MTRjZDYxMjk0OS53ZWJw,The Way Back,2500,212,2020.0,Drama,0 days 01:48:00.000000000,-1
36,65,,The Shed,50,20,2019.0,Horror/Mystery and thriller,0 days 01:38:00.000000000,29
82,94,https://resizing.flixster.com/z2LKVIMzn55JExeoCU4_1aYwDfM=/206x305/v2/https://resizing.flixster.com/7hjMo-ZhjmKlwXIjekFgd0ZQGs0=/ems.ZW1zLXByZC1hc3NldHMvbW92aWVzLzYyZDg5OTMzLTMwYmUtNGRmMy04MjNmLTJhNTE4OGM4ZjJhZS53ZWJw,In Search of Darkness: A Journey Into Iconic 80s Horror,1,17,2019.0,Documentary,0 days 04:24:00.000000000,12
92,91,https://resizing.flixster.com/_F2EP9Vyb7LGDb4oTX7X1b21Hj4=/206x305/v2/https://resizing.flixster.com/C2ouawfULHiwvmOPTH6z4BdJ8C4=/ems.ZW1zLXByZC1hc3NldHMvbW92aWVzL2Y1NDFkNTRhLTcxYjEtNGVmOC1hMWQ5LTI0ODQ0Y2YxZjNkNS53ZWJw,QT8: The First Eight,1,23,2019.0,Documentary,0 days 01:40:00.000000000,-1
72,93,https://resizing.flixster.com/wADofHqgipBTh7wtscznFCbz7a0=/206x305/v2/https://resizing.flixster.com/jwuWd1Xup8dG5IF0c3u_b_Z0Re4=/ems.ZW1zLXByZC1hc3NldHMvbW92aWVzLzcwMTAwZjUyLTIxN2YtNGQ5NS04ODBiLWQ3NTMxOWMwZWE3Mi53ZWJw,Capital in the Twenty-First Century,50,41,2019.0,Documentary,0 days 01:43:00.000000000,21
90,93,,A Sun,50,15,2019.0,Crime/Drama,0 days 02:36:00.000000000,3
86,83,https://resizing.flixster.com/7tX77hKy0CKkvcuOj6A25_q5TJg=/206x305/v2/https://resizing.flixster.com/BA8R325IJUuVi7b8u_uKsuS3zmI=/ems.ZW1zLXByZC1hc3NldHMvbW92aWVzL2Y2NTRkZWNlLTdiNjAtNDJkZi05MzM4LTYwYmJjZDJmYzAzMS53ZWJw,Fire in Paradise,1,6,2019.0,Documentary,0 days 00:40:00.000000000,-3
84,93,https://resizing.flixster.com/yj1g4NKroEi6jof8weJLz_EobMk=/206x305/v2/https://resizing.flixster.com/V3Tf6TrQ9bhWCAg2PFTmg0R-Y00=/ems.ZW1zLXByZC1hc3NldHMvbW92aWVzLzgxYTJlOGVjLTc1ZmEtNDJlYy1hZDU5LWU3MDlhOGYyYWUxZC53ZWJw,ANYA,1,14,2019.0,Sci fi/Drama,0 days 01:20:00.000000000,9
67,93,https://resizing.flixster.com/b0_2A2QToux4ZJUDlCRJVCN-9Xg=/206x305/v2/https://resizing.flixster.com/zhOZfWY2jHrdDtvscwVVD5oRlic=/ems.ZW1zLXByZC1hc3NldHMvbW92aWVzL2JjMmRhZGEzLWE5ZjUtNDAzZi05MTk0LTQzN2ZhY2E3YTY0ZS53ZWJw,Blue Story,100,43,2019.0,Crime/Drama,0 days 01:31:00.000000000,26
74,20,https://resizing.flixster.com/khYXTW5olkWW9-FF6TXGYTF8_YY=/206x305/v2/https://resizing.flixster.com/ZKf3LCsaoZLsAXVncpj47_mN9CU=/ems.ZW1zLXByZC1hc3NldHMvbW92aWVzLzAwOTU2ZjEyLTM1ZWEtNGIxNi1iN2YzLTM5ODZmNmFjN2EwZi53ZWJw,The Mandela Effect,100,5,2019.0,Mystery and thriller,0 days 01:20:00.000000000,-54
48,38,https://resizing.flixster.com/opv025E23NihyjjgXgRfkOKdfYY=/206x305/v2/https://resizing.flixster.com/Wr5zqQWArsFfQOm4cIjXzIrsnM4=/ems.ZW1zLXByZC1hc3NldHMvbW92aWVzLzlkZDAyOWFhLTQzYzctNDZiNi05YjgzLWE0MmUwNTVlMmFlZC5qcGc=,Holiday in the Wild,100,8,2019.0,Romance/Other,0 days 01:25:00.000000000,-10
45,81,,Let It Snow,250,26,2019.0,Romance/Other,0 days 01:33:00.000000000,36
42,70,https://resizing.flixster.com/bTIXwH3Hw9lT4GF8bbnh8wxdL2Q=/206x305/v2/https://resizing.flixster.com/MGVvurlh2lqiFl7cknsFUq2z1fQ=/ems.ZW1zLXByZC1hc3NldHMvbW92aWVzL2ZjY2Y2Njk3LWQ1OTctNGIxZi1hZmY1LTFkZTEzMDViZTJkZC53ZWJw,The Knight Before Christmas,250,20,2019.0,Romance/Other,0 days 01:33:00.000000000,28
100,79,https://resizing.flixster.com/nHNIsVQI4zFh_cbq1QxiSQa8qZg=/206x305/v2/https://resizing.flixster.com/gSv1tYzm__a-FdzpvkRWNMf6_QY=/ems.ZW1zLXByZC1hc3NldHMvbW92aWVzL2MzM2ZlNmQzLTljNWYtNDE3NC04MTFiLWNjZmFhNzkzNWI2Zi53ZWJw,The Banker,50,76,2020.0,Drama/History,0 days 02:00:00.000000000,-21
38,59,https://resizing.flixster.com/nDvO4DYMGiKLacKwEzHGRR5PggM=/206x305/v2/https://resizing.flixster.com/rKOhqBCCUE4SMMGFRTZunpHkSg8=/ems.ZW1zLXByZC1hc3NldHMvbW92aWVzLzFhZTkwM2RiLTgxN2MtNDk3NC05ZTI0LWQ0YjY1NTVhYWQ3ZC53ZWJw,Line of Duty,100,17,2019.0,Action/Mystery and thriller,0 days 01:39:00.000000000,21
34,30,https://resizing.flixster.com/nCVqc7W3pbGQhBytOcZa_doH0kw=/206x305/v2/https://resizing.flixster.com/rv5Y18huH9y_IV81cDZNre2S01w=/ems.ZW1zLXByZC1hc3NldHMvbW92aWVzLzc0OTY1MDBmLWFiZGUtNDQwMC04NzhjLTUzMmM1NjJiNGUyZC53ZWJw,A Christmas Prince: The Royal Baby,50,10,2019.0,Romance/Other,0 days 01:25:00.000000000,-4
89,100,,Mike Birbiglia: The New One,1,5,2019.0,Stand up/Comedy,0 days 01:25:00.000000000,11
62,80,,Code 8,500,20,2019.0,Sci fi,0 days 01:38:00.000000000,18
100,71,,Most Likely to Succeed,1,7,2019.0,Documentary,0 days 01:37:00.000000000,-29
78,25,https://resizing.flixster.com/iN2k7bfiXkUBmlzEJJsKbwckQes=/206x305/v2/https://resizing.flixster.com/9glqVt-CP0ZDBHFhCFm2K-hUtoo=/ems.ZW1zLXByZC1hc3NldHMvbW92aWVzL2ZjMjBkNzgyLWFmNGYtNGZiMi1iZWM2LTA2NmVhMjBlMzE5ZC53ZWJw,The Host,50,16,2020.0,Crime/Drama,0 days 01:43:00.000000000,-53
81,74,https://resizing.flixster.com/gLpcqOP_ioZ2eUFuKtFYLUZnQd8=/206x305/v2/https://resizing.flixster.com/4oyCyxJplOsZsHI2l0y5kUjfvbE=/ems.ZW1zLXByZC1hc3NldHMvbW92aWVzLzllZTQ3ODI4LWM3ZDYtNGI1Zi1iM2M5LWIwNzY5YjMzNDA1Zi53ZWJw,The Photograph,5000,109,2020.0,Romance/Drama,0 days 01:46:00.000000000,-7
43,50,https://resizing.flixster.com/2uPgEIMF-eWF-FkBhuEQ2Ng8-6w=/206x305/v2/https://resizing.flixster.com/ZSV6Xl6ScLVIExRH4uuFciW9bIg=/ems.ZW1zLXByZC1hc3NldHMvbW92aWVzLzBmZTZmYzk1LTJhYzYtNGE0NS05ODg5LWY5NTU4YTRlYmY1ZC53ZWJw,2nd Date Sex,1,10,2019.0,Romance,0 days 01:38:00.000000000,7
31,40,,Hell on the Border,1,5,2019.0,Western,0 days 01:27:00.000000000,9
95,84,https://resizing.flixster.com/z8P7dGWp9c05g7uxer2GKR6EUqc=/206x305/v2/https://resizing.flixster.com/U784FYeZ-w2IZQtr9bKPoCLn3CQ=/ems.ZW1zLXByZC1hc3NldHMvbW92aWVzLzI0Nzc4YzQ5LTUyZjctNGFhMS1hYWViLTY0MTIzZDQyNzk3MS53ZWJw,Ip Man 4: The Finale,500,32,2019.0,Sports and fitness/Action,0 days 01:45:00.000000000,-11
88,91,,The Invisible Man,10000,406,2020.0,Horror/Mystery and thriller,0 days 02:04:00.000000000,3
74,100,https://resizing.flixster.com/_04B01688S79EoSGlfm6_kURw6U=/206x305/v2/https://flxt.tmsimg.com/assets/p17403781_p_v13_aa.jpg,International Falls,1,11,2019.0,Comedy,0 days 01:33:00.000000000,26
59,100,,Michelle Wolf: Joke Show,50,8,2019.0,Comedy/Stand up,,41
68,86,https://resizing.flixster.com/StZzYIQBnHOKK4t8ndfni389fKs=/206x305/v2/https://resizing.flixster.com/d7vsdbQrsm04GjZKrS6F_C3CvW0=/ems.ZW1zLXByZC1hc3NldHMvbW92aWVzL2I2MTVhYThlLTM4MDgtNDg2Ny1hYmM2LTBhMzNkZDYxMTRhMi53ZWJw,Inside the Rain,1,21,2019.0,Romance/Comedy,0 days 01:30:00.000000000,18
38,17,https://resizing.flixster.com/R8pMtbbshbU8vZC0LRE08XPmIqg=/206x305/v2/https://resizing.flixster.com/AVyht-zrcLrFIlT7DY8PJqQh1T8=/ems.ZW1zLXByZC1hc3NldHMvbW92aWVzLzc0YzMyOTlhLTIwZWYtNDY4Ni1iMmRhLTEyN2RlYTlhOWU4ZC53ZWJw,The Great War,1,6,2019.0,War,0 days 01:50:00.000000000,-21
30,0,https://resizing.flixster.com/r8dwqQ6Dohhzcm2R4jhGJK2BPak=/206x305/v2/https://resizing.flixster.com/38cRUb4Mq7GHDktu9P8IRLLLeDk=/ems.ZW1zLXByZC1hc3NldHMvbW92aWVzLzBmZDJhOGU5LThkZGMtNDAwNS05NjNhLTdlMjUwODkxN2NlZi53ZWJw,Invasion Planet Earth,1,6,2019.0,Sci fi/Mystery and thriller,0 days 01:38:00.000000000,-30
76,96,https://resizing.flixster.com/Mt9t3lYbB7ThirHrsNBsemWnXgo=/206x305/v2/https://resizing.flixster.com/efup3MZl_eprh6Y2T8BIIe90ojQ=/ems.ZW1zLXByZC1hc3NldHMvbW92aWVzLzY0OTM2YTFjLTQ0NzctNDE1NS05ZGE1LWU5MzEyNmRkMTA2Yy5qcGc=,John Mulaney & The Sack Lunch Bunch,100,26,2019.0,Comedy/Kids and family,0 days 01:10:00.000000000,20
23,0,https://resizing.flixster.com/c5gTW4rkDiDAID2bC4-ml8D3h_o=/206x305/v2/https://resizing.flixster.com/57Z5e--fdNDaDcQJvliz2v1B3T8=/ems.ZW1zLXByZC1hc3NldHMvbW92aWVzLzUxNGI4ZTZkLWM5YzktNGU5ZC05YTJkLTNjZWU5NTI1MmYzMS53ZWJw,John Henry,100,20,2020.0,Drama/Mystery and thriller,0 days 01:31:00.000000000,-23
10,20,https://resizing.flixster.com/gFSK1E3Ve6jEjbn_S27LvwujLyU=/206x305/v2/https://resizing.flixster.com/damJSUSJCSoc9hmkW5Ud3TNo1q4=/ems.ZW1zLXByZC1hc3NldHMvbW92aWVzLzhmOTg4YmRjLTUwZWUtNDFiNC1hYmQzLTgzNzg0ZDg2OTA3MS53ZWJw,Disturbing the Peace,50,20,2020.0,Action/Mystery and thriller,0 days 01:40:00.000000000,10
78,17,,Dead Kids,1,6,2019.0,Mystery and thriller,0 days 01:38:00.000000000,-61
47,0,https://resizing.flixster.com/SrdETNC_jqHjc-ovptOSdUS0ltA=/206x305/v2/https://resizing.flixster.com/YBGTTA1O2h-BC3Xnm6HfxOW5KaY=/ems.ZW1zLXByZC1hc3NldHMvbW92aWVzL2I1NmYxMjUwLWU0Y2QtNGJiYS04N2ZhLTEyM2I5N2U5ZmY5OS53ZWJw,Get Gone,1,6,2019.0,Horror/Mystery and thriller,0 days 01:31:00.000000000,-47
95,92,,Togo,1000,39,2019.0,Drama/Adventure,0 days 01:54:00.000000000,-3
50,0,https://resizing.flixster.com/0KlaGE4l9HkvcL6DtJXE3hNP7vg=/206x305/v2/https://flxt.tmsimg.com/assets/p17875082_p_v13_aa.jpg,The Coldest Game,100,5,2019.0,Mystery and thriller,0 days 01:43:00.000000000,-50
47,80,https://resizing.flixster.com/7ZjWpwU1eAS0mZdLR7iAS521M_8=/206x305/v2/https://resizing.flixster.com/VcICDSrt9YwNhdT6ioyaf9vSACg=/ems.ZW1zLXByZC1hc3NldHMvbW92aWVzL2MxOGI3ZGMxLTU3YTgtNGY0MC1iMjQxLTYyYjM0YzZkN2Y1YS53ZWJw,Legado en los huesos,1,5,2020.0,Drama/Mystery and thriller,,33
3,0,,The Murder of Nicole Brown Simpson,50,9,2019.0,Mystery and thriller,0 days 01:22:00.000000000,-3
51,16,https://resizing.flixster.com/G6CheSt2Oga6MgWbudzif20fFgk=/206x305/v2/https://resizing.flixster.com/GiXbqbWLSaMFpQ8k21c7wQ15EUk=/ems.ZW1zLXByZC1hc3NldHMvbW92aWVzLzI5NDkxNDIyLTI2ZGMtNDlhZi05ODRmLWRmY2NjYTc0MTFhNy53ZWJw,Tyler Perry's A Fall From Grace,250,25,2020.0,Mystery and thriller,0 days 02:00:00.000000000,-35
62,84,https://resizing.flixster.com/dvsiADp0yxGJXOR8pL_Z7_Zi9lg=/206x305/v2/https://resizing.flixster.com/jsGJt7BMRN0CGuCaMF_OeE5054I=/ems.ZW1zLXByZC1hc3NldHMvbW92aWVzL2ZlNGI1MjE5LWE4NzItNDFlYi1iMjIzLTQ4ZGFjMDlmYzRlNC53ZWJw,Timmy Failure: Mistakes Were Made,100,31,2020.0,Adventure/Kids and family,,22
9,71,https://resizing.flixster.com/svEm2--DjIn3jF2QGrlFKBn9NxI=/206x305/v2/https://resizing.flixster.com/SV5V2a1AbjiqZTk-BDBi9nncBBc=/ems.ZW1zLXByZC1hc3NldHMvbW92aWVzLzE0Y2Q2ZjA0LTZiM2MtNDNlZS1iM2FhLTgxY2M2M2ZhYTE0Zi53ZWJw,Ilana Glazer: The Planet is Burning,1,7,2020.0,Comedy/Stand up,0 days 00:59:00.000000000,62
16,33,https://resizing.flixster.com/Q8rPXzGOaNtQjBCzTnImv8Btq14=/206x305/v2/https://resizing.flixster.com/mtPUGnWnM7_c79UTy899BjYB3XI=/ems.ZW1zLXByZC1hc3NldHMvbW92aWVzLzU5NWYzNmY0LWE0MDAtNGRjYS04YWVmLTlmODk4YWRjNGViZi53ZWJw,Ghost Stories,50,9,2020.0,Horror,0 days 02:24:00.000000000,17
46,99,,Never Rarely Sometimes Always,500,225,2020.0,Drama,0 days 01:41:00.000000000,53
64,80,https://resizing.flixster.com/4VjlvHwjrJV9l8iL2nEAdHv-Aok=/206x305/v2/https://resizing.flixster.com/obNBSjJwNQOYyYyApLZ709WSiCU=/ems.ZW1zLXByZC1hc3NldHMvbW92aWVzLzVhOTA5Y2RmLWE3ZDAtNDRiNi05ODExLTU0NWYzOGQ5YWNjYS53ZWJw,Go!,50,10,2020.0,Action,0 days 01:42:00.000000000,16
50,43,https://resizing.flixster.com/7c5eAc-y8E-nhwbA4htCS_v9Nec=/206x305/v2/https://resizing.flixster.com/fps7DIHkApNhFmkP0lPEnsHFGHM=/ems.ZW1zLXByZC1hc3NldHMvbW92aWVzLzAxZTMwOTM3LWMwYTMtNDUxOC1hMjBmLTc5YTg4YzE0OTA1MC53ZWJw,Sergio,100,47,2020.0,Drama,0 days 01:58:00.000000000,-7
14,5,,The Last Thing He Wanted,250,56,2020.0,Crime/Drama,0 days 01:55:00.000000000,-9
91,91,https://resizing.flixster.com/Ztylh4ew--wuoUpwvCo_Nqqx1Ng=/206x305/v2/https://resizing.flixster.com/0zQB2Exg7tBc245LYfBmQxvvXfE=/ems.ZW1zLXByZC1hc3NldHMvbW92aWVzLzUzYjg3NmZmLWRiYWYtNDkwNy1hZTYzLTJmMTk3YWRkZmU0Zi53ZWJw,Taylor Swift: Miss Americana,2500,93,2020.0,Documentary/Music,0 days 01:26:00.000000000,0
87,100,,Mnemophrenia,1,6,2018.0,Sci fi/Drama,0 days 01:18:00.000000000,13
90,75,https://resizing.flixster.com/yOVckDMuSuxAjPpbySh3aeny9_E=/206x305/v2/https://resizing.flixster.com/VZaMHeiHlg6aa2Pqma98v0hB-kQ=/ems.ZW1zLXByZC1hc3NldHMvbW92aWVzLzQ2YjEzNjY5LTEyN2EtNGZhZS05ZGFiLTAyMmNmY2QyMTc4Ny53ZWJw,Family Obligations,1,8,2019.0,Comedy/Drama,0 days 01:22:00.000000000,-15
31,100,https://resizing.flixster.com/QnyvM78OOFszu60G4TWsvCz2wAI=/206x305/v2/https://resizing.flixster.com/YgSILQd-4-J8Qtsdx5uahdJd3fc=/ems.ZW1zLXByZC1hc3NldHMvbW92aWVzL2M4NmE4NjE5LTMxYjktNDFlNC1iMjdlLWVjNWE0NWMzMTI0Ni53ZWJw,Leslie Jones: Time Machine,50,6,2020.0,Comedy,,69
61,64,https://resizing.flixster.com/20sHjkolGT435I3SWzolAOsb4r4=/206x305/v2/https://resizing.flixster.com/i1ajdRfuq__cxEKdi-3_grsg9Pw=/ems.ZW1zLXByZC1hc3NldHMvbW92aWVzLzM5MDdhNDFlLWVhMTQtNDRkZi04MjRlLWQ5N2MyMThiYzBiYi53ZWJw,All the Bright Places,250,39,2020.0,Romance/Drama,0 days 01:47:00.000000000,3
48,70,https://resizing.flixster.com/Si1wbS1jNc4g4RyV-xBuK55ge2A=/206x305/v2/https://resizing.flixster.com/aaBRw2nO4RGQxevc49VWpQ5PlFw=/ems.ZW1zLXByZC1hc3NldHMvbW92aWVzLzgzYzgyNTUyLWVkMzItNDQwOC04OTc4LWZiYjJmNjU2NTNhOS53ZWJw,Horse Girl,250,57,2020.0,Comedy/Drama,0 days 01:44:00.000000000,22
52,73,https://resizing.flixster.com/o-WIegzvrGDuXbttV5Uxth0tLX4=/206x305/v2/https://resizing.flixster.com/lpXueXgKppcf9w7x-MZCjH2GcuY=/ems.ZW1zLXByZC1hc3NldHMvbW92aWVzLzcxYWM1MTRhLWE0ODEtNDhlZS1hZTlhLTE1NDAyMTNmYjNlNS53ZWJw,Lost Girls,250,55,2020.0,Drama,0 days 01:35:00.000000000,21
76,35,https://resizing.flixster.com/sxGaT3CfohdpUBEDd6uO_llq2No=/206x305/v2/https://resizing.flixster.com/F8w7g38O58b6n15GTdDxBN_U0E0=/ems.ZW1zLXByZC1hc3NldHMvbW92aWVzLzE4ZTIxOTdlLWExYjktNDRjMy04NDI5LTk0ZDAyZjkzMTdlNi53ZWJw,Impractical Jokers: The Movie,1000,26,2020.0,Comedy,0 days 01:33:00.000000000,-41
80,78,https://resizing.flixster.com/PO60APkf97K_q7x8uzqabt1BWYI=/206x305/v2/https://resizing.flixster.com/1JTMe7cfx4mGbmXn8TLziNeVC0M=/ems.ZW1zLXByZC1hc3NldHMvbW92aWVzLzc2ZDc3MTc2LWNmNGQtNDY1MC1iNDBiLTc3OGU0MDZlZGZjYi53ZWJw,Natalie Wood: What Remains Behind,1,32,2020.0,Documentary,0 days 01:40:00.000000000,-2
92,100,https://resizing.flixster.com/RrpbIXrbCLMapAQj8eDgAz8fFDI=/206x305/v2/https://resizing.flixster.com/U6WAzNLI-RlqVrk2sn0qPbdna_w=/ems.ZW1zLXByZC1hc3NldHMvbW92aWVzL2FhZTUxZGU5LTE3MDctNGI0Ni05MzI4LTQ2NmEwN2IwYzYwMS53ZWJw,Crip Camp,100,96,2020.0,Documentary,0 days 01:47:00.000000000,8
33,50,https://resizing.flixster.com/JvPeDPzAixQdE8mEoxpw8och_cg=/206x305/v2/https://resizing.flixster.com/pCoelb8IB0BR4Hl_jNHwTIqW930=/ems.ZW1zLXByZC1hc3NldHMvbW92aWVzLzk3MDFhNDJkLWVkZDMtNDMwNS1hZjhlLTI5ZjI1YjMzZGMyNy53ZWJw,El silencio del pantano,1,6,2020.0,Mystery and thriller,,17
58,36,https://resizing.flixster.com/SwXiRs6sx7pDpK0CwyLc3Iqqpto=/206x305/v2/https://resizing.flixster.com/HsmKLZlQu2_1wkZF9AnWAU1DtXI=/ems.ZW1zLXByZC1hc3NldHMvbW92aWVzLzQxMWVkYjc5LWE2NGEtNGM0Ni04Yjg1LTJiNGUyMzlmYTUwMS53ZWJw,Waiting for Anya,1,22,2020.0,Drama/History,0 days 01:49:00.000000000,-22
50,78,https://resizing.flixster.com/6kqdc-QEgmCXQp1JdjIdkZZOlMM=/206x305/v2/https://resizing.flixster.com/FDfzQ2G45Gz4rmP94C1QXC8aR64=/ems.ZW1zLXByZC1hc3NldHMvbW92aWVzLzQ4Yjk4ZmU4LTMyMTktNGMyMS1hZTFjLTgwNzY5NmMxZjRhNC53ZWJw,Speed of Life,1,9,2019.0,Drama,0 days 01:16:00.000000000,28
64,88,https://resizing.flixster.com/Kazz9bCJdZVNf3ivsngtPKi9y3w=/206x305/v2/https://resizing.flixster.com/rk7dAd8vA4YlTdgwsj3vxOG5phs=/ems.ZW1zLXByZC1hc3NldHMvbW92aWVzL2Y4YzE5ZDE3LWRhMzktNDliOC1iYTUxLTk1ZjBiMzZiMDJlZC53ZWJw,Superman: Red Son,250,16,2020.0,Animation/Action,0 days 01:24:00.000000000,24
55,28,,Clover,1,18,2020.0,Comedy,0 days 01:31:00.000000000,-27
70,70,https://resizing.flixster.com/zFRQJW-qaWHherHiNOBpXl75HzA=/206x305/v2/https://resizing.flixster.com/6ewGIruCqBwEO9AXvkIT2XePsHs=/ems.ZW1zLXByZC1hc3NldHMvbW92aWVzL2Y1YTAxYmY0LWE0NmUtNDdhNC04MmZkLTY1ZDIwZWY1YTRhNC53ZWJw,Stargirl,250,40,2020.0,Romance/Comedy,0 days 01:47:00.000000000,0
77,100,,Man Camp,1,5,2019.0,Comedy,0 days 01:34:00.000000000,23
58,58,https://resizing.flixster.com/FJI_xoOYfNdnXFkMCDinQtXLMCQ=/206x305/v2/https://resizing.flixster.com/tp1wea0TkrHN01facOkIywYOYh8=/ems.ZW1zLXByZC1hc3NldHMvbW92aWVzL2UzZDQ3MDZmLTg4ZmEtNGYzZi1iY2I4LTVjMjM0YjNmMGU0NC53ZWJw,Coda,1,12,2020.0,Drama,0 days 01:36:00.000000000,0
52,37,https://resizing.flixster.com/ybye7rb2kXcfoLp-j-9ALDSHPTI=/206x305/v2/https://resizing.flixster.com/pCiJTArPsYITOtqoOUsvWDcW4eo=/ems.ZW1zLXByZC1hc3NldHMvbW92aWVzLzdmNGEyMTYzLTU2ZmItNGZkZC1hNmIwLWUxNjBkMjBmN2MxMS53ZWJw,Spenser Confidential,1000,83,2020.0,Action,0 days 01:51:00.000000000,-15
70,92,,What Did Jack Do?,100,13,2020.0,Crime/Comedy,0 days 00:17:00.000000000,22
77,72,https://resizing.flixster.com/r1cHWlbTKuN2GoGO8ssdsrC43lk=/206x305/v2/https://resizing.flixster.com/3c9pSDjh106r60N2RnjIyupBte8=/ems.ZW1zLXByZC1hc3NldHMvbW92aWVzL2JiOThlZWYxLWM3OTEtNDZlYi1hZjI5LTZmNTFmOGI5NzgyMi53ZWJw,Escape From Pretoria,250,43,2020.0,Drama/Mystery and thriller,0 days 01:41:00.000000000,-5
85,94,,Beastie Boys Story,100,80,2020.0,Documentary/Music,0 days 01:59:00.000000000,9
41,33,https://resizing.flixster.com/Dm7DWFYu7WOII7u2Dh_P2DysTJs=/206x305/v2/https://resizing.flixster.com/c0sQ8bho8xr_ZXsk9sQ4i-Gq9_4=/ems.ZW1zLXByZC1hc3NldHMvbW92aWVzL2VmY2JkY2QxLTUzMzgtNGUxNS1hMGI0LTE2ODBiZjJiN2Y3Yi53ZWJw,Spy Intervention,1,6,2020.0,Comedy/Adventure,0 days 01:33:00.000000000,-8
100,100,https://resizing.flixster.com/WCZSH2wHGWqsfoagc-55CLY98WA=/206x305/v2/https://resizing.flixster.com/c4d9O-ZfWhNv_oMg9Ytsoo7oYlk=/ems.ZW1zLXByZC1hc3NldHMvbW92aWVzLzBmYjhiYTEzLTJlNGEtNGYxOS1hZGY4LTA4ZDU2MmNkOTFiNS53ZWJw,Streetlight Harmonies,1,9,2020.0,Documentary/Music,0 days 01:24:00.000000000,0
75,87,,Vanilla,1,15,2019.0,Romance,0 days 01:27:00.000000000,12
60,56,https://resizing.flixster.com/zjOKVxvK__gbJDlkJmA-39uGa5c=/206x305/v2/https://resizing.flixster.com/C14cBM0bBP5TRZxLZJf-d4AgSFI=/ems.ZW1zLXByZC1hc3NldHMvbW92aWVzLzg1MGYyNWY4LTM5ZDAtNGQ4Ny1hOTk3LTkzMTUxNjc5YWEzNy53ZWJw,Resistance,100,94,2020.0,Drama/History,0 days 02:00:00.000000000,-4
53,26,,Hooking Up,50,23,2020.0,Comedy/Drama,0 days 01:44:00.000000000,-27
52,10,https://resizing.flixster.com/NqWAe9h9rNFN3giNzvduWND3YEU=/206x305/v2/https://resizing.flixster.com/5TW5mGoQEBOZbVjjHbVABH-JfDw=/ems.ZW1zLXByZC1hc3NldHMvbW92aWVzLzM1YjA3NzFhLTFiY2ItNDZkOS1hMTJjLWY0YTM2NDk5NTJiZS53ZWJw,Lazy Susan,1,10,2020.0,Comedy,0 days 01:30:00.000000000,-42
96,100,https://resizing.flixster.com/zAYIq8s7dnfcHXgGP2Ze3vtHHls=/206x305/v2/https://resizing.flixster.com/24PTQNqllU_kNfBkvY1h7lOtDUo=/ems.ZW1zLXByZC1hc3NldHMvbW92aWVzLzIyNGMyMWI4LTUwYjUtNGRiNC1hNDJmLTBmYzAxNzljZmYzYS53ZWJw,Turnover,50,14,2019.0,Comedy/Drama,0 days 02:03:00.000000000,4
86,89,,Mortal Kombat Legends: Scorpion's Revenge,250,19,2020.0,Animation/Action,0 days 01:20:00.000000000,3
84,88,,The Scheme,1,8,2020.0,Documentary,0 days 02:00:00.000000000,4
81,73,https://resizing.flixster.com/RdleOLAjQRoWKbRrR0WUDQc7NVc=/206x305/v2/https://resizing.flixster.com/SV13n46GNc9jkdBZPBBQrCfeu_M=/ems.ZW1zLXByZC1hc3NldHMvbW92aWVzLzliMGEyYWY1LThjMmItNGJhZC04OTcyLTIxNTU3NTkyY2EyZi53ZWJw,M.O.M. (Mothers of Monsters),100,11,2020.0,Mystery and thriller,0 days 01:38:00.000000000,-8
57,100,https://resizing.flixster.com/Zzo9Lb-wKGAob7KcAoBTWcmgS58=/206x305/v2/https://resizing.flixster.com/I6Viwe5lJ0AGqRdiTw98p5MjZJw=/ems.ZW1zLXByZC1hc3NldHMvbW92aWVzLzJkOWQwMjE2LWVlY2UtNDZlZC04ZmU2LWM3ZGYwZjhkZmI4NC53ZWJw,James vs. His Future Self,1,17,2019.0,Drama,0 days 01:34:00.000000000,43
59,40,https://resizing.flixster.com/uarOT7s5rJBv45frcaxCnC98oZI=/206x305/v2/https://resizing.flixster.com/b8OAlHcAROqQaPGgwBJKMn5liCQ=/ems.ZW1zLXByZC1hc3NldHMvbW92aWVzL2M2OTE3YzJiLWQwM2UtNDYzMi1hZjAxLWI0ZWVlZGViOWY5Zi5qcGc=,Pete Davidson: Alive From New York,250,10,2020.0,Comedy/Stand up,0 days 00:49:00.000000000,-19
81,64,,Tuscaloosa,1,11,2019.0,Drama,0 days 01:40:00.000000000,-17
42,20,https://resizing.flixster.com/U1eUkoVaWHwexoqvrlcbf-IlJM8=/206x305/v2/https://flxt.tmsimg.com/assets/p18052769_p_v13_ac.jpg,Enemy Lines,1,5,2020.0,History/War,0 days 01:33:00.000000000,-22
43,41,https://resizing.flixster.com/HUtWtuZTdODOuX6LUVmis2AAfL4=/206x305/v2/https://resizing.flixster.com/X89FjaMXZSS8xAKgkbqMG_kV31U=/ems.ZW1zLXByZC1hc3NldHMvbW92aWVzLzdjYmVjNGQ3LWEzMmEtNDQxNC1iYzNiLWZlMjRkMGFkYmM3ZC53ZWJw,The Quarry,1,46,2020.0,Crime/Drama,0 days 01:38:00.000000000,-2
37,24,https://resizing.flixster.com/vNsylIfyO6N51pDqfjIA5P1uTH4=/206x305/v2/https://resizing.flixster.com/c66oawiW4HzsalOHSxx-NzlUkPA=/ems.ZW1zLXByZC1hc3NldHMvbW92aWVzL2RiOTQ3Y2I4LTViNTQtNDI3My1iNjMxLTI1YWVhYTYyYmQxOS53ZWJw,The Postcard Killings,100,21,2020.0,Mystery and thriller,0 days 01:44:00.000000000,-13
31,20,https://resizing.flixster.com/c5yogpIDVoE9tVjTat-fN0p81e4=/206x305/v2/https://resizing.flixster.com/AiTUUbVTesNIhvafLVRaWzT1oIU=/ems.ZW1zLXByZC1hc3NldHMvbW92aWVzL2NmMWQ3ZmZiLTI2ODctNDJmNi1hNjQ0LTA1NTFjNTE2ZWRiYS53ZWJw,Love Aaj Kal,50,15,2020.0,Romance/Drama,0 days 02:22:00.000000000,-11
69,67,,Extraction,2500,213,2020.0,Action/Mystery and thriller,0 days 01:57:00.000000000,-2
25,60,https://resizing.flixster.com/KuU9Z1uFwVWkQgdh8hQ5wTRpCWQ=/206x305/v2/https://resizing.flixster.com/BxrqQp9mjYUJVRxlkEphZ46POqY=/ems.ZW1zLXByZC1hc3NldHMvbW92aWVzL2I3ZTAyMmIzLWFiYTMtNDcwMi05ZmU1LTk5ODhiYzQ4ODZiNC53ZWJw,Guilty,1,5,2020.0,Mystery and thriller,0 days 01:59:00.000000000,35
100,100,https://resizing.flixster.com/yzl5Z1NHzVtNZd9eWM9fm_txNzg=/206x305/v2/https://resizing.flixster.com/2WXTr5DJul9twKiMseiBy3nv3Xo=/ems.ZW1zLXByZC1hc3NldHMvbW92aWVzLzI4OGVlMDJlLWFlNWYtNGJkYi1iNGY4LTZhNzQ2N2QxMTM4Yy53ZWJw,Foosballers,1,5,2019.0,Documentary,0 days 01:36:00.000000000,0
73,100,https://resizing.flixster.com/S3pRo045fBhWShOljpghX2-c1Mo=/206x305/v2/https://resizing.flixster.com/J1rMpWkTLRf_CqzM8MQnUK8jgDM=/ems.ZW1zLXByZC1hc3NldHMvbW92aWVzLzhjNTg5ZDY2LTczMGYtNDZmMC04OGRjLTQzMDZkNDk0Y2Y2Ni53ZWJw,Kill Chain: The Cyber War on America's Elections,1,8,2020.0,Documentary,0 days 01:31:00.000000000,27
82,17,https://resizing.flixster.com/WxCltesURSYl7sa427rZOwZejJc=/206x305/v2/https://resizing.flixster.com/fFwhBsOY0pHzYiRNfBFPBzdarVI=/ems.ZW1zLXByZC1hc3NldHMvbW92aWVzLzJiNzEyNWYzLWY0NTgtNDA2Mi1hZWIxLTZiMDA4M2E0YTBmNC53ZWJw,Close Encounters of the Fifth Kind: Contact has Begun,100,6,2020.0,Documentary,,-65
65,55,https://resizing.flixster.com/KpSpis_fb-xKeCp6GV3NtUEmcyQ=/206x305/v2/https://resizing.flixster.com/icmN6GiLRiA7m8LLKbqB4XG57dY=/ems.ZW1zLXByZC1hc3NldHMvbW92aWVzLzc2ZTM2ZDQ4LWQ1ODQtNDZiNy1hMzZhLWEyODMyOGMyMzY0OC53ZWJw,The Lost Husband,250,22,2020.0,Drama,0 days 01:49:00.000000000,-10
52,47,https://resizing.flixster.com/cUCMiM_hGuT4ppRqjSQOv98n3dM=/206x305/v2/https://resizing.flixster.com/AxVTCPICGmyHwWt40FoIi5n33jY=/ems.ZW1zLXByZC1hc3NldHMvbW92aWVzL2FlZjFlOTJhLWE0NTUtNDQ0NC1iNmMyLTlmNGRiODQwNDEzMi53ZWJw,Arkansas,250,66,2020.0,Crime/Comedy,0 days 01:55:00.000000000,-5
91,100,https://resizing.flixster.com/IghYSqYd3o2WlWVMpbO5Qzfmp3o=/206x305/v2/https://flxt.tmsimg.com/assets/p18063532_p_v13_aa.jpg,Justice League Dark: Apokolips War,500,18,2020.0,Animation/Action,0 days 01:30:00.000000000,9
65,91,https://resizing.flixster.com/uEzq4XXFl_AgiPzrRhEaZ_3pwj0=/206x305/v2/https://resizing.flixster.com/zT7ZMSRylV9RQ5BpT-auiknttV4=/ems.ZW1zLXByZC1hc3NldHMvbW92aWVzLzdlZDNkODM3LTdkZGUtNDczMS05MWM4LWE2NWE4MDNhNGMyMi53ZWJw,Uncorked,100,46,2020.0,Drama,0 days 01:44:00.000000000,26
50,60,,Altered Carbon: Resleeved,100,5,2020.0,Sci fi/Anime,0 days 01:14:00.000000000,10
33,0,,The Legion,1,5,2020.0,Action/Adventure,0 days 01:36:00.000000000,-33
29,61,https://resizing.flixster.com/NFL-Mzw1RALMCjsnI8j3OOY8dKo=/206x305/v2/https://resizing.flixster.com/gt1MQwmq1LpDHTqBNkg33GQIdT0=/ems.ZW1zLXByZC1hc3NldHMvbW92aWVzL2JlMDVkZmU3LTQ0ZmQtNDcxNS04ZjM4LTMxM2I4ZTVjNmQ1YS53ZWJw,Tape,1,23,2020.0,Drama,0 days 01:38:00.000000000,32
36,60,https://resizing.flixster.com/TBsqP5TlKwgYs4hClUWkHF5Fa4w=/206x305/v2/https://resizing.flixster.com/Z7OrwMz7VHpJEiY69pAi_rFCyKM=/ems.ZW1zLXByZC1hc3NldHMvbW92aWVzL2Y5NjE0OTZkLTY0YmMtNGRlYi04MmU2LWFlNGExZTNmNGJkNC53ZWJw,Ultras,1,5,2020.0,Drama,0 days 01:48:00.000000000,24
65,90,https://resizing.flixster.com/h9ciCtOxQlotIgQ825qvR21Draw=/206x305/v2/https://resizing.flixster.com/vyR4s7nFOJNqYTQTYRNPTlUPKcY=/ems.ZW1zLXByZC1hc3NldHMvbW92aWVzLzdjNGMwZGNjLTg1MzUtNGIxMC1hYWYwLWY3N2I3MjlkYjk1Ni53ZWJw,The Decline,100,10,2020.0,Mystery and thriller,0 days 01:23:00.000000000,25
26,6,,Behind You,50,16,2020.0,Horror,0 days 01:26:00.000000000,-20
30,20,https://resizing.flixster.com/fbYP_6_6hfIwm1obJ0IK6v3rtow=/206x305/v2/https://resizing.flixster.com/YzsxqPJ7lyqYY3AdcrA-UFYj76M=/ems.ZW1zLXByZC1hc3NldHMvbW92aWVzLzU1NGViNTE5LWI1ZDktNGU4MC1hYjJlLTJkMmQzODY1NGQxZC53ZWJw,Coffee & Kareem,250,70,2020.0,Comedy/Action,0 days 01:28:00.000000000,-10
100,64,https://resizing.flixster.com/tR8979simO9bVIh0lnUOpl31toA=/206x305/v2/https://resizing.flixster.com/rqPsLv75yL-mlg5Q6k6MglWKdvM=/ems.ZW1zLXByZC1hc3NldHMvbW92aWVzLzBjNmZhNWIzLWM3NDYtNGViNy1hMDZmLWNkMGI5ZjRiMTExYi53ZWJw,Same Boat,1,11,2019.0,Romance,0 days 01:23:00.000000000,-36
47,61,https://resizing.flixster.com/JAlLPhP2dJ9rhXboPOhche4kKCs=/206x305/v2/https://resizing.flixster.com/2O152CKsaSop1VXfFsoeMulclD4=/ems.ZW1zLXByZC1hc3NldHMvbW92aWVzL2VlYWEwZTg3LTdmOTUtNDczMy04ZTRkLTIyYTI1YTgzOTEzNy53ZWJw,The Occupant,100,23,2020.0,Drama/Mystery and thriller,0 days 01:43:00.000000000,14
65,81,https://resizing.flixster.com/0FE_cO9Bog9eXA7vEgvwHgmf7KU=/206x305/v2/https://resizing.flixster.com/fPhkbIRTOoV4kpFFwQd35VOij-0=/ems.ZW1zLXByZC1hc3NldHMvbW92aWVzLzcyODBmMGE0LTUyYmMtNGIwMS04Zjg3LTQzZmM1YjEyOWRlZC53ZWJw,Tigertail,100,80,2020.0,Drama,0 days 01:31:00.000000000,16
91,100,https://resizing.flixster.com/vVh-Aq4mGCTTH5K8J2BmJaaMSjQ=/206x305/v2/https://resizing.flixster.com/ujahZK61QeoEuWtA14xQDZ0WqMM=/ems.ZW1zLXByZC1hc3NldHMvbW92aWVzL2IyNGFiZWVkLWVmOTItNDJhMy1iMzgwLTMxYjliMTQ4ZmMwOS53ZWJw,Disneynature: Dolphin Reef,50,21,2020.0,Documentary,,9
74,81,https://resizing.flixster.com/XzZI0bzg3Jao6djeKqAx4-qrb70=/206x305/v2/https://resizing.flixster.com/cXIHxBepxCKgqOqtUV5CTwzgcCk=/ems.ZW1zLXByZC1hc3NldHMvbW92aWVzLzQ0OTc2MTU4LWIxNDUtNGI2MS05YTVhLTI3ZGIxZGM5OWIwMS53ZWJw,Disneynature: Elephant,250,27,2020.0,Documentary,,7
100,50,https://resizing.flixster.com/qeSLAtzgTuhfaGWMCnpKVUP3F9M=/206x305/v2/https://resizing.flixster.com/JPc1ye6uJZjyxSd1HZg2boP7G9k=/ems.ZW1zLXByZC1hc3NldHMvbW92aWVzLzBkZWFiOGM1LWEyYzctNDA0YS1iODA5LTA3YWMwNTllYjg0Ni53ZWJw,The Mindfulness Movement,1,8,2020.0,Documentary,0 days 01:41:00.000000000,-50
24,26,https://resizing.flixster.com/HW2oX5zSn4d-kvH2epj6yLBs5yw=/206x305/v2/https://resizing.flixster.com/XWR_gFJt_GZxKVMKgPyfoyX6c-4=/ems.ZW1zLXByZC1hc3NldHMvbW92aWVzL2ExZDgwNTgzLWExOWYtNDY4Yy1hYmEzLTEyNWU5YTMzZjc3YS53ZWJw,The Main Event,50,19,2020.0,Comedy,0 days 01:41:00.000000000,2
36,34,https://resizing.flixster.com/VTi_DAtwNcOg-8g_k0O6OEq6WO4=/206x305/v2/https://resizing.flixster.com/xMAXvYq61iBRIRumhYDpIitLSGQ=/ems.ZW1zLXByZC1hc3NldHMvbW92aWVzL2U4YzU3OTBhLTg2NjktNDkxZi1hYzUzLWNiNDAwMjJlMjFkMi53ZWJw,Love. Wedding. Repeat,250,68,2020.0,Comedy,0 days 01:40:00.000000000,-2
75,92,,School Life,1,12,2019.0,Comedy/Drama,0 days 01:51:00.000000000,17
50,33,https://resizing.flixster.com/25w6lxDiBrjl3-qhYxy6ji3Lc4k=/206x305/v2/https://resizing.flixster.com/WCR7WeGpFeB1Qfv9PPD6Vf4pfFw=/ems.ZW1zLXByZC1hc3NldHMvbW92aWVzLzQ3Nzk2MWE1LWI5OGQtNGI5YS04YjY2LWNiM2Y1OGRlZWVhZC53ZWJw,Rising High,1,9,2020.0,Comedy,0 days 01:34:00.000000000,-17
81,97,https://resizing.flixster.com/ZjjyK3FCkXjJ57HA8Jqr1_DWcF4=/206x305/v2/https://resizing.flixster.com/pSYmtmHsVnfUmGrsC0eepkM7N_M=/ems.ZW1zLXByZC1hc3NldHMvbW92aWVzL2M2MjQzNWU5LTRmOGYtNDJkZS1hNWMxLTU2ZGFhN2M4MmNhZi53ZWJw,The Half of It,500,99,2020.0,Romance/Gay and lesbian,0 days 01:45:00.000000000,16
47,79,https://resizing.flixster.com/B5PRxnUUE2jqBJCha-YCH3B8k5o=/206x305/v2/https://resizing.flixster.com/hoXVOQJWOpNJS2h7DZZ8wCKekn8=/ems.ZW1zLXByZC1hc3NldHMvbW92aWVzLzg5ZjhiODI4LWYxNjMtNDc4MC05NWJlLWZjYTJlNmJlNGJmMi53ZWJw,Murder to Mercy: The Cyntoia Brown Story,1,14,2020.0,Documentary,0 days 01:37:00.000000000,32
59,54,,All Day and a Night,100,37,2020.0,Drama,0 days 02:01:00.000000000,-5
95,61,https://resizing.flixster.com/MsRSnphkbk7G3ZhuJIuFQK6Btp0=/206x305/v2/https://resizing.flixster.com/bLnhoJIfZzrsQbfBLNny4Lmeopg=/ems.ZW1zLXByZC1hc3NldHMvbW92aWVzL2NiNzgzNjVmLWU1YTQtNGUzZi05NDg4LTFkZjA2ZjUzZTU1ZS53ZWJw,Shooting Heroin,100,18,2019.0,Action/Drama,,-34
63,65,https://resizing.flixster.com/-ZAryIuSuCBnSecvOYIqYBQg96A=/206x305/v2/https://resizing.flixster.com/WfDqZMvxVqK499lWLMJLRfVpqoo=/ems.ZW1zLXByZC1hc3NldHMvbW92aWVzL2QyY2M2MDhmLWQ4NGQtNDZkMy1hN2JhLWI1OTQyZTE3ZTdjNy53ZWJw,Planet of the Humans,100,23,2019.0,Documentary,0 days 01:40:00.000000000,2
92,100,https://resizing.flixster.com/vF_RGYkmK9IbgzB6U0PpcuwYlig=/206x305/v2/https://resizing.flixster.com/LS8ySbOTra4Q3jOIkl_oF8Q39O0=/ems.ZW1zLXByZC1hc3NldHMvbW92aWVzLzM5OTcxZDBhLWFiMGItNDBjYy1hNmRlLThjNTk5NWIwZjEwMC53ZWJw,A Secret Love,100,43,2020.0,Documentary/Drama,0 days 01:23:00.000000000,8
51,75,https://resizing.flixster.com/QHjX0W49N_leXW4Lw_VKYv1fd14=/206x305/v2/https://resizing.flixster.com/IpLjPlrcvijXEJiAeKlAHcpTM2k=/ems.ZW1zLXByZC1hc3NldHMvbW92aWVzLzhiMjY0MjNjLTJlYWQtNDAxOC1hNDljLTA1Yzk4N2IzMzMwYS53ZWJw,Jerry Seinfeld: 23 Hours to Kill,100,16,2020.0,Stand up/Comedy,0 days 01:00:00.000000000,24
32,50,https://resizing.flixster.com/DDAxDBEseUx_exmf-mHko3WrtmU=/206x305/v2/https://resizing.flixster.com/tWMKEAvWh2OkK3-nkGlmHCLPsYE=/ems.ZW1zLXByZC1hc3NldHMvbW92aWVzLzUwOWFmMjI3LWViYWQtNGYwZS1hMDYxLTRiYzFlYmRkMDkxYi53ZWJw,Get In,1,6,2019.0,Horror/Mystery and thriller,0 days 01:37:00.000000000,18
52,17,/assets/pizza-pie/images/poster_default.c8c896e70c3.gif,Mrs. Serial Killer,50,12,2020.0,Drama/Mystery and thriller,0 days 01:46:00.000000000,-35
94,80,https://resizing.flixster.com/nZ54BswRFnvclJ4Otxy4oJ-7lb4=/206x305/v2/https://resizing.flixster.com/iKNsgiluddofWPJri9yKWOsUeVc=/ems.ZW1zLXByZC1hc3NldHMvbW92aWVzLzY2YjZmZDkxLTA4NzUtNDNiMC04NWI2LWEzMTMwMTc4NzhiMy53ZWJw,Sincerely Louis C.K.,1,5,2020.0,Comedy,0 days 01:00:00.000000000,-14
100,43,https://resizing.flixster.com/PIiojRdIvoHyRRRPTU4VbwFkac8=/206x305/v2/https://resizing.flixster.com/5NV_Xn9mtVFrSRcot5LqGLd4mpE=/ems.ZW1zLXByZC1hc3NldHMvbW92aWVzLzFkNTRhYjQ3LTBjYzYtNDI0YS04ZTY4LTcyZDMxMTI0MjMwNS53ZWJw,The Mentor,1,7,2020.0,Mystery and thriller,0 days 01:14:00.000000000,-57
57,93,https://resizing.flixster.com/pja0N4N_-a1daIJbnDoP7SlGYAI=/206x305/v2/https://resizing.flixster.com/d6cGkAv7-imqQwJFb1T1Jboug3A=/ems.ZW1zLXByZC1hc3NldHMvbW92aWVzLzg0MTFmNGQ1LTAwYTEtNDBhNy05ODNjLTUyNTgyYjk5NzJjYi53ZWJw,Becoming,250,74,2020.0,Documentary,0 days 01:29:00.000000000,36
100,100,https://resizing.flixster.com/b-5k9-E3eFGz7-rHO2n7w-78_I8=/206x305/v2/https://resizing.flixster.com/M1QRSbO2r0gpH6oo2tK5lXwNLgk=/ems.ZW1zLXByZC1hc3NldHMvbW92aWVzLzRlMmEyOWE2LTM5NzQtNDk3Yy04NmY4LWQ2NWI0OWYzZDdlOS53ZWJw,Unprescribed,1,14,2020.0,Documentary,,0
53,50,https://resizing.flixster.com/IkFHbVbEAtQthffkNUCJxQV1Dbs=/206x305/v2/https://flxt.tmsimg.com/assets/p48182_p_v13_ab.jpg,The Last Movie,500,16,1971.0,Drama,0 days 01:48:00.000000000,-3
93,100,https://resizing.flixster.com/pbsRZk9L4C3DbP6gfiY5Gejw5N0=/206x305/v2/https://flxt.tmsimg.com/assets/p194644_p_v8_aa.jpg,Mind Game,2500,11,2004.0,Mystery and thriller/Comedy,0 days 01:43:00.000000000,7
25,0,/assets/pizza-pie/images/poster_default.c8c896e70c3.gif,The Horror of Party Beach,500,6,1964.0,Horror,0 days 01:12:00.000000000,-25
68,100,https://resizing.flixster.com/xw5LC3q2-3dWWrF8wO7GhwXH4Fw=/206x305/v2/https://flxt.tmsimg.com/assets/p7245_p_v10_aa.jpg,The Ballad of Gregorio Cortez,250,6,1983.0,Drama/History,0 days 01:44:00.000000000,32
77,100,https://resizing.flixster.com/PN8ONsPrKI8CQPakBOjigncbNkk=/206x305/v2/https://flxt.tmsimg.com/assets/p2988_p_v10_aa.jpg,The Farmer's Daughter,500,8,1947.0,Comedy,0 days 01:37:00.000000000,23
29,14,,The Squeeze,250,7,1987.0,Comedy,0 days 01:41:00.000000000,-15
86,100,,The Kid Brother,500,9,1927.0,Comedy,0 days 01:23:00.000000000,14
57,60,https://resizing.flixster.com/r1XpEDk6uOqP-SabsMjLgJoSO9I=/206x305/v2/https://flxt.tmsimg.com/assets/p2501_p_v8_aa.jpg,The Group,250,5,1966.0,Gay and lesbian/Drama,0 days 02:30:00.000000000,3
92,100,https://resizing.flixster.com/Fw9beJxPMDMu9jMuND79iwz3bfo=/206x305/v2/https://flxt.tmsimg.com/assets/p19960_p_v8_aa.jpg,Chikamatsu Monogatari,250,7,1954.0,Drama/History,0 days 01:56:00.000000000,8
88,67,,The Truth,100,6,1960.0,Drama,0 days 02:07:00.000000000,-21
70,63,https://resizing.flixster.com/mWWYS7o10hxtLl0BmAwHBcHa0u4=/206x305/v2/https://flxt.tmsimg.com/assets/p36774_p_v8_aa.jpg,Desert Fury,50,8,1947.0,Western,0 days 01:35:00.000000000,-7
63,64,https://resizing.flixster.com/MX2_4aWVp7TMlFxOV12Eqw6kNJw=/206x305/v2/https://resizing.flixster.com/ZAbmOvOPQLfJ_nyJ2zOxr3rLhZU=/ems.ZW1zLXByZC1hc3NldHMvbW92aWVzL2VkOTRhYWYyLTQ5MjktNDU3ZS04ZDYzLWZlNjRmN2U3ZjViNC53ZWJw,The Man Who Killed Don Quixote,250,123,2018.0,Comedy/Adventure,0 days 02:13:00.000000000,1
60,100,/assets/pizza-pie/images/poster_default.c8c896e70c3.gif,Old Ironsides,1,5,1926.0,Adventure,0 days 01:52:00.000000000,40
72,67,https://resizing.flixster.com/GzNWyzh32_swWxImKOzpNTQ_CMY=/206x305/v2/https://resizing.flixster.com/afa1bzqCe5lCaifo3nDLCHmEOto=/ems.ZW1zLXByZC1hc3NldHMvbW92aWVzL2JlNjM0YmExLTk5YmItNGU4OC1iODA2LWQ5MTZjMGQzODI3ZC53ZWJw,Nappily Ever After,250,15,2018.0,Romance/Comedy,,-5
78,85,,As If I Am Not There,500,13,2009.0,Drama,0 days 01:40:00.000000000,7
45,0,https://resizing.flixster.com/Edp6DS_l-OI_ef2w1I-pF_UJajg=/206x305/v2/https://resizing.flixster.com/r2NLXlVxmxKkOrzzkUaS_xBf1LU=/ems.ZW1zLXByZC1hc3NldHMvbW92aWVzL2IzNjVhZGMyLWI0OWYtNGM3ZC05NjYzLWNlZWMwODVmNjcyOC53ZWJw,Gotti,5000,58,2018.0,Crime/Drama,0 days 01:45:00.000000000,-45
68,37,,Hunter Killer,1000,112,2018.0,Action/Mystery and thriller,0 days 02:01:00.000000000,-31
50,59,https://resizing.flixster.com/Y9785RjG_MUXDKRfJAyZgadpcyA=/206x305/v2/https://resizing.flixster.com/aiufNuFSCKDW4DW3XDRuu4Fw7tQ=/ems.ZW1zLXByZC1hc3NldHMvbW92aWVzL2NhY2I4Mjg3LWQ3NGUtNDk1NC1hNjNjLTg2ZDFmYTExOGM0Yy53ZWJw,Dr. Seuss' The Grinch,10000,192,2018.0,Other/Kids and family,0 days 01:26:00.000000000,9
70,42,/assets/pizza-pie/images/poster_default.c8c896e70c3.gif,Let Fury Have the Hour,100,12,2011.0,Documentary,0 days 01:27:00.000000000,-28
100,100,https://resizing.flixster.com/eAaFGOWsZJejBaX9MYSz_7sM0Jc=/206x305/v2/https://resizing.flixster.com/xiVlpSqDAhcfRaZ0-VA8YxkZKZo=/ems.ZW1zLXByZC1hc3NldHMvbW92aWVzL2VmMGFiZjFiLTQ4ZTAtNDQwYi1iZDZiLTA3MzI3ZDY1YWFlYy53ZWJw,CinemAbility,1,10,2012.0,Documentary,0 days 01:38:00.000000000,0
86,90,https://resizing.flixster.com/FkHJY3w1Gnw8bIdkz4Wwlnjh4hg=/206x305/v2/https://resizing.flixster.com/SHxVLsm1bFQpHod429HWNZpzGbM=/ems.ZW1zLXByZC1hc3NldHMvbW92aWVzL2U3YmIxNWJiLTc0YjEtNGU5ZS04YzQ0LWFiZmY3MDk1OTU3My53ZWJw,How to Train Your Dragon: The Hidden World,50000,269,2019.0,Comedy/Kids and family,0 days 01:44:00.000000000,4
30,0,https://resizing.flixster.com/TJM1P30miyItHBSvVkKGqqT-5pg=/206x305/v2/https://resizing.flixster.com/untOtl3n2frYBWDUgrqjFbxkBGg=/ems.ZW1zLXByZC1hc3NldHMvbW92aWVzLzM3NjQ5OTBkLTQ1NTctNGM5OS1iODk0LTY4NWY2YTQ3ODVlYy53ZWJw,True Crimes,500,37,2016.0,Crime/Drama,0 days 01:32:00.000000000,-30
83,91,,The Night Comes for Us,500,32,2018.0,Mystery and thriller/Action,0 days 02:01:00.000000000,8
68,84,https://resizing.flixster.com/zb1lsWySCRu7zVI9EIx_PfqJ508=/206x305/v2/https://resizing.flixster.com/ENMTcZvK7Gd3T1jWOulO-iCfOBU=/ems.ZW1zLXByZC1hc3NldHMvbW92aWVzLzZjNTA5NTY4LTEwZWUtNDNiOS05OTgxLTkwYWEzNDkzZmVlZi53ZWJw,The LEGO Movie 2: The Second Part,25000,297,2019.0,Action/Adventure,0 days 01:47:00.000000000,16
51,52,https://resizing.flixster.com/gpofKKhTwyrBeiADBwdwNnYZVgY=/206x305/v2/https://resizing.flixster.com/C8MHrCrmWz22PirW6qU4McP0jnc=/ems.ZW1zLXByZC1hc3NldHMvbW92aWVzL2JiOWMyN2JkLWE3ZjItNGE5MS1hNTM5LWM0MjljNDE4ZTMxYi53ZWJw,Mowgli: Legend of the Jungle,1000,105,2018.0,Action/Fantasy,0 days 01:45:00.000000000,1
54,36,https://resizing.flixster.com/q5UCokcl0trqmKJBfgQAV75OEo4=/206x305/v2/https://resizing.flixster.com/OQleOyvjZKSRHVMR4sPJnOhyMYo=/ems.ZW1zLXByZC1hc3NldHMvbW92aWVzLzc4M2IyOTU3LTYwMjEtNGY1Ni1hMTE4LTU3NGI5ZjVkYTM2My53ZWJw,Fantastic Beasts: The Crimes of Grindelwald,10000,331,2018.0,Fantasy/Adventure,0 days 02:14:00.000000000,-18
91,85,https://resizing.flixster.com/z3-AE4Fnlbj3N_O5YCFE9aukVdU=/206x305/v2/https://resizing.flixster.com/nYD953eaRxwQdF4TXY5jRu18MGQ=/ems.ZW1zLXByZC1hc3NldHMvbW92aWVzLzM0NGRkMDM2LWVjNDQtNGZlMC04NGM3LWZkMzQ2Njg1OTUyNi53ZWJw,Avengers: Infinity War,50000,478,2018.0,Sci fi/Action,0 days 02:29:00.000000000,-6
45,79,/assets/pizza-pie/images/poster_default.c8c896e70c3.gif,Captain Marvel,100000,535,2019.0,Fantasy/Adventure,0 days 02:04:00.000000000,34
69,36,,Honeyglue,50,11,2015.0,Romance/Drama,0 days 01:47:00.000000000,-33
60,51,https://resizing.flixster.com/mGnZX0QG7eLC66tAQwSYnu055-E=/206x305/v2/https://resizing.flixster.com/NT4I0c4uC2JIqUsTmc5T0RrXV6w=/ems.ZW1zLXByZC1hc3NldHMvbW92aWVzL2Q2YzI3Y2NjLTdkYjYtNDg1Ny05ZjE3LTE0N2ViNThkZDFjMC53ZWJw,The Equalizer 2,2500,204,2018.0,Mystery and thriller/Action,0 days 02:01:00.000000000,-9
100,100,,The Uncondemned,100,13,2015.0,Documentary,0 days 01:21:00.000000000,0
64,69,https://resizing.flixster.com/xq7b7m5keIA7NOcLk_hRgO28rMo=/206x305/v2/https://resizing.flixster.com/x95r5VkAatRldQAPKjuoaoU9Fhg=/ems.ZW1zLXByZC1hc3NldHMvbW92aWVzLzFmYzgxODBkLTQ3ODctNDlmMi1iMDQ4LWUzODljNjIwZTQ2NS53ZWJw,Solo: A Star Wars Story,25000,477,2018.0,Fantasy/Action,0 days 02:15:00.000000000,5
48,47,https://resizing.flixster.com/h7sp3X2pfhndV7Bo0VS338ewU3c=/206x305/v2/https://resizing.flixster.com/HOkXLx-iQq03yNdJ3cr7rRb2W0w=/ems.ZW1zLXByZC1hc3NldHMvbW92aWVzLzQ5Y2U5NjgyLWUzY2YtNDkyZS04ZDA5LWJjOTQ2NzU2ZjU5ZS53ZWJw,Jurassic World: Fallen Kingdom,25000,425,2018.0,Sci fi/Mystery and thriller,0 days 02:08:00.000000000,-1
24,14,https://resizing.flixster.com/dY7Eam7Hxj15Tra_b8hJ3u5M2Sg=/206x305/v2/https://flxt.tmsimg.com/assets/p12665805_p_v13_ac.jpg,Patient Zero,500,7,2018.0,Horror/Mystery and thriller,0 days 01:26:00.000000000,-10
68,87,https://resizing.flixster.com/PqFMQyq3ukfEU8kfPIkDlde2H04=/206x305/v2/https://resizing.flixster.com/uhcwDQ9uD3HcrGj1auApGIiXHRQ=/ems.ZW1zLXByZC1hc3NldHMvbW92aWVzLzg5ZjYzNjY4LThlNGMtNDQyOC05Zjk2LWNkOWQ3N2FiMzYzNS53ZWJw,The Sisters Brothers,2500,206,2018.0,Western/Comedy,0 days 02:00:00.000000000,19
38,48,https://resizing.flixster.com/LiQBFr6_oWClGrPWQ7bMiLgTMBM=/206x305/v2/https://resizing.flixster.com/V4Fu42CAeyHDHlqTEhVacwJp4I8=/ems.ZW1zLXByZC1hc3NldHMvbW92aWVzLzQzYWU4MWNkLTNiMTAtNDZlNy04MjM1LTk3OGQ4YWNlOTBjYi53ZWJw,How to Talk to Girls at Parties,500,94,2017.0,Romance/Sci fi,0 days 01:42:00.000000000,10
42,0,/assets/pizza-pie/images/poster_default.c8c896e70c3.gif,London Fields,250,35,2018.0,Mystery and thriller,0 days 01:58:00.000000000,-42
81,76,https://resizing.flixster.com/caCL5anXojYg-OqWUitZPQ9jFPk=/206x305/v2/https://resizing.flixster.com/l4XJN9loungbc9E71lGFbvc9PhY=/ems.ZW1zLXByZC1hc3NldHMvbW92aWVzL2Y2MTI0MDRjLTgzYzktNGFlYy1hMTJiLTg3NmZkYTM4NzhjZC53ZWJw,Little Pink House,250,29,2017.0,Drama,0 days 01:39:00.000000000,-5
76,59,,Then Came You,250,22,2018.0,Romance/Comedy,0 days 01:39:00.000000000,-17
43,44,https://resizing.flixster.com/EodQFmyVxShUgLXpt2rPy7zBCvE=/206x305/v2/https://resizing.flixster.com/m0E_aXJfxV328qoCrkLXB1KB2t4=/ems.ZW1zLXByZC1hc3NldHMvbW92aWVzLzEwNWFiZGVmLTNhMGQtNGNjNy1iZjRhLTEwM2MxMDU4YTE1NS53ZWJw,The Yellow Birds,250,41,2017.0,Drama/War,0 days 01:50:00.000000000,1
75,87,https://resizing.flixster.com/e3aYnqF4Uvd9TjHgVIA8cjx2sjw=/206x305/v2/https://resizing.flixster.com/mIMdDiMRxAgtv_1rfHhobVOwPns=/ems.ZW1zLXByZC1hc3NldHMvbW92aWVzLzQyNTBjMzY2LWJiMTItNDc3YS04ZDFiLWFiYTcxNzM4NThlZC53ZWJw,Ant-Man and The Wasp,25000,433,2018.0,Fantasy/Comedy,0 days 01:58:00.000000000,12
84,93,https://resizing.flixster.com/wNIWwNsgBNWnUiCNrk3EVZ5O7qE=/206x305/v2/https://resizing.flixster.com/6AZDGtepBnlO1ytECJMraDU4TFY=/ems.ZW1zLXByZC1hc3NldHMvbW92aWVzLzdiZDJmN2M0LWNjYTQtNDIxMy1iNTQ3LTBjMTJkMjhlZWYwOS53ZWJw,Incredibles 2,10000,382,2018.0,Comedy/Kids and family,0 days 01:58:00.000000000,9
65,52,https://resizing.flixster.com/2pwvHIUL9bBM6W4FeYHzJ7g-mmY=/206x305/v2/https://resizing.flixster.com/XtKzGB3BdnCcfiigiytn7e_eLpM=/ems.ZW1zLXByZC1hc3NldHMvbW92aWVzL2UxYjk5YjE0LThhNDItNGIzMC05MTExLTk1OWIwM2NiY2FmMy53ZWJw,Papillon,1000,110,2017.0,Drama/Adventure,0 days 02:13:00.000000000,-13
71,80,,The Keeping Hours,100,5,2017.0,Romance/Horror,0 days 01:31:00.000000000,9
41,15,https://resizing.flixster.com/wZPNqhaKe5Af6QcEDpfU1REx0AY=/206x305/v2/https://resizing.flixster.com/NgPVtSWjU3dgCeyn4iAkNIKy8ug=/ems.ZW1zLXByZC1hc3NldHMvbW92aWVzLzRlZGQ2NWU0LWU0MGItNGZlYi1iYzI5LTM4YzdjNGRlZDc1MS53ZWJw,Robin Hood,2500,165,2018.0,Action/Adventure,0 days 01:58:00.000000000,-26
44,23,,Mile 22,2500,191,2018.0,Action/Mystery and thriller,0 days 01:35:00.000000000,-21
64,35,https://resizing.flixster.com/4N3mGu4lhvTFm_GFNPhhL3ntcZ0=/206x305/v2/https://resizing.flixster.com/sKOYz1q9HO8AX2m0MVfiIehNqYk=/ems.ZW1zLXByZC1hc3NldHMvbW92aWVzLzM4M2ZhZjJmLTcwMTUtNDA5ZS1hOTliLWY5MTZkNGIyODE5ZC53ZWJw,Super Troopers 2,2500,100,2018.0,Comedy,0 days 01:43:00.000000000,-29
45,69,,Ocean's 8,10000,360,2018.0,Drama/Crime,0 days 01:50:00.000000000,24
48,62,https://resizing.flixster.com/CdPRqIYiFZb-ybe2a0n_LnavtuQ=/206x305/v2/https://resizing.flixster.com/PCOdGp24ECb6KpKEavI6txHk_Nw=/ems.ZW1zLXByZC1hc3NldHMvbW92aWVzL2VmOGJlZDRiLTM0YjMtNDFjMS1iNTA5LWFmNzQ4ZTVmNzlhNy53ZWJw,Hotel Transylvania 3: Summer Vacation,2500,119,2018.0,Adventure/Kids and family,0 days 01:37:00.000000000,14
80,87,https://resizing.flixster.com/l3_yz0u0EV64yHrTpGpT5qOeahk=/206x305/v2/https://flxt.tmsimg.com/assets/p12556023_p_v10_aa.jpg,A Space Program,50,15,2015.0,Documentary,0 days 01:12:00.000000000,7
88,97,,Mission: Impossible -- Fallout,10000,433,2018.0,Mystery and thriller/Action,0 days 02:27:00.000000000,9
68,81,https://resizing.flixster.com/r-vEjWLMxugB50ypEUAFJHdhR6c=/206x305/v2/https://resizing.flixster.com/5aeIptIVBZJCitgSm_rK0wVXKJE=/ems.ZW1zLXByZC1hc3NldHMvbW92aWVzL2M1NzMzZTk3LTAxMTItNDRiOS04MmRkLWMyMjVhYzE5ZDlkMS53ZWJw,Chappaquiddick,1000,145,2017.0,Drama/Mystery and thriller,0 days 01:41:00.000000000,13
43,33,https://resizing.flixster.com/y5MOXXYzKXSCx9-iaGY6SWKiEFk=/206x305/v2/https://resizing.flixster.com/MjGpU4l8mZampcYiFf3HRMQg3bk=/ems.ZW1zLXByZC1hc3NldHMvbW92aWVzLzYyODU4M2U5LTg1YzEtNDBmNy05MWQzLWI2YjgzZDJkOWMzZC53ZWJw,Mapplethorpe,1,52,2018.0,Gay and lesbian/Drama,0 days 01:42:00.000000000,-10
79,90,https://resizing.flixster.com/oTyuheYmpsVkHJaMFkVRvrbuSnM=/206x305/v2/https://resizing.flixster.com/F883AzydTW-sfBm3lx-9BeVlfLQ=/ems.ZW1zLXByZC1hc3NldHMvbW92aWVzLzQyNWM2MmY3LTkyMTctNDU1YS1hNDk1LTBjNDBlNmE1NmQzZi53ZWJw,A Star Is Born,10000,524,2018.0,Romance/Drama,0 days 02:15:00.000000000,11
42,21,https://resizing.flixster.com/IJjPAZBLXCdTA72M-un4tebCwG4=/206x305/v2/https://resizing.flixster.com/VYfPkHlRl0nih-WkEAxcR82MBL4=/ems.ZW1zLXByZC1hc3NldHMvbW92aWVzL2VlMWRhMDQzLWRiZTAtNDQ1YS04MjcxLWNlYTczZTdlYmZlNS53ZWJw,The Cloverfield Paradox,5000,153,2018.0,Sci fi/Mystery and thriller,0 days 01:42:00.000000000,-21
85,84,https://resizing.flixster.com/mBG-cwnkUv_E29rpqJBok4x1Lrs=/206x305/v2/https://resizing.flixster.com/v2dRaw5RTtKoQE2_7CbCZ67GaWw=/ems.ZW1zLXByZC1hc3NldHMvbW92aWVzL2EwODJjYjgyLTU5YzctNGEyYi05M2VmLWM5NzUzYWQ0MDRjNS53ZWJw,Deadpool 2,25000,416,2018.0,Action/Fantasy,0 days 02:00:00.000000000,-1
34,32,,The Nutcracker and the Four Realms,1000,202,2018.0,Fantasy/Other,0 days 01:39:00.000000000,-2
33,33,,The Predator,5000,290,2018.0,Horror/Sci fi,0 days 01:46:00.000000000,0
53,10,,God's Not Dead: A Light in Darkness,1000,20,2018.0,Drama,0 days 01:46:00.000000000,-43
51,65,https://resizing.flixster.com/F4CvgTKW-5zfg8iO80BxktWm-kw=/206x305/v2/https://resizing.flixster.com/G5tpCEjwGksJ_gLV7Rm_xGk5heI=/ems.ZW1zLXByZC1hc3NldHMvbW92aWVzL2M4M2Q2ODY4LTFlNzktNGYwNS04NjE5LTkxNmI5OTY4MjMzNS53ZWJw,Marie Curie,1000,26,2016.0,Drama/History,0 days 01:40:00.000000000,14
91,100,https://resizing.flixster.com/RISaKGOvvG1E30eq9mwXsgDQ-Us=/206x305/v2/https://resizing.flixster.com/eKRP2R6BuKx-V2mFB1Nk4eNGLyM=/ems.ZW1zLXByZC1hc3NldHMvbW92aWVzL2NlNTZiZDg5LWMzNTctNDNlYi1iN2I4LTg2NGZiNjRiZmU1Yi53ZWJw,Untouchable,50,9,2016.0,Documentary,0 days 01:45:00.000000000,9
25,16,,Show Dogs,500,63,2018.0,Comedy/Kids and family,0 days 01:32:00.000000000,-9
42,45,https://resizing.flixster.com/8t7FNVRZ6ptyuczgO30omULvr_A=/206x305/v2/https://resizing.flixster.com/Nw7ly4QPUKT44aMV421dozFEtRM=/ems.ZW1zLXByZC1hc3NldHMvbW92aWVzLzFkMmFkYTI0LWUyZTctNDdlYS1iYjg5LTM4OGYyZjcxZDE4Mi53ZWJw,The Meg,5000,305,2018.0,Action/Sci fi,0 days 01:53:00.000000000,3
40,23,,The Happytime Murders,2500,247,2018.0,Comedy/Mystery and thriller,0 days 01:31:00.000000000,-17
55,59,https://resizing.flixster.com/LTQktji9Qk2UH953jKcVYOsXp50=/206x305/v2/https://resizing.flixster.com/FKSS1RtV2lUOB3qPQ_vshLnMPss=/ems.ZW1zLXByZC1hc3NldHMvbW92aWVzL2U0MTY3ZjA3LTlkMzItNDI2Ni05NzAxLTIwYTAzNjQ3OTI3Ni53ZWJw,Under the Silver Lake,500,152,2018.0,Comedy/Mystery and thriller,0 days 02:19:00.000000000,4
56,38,,The Leisure Seeker,500,109,2017.0,Comedy/Drama,0 days 01:52:00.000000000,-18
12,0,https://resizing.flixster.com/DOvQ5MpKcmGmMPqXBkqzUUQ5drY=/206x305/v2/https://resizing.flixster.com/uDOpwRBtZ2J0GJRGeemC-ZeWgHQ=/ems.ZW1zLXByZC1hc3NldHMvbW92aWVzLzYwOTI5ZDUyLWNiZjUtNDNhNC1hNTRjLTBkM2QzZTExM2JjNi53ZWJw,Future World,250,9,2018.0,Action/Sci fi,0 days 01:30:00.000000000,-12
65,63,,Sicario: Day of the Soldado,5000,288,2018.0,Crime/Action,0 days 02:02:00.000000000,-2
65,88,https://resizing.flixster.com/04Dga41Hye0SQodrXPXGTUTGD10=/206x305/v2/https://resizing.flixster.com/9MUp3VwF7SLBrWSR07wtJYFMuT0=/ems.ZW1zLXByZC1hc3NldHMvbW92aWVzLzY4MTk2NTkwLTljN2MtNDgwNy04MmE1LTE2YjI0ODcxOTgzOC53ZWJw,Ralph Breaks the Internet,5000,274,2018.0,Animation/Comedy,0 days 01:52:00.000000000,23
74,90,,Lean on Pete,1000,188,2017.0,Drama,0 days 02:02:00.000000000,16
40,38,,Life of the Party,1000,154,2018.0,Comedy,0 days 01:45:00.000000000,-2
86,85,https://resizing.flixster.com/x9zTozDMqrF7xAAnu8bCdDPCFBo=/206x305/v2/https://flxt.tmsimg.com/assets/p13497405_p_v13_ab.jpg,God Knows Where I Am,100,26,2016.0,Documentary,0 days 01:39:00.000000000,-1
78,17,https://resizing.flixster.com/hyxBc06XZV6WeSRDjTumpFxO6pY=/206x305/v2/https://resizing.flixster.com/cMW9X8lVUT_gjhO8ldc0hc3a83U=/ems.ZW1zLXByZC1hc3NldHMvbW92aWVzL2U4ODRkNDMyLWY4NWQtNGNlMC1hZTcwLWY2MTM0OTg0NTk2MS53ZWJw,God Bless the Broken Road,250,12,2018.0,Drama,0 days 01:53:00.000000000,-61
86,78,,Scarred Hearts,50,18,2016.0,Drama/History,0 days 02:21:00.000000000,-8
56,48,,Cold Skin,250,27,2017.0,Horror/Mystery and thriller,0 days 01:36:00.000000000,-8
46,100,https://resizing.flixster.com/0triXL1_SM0UAF-MDAPnCcwcyIE=/206x305/v2/https://resizing.flixster.com/1f5-C1UvPMfneW5yfyv8cwjWWbc=/ems.ZW1zLXByZC1hc3NldHMvbW92aWVzLzQ1NDRmNmMxLWE2MGItNGVjZi1iZjA2LTlmZjRiYTQ4M2E4NC53ZWJw,Found Footage,100,6,2016.0,Horror,0 days 01:40:00.000000000,54
82,43,https://resizing.flixster.com/bPVvf5Ai4Iv9ulwpUUFmL9AbBKM=/206x305/v2/https://resizing.flixster.com/8wrulYVAA4ZJUpjO2vyg8bRMUJk=/ems.ZW1zLXByZC1hc3NldHMvbW92aWVzLzRkODdhYWRmLWYyYWUtNGFhZC04ZWEyLWMyNTIyMzk0NjhjYi53ZWJw,The Upside,2500,188,2017.0,Comedy/Drama,0 days 02:06:00.000000000,-39
50,81,https://resizing.flixster.com/AEeP8LzOTKRChJtvZdfIfs_ti4M=/206x305/v2/https://resizing.flixster.com/NZMX_PytzjWYc9OgRaQvqnKCiZ0=/ems.ZW1zLXByZC1hc3NldHMvbW92aWVzL2E3YjE1MDg3LWRkNzUtNDM3NS04NTIyLTdlNGE4ZTdkNzVkMy53ZWJw,Without Name,50,16,2016.0,Drama/Mystery and thriller,0 days 01:33:00.000000000,31
71,80,https://resizing.flixster.com/ugH4YIrrZCTMP1h-tHzHmW-Op6o=/206x305/v2/https://resizing.flixster.com/ogQDhqlz45WLwWhfyhLRyBXrnKo=/ems.ZW1zLXByZC1hc3NldHMvbW92aWVzLzBiYjM1N2QxLTZmNWQtNGNhZi04YTZhLWIzMjZlMDM3MmE2OC53ZWJw,Alpha,2500,132,2018.0,Adventure/Drama,0 days 01:37:00.000000000,9
87,90,https://resizing.flixster.com/7t0sWUFGF1AK7cWGbh97dg7VcWQ=/206x305/v2/https://resizing.flixster.com/WzXh9s5LIUPuEuABVAqZ3VohKZE=/ems.ZW1zLXByZC1hc3NldHMvbW92aWVzL2E1ZjdlMzNkLTA0MTctNGNmNy1iMjljLThkZGU1NzA2NmUyYy53ZWJw,Isle of Dogs,5000,363,2018.0,Animation/Comedy,0 days 01:41:00.000000000,3
73,42,https://resizing.flixster.com/iZ3XbT_GtUYQFvv19ctbD7yS36s=/206x305/v2/https://resizing.flixster.com/H8VLpgvFXpdL__vruQyf_1pBcWo=/ems.ZW1zLXByZC1hc3NldHMvbW92aWVzL2IxNDYxYzQ3LTg5MDEtNDJmMS1hOGQwLWMzODhiZmVjOWEzOS53ZWJw,Katie Says Goodbye,50,19,2016.0,Drama,0 days 01:28:00.000000000,-31
78,100,https://resizing.flixster.com/Lrb_hxrFZ1bWGLWTIA-0UEyWJB0=/206x305/v2/https://resizing.flixster.com/iQCA0UjEpKpOquSnpb-0u0i6Dig=/ems.ZW1zLXByZC1hc3NldHMvbW92aWVzLzMyMzQ4ODljLThlYTUtNGYzYy05NmFhLWZkN2I0NWI0YWJmMi53ZWJw,SoulMate,100,10,2016.0,Romance/Drama,0 days 01:50:00.000000000,22
16,0,https://resizing.flixster.com/HRQpQZhIAHH_HZ_IuQXQXFJ6qyg=/206x305/v2/https://resizing.flixster.com/S6NeidRDzdrDatnKeRv-oyIRyGw=/ems.ZW1zLXByZC1hc3NldHMvbW92aWVzLzkyZmRjZDA3LTJlNDctNDQ0NS1iNTI2LWRhNWY2OWU3NGI0OC53ZWJw,Drunk Parents,250,5,2019.0,Comedy,0 days 01:37:00.000000000,-16
73,93,,Wildlife,1000,215,2018.0,Drama,0 days 01:44:00.000000000,20
64,84,https://resizing.flixster.com/Ssd8L4Nt2N0lDUCOEV-gwPBB2v8=/206x305/v2/https://resizing.flixster.com/IYqhbUCIAjNjUVDLIJ2QAbOMBEA=/ems.ZW1zLXByZC1hc3NldHMvbW92aWVzLzM0NmMyMmE3LTFmMzctNDdiZC05MzBlLTIxNmQ1OTk2NDNhNy53ZWJw,Letters From Baghdad,500,38,2016.0,Documentary,0 days 01:35:00.000000000,20
40,40,,Death House,100,5,2017.0,Horror,0 days 01:35:00.000000000,0
85,60,,Bohemian Rhapsody,10000,407,2018.0,Drama/Gay and lesbian,0 days 02:15:00.000000000,-25
48,26,,Mortal Engines,2500,187,2018.0,Fantasy/Action,0 days 02:08:00.000000000,-22
50,67,https://resizing.flixster.com/KsfRmV8FrPTDHi8WHEqRomFQsvM=/206x305/v2/https://resizing.flixster.com/8Df7b7s-rE3uHyBTYSYJMeshT6k=/ems.ZW1zLXByZC1hc3NldHMvbW92aWVzL2YxMGM5NTdkLWNlNjQtNDhmZi05NDNkLWIwNjU0Y2RhY2ZmOC53ZWJw,Domain,1,6,2017.0,Sci fi/Mystery and thriller,0 days 01:37:00.000000000,17
35,7,,Billionaire Boys Club,250,15,2018.0,Drama/Mystery and thriller,0 days 01:48:00.000000000,-28
27,18,https://resizing.flixster.com/EkK0PTBvXEGpfeC7kDNAQ5cSFlU=/206x305/v2/https://resizing.flixster.com/X_Mgc1WW0spwAkeRvfywRlQKjQM=/ems.ZW1zLXByZC1hc3NldHMvbW92aWVzLzY2ZjJlZTcxLTM4MjItNGYzOC1iMmI0LTRkNDg0NDdjYjdmOC53ZWJw,The Possession of Hannah Grace,500,56,2018.0,Horror/Mystery and thriller,0 days 01:25:00.000000000,-9
17,8,,Slender Man,2500,80,2018.0,Horror/Mystery and thriller,0 days 01:33:00.000000000,-9
92,89,https://resizing.flixster.com/Iu3hvl7zLdLnaf9mbQzusVbGvKA=/206x305/v2/https://flxt.tmsimg.com/NowShowing/184247/184247_aa.jpg,Sgt. Stubby: An American Hero,500,46,2018.0,Animation/Kids and family,0 days 01:24:00.000000000,-3
67,75,https://resizing.flixster.com/A-aTA0nvpIhsWOq7bzTAi9osjHQ=/206x305/v2/https://resizing.flixster.com/A_OAnFG121uaKPWNk79SJzvownA=/ems.ZW1zLXByZC1hc3NldHMvbW92aWVzLzBiNjFkZmY0LTE0NDQtNGI3Ni1iZGY1LTIwZWU2Y2FhOGY2Zi53ZWJw,The Forest of the Lost Souls,50,16,2017.0,Horror/Drama,0 days 01:11:00.000000000,8
33,74,https://resizing.flixster.com/Z6D4Xrd1-kYJTGjSDhg5wHKmu_8=/206x305/v2/https://resizing.flixster.com/nr5chIhM5PjcdIFV28GKCB0ohDs=/ems.ZW1zLXByZC1hc3NldHMvbW92aWVzL2Q4OTgwNjlkLTM5MDMtNGI1Yi05ZTk3LWQ4YTg0ZTI2Nzk5Mi53ZWJw,The Mercy,250,82,2018.0,Drama/Biography,0 days 01:41:00.000000000,41
37,47,https://resizing.flixster.com/DNu4kOG5mWUkSRdjaZyYFt-7G8A=/206x305/v2/https://resizing.flixster.com/pAmFWGqVlNUTP9Am2DrjcJYJO24=/ems.ZW1zLXByZC1hc3NldHMvbW92aWVzL2JmYWU3NTdhLWEwMzktNDhiZS1hMzVlLTgyYTQyY2Y4MDUwOS53ZWJw,Goosebumps 2: Haunted Halloween,1000,95,2018.0,Adventure/Other,0 days 01:30:00.000000000,10
64,100,https://resizing.flixster.com/s-40z47Xywxt-w18dnE2Xytt5lY=/206x305/v2/https://resizing.flixster.com/lZ60l_lpLstUXvs2Ed7VSHxNFYs=/ems.ZW1zLXByZC1hc3NldHMvbW92aWVzLzA2YjBjZmEzLWM3MDUtNDg0Mi1hNDBlLWFlN2JmZDVjN2VlNS53ZWJw,Dream Big: Engineering Our World,100,7,2017.0,Documentary,0 days 00:40:00.000000000,36
50,57,https://resizing.flixster.com/eu1M-NeNDfJhiJgzflDgV9POLM0=/206x305/v2/https://resizing.flixster.com/sWNaZtwjxc4omlDrQecxzVdiuDI=/ems.ZW1zLXByZC1hc3NldHMvbW92aWVzLzVmYmJmYTA0LWYwYzAtNDhmMy1hMDcyLTIxZjlkNjgxYzZiOC53ZWJw,White Boy Rick,1000,155,2018.0,Crime/Drama,0 days 01:51:00.000000000,7
49,73,,Final Portrait,500,129,2017.0,Comedy/Drama,0 days 01:30:00.000000000,24
70,79,https://resizing.flixster.com/jXlZeIYKGVTxSPIuECkI6aIjh4g=/206x305/v2/https://resizing.flixster.com/WLQR0PxLmcs1MPNRzH4_yoPcaI8=/ems.ZW1zLXByZC1hc3NldHMvbW92aWVzLzJkNzc5YmIxLTQzMTQtNDRmZC04NDA2LTAwYjEzYzJlNzZkOC53ZWJw,Halloween,10000,377,2018.0,Other/Horror,0 days 01:46:00.000000000,9
35,24,https://resizing.flixster.com/Ha4t1YrwNkag8vGT_LtNMicf1wE=/206x305/v2/https://resizing.flixster.com/1B78Uqg68De3wK3R0u8A_vHr8o0=/ems.ZW1zLXByZC1hc3NldHMvbW92aWVzL2ZhYmRmZDlmLTFhMGUtNDhlMi1hODAwLWM1Mzk0MjgzZDVkZi53ZWJw,The Nun,5000,205,2018.0,Horror/Mystery and thriller,0 days 01:36:00.000000000,-11
27,56,https://resizing.flixster.com/AaFCZeaUqGBlihNEAcDn0UbOgQ8=/206x305/v2/https://resizing.flixster.com/hHxLzkAYHWQVflZsGWv9wZIv3lM=/ems.ZW1zLXByZC1hc3NldHMvbW92aWVzLzEzNWM0ZjlkLTc0ZjUtNGMyOC1iMjliLTI4MDRmZTU5Y2NmMy53ZWJw,The First Purge,2500,173,2018.0,Action/Horror,0 days 01:37:00.000000000,29
47,32,https://resizing.flixster.com/A16U1xrfE1dLgy_6OAm7P3oOr3M=/206x305/v2/https://resizing.flixster.com/1lV9IdiNnU80Qi7lMupqQvjYOlU=/ems.ZW1zLXByZC1hc3NldHMvbW92aWVzLzk0NDI0MWJmLTFiNzMtNGM1My05YWQxLTgwNjAwMjFhYWNkOC53ZWJw,Extinction,1000,25,2018.0,Sci fi/Mystery and thriller,,-15
81,100,https://resizing.flixster.com/ME9jfYCzxJWpPjc5KCbYg9PK7A4=/206x305/v2/https://resizing.flixster.com/qv46Ca9bLAOBaklK9EstETkaiAc=/ems.ZW1zLXByZC1hc3NldHMvbW92aWVzLzIyMWNhY2M3LWZjMTItNDdmOS1iYjZjLTM2NmVlNzA4NDc5NC53ZWJw,Leave No Trace,2500,237,2018.0,Drama,0 days 01:48:00.000000000,19
67,87,https://resizing.flixster.com/NtssHDRdFCeWGeIDeWSSwWK-yWA=/206x305/v2/https://resizing.flixster.com/N4Hvx_oEXDFwB04LJeBfsyvbE2Y=/ems.ZW1zLXByZC1hc3NldHMvbW92aWVzLzgwYjM0YTBhLWYzZGMtNDc0Zi1iYTJlLThlMmEyNDFmZWJmOC53ZWJw,First Man,5000,449,2018.0,Drama/Adventure,0 days 02:21:00.000000000,20
35,39,https://resizing.flixster.com/0Gr-SK7TBkc5o4prUALccY2beCE=/206x305/v2/https://resizing.flixster.com/d21QTBFHE965kNLjVUYn3loCMLs=/ems.ZW1zLXByZC1hc3NldHMvbW92aWVzL2U0OTRiM2UzLTE5NjUtNDg2ZS04MTRjLWE1ZmI1NWU3ZDNhZi53ZWJw,The Girl in the Spider's Web,1000,237,2018.0,Action/Mystery and thriller,0 days 01:57:00.000000000,4
57,43,https://resizing.flixster.com/ZOe70V9Yp1DzuP1tGlzQ7iH-xbY=/206x305/v2/https://resizing.flixster.com/FvqQTY9GJMlGZ6mdj5e1hli9oaA=/ems.ZW1zLXByZC1hc3NldHMvbW92aWVzL2QyMGU2OGMwLTdlNzItNDU4Yy1hMzY1LWYzMjBhMzhlODU0YS53ZWJw,Hot Summer Nights,500,40,2017.0,Romance/Drama,0 days 01:47:00.000000000,-14
81,29,https://resizing.flixster.com/K-JAdRwK34smL5X2PnbGM4_BPoQ=/206x305/v2/https://resizing.flixster.com/_TrSpIHprhkFg_xVvD7wyvVWGlM=/ems.ZW1zLXByZC1hc3NldHMvbW92aWVzL2U1MmYxYjE2LWQ3ZDUtNDYyYi05MmJhLWY5ODkzZTcyODVjOS53ZWJw,Venom,25000,353,2018.0,Sci fi/Action,0 days 01:52:00.000000000,-52
73,15,https://resizing.flixster.com/xOf5bYWQF2zImHFZQQGWzTtrU5g=/206x305/v2/https://resizing.flixster.com/N4wwAQv73l-jsbvhWhdkMS1oQ4o=/ems.ZW1zLXByZC1hc3NldHMvbW92aWVzLzVkNWE5ODZmLWU1OWUtNDcwZi1hOTllLTE3YWJkNmJmMDMyMy53ZWJw,The Darkest Minds,2500,140,2018.0,Mystery and thriller/Sci fi,0 days 01:44:00.000000000,-58
48,45,https://resizing.flixster.com/cQ5iZHIrFvhXoqEMK5gfXbCbAkA=/206x305/v2/https://resizing.flixster.com/-6_p5-slo-gxLtwSlKWl6spM3tg=/ems.ZW1zLXByZC1hc3NldHMvbW92aWVzLzkyYzUzNmQ4LWRjNzAtNDU1OS1hMTI0LTdjNGRkMDhiYWY5MC53ZWJw,Mary Magdalene,100,112,2018.0,Drama,0 days 02:00:00.000000000,-3
41,43,,Hampstead,250,60,2017.0,Romance,0 days 01:43:00.000000000,2
26,15,,Action Point,500,48,2018.0,Comedy,0 days 01:25:00.000000000,-11
22,16,https://resizing.flixster.com/OObdiQbKQwym48LT__1PNSIzDGA=/206x305/v2/https://resizing.flixster.com/aE_6bSeXXzJ35nnkvx1_k_itVyc=/ems.ZW1zLXByZC1hc3NldHMvbW92aWVzL2IwZTY0NjI0LWY4OGQtNDVlMS1iYjQ5LTkyYWY5ZjNiYWU1ZC53ZWJw,Blumhouse's Truth or Dare,2500,161,2018.0,Horror/Mystery and thriller,0 days 01:40:00.000000000,-6
50,100,,The Domestics,500,6,2018.0,Action/Mystery and thriller,0 days 01:35:00.000000000,50
38,26,https://resizing.flixster.com/JwfQP0seEdI9QmIQl3e6lwjXthw=/206x305/v2/https://resizing.flixster.com/TFB9V_fVAdRFDiWqLseWnHZsHX4=/ems.ZW1zLXByZC1hc3NldHMvbW92aWVzLzAwY2NlOWRlLWFkNzQtNGM3ZC1iZGI3LWI3MjFhNzJhODcwNC53ZWJw,Night School,1000,143,2018.0,Comedy,0 days 01:51:00.000000000,-12
41,86,https://resizing.flixster.com/QKdw3DzIfnMJJ0xTan3kfDa2jHA=/206x305/v2/https://resizing.flixster.com/s9tgawZX7E1lAXBTlvgR54hxslk=/ems.ZW1zLXByZC1hc3NldHMvbW92aWVzLzc3OTEyMjg5LTg1N2EtNDc0My05NmU3LTY4N2MyMzYxMjRiYi53ZWJw,Love After Love,250,28,2017.0,Drama,0 days 01:31:00.000000000,45
33,12,https://resizing.flixster.com/MAJUGl4HPp117OeIivnmOgHWB-Y=/206x305/v2/https://resizing.flixster.com/8T_byoIhG42Jk13rRRxGqgHssUk=/ems.ZW1zLXByZC1hc3NldHMvbW92aWVzL2QzNTZhZmNlLWYxOWYtNDlmMy04YWJiLWM2ZTBlZjQ3OGQyOC53ZWJw,Aardvark,50,26,2017.0,Drama,0 days 01:29:00.000000000,-21
20,32,https://resizing.flixster.com/1KLHmrMFtKuqUpwuHduxpIS80iY=/206x305/v2/https://resizing.flixster.com/K6HNyNinNdJebmr9MNFtMpzGmsA=/ems.ZW1zLXByZC1hc3NldHMvbW92aWVzLzE0YzM5YmFiLTIxZjUtNGY5OC04MDYzLTI4MjBjZTI1OTIzMC53ZWJw,Rodin,1,41,2017.0,Romance/Drama,0 days 01:59:00.000000000,12
55,89,https://resizing.flixster.com/WglZwmLcUj0y8q1QZlRdbnBMpUI=/206x305/v2/https://resizing.flixster.com/lPme2oHAl59SnbQsUyI03rratbA=/ems.ZW1zLXByZC1hc3NldHMvbW92aWVzL2UyMTJjMDExLTRmNjQtNGU4Mi05NjUxLWVjZWRlNmNhMDU4MS53ZWJw,The Kid Who Would Be King,1000,188,2019.0,Fantasy/Kids and family,0 days 02:00:00.000000000,34
40,59,,Mobile Homes,1,22,2017.0,Drama,0 days 01:46:00.000000000,19
47,70,https://resizing.flixster.com/fiLB9O_LvUQ5Ann0dhSbhkpYPJA=/206x305/v2/https://flxt.tmsimg.com/NowShowing/188522/188522_ab.jpg,Isn't It Romantic,2500,178,2019.0,Fantasy/Romance,0 days 01:28:00.000000000,23
62,76,https://resizing.flixster.com/BPYfe3WAjRMkYpur-wos6zOAIEs=/206x305/v2/https://resizing.flixster.com/0ETRm1YG5O1baH0G4DM1DWxb6dM=/ems.ZW1zLXByZC1hc3NldHMvbW92aWVzLzhlNTUyY2NiLTkwN2EtNDZhOS1hOWIwLTBiYjE5YTc0Zjc4Ni53ZWJw,Smallfoot,1000,127,2018.0,Animation/Comedy,0 days 01:36:00.000000000,14
74,87,https://resizing.flixster.com/qWm9oLmXHdUpAtk4UE031oq2NXo=/206x305/v2/https://resizing.flixster.com/fWziVfpEf9WkhKqIKnnFutlLqAU=/ems.ZW1zLXByZC1hc3NldHMvbW92aWVzL2UyYjIxMjllLTZlMDMtNDM4ZS05ZjM3LWVmMmIzMzM0YzQ2YS53ZWJw,Tully,2500,282,2018.0,Comedy/Drama,0 days 01:34:00.000000000,13
50,63,https://resizing.flixster.com/RW0vB358UtUBjkWsysNe51_mjTc=/206x305/v2/https://resizing.flixster.com/amIvfy1ePdt0126B3UFtg6hwvH8=/ems.ZW1zLXByZC1hc3NldHMvbW92aWVzLzg3ZjgzN2ZjLTZlNGUtNDFmNC05ZDg2LTA1OTI1OGFjN2U3MS53ZWJw,Applecart,100,16,2017.0,Horror,0 days 01:26:00.000000000,13
64,89,https://resizing.flixster.com/0Z1e7WgqbG2SVLzFsCOWoLF1seU=/206x305/v2/https://resizing.flixster.com/1gw3aixjLY6ujtx3nHOZCRtQ7rQ=/ems.ZW1zLXByZC1hc3NldHMvbW92aWVzLzg0Yzg5NmRkLWRjNmEtNGQ1My05YmMwLTgzNjEwYThkNDVkNS53ZWJw,You Were Never Really Here,5000,283,2017.0,Drama/Mystery and thriller,0 days 01:30:00.000000000,25
56,56,,Tag,2500,202,2018.0,Comedy,0 days 01:40:00.000000000,0
38,44,https://resizing.flixster.com/X-voUX2gN-XQllQAPLzzC9X--xQ=/206x305/v2/https://resizing.flixster.com/CLV6dasSZ4FDV4Qal_ZCuX_PcBY=/ems.ZW1zLXByZC1hc3NldHMvbW92aWVzL2FkZTI0OGQ1LTM5ZWMtNDJhYi04ODdjLTIxMWM1MjJhNTE2MS53ZWJw,Captive State,500,78,2019.0,Mystery and thriller/Sci fi,0 days 01:49:00.000000000,6
61,91,https://resizing.flixster.com/OAbd0T-S4en5GNgeVam1gqRI0p4=/206x305/v2/https://resizing.flixster.com/DG3R4c7FEUR-ySXaWr2KdqxelP8=/ems.ZW1zLXByZC1hc3NldHMvbW92aWVzLzNiOGRiNDI4LTFjNmItNDc3My1iNzViLTc5ODNiYjAyMmYwYS53ZWJw,Widows,5000,417,2018.0,Drama/Mystery and thriller,0 days 02:08:00.000000000,30
38,30,https://resizing.flixster.com/sGgHk9NSiwx5Uygnv6ap9Z7B1ng=/206x305/v2/https://resizing.flixster.com/wGfxaJMqPrptPsw14qc8iG8tHZk=/ems.ZW1zLXByZC1hc3NldHMvbW92aWVzLzhiYmY0Y2JmLTY2ZTQtNGVkMi1hNjUwLTNjMGQ4NGYwZTAyNy53ZWJw,Shock and Awe,250,47,2017.0,Drama,0 days 01:30:00.000000000,-8
73,96,https://resizing.flixster.com/wjvT46bHKp1egr3UWOqFjQvMy04=/206x305/v2/https://resizing.flixster.com/fmM4Uvprir_5PtYgIm2bkitJuJ4=/ems.ZW1zLXByZC1hc3NldHMvbW92aWVzL2EwYTIxOGYwLThjMGItNDhjMy1iN2JlLTgxZWYxYzE3MWEzYS53ZWJw,Western,500,72,2017.0,Drama,0 days 02:00:00.000000000,23
77,75,,The Gardener,50,8,2016.0,Documentary,0 days 01:28:00.000000000,-2
76,89,https://resizing.flixster.com/syMgg--drd8Z1F_PmtNArfKh1vc=/206x305/v2/https://resizing.flixster.com/o6jIJRJ8JmQ721Z7l6WtQjwULOc=/ems.ZW1zLXByZC1hc3NldHMvbW92aWVzL2UyY2MyY2Y4LWU4YWUtNDI0Mi04ZTNlLWU0OTcwMDMzNTNhNi53ZWJw,A Ciambra,250,57,2017.0,Drama,0 days 01:58:00.000000000,13
65,79,https://resizing.flixster.com/An6tgW9qNe70ZK52IOgiAs8kahs=/206x305/v2/https://resizing.flixster.com/Aa7RdmxS3inicIebgIrX-UHVIgw=/ems.ZW1zLXByZC1hc3NldHMvbW92aWVzL2JiZTExYzhlLTcyNDgtNDAzMi1iYTlhLWI1NGI4ZWQ3ZDgxNy53ZWJw,Mamma Mia! Here We Go Again,5000,277,2018.0,Comedy/Musical,0 days 01:54:00.000000000,14
75,100,https://resizing.flixster.com/FslwMjFUPM6-ypjf2I7O6rbpaPY=/206x305/v2/https://resizing.flixster.com/JYlC2w1XI48qahTAvUIXfN7rdUA=/ems.ZW1zLXByZC1hc3NldHMvbW92aWVzL2Q4MDRlMGQ3LWRhMjctNDhiYy05ODUxLWY2MTE5NWIwN2M5OC53ZWJw,Susanne Bartsch: On Top,50,7,2017.0,Documentary,0 days 01:24:00.000000000,25
93,60,,Chimera Strain,250,5,2018.0,Sci fi/Mystery and thriller,0 days 01:20:00.000000000,-33
89,75,,Moss,100,8,2017.0,Romance/Adventure,0 days 01:21:00.000000000,-14
82,97,https://resizing.flixster.com/dqzHjg2t2ha-j72O_gMejKt4Pn4=/206x305/v2/https://resizing.flixster.com/8ILOONmX8jmJqa4CHmXi4TyZRtU=/ems.ZW1zLXByZC1hc3NldHMvbW92aWVzLzY1YTUwMjQzLWRhYjMtNDUwMi05NmY1LTQ0Mjc3OWJmNjllMC53ZWJw,The Rider,1000,182,2017.0,Western/Drama,0 days 01:44:00.000000000,15
74,92,,A Prayer Before Dawn,1000,62,2017.0,Action/Mystery and thriller,0 days 01:57:00.000000000,18
60,88,https://resizing.flixster.com/L49oWUga98keZNoDVB4D7Bl5R8o=/206x305/v2/https://resizing.flixster.com/hu-qTfpJsgKbEZ6Pkjg2K0fj5AY=/ems.ZW1zLXByZC1hc3NldHMvbW92aWVzL2JmNjEwYTg1LWUwMzQtNGUzYi1hZmY2LTgwZTcyY2JkYjExNS53ZWJw,Claire's Camera,100,49,2017.0,Comedy/Drama,0 days 01:09:00.000000000,28
56,17,https://resizing.flixster.com/c-nesHDq1rhiKstMB81KEUXhQfQ=/206x305/v2/https://resizing.flixster.com/k-QMloIkM2COR0ndONByO3nwUXM=/ems.ZW1zLXByZC1hc3NldHMvbW92aWVzLzliZTgyYTA4LWFjODgtNGI1Yy04MmFkLTk4ODAxMWZlZTkyZi53ZWJw,The Healer,100,6,2017.0,Drama,0 days 01:43:00.000000000,-39
89,86,https://resizing.flixster.com/f89Fyp31jn4sB9_N09fGVH4ieik=/206x305/v2/https://resizing.flixster.com/bkKjYpaA7ASLlZJXN6pBsC4PxLE=/ems.ZW1zLXByZC1hc3NldHMvbW92aWVzL2JlMGQwYjU5LTcwMjEtNDZmMC04YTZjLWNkZDNlMzcwNmVhNy53ZWJw,Tater Tot & Patton,50,21,2017.0,Drama,0 days 01:31:00.000000000,-3
64,78,https://resizing.flixster.com/fMnhghmzG6miBuwBU7_grx9Di7U=/206x305/v2/https://resizing.flixster.com/8RvaUcZ7LYP6t4W05evnMmBh_CU=/ems.ZW1zLXByZC1hc3NldHMvbW92aWVzLzFmMDFhMmQwLWNjMDAtNDE3Mi05NmZlLTI4NmE5NmMzMDI1Yy53ZWJw,Lu Over the Wall,100,46,2017.0,Comedy/Kids and family,0 days 01:47:00.000000000,14
33,13,https://resizing.flixster.com/8jXNEZBuTx2C02HJBt6hOvH40XM=/206x305/v2/https://resizing.flixster.com/0ivD0YE19_b8SgxhbfTs3v7bxi4=/ems.ZW1zLXByZC1hc3NldHMvbW92aWVzL2UwMjg1NWM0LWNiNDQtNDY0MS04M2ZhLWQ4MjIxNGM5OTdmOC53ZWJw,Kings,100,38,2017.0,Drama,0 days 01:27:00.000000000,-20
45,49,,A Kid Like Jake,100,49,2018.0,Drama,0 days 01:32:00.000000000,4
74,82,,Pope Francis -- A Man of His Word,250,77,2018.0,Documentary,0 days 01:36:00.000000000,8
61,68,,On Chesil Beach,500,168,2017.0,Romance/Drama,0 days 01:50:00.000000000,7
83,96,https://resizing.flixster.com/nMjwKNgmZ7LFKavtO9LP7LXK290=/206x305/v2/https://resizing.flixster.com/jUkQ7SgQdWoI3xnz1OdwSxEaI2c=/ems.ZW1zLXByZC1hc3NldHMvbW92aWVzLzNmYjhmOGMzLWU1YjctNGEyNS04OTJhLWY4YmIwMjNmZmFiMC53ZWJw,A Quiet Place,10000,383,2018.0,Horror/Mystery and thriller,0 days 01:30:00.000000000,13
69,48,/assets/pizza-pie/images/poster_default.c8c896e70c3.gif,Skyscraper,5000,290,2018.0,Action/Mystery and thriller,0 days 01:42:00.000000000,-21
56,49,https://resizing.flixster.com/BmA2yqeUgbJN6nEj8UxZjnGFiH0=/206x305/v2/https://resizing.flixster.com/UYxWf67wGAwuJ8qdUZ2arlZxmtc=/ems.ZW1zLXByZC1hc3NldHMvbW92aWVzLzkyYWU3MWMwLWUwNTYtNGM3Zi04YTU4LWJkY2Y2NGVkYzc3Yi53ZWJw,The Spy Who Dumped Me,2500,208,2018.0,Comedy/Action,0 days 01:56:00.000000000,-7
67,36,https://resizing.flixster.com/MKKwz7QBJVvY4sKBfbF5eHLeUek=/206x305/v2/https://resizing.flixster.com/MoF9JJvg3Ver6U58l9Wjpgk_y6o=/ems.ZW1zLXByZC1hc3NldHMvbW92aWVzLzllNzJhMjdmLTQ3MDYtNGIyOC1hMzkwLTIxMGM2OGU0NzZmZi53ZWJw,Glass,10000,398,2019.0,Drama/Mystery and thriller,0 days 02:09:00.000000000,-31
67,75,,After Louie,50,12,2017.0,Romance/Gay and lesbian,0 days 01:40:00.000000000,8
47,38,https://resizing.flixster.com/yoEr5SxtI5ut5PDrxxqQBadRDMo=/206x305/v2/https://resizing.flixster.com/fC3c-3XavKtQubLYVegQA54Bt2Y=/ems.ZW1zLXByZC1hc3NldHMvbW92aWVzLzVmYzdhZjgwLWViNTktNDY3OC04MWQ4LTY2Nzg5MDliOTczYi53ZWJw,Mary Shelley,500,125,2017.0,Romance/Drama,0 days 02:00:00.000000000,-9
66,81,,Overlord,2500,225,2018.0,Action/Horror,0 days 01:50:00.000000000,15
80,42,,The Song of Sway Lake,50,33,2017.0,Romance/Drama,0 days 01:40:00.000000000,-38
70,88,,Don't Come Back From the Moon,250,17,2017.0,Drama,0 days 01:38:00.000000000,18
74,81,,Boy Erased,1000,262,2018.0,Gay and lesbian/Drama,0 days 01:55:00.000000000,7
73,33,https://resizing.flixster.com/YYNd7zZU8Ua9x5S9fIEv9xPRu5E=/206x305/v2/https://resizing.flixster.com/VeggntqEq5lVghg38Ioasa5Vqxw=/ems.ZW1zLXByZC1hc3NldHMvbW92aWVzLzhlODJmYzMyLTcxZjUtNDE2ZC1iMTFiLTA2YTkyZjY3NjhmZC53ZWJw,Modern Life Is Rubbish,50,15,2017.0,Romance,0 days 01:45:00.000000000,-40
73,75,https://resizing.flixster.com/oe7_mxTNL-cYzozlkUzp7IMvApo=/206x305/v2/https://resizing.flixster.com/GAvwcvYgblJ38ANTiFCBVi74Xws=/ems.ZW1zLXByZC1hc3NldHMvbW92aWVzL2FmYzIwODAyLWJjODEtNDZmNS1hNTdiLTdiY2Q0NGZhYTUzMy53ZWJw,Bad Times at the El Royale,5000,252,2018.0,Crime/Drama,0 days 02:21:00.000000000,2
67,67,,The Delinquent Season,50,12,2017.0,Romance/Drama,0 days 01:44:00.000000000,0
66,53,,Bad Samaritan,500,77,2018.0,Mystery and thriller,0 days 01:47:00.000000000,-13
54,24,/assets/pizza-pie/images/poster_default.c8c896e70c3.gif,Overboard,1000,89,2018.0,Romance,0 days 01:52:00.000000000,-30
58,85,https://resizing.flixster.com/QXBQMqotlNimk97zEfUDkqo0fxI=/206x305/v2/https://resizing.flixster.com/ZjQwcqR7O45r-9UGm73pxqfGurg=/ems.ZW1zLXByZC1hc3NldHMvbW92aWVzL2M5ZDY0M2IwLTUzNmUtNGVmOC1hMzY4LTI5ZWZhYTQ1MzVhOC53ZWJw,Ghost Stories,1000,130,2017.0,Horror/Mystery and thriller,0 days 01:37:00.000000000,27
37,69,https://resizing.flixster.com/843Bs0RxhQGcCFnVQ4Tc-APPaeE=/206x305/v2/https://resizing.flixster.com/bjUct-Nrg17vZNXdulkRdejTR7U=/ems.ZW1zLXByZC1hc3NldHMvbW92aWVzL2JmMzA3ZjE1LTg0ZGQtNDYzZC1hOGIzLTViNTc1NjZiZDRmNC53ZWJw,Triple Threat,100,32,2019.0,Action/Sports and fitness,0 days 01:36:00.000000000,32
66,91,https://resizing.flixster.com/b5VMEQusOqntX1lK7pht6eQznwk=/206x305/v2/https://resizing.flixster.com/NLncl8Q9BOvN37Qg-SBGF6mv3pY=/ems.ZW1zLXByZC1hc3NldHMvbW92aWVzLzZjZjQzNDA1LWRhMGYtNGQ2Yi1iY2RiLTM0ZmY0ZGIwOTJiMS53ZWJw,Lowlife,500,35,2017.0,Comedy/Drama,0 days 01:36:00.000000000,25
64,59,https://resizing.flixster.com/aGDH90oQlkNpWsb3ln93cJfklIc=/206x305/v2/https://resizing.flixster.com/AhCP3kQTxSe2s3dcnyq4tUzw9M8=/ems.ZW1zLXByZC1hc3NldHMvbW92aWVzL2E2YzU4MWViLTRiZDItNDU4My1hOTc3LTg3NzczMDcxOGRlNS53ZWJw,The House That Jack Built,1000,133,2018.0,Crime/Drama,0 days 02:31:00.000000000,-5
36,85,,Ruin Me,50,13,2017.0,Horror/Mystery and thriller,0 days 01:27:00.000000000,49
75,84,https://resizing.flixster.com/Qu0Mc2HWtaT7fVZB_mlHYaqj44c=/206x305/v2/https://resizing.flixster.com/4_5BoGwNBj3kgn2-sTxJeleNst0=/ems.ZW1zLXByZC1hc3NldHMvbW92aWVzLzU3N2UxZDhhLTdlODYtNDY1NC04YTJmLTRhNDUyMDI1ZjZmNS53ZWJw,Disobedience,2500,204,2017.0,Romance/Gay and lesbian,0 days 01:54:00.000000000,9
74,91,https://resizing.flixster.com/93CAv89jHTGK60TmCkBRH5Lc-lY=/206x305/v2/https://resizing.flixster.com/CVu8FXpochEPu1T3W7P5a5ZsArU=/ems.ZW1zLXByZC1hc3NldHMvbW92aWVzL2Q2NzMzZjBkLTdhNTctNGQzYy04NjI1LWQ5MjdiYThmNTE4Ni53ZWJw,Bumblebee,10000,247,2018.0,Action/Sci fi,0 days 01:54:00.000000000,17
25,11,,The Basement,100,9,2018.0,Horror,0 days 01:30:00.000000000,-14
51,36,,Attraction,100,11,2017.0,Sci fi/Drama,0 days 02:17:00.000000000,-15
41,62,https://resizing.flixster.com/wBChDEQ1extOEYbjYaGZOsKx3uE=/206x305/v2/https://resizing.flixster.com/TIwDtD53PBujTlU8hmcOhejo-hQ=/ems.ZW1zLXByZC1hc3NldHMvbW92aWVzL2FkZjMzNzM5LTgzYTEtNDlhZC1hMmE2LTY5NDcxNzcxZjQ4Yy53ZWJw,Mary Queen of Scots,2500,287,2018.0,Drama/History,0 days 02:04:00.000000000,21
62,77,https://resizing.flixster.com/d9ZmAicxuItpF3-MM1kZcfh-s-A=/206x305/v2/https://resizing.flixster.com/WjDj-5UyfFU9m0ka-w7ziQk6Ud4=/ems.ZW1zLXByZC1hc3NldHMvbW92aWVzLzUxYjI1ZDRlLWNhMzMtNGE2Zi05YWMyLWUwMmRhOWE5ODdmMi53ZWJw,Anna and the Apocalypse,1000,122,2017.0,Other/Horror,0 days 01:32:00.000000000,15
50,32,https://resizing.flixster.com/VVbJ6FUkS1q8ywx_xIv_dFL_Ze0=/206x305/v2/https://resizing.flixster.com/0aq6M9V2_x8V_Id4oI5K-D12aVE=/ems.ZW1zLXByZC1hc3NldHMvbW92aWVzLzZjY2MwNmZjLWM0MDktNGQ1YS05NDZjLTg3MDZiYjNiNDQ5Ni53ZWJw,The Catcher Was a Spy,500,75,2018.0,Biography/History,0 days 01:34:00.000000000,-18
64,100,https://resizing.flixster.com/9TKUqvTnY_3632LxTRn2Hb8LUZk=/206x305/v2/https://resizing.flixster.com/vFcipSRFd9IqTcOaseGXz3mo8Bo=/ems.ZW1zLXByZC1hc3NldHMvbW92aWVzLzFlOGFiZDlmLTU3MzUtNDBlYi1iYmE2LWE5MTkyMGJjM2UzOS53ZWJw,Our Evil,1,6,2017.0,Horror,0 days 01:32:00.000000000,36
41,40,https://resizing.flixster.com/v14y9D1w9yc8OHUmOeR8mYE_4Qs=/206x305/v2/https://resizing.flixster.com/plcWPAbHwlFfDCZ7l6p6GJLxDWg=/ems.ZW1zLXByZC1hc3NldHMvbW92aWVzL2IwNjRhNzk3LWY5YjAtNDJmMy1hZmNhLTJiNTEwYThjZGI2MS53ZWJw,Hell Fest,500,65,2018.0,Horror/Mystery and thriller,0 days 01:29:00.000000000,-1
46,27,https://resizing.flixster.com/BB5TFE_qDTsczRKxIhIqhcDE8uo=/206x305/v2/https://resizing.flixster.com/gx7m8GEQZ8npBLP-Oi9gMxBZq9U=/ems.ZW1zLXByZC1hc3NldHMvbW92aWVzLzVmNmE4MTQ5LTY1MDMtNGJiMi1hMmY2LWQ5MTE3ZDhkOWIxMS53ZWJw,Traffik,500,33,2018.0,Action/Mystery and thriller,0 days 01:36:00.000000000,-19
68,93,https://resizing.flixster.com/TmfeEU_iL6w3_Vyk3_5o2RWEOdU=/206x305/v2/https://resizing.flixster.com/vkUKqIa3-r_W1Fi9B72FROvpQ0Q=/ems.ZW1zLXByZC1hc3NldHMvbW92aWVzLzU3ODUzZGM4LTZmYjQtNDNhYy1hZWJlLTA2YTE3OGM5YjhkZC53ZWJw,First Reformed,2500,242,2017.0,Mystery and thriller/Drama,0 days 01:53:00.000000000,25
25,10,,Holmes & Watson,2500,79,2018.0,Comedy/Mystery and thriller,0 days 01:30:00.000000000,-15
66,87,,The Third Murder,250,83,2017.0,Drama/Mystery and thriller,0 days 02:05:00.000000000,21
60,53,https://resizing.flixster.com/uNorhxEqqIMOTnNLRwXCHK_3nik=/206x305/v2/https://resizing.flixster.com/-UKzw_UlHmz2S3YRxtBw4kT9jf4=/ems.ZW1zLXByZC1hc3NldHMvbW92aWVzL2JiNDI4ZDgyLWQ2MjctNDUxMi05ZDFjLWQxNTE5OWNjNDQ5ZC53ZWJw,Woman Walks Ahead,250,38,2017.0,Western/Drama,0 days 01:42:00.000000000,-7
30,11,https://resizing.flixster.com/WpM6xprXANH-koqpi_PHppuSFAc=/206x305/v2/https://resizing.flixster.com/fRaAuSikmfvomkUOjIYZierjEOk=/ems.ZW1zLXByZC1hc3NldHMvbW92aWVzLzU4ZWE3MDhiLWM5ZWItNDczOS1iMzBhLWJlMTk0NDFmMDIwMC53ZWJw,Tyler Perry's A Madea Family Funeral,500,35,2019.0,Comedy,0 days 01:49:00.000000000,-19
75,77,https://resizing.flixster.com/3Wmq1pZo2243Wiq0fHChzs_vquU=/206x305/v2/https://resizing.flixster.com/7yA1awFkcA41BUODftpNBRSiRoo=/ems.ZW1zLXByZC1hc3NldHMvbW92aWVzLzNkZjNiMzRjLTVjZTgtNGU2Mi1hNWJhLWFjNTE4M2M5NDE3Zi53ZWJw,"Don't Worry, He Won't Get Far on Foot",1000,190,2018.0,Comedy/Drama,0 days 01:53:00.000000000,2
35,35,,I Feel Pretty,2500,230,2018.0,Comedy,0 days 01:50:00.000000000,0
35,65,,The Little Stranger,500,141,2018.0,Horror/Mystery and thriller,0 days 01:51:00.000000000,30
35,31,https://resizing.flixster.com/ZvRo3PXd8l3R5gSVXW53F3CUeRg=/206x305/v2/https://resizing.flixster.com/OZqx3gxsYIqqUYIR0-4xhr8rON8=/ems.ZW1zLXByZC1hc3NldHMvbW92aWVzL2Q0NDMwYmNiLTBmNmMtNDA4Ni04N2VjLWM3NGZjNzU0MjQzYS53ZWJw,Loving Pablo,500,48,2017.0,Crime/Drama,0 days 02:08:00.000000000,-4
71,94,,Angels Wear White,50,33,2017.0,Drama,0 days 01:47:00.000000000,23
82,83,,The Captain,500,53,2017.0,War/Drama,0 days 01:58:00.000000000,1
85,50,,55 Steps,50,8,2017.0,Drama/Biography,0 days 01:55:00.000000000,-35
67,62,https://resizing.flixster.com/EyyjGQoKaAt82JeQCWxHxw4v8ZI=/206x305/v2/https://resizing.flixster.com/8dMTiVGJYABpkHrmBuEou5yLvxI=/ems.ZW1zLXByZC1hc3NldHMvbW92aWVzLzZlN2I5MWIwLTk1MzUtNDQxOS04YmVjLWU0YzNlYjcxOWM3Ni53ZWJw,Outlaw King,1000,149,2018.0,War/Drama,0 days 02:17:00.000000000,-5
55,93,https://resizing.flixster.com/xy0YAxxqFVS-fqYAtcgdNEGhRZ8=/206x305/v2/https://resizing.flixster.com/JQdGudMef9LC0yF-gFbN6M8dFLo=/ems.ZW1zLXByZC1hc3NldHMvbW92aWVzLzcxMmUzZWEwLThjOTktNDA2YS1iNTI1LWFmZWMwZTE5NmVlMC53ZWJw,The Guardians,250,61,2017.0,Drama/History,0 days 02:15:00.000000000,38
74,91,,Eating Animals,250,46,2017.0,Documentary,0 days 01:35:00.000000000,17
50,76,https://resizing.flixster.com/eJrlnJO3smjEC6PKykjN52FBt-U=/206x305/v2/https://resizing.flixster.com/8DEyQsP7lg793Y0r-AyOjd_qZfA=/ems.ZW1zLXByZC1hc3NldHMvbW92aWVzLzkzOGIwZDc5LTJiMjYtNGFkOS1iOTk5LTI4YTRiN2EyMjRlNS53ZWJw,The Escape,250,46,2017.0,Drama,0 days 01:41:00.000000000,26
62,80,https://resizing.flixster.com/tPYY1dvkbjknLKaBzPfSy9fV6S8=/206x305/v2/https://resizing.flixster.com/visiWfq1lY9ZH60M4aJ9hI7qzzA=/ems.ZW1zLXByZC1hc3NldHMvbW92aWVzL2Y4MGE0NmM1LTliMjctNDVlNi04ZDZmLWE4NzkyZmMyMDQ4Ny53ZWJw,Dark River,500,59,2017.0,Drama/Mystery and thriller,0 days 01:29:00.000000000,18
64,74,https://resizing.flixster.com/Qmyc_PlJaAjMYgZOTeOdsBRJmGo=/206x305/v2/https://resizing.flixster.com/kuE7yhgAmawK0P6r52tXNetqIYk=/ems.ZW1zLXByZC1hc3NldHMvbW92aWVzLzU1NzJlNDMyLThkYjgtNGQ3Yi1iMTk0LTVkOTE1M2M3ZjJmMy53ZWJw,The Children Act,500,112,2017.0,Drama,0 days 01:45:00.000000000,10
53,60,https://resizing.flixster.com/ORvpFaeO38ty6KT6TCwxvWds5BE=/206x305/v2/https://resizing.flixster.com/1xwIelkp8fjWOgvli95ykaGwll0=/ems.ZW1zLXByZC1hc3NldHMvbW92aWVzLzM2ZjVlZGU4LTczZGMtNGIxYy04MDc1LTcwYzM3MjA0NDA3MC53ZWJw,The Motive,50,20,2017.0,Mystery and thriller,0 days 01:54:00.000000000,7
41,64,https://resizing.flixster.com/4aSfHNnmjaeaIZlY_b3doc8d1ds=/206x305/v2/https://resizing.flixster.com/wV4GktTCPSevQBN5kUuTKFZ4XX0=/ems.ZW1zLXByZC1hc3NldHMvbW92aWVzLzQ3YzRhZDkxLTcxY2ItNDlkNC05NzgxLWVlODkxYjQ1N2Q3Zi53ZWJw,The Unicorn Store,1000,86,2017.0,,,23
57,93,https://resizing.flixster.com/4cPiNHgISSIbrFqr1cNeTrDWw74=/206x305/v2/https://resizing.flixster.com/VzvzLKJW0xWOpUAlmPMHc_lCvYI=/ems.ZW1zLXByZC1hc3NldHMvbW92aWVzL2ExMDBlOWExLTU4YjUtNDEzOC04ZDljLTVhMTJmMTQ2MjMwYS53ZWJw,Revenge,2500,133,2017.0,Mystery and thriller,0 days 01:48:00.000000000,36
83,97,https://resizing.flixster.com/c8cGdV1w-l7pdwWDqD3m_sXXt-g=/206x305/v2/https://resizing.flixster.com/SlFUAJxD8qYQguDGOXb5hag_wXU=/ems.ZW1zLXByZC1hc3NldHMvbW92aWVzLzc0NWU3Mzc2LWE0NWQtNDhjMS1hOGNmLTAwZGZlZGQ5MmM5NS53ZWJw,The Hate U Give,2500,223,2018.0,Crime/Drama,0 days 02:13:00.000000000,14
47,61,,Uncle Drew,1000,99,2018.0,Comedy,0 days 01:44:00.000000000,14
56,49,https://resizing.flixster.com/zYMfXnR0M132ALI89n28NdNLY9g=/206x305/v2/https://resizing.flixster.com/Ls-PEzgeHT7T5fjzJZkfH_0MvYE=/ems.ZW1zLXByZC1hc3NldHMvbW92aWVzLzdmYjRiZGQ3LTQzNTYtNDdiMC1iOTllLTkzM2UxZTRmYmY4NS53ZWJw,Marrowbone,500,75,2017.0,Horror/Mystery and thriller,0 days 01:50:00.000000000,-7
80,83,https://resizing.flixster.com/qwfAV6_81FZVgNOj5OL0RcI1MrI=/206x305/v2/https://resizing.flixster.com/aaNzwIb2379ANp5b61wRPCcZMrs=/ems.ZW1zLXByZC1hc3NldHMvbW92aWVzLzU5ZmZjNDBhLTcwNDItNDQzNC04MDc4LWUzYzkyY2E2M2NhNy53ZWJw,Scaffolding,50,12,2017.0,Drama,0 days 01:30:00.000000000,3
83,72,,Christopher Robin,5000,275,2018.0,Fantasy/Comedy,0 days 01:44:00.000000000,-11
83,51,https://resizing.flixster.com/edrLx1vGQymVZ8T-c0MrcyQqcys=/206x305/v2/https://resizing.flixster.com/9ismFg9ZnzqnI72ByBpnKqzqM4Q=/ems.ZW1zLXByZC1hc3NldHMvbW92aWVzL2E4YmI0ZWVmLTczZGItNGU5ZS1iNWRmLTc1YzE1YThmMzk5Zi53ZWJw,The Miracle Season,500,45,2018.0,Drama,0 days 01:39:00.000000000,-32
50,66,https://resizing.flixster.com/ZsP1h-aAwNlwyS8fPWur1_T8fvQ=/206x305/v2/https://resizing.flixster.com/mzJDXz-n2mdF-V8NJpxuntmvseI=/ems.ZW1zLXByZC1hc3NldHMvbW92aWVzL2YyN2U0ZmVhLTU3ZjAtNDY2Mi1iZDUyLTdhNjliYWI2Y2QyMS53ZWJw,Memoir of War,1,41,2017.0,War/Drama,0 days 02:07:00.000000000,16
45,65,https://resizing.flixster.com/XoaQ89GSltIkpJtZhefGGxkatXw=/206x305/v2/https://resizing.flixster.com/Wc8KetF54kzb6FVOIAm8sYbQLF4=/ems.ZW1zLXByZC1hc3NldHMvbW92aWVzL2VjYjZkMTcwLTgzZDQtNDUwOC1iNTc2LThmOTQzMWIyOWE3MS53ZWJw,The House With a Clock in Its Walls,2500,219,2018.0,Comedy/Fantasy,0 days 01:45:00.000000000,20
71,90,https://resizing.flixster.com/9-6aOPEVr_OlNZjaGSlRb7nG11s=/206x305/v2/https://resizing.flixster.com/-U68yfulpBQdZJsl713i-nMVxV4=/ems.ZW1zLXByZC1hc3NldHMvbW92aWVzLzllZjY3M2FjLTEyNzgtNGE0My05YzMyLWM3NTcyM2ViNGQ5Yi53ZWJw,Pin Cushion,100,40,2017.0,Drama,0 days 01:22:00.000000000,19
36,41,,Gauguin: Voyage to Tahiti,100,37,2017.0,Romance/Drama,0 days 01:42:00.000000000,5
58,85,,Sollers Point,100,27,2017.0,Drama,0 days 01:41:00.000000000,27
67,69,,The Changeover,250,32,2017.0,Fantasy/Mystery and thriller,0 days 01:35:00.000000000,2
86,65,https://resizing.flixster.com/M0y-kMOeMsSyqFgMTWRu9QT6rlg=/206x305/v2/https://resizing.flixster.com/HcqKNyoQvkwYlbfKCeFyWxzV1nA=/ems.ZW1zLXByZC1hc3NldHMvbW92aWVzLzc1ZjI3NmQ3LTJlOTAtNDRiOS05MWEyLTk0NmMwZTM2YmIwYy53ZWJw,Ramen Heads,50,17,2017.0,Documentary,0 days 01:33:00.000000000,-21
72,43,https://resizing.flixster.com/t5UgqqhxK80PbhgircxYK8bRgXs=/206x305/v2/https://resizing.flixster.com/y0AG8Dgmt587iudWxhPUNtoTDhk=/ems.ZW1zLXByZC1hc3NldHMvbW92aWVzL2E3Nzc2YWQyLWMxNmItNGZkMy1hYTBhLTAzOTI3MzI5MjI2NS53ZWJw,Where Hands Touch,250,49,2018.0,Romance/Drama,0 days 02:02:00.000000000,-29
100,78,,Wonders of the Sea,1,18,2017.0,Documentary,0 days 01:23:00.000000000,-22
84,89,https://resizing.flixster.com/dBYNyYE-95oQJj4_Qlt7-k8vtPQ=/206x305/v2/https://resizing.flixster.com/KvyHkBoPlnX0NGB6byLQOYbTkSk=/ems.ZW1zLXByZC1hc3NldHMvbW92aWVzLzA5MmYzNDNhLWNiMmEtNDdkNy04M2Q4LTU5Y2ZhY2EzMGYwMS53ZWJw,The Great Buddha+,100,18,2017.0,Comedy,0 days 01:44:00.000000000,5
64,94,https://resizing.flixster.com/K-yRzvz-pLDPvri-gNIsNgeUzz4=/206x305/v2/https://resizing.flixster.com/G6njR-aljc8bCtXULoI_DEnBW9Q=/ems.ZW1zLXByZC1hc3NldHMvbW92aWVzLzhiNGE2NjMzLWUzMmYtNDU2Mi05NDE2LTg5YmVkODg1ODYzZC53ZWJw,The Rape of Recy Taylor,100,35,2017.0,Drama,0 days 01:31:00.000000000,30
54,100,,The Unseen,250,9,2016.0,Sci fi/Action,0 days 01:44:00.000000000,46
86,50,https://resizing.flixster.com/F5cC5A1YeF7ypxZ2qTbOLEci93E=/206x305/v2/https://resizing.flixster.com/ZJ3gnPjtVZXB6510U9dKR2v5GqI=/ems.ZW1zLXByZC1hc3NldHMvbW92aWVzL2Y2YjdlNmE2LTNjNjgtNGY5Mi04OTA2LTBkOTRiODlhNmY1Ny53ZWJw,DriverX,50,10,2017.0,Comedy/Drama,0 days 01:38:00.000000000,-36
50,56,https://resizing.flixster.com/F-7DPXrSdbKqd-foCMZETZ1piPw=/206x305/v2/https://resizing.flixster.com/D9m3zOS5kYNKvAQAKuYSOTuHZ44=/ems.ZW1zLXByZC1hc3NldHMvbW92aWVzLzlmMGFhYjkwLWRhNDQtNGY5Yi05OTU1LTAwZjE0NjE3NjIyZS53ZWJw,The Bookshop,250,108,2017.0,Drama,0 days 01:53:00.000000000,6
51,93,,Hagazussa: A Heathen's Curse,100,29,2017.0,Horror,0 days 01:42:00.000000000,42
30,61,https://resizing.flixster.com/22OB9yDYQfopiWhnWBjps-m1koY=/206x305/v2/https://resizing.flixster.com/0sN246abTxf4dAPRZuTapfVwuz4=/ems.ZW1zLXByZC1hc3NldHMvbW92aWVzL2U1NmZlYTM5LTRhNDAtNGQ3ZS1hYTNjLTY3ZjQ0YjNjYmU5NS53ZWJw,Sierra Burgess Is a Loser,1000,38,2018.0,Romance,0 days 01:45:00.000000000,31
84,90,,Itzhak,100,40,2017.0,Documentary/Music,0 days 01:23:00.000000000,6
64,100,https://resizing.flixster.com/kmzKGuSKJc_W1Ag_7lK1kUVfWNY=/206x305/v2/https://resizing.flixster.com/B88mSSw48834HTEiU0RiSGrqrH8=/ems.ZW1zLXByZC1hc3NldHMvbW92aWVzLzgzZDY3ZjQ5LTc4MjMtNGUwNi04YWM3LTBlYWIyNGIxMzZmMi53ZWJw,City of Joy,1,8,2016.0,Documentary,0 days 01:14:00.000000000,36
91,98,,Rodents of Unusual Size,100,46,2017.0,Documentary,0 days 01:11:00.000000000,7
95,90,https://resizing.flixster.com/BCF3LjpKem3jT-5PXIuYJJNaajc=/206x305/v2/https://resizing.flixster.com/LgtL_lu_3WVFP5QUVQlNhcBZ7yY=/ems.ZW1zLXByZC1hc3NldHMvbW92aWVzL2I4ODg4Y2Y2LWU4OTItNGYyNC1iZDFmLWVjNGEwOWJiNDMxNy53ZWJw,Far From the Tree,250,42,2017.0,Documentary,0 days 01:33:00.000000000,-5
81,81,https://resizing.flixster.com/Jvb4iRfWs-7znpDfA-9clBFsQxc=/206x305/v2/https://resizing.flixster.com/HS6k7z_rT01ZrZqwGuoNBjn5FC0=/ems.ZW1zLXByZC1hc3NldHMvbW92aWVzLzk2NjRlNDlmLTdmYTktNDg1My1hOTlmLThjZjQzMmY4OGQ0Mi53ZWJw,The Guernsey Literary and Potato Peel Pie Society,1000,72,2018.0,Romance/Drama,0 days 02:04:00.000000000,0
31,50,https://resizing.flixster.com/GiuH2v-t2jvzC0UuQR0GMZLZO1k=/206x305/v2/https://resizing.flixster.com/gc3kFNdW-uLJoDHUI8HusaT_STc=/ems.ZW1zLXByZC1hc3NldHMvbW92aWVzLzEwYjQwN2RkLTY0NDQtNDBkNy05MWZiLWUwNGUxYzMyOTA2NS53ZWJw,Postcards From London,50,16,2018.0,Gay and lesbian/Drama,0 days 01:29:00.000000000,19
69,75,,Anchor and Hope,100,28,2017.0,Drama/Comedy,0 days 01:53:00.000000000,6
71,91,https://resizing.flixster.com/2kzFTCZ1mHMClZag2PD7-txqSWg=/206x305/v2/https://resizing.flixster.com/IVPogZ4UQbt4Z1wIJy7-Jao27IQ=/ems.ZW1zLXByZC1hc3NldHMvbW92aWVzLzk2YjA0ZWJlLTkzN2QtNDQ2OS05N2IyLTNhN2E4ZWYyNzA0YS53ZWJw,Maria by Callas: In Her Own Words,250,80,2017.0,Documentary/Music,0 days 01:53:00.000000000,20
76,91,,Crazy Rich Asians,10000,362,2018.0,Romance,0 days 02:00:00.000000000,15
54,14,,The Little Vampire,50,14,2017.0,Comedy/Kids and family,0 days 01:23:00.000000000,-40
82,86,,What They Had,500,116,2018.0,Drama,0 days 01:40:00.000000000,4
58,51,,Destination Wedding,500,86,2018.0,Romance,0 days 01:26:00.000000000,-7
86,93,https://resizing.flixster.com/wXki0r4xv_x-BZlMBm-Mc9ke5JI=/206x305/v2/https://resizing.flixster.com/iOmFzLLNdowR9jJ7oVk8copIFRE=/ems.ZW1zLXByZC1hc3NldHMvbW92aWVzL2JlNjBkNDA1LTZjMGYtNGM4Zi04MDQyLTM5MGNlNDIzMjA1OC53ZWJw,Fighting With My Family,2500,241,2019.0,Comedy/Drama,0 days 01:47:00.000000000,7
84,88,,Newly Single,1,8,2017.0,Comedy/Drama,0 days 01:36:00.000000000,4
89,100,,Transformer,100,11,2017.0,Documentary,0 days 01:19:00.000000000,11
81,60,https://resizing.flixster.com/Up4_bMNnqd5_aNppetc2HT6pcHw=/206x305/v2/https://resizing.flixster.com/diUcJhcaC1hPyBpGeRJILvNDjGo=/ems.ZW1zLXByZC1hc3NldHMvbW92aWVzLzM4ZjkzYzM4LTliYzQtNDc4OC1hNzA0LTJkYWIxMDI5MGFkNy53ZWJw,Hostile,250,5,2017.0,Horror/Mystery and thriller,0 days 01:23:00.000000000,-21
86,78,,El último traje,100,23,2017.0,Comedy/Drama,0 days 01:32:00.000000000,-8
23,22,,Bleeding Steel,100,18,2017.0,Action/Sci fi,0 days 01:50:00.000000000,-1
83,88,,Life After Flash,1,8,2017.0,Documentary,0 days 01:34:00.000000000,5
33,42,,What Men Want,1000,146,2019.0,Romance/Fantasy,0 days 01:57:00.000000000,9
51,74,,Destroyer,1000,268,2018.0,Crime/Action,0 days 02:03:00.000000000,23
64,60,,Operation Finale,1000,134,2018.0,Drama/Mystery and thriller,0 days 02:02:00.000000000,-4
92,100,,Among Wolves,100,13,2016.0,Documentary,0 days 01:34:00.000000000,8
99,100,https://resizing.flixster.com/gATxddroZm-TWS3FfnrNtx6k8Mw=/206x305/v2/https://resizing.flixster.com/uSKcNfYMUU-WUUPLvWJGRxGELuo=/ems.ZW1zLXByZC1hc3NldHMvbW92aWVzLzk0MzhhZDYwLWVmYWUtNGEyMS05YTg0LTU0ZjE1MmNkMjEwZC53ZWJw,Mosul,1000,5,2019.0,Documentary,0 days 01:26:00.000000000,1
94,97,https://resizing.flixster.com/A8Kwepq2iWs4oC-DqFNRFx_FNmk=/206x305/v2/https://resizing.flixster.com/I6wELCd4sPygaUraT0s_oVGLsdM=/ems.ZW1zLXByZC1hc3NldHMvbW92aWVzL2YyNWI0NmIyLWQ1YmUtNGE5ZC1iZDQ3LWU1ZTVhMjAwNGVkYi53ZWJw,Won't You Be My Neighbor?,2500,253,2018.0,Documentary,0 days 01:34:00.000000000,3
82,81,https://resizing.flixster.com/4pUgaeSP9ucFRDhkS6G5Oun-bQw=/206x305/v2/https://resizing.flixster.com/Dp3pa_jU90FAoE-t1Jb9VuUe-So=/ems.ZW1zLXByZC1hc3NldHMvbW92aWVzLzc5YTY0MDhiLTFkYTMtNGU2Ni04N2M5LTQ4YzlhMzEwZDg3Mi53ZWJw,Instant Family,2500,155,2018.0,Comedy/Drama,0 days 01:59:00.000000000,-1
93,97,,Spider-Man: Into the Spider-Verse,10000,388,2018.0,Comedy/Kids and family,0 days 01:57:00.000000000,4
58,37,https://resizing.flixster.com/czHA79VOzw7CIDhtBcerEZXIspA=/206x305/v2/https://resizing.flixster.com/8NH41r3LCDT4AaMEk-GAVHkHpf4=/ems.ZW1zLXByZC1hc3NldHMvbW92aWVzLzlmNzJjNGExLThhZDItNGFjNC1iNTAzLTIyYjkxMDFiZGUzMS53ZWJw,Patrick,100,35,2018.0,Comedy,0 days 01:34:00.000000000,-21
54,34,https://resizing.flixster.com/2JIQ8GH9sP93QKAMOuMsUDz-xug=/206x305/v2/https://resizing.flixster.com/xp6miwEW4Sd6daMfiIe7quKCtBE=/ems.ZW1zLXByZC1hc3NldHMvbW92aWVzLzcxYTA2OTYxLTFjYTEtNDg5ZS1iMzA1LTk5ZjI1MmYzMTQ4Yi53ZWJw,Kin,500,94,2018.0,Action/Sci fi,0 days 01:42:00.000000000,-20
53,38,,Slaughterhouse Rulez,250,34,2018.0,Comedy/Horror,0 days 01:44:00.000000000,-15
71,91,https://resizing.flixster.com/wZx0GFyFHTZy6mWg4gS78I5m1X8=/206x305/v2/https://resizing.flixster.com/ZTpa6teumgFdq0RCPR8wgRy3Do8=/ems.ZW1zLXByZC1hc3NldHMvbW92aWVzLzg1ZTY5MjA1LWFiNmMtNGE1ZC1iYWRmLTE0ODVlNGYzODg3NC53ZWJw,Teen Titans GO! to the Movies,2500,132,2018.0,Action/Adventure,0 days 01:27:00.000000000,20
82,99,https://resizing.flixster.com/dUTO4v3rNcKl6GGIuxbhAgFB9M4=/206x305/v2/https://resizing.flixster.com/My4HL1-D8tVQk56Q95Q85RAnQ5E=/ems.ZW1zLXByZC1hc3NldHMvbW92aWVzLzdjNGU2ZmY4LTBhOTYtNDU4Ni1iYjA2LWJlZWMyODliZDM5YS53ZWJw,Eighth Grade,5000,313,2018.0,Comedy/Drama,0 days 01:33:00.000000000,17
42,73,,Piercing,250,100,2018.0,Comedy/Horror,0 days 01:21:00.000000000,31
54,74,,Assassination Nation,1000,136,2018.0,Action/Comedy,0 days 01:50:00.000000000,20
79,93,,RBG,1000,178,2018.0,Documentary,0 days 01:37:00.000000000,14
73,92,https://resizing.flixster.com/aAwnJHWzp9Hiwo0xY8vwvTXrmrY=/206x305/v2/https://resizing.flixster.com/i1AHcgRw3b7BMIUqVqQR2l1yBcA=/ems.ZW1zLXByZC1hc3NldHMvbW92aWVzL2YyYjFiZTIyLTViNmItNDE5OS04NmViLTJkMDYyMGQ1ZTdhMi53ZWJw,Hearts Beat Loud,1000,157,2018.0,Comedy/Drama,0 days 01:37:00.000000000,19
54,68,,Damsel,500,114,2018.0,Western/Comedy,0 days 01:53:00.000000000,14
67,88,,White Rabbit,50,8,2018.0,Comedy/Drama,0 days 01:11:00.000000000,21
77,89,,Skate Kitchen,250,93,2018.0,Drama,0 days 01:46:00.000000000,12
44,88,,Madeline's Madeline,250,122,2018.0,Drama,0 days 01:34:00.000000000,44
61,93,https://resizing.flixster.com/fmkNyVWXZCzHtBu6mw1eYeIOIeU=/206x305/v2/https://resizing.flixster.com/U2tZIr-hVDc_CDCsBkOl6mf6mK4=/ems.ZW1zLXByZC1hc3NldHMvbW92aWVzLzc2OTU0ZmUxLTgzMTItNDY3Yy05MzRiLTkwODRlMWQ0OWIwMC53ZWJw,The Last Race,100,15,2018.0,Documentary,0 days 01:14:00.000000000,32
95,80,https://resizing.flixster.com/9eJDhuLvzO3rcEprFi_oe5zBuEc=/206x305/v2/https://resizing.flixster.com/10pWpWYYv4RZEv2kQNwaFzG3IME=/ems.ZW1zLXByZC1hc3NldHMvbW92aWVzL2JmMTNiZjE2LTJlYWItNDEzZi05YTZiLTAyNjBkNzQ4MWRiMC53ZWJw,Kailash,50,5,2018.0,Documentary,0 days 01:32:00.000000000,-15
40,63,https://resizing.flixster.com/6-O74YMCUKYdUX6rDaEdJ6zOe5Q=/206x305/v2/https://resizing.flixster.com/saRr8wxKrUfO5h-dHPx73v-632M=/ems.ZW1zLXByZC1hc3NldHMvbW92aWVzLzg4NDNmODc2LTVlMjYtNDU3ZC05YzBmLTU4MzY4MDcyOGUzMC53ZWJw,I Think We're Alone Now,250,40,2018.0,Sci fi/Drama,0 days 01:33:00.000000000,23
67,95,https://resizing.flixster.com/6royyHJbmiPwEGliZ8ANE1WH1Uw=/206x305/v2/https://resizing.flixster.com/EA7AKZZTxCZ7OwavkOkiAkxQvTY=/ems.ZW1zLXByZC1hc3NldHMvbW92aWVzLzg5M2FiY2Q4LTM1ZmYtNDE0Ni04NzIyLTA2NjUxMTdlYzA1ZS53ZWJw,Blaze,500,91,2018.0,Drama/Music,0 days 02:07:00.000000000,28
69,72,https://resizing.flixster.com/3TIMsYB88Ujb2SOuDvWn2ojt3rA=/206x305/v2/https://resizing.flixster.com/XlWUaERov4RT13FyS3zoU6tZuzM=/ems.ZW1zLXByZC1hc3NldHMvbW92aWVzL2M5YmY4MDRjLWRlMDktNDQ0NC1iM2Y2LTVkZDNjMTg5MTFlNi53ZWJw,Chef Flynn,50,29,2018.0,Documentary,0 days 01:22:00.000000000,3
86,79,https://resizing.flixster.com/ehwjE0Qvc7e7YLV43-n7HIAd32I=/206x305/v2/https://resizing.flixster.com/j0sqxawPn_uDu0O2yLvGLx8fDDw=/ems.ZW1zLXByZC1hc3NldHMvbW92aWVzL2U3ZjdhZjMyLTYzMzktNGEyYy1iNTVjLWI5ODYzYzRkMDc4Yi53ZWJw,Bad Reputation,100,38,2018.0,Documentary/Music,0 days 01:35:00.000000000,-7
74,83,https://resizing.flixster.com/Pg70UDvpoAuNie5aVSFKKcgnyTQ=/206x305/v2/https://resizing.flixster.com/mD2M_vrjAuIeQoT7vk51FtluUXs=/ems.ZW1zLXByZC1hc3NldHMvbW92aWVzLzNiNmFlMDBiLTMyZjYtNDBlZi04MTNkLTBiZDhjYTU1MDBkMC53ZWJw,"Juliet, Naked",1000,167,2018.0,Romance/Music,0 days 01:45:00.000000000,9
75,92,,We the Animals,500,100,2018.0,Gay and lesbian/Drama,0 days 01:34:00.000000000,17
77,98,,Night Comes On,250,49,2018.0,Drama,0 days 01:26:00.000000000,21
33,74,https://resizing.flixster.com/cZPtvo3lIlcakhnn_Out-MVdpVQ=/206x305/v2/https://resizing.flixster.com/2IYjCGoHrpNoBFAuaintDxkE-h4=/ems.ZW1zLXByZC1hc3NldHMvbW92aWVzLzhlZTM0Mjg3LThkYmMtNDlkYy1hOTE5LThkZTRiYWNiOTNhZS53ZWJw,Clara's Ghost,1,31,2018.0,Comedy,0 days 01:33:00.000000000,41
78,100,https://resizing.flixster.com/uwQUJmqiFYokWu8nuK8-Ou7ojJo=/206x305/v2/https://resizing.flixster.com/jCynDz-9i_Y-33fHL2RtHPJzE7s=/ems.ZW1zLXByZC1hc3NldHMvbW92aWVzLzgwNTZkZTQxLTIyN2ItNDJjNy1iZjYwLWNhNmE1NzM0NjcyMC53ZWJw,Shirkers,250,69,2018.0,Documentary,0 days 01:36:00.000000000,22
89,90,https://resizing.flixster.com/mX5mBOGXH_qjw_akTX70RZQVd3k=/206x305/v2/https://resizing.flixster.com/OuBoqAioYjPByOFzVJqY7o2Wq9M=/ems.ZW1zLXByZC1hc3NldHMvbW92aWVzL2E0ZWQyMWJjLWI0MjItNGM5ZC1iYjc1LTM3ZjZmZjNkZDhiMi53ZWJw,The Sentence,100,20,2018.0,,,1
92,100,,Minding the Gap,500,122,2018.0,Documentary,0 days 01:33:00.000000000,8
40,97,,"Hale County This Morning, This Evening",100,69,2018.0,Documentary,0 days 01:16:00.000000000,57
91,100,https://resizing.flixster.com/QPA1k0MABmhFwnu0uNZsBRhfAM8=/206x305/v2/https://resizing.flixster.com/KkmjLrkJoAzBUEQ_Rv-Hz0njI2E=/ems.ZW1zLXByZC1hc3NldHMvbW92aWVzL2EzMDU2ZGJhLTk4YjEtNGU5ZS04OGU3LTRiNGQ0OWM0NzI2ZS53ZWJw,The Devil We Know,100,7,2018.0,Documentary,0 days 01:35:00.000000000,9
32,60,https://resizing.flixster.com/Y64T1cAy9sXG4xPfqM4uKdA4nZI=/206x305/v2/https://resizing.flixster.com/qierpkL1k3vkhIejV6bwtUJ4g4M=/ems.ZW1zLXByZC1hc3NldHMvbW92aWVzL2Y4YmU1ZmMyLWJmMzEtNDY4NC1hNmMxLWNjOWRhODM2MTFlMi53ZWJw,Tyrel,100,50,2018.0,Comedy/Drama,0 days 01:26:00.000000000,28
70,84,https://resizing.flixster.com/whHjCGs-pNIprJ9vbk-7ButeW48=/206x305/v2/https://resizing.flixster.com/rfln87tBSbcQZwAb5tq-qKktjDw=/ems.ZW1zLXByZC1hc3NldHMvbW92aWVzLzhiYWQwMTBhLTNhOGUtNGU0NC1hNzFhLWJiN2IwYmQwZTM2NC53ZWJw,Monsters and Men,500,79,2018.0,Drama,0 days 01:35:00.000000000,14
68,90,,The Kindergarten Teacher,250,102,2018.0,Drama,0 days 01:36:00.000000000,22
81,88,,American Animals,2500,214,2018.0,Mystery and thriller/Drama,0 days 01:56:00.000000000,7
48,66,https://resizing.flixster.com/B8dIC3rKQG_dny_oRIPbRndWl6E=/206x305/v2/https://resizing.flixster.com/O7JoAZH9R_T9-mD0k7gPBYR6RXY=/ems.ZW1zLXByZC1hc3NldHMvbW92aWVzLzM5ZDc3ODAxLWQ5YmQtNDFmNC05NDdlLTg2Yzg3YmI3MzJmZC53ZWJw,Lizzie,500,149,2018.0,Drama/Mystery and thriller,0 days 01:45:00.000000000,18
87,92,https://resizing.flixster.com/Dru-INomsfZdb9ItQh4r7B-l8q0=/206x305/v2/https://resizing.flixster.com/c1rUN8pucRTDGh3jr9jM_o2EiCQ=/ems.ZW1zLXByZC1hc3NldHMvbW92aWVzLzRhNmJkYzJmLTUxYTAtNDg5Ny1hM2U0LTdmMDU0MWM2ZjVjNi53ZWJw,Searching,5000,253,2018.0,Mystery and thriller,0 days 01:42:00.000000000,5
39,95,,See You Yesterday,250,40,2019.0,Action/Sci fi,0 days 01:26:00.000000000,56
62,40,,Spiral,1,10,2017.0,Documentary,0 days 01:19:00.000000000,-22
91,97,https://resizing.flixster.com/cgg0O0U43yJDfFTJ-jA5wbg4xMM=/206x305/v2/https://resizing.flixster.com/9GAzPKMPz66l7DnhaMz6Vj2JjXk=/ems.ZW1zLXByZC1hc3NldHMvbW92aWVzLzIxYmFlMmE5LWFmMGMtNGM5ZS04ZjEyLThkMDJiMGYxYTJhMi53ZWJw,Pick of the Litter,500,66,2018.0,Documentary,0 days 01:21:00.000000000,6
31,27,https://resizing.flixster.com/Wuh0_4QP_yHH38JlOG8suEfh0Ls=/206x305/v2/https://resizing.flixster.com/zbsArKJ0_GyDYHKre5WwqSXY-9w=/ems.ZW1zLXByZC1hc3NldHMvbW92aWVzLzQ5NTBlYjhkLTljN2MtNDQ3YS1hMThmLTE3YmYwMjE1M2UyZi53ZWJw,Breaking In,1000,107,2018.0,Drama/Mystery and thriller,0 days 01:28:00.000000000,-4
50,83,https://resizing.flixster.com/J--qhZA-LmGjKfta7I2u7An6wDo=/206x305/v2/https://resizing.flixster.com/WUehkRxIZjwd1DtAoFPfhIUu2Fg=/ems.ZW1zLXByZC1hc3NldHMvbW92aWVzLzNhMjAwN2Y5LTkwMzItNDFhOC05YmU3LTcwNmIzODA0ZTI5Ny53ZWJw,In the Intense Now,1,18,2017.0,Documentary,0 days 02:07:00.000000000,33
25,0,,Black Water,100,9,2018.0,Action/Mystery and thriller,0 days 01:45:00.000000000,-25
76,73,https://resizing.flixster.com/Xk-o2b8UqebG7QYPFX2S1hKkGiM=/206x305/v2/https://resizing.flixster.com/BkkgC9NglgXxGxsus3b7dln3xFI=/ems.ZW1zLXByZC1hc3NldHMvbW92aWVzL2YwNDlmMWM3LTJlZTUtNDFmOS1iNzQ5LWQ4M2QzZDA0ZmFkNi53ZWJw,On the Basis of Sex,1000,263,2018.0,Drama/History,0 days 02:00:00.000000000,-3
80,56,,The Rainbow Experiment,1,9,2018.0,Drama,0 days 01:29:00.000000000,-24
71,83,https://resizing.flixster.com/SK_PQFOROcDKvykM9OQHoryMEjQ=/206x305/v2/https://resizing.flixster.com/J9dxAEvH0PKvyonLglXDWtdTu9M=/ems.ZW1zLXByZC1hc3NldHMvbW92aWVzL2UxYThiM2E2LWVjMGYtNDQ2Ny1iYmNmLTM0YjBhODYwMWNlZi53ZWJw,Funny Story,1,18,2018.0,Comedy/Drama,0 days 01:25:00.000000000,12
79,93,,Private Life,1000,106,2018.0,Comedy/Drama,0 days 02:04:00.000000000,14
87,94,https://resizing.flixster.com/aBcv37XwUD92ibTaVOtA3Q22TTw=/206x305/v2/https://resizing.flixster.com/_aakXrhXhsJIkmYW-0sr47LWFBU=/ems.ZW1zLXByZC1hc3NldHMvbW92aWVzLzllNDMxMjdiLWY2NmUtNDc1ZS04MjEyLTNkYmUwOGQ5ZDJhOC53ZWJw,Blindspotting,1000,173,2018.0,Comedy/Drama,0 days 01:35:00.000000000,7
87,97,,The Guilty,1000,118,2018.0,Crime/Drama,0 days 01:25:00.000000000,10
88,97,https://resizing.flixster.com/ftcgTm5-bkeTnKEix9Fzb4_9j-g=/206x305/v2/https://resizing.flixster.com/Hl6A_tECrOdtRfMGydy3z3AMZD4=/ems.ZW1zLXByZC1hc3NldHMvbW92aWVzLzg2OWQ3MjZjLTg1YTgtNDJjYy1hY2MyLWM5ZGQ1MDVkYWI3YS53ZWJw,Three Identical Strangers,2500,183,2018.0,Biography/History,0 days 01:36:00.000000000,9
49,86,https://resizing.flixster.com/Hhjx54XnipUYKHuQR4NRjykH5Xw=/206x305/v2/https://resizing.flixster.com/kP6KEiZwKLSSJmB9NJSXMjtF2js=/ems.ZW1zLXByZC1hc3NldHMvbW92aWVzLzIzM2VjMTMwLTM2NDEtNDAyYS1hYTg1LWU4OGM3MTA0YmQ4Yy53ZWJw,Time Share,100,22,2018.0,Drama,0 days 01:36:00.000000000,37
52,75,https://resizing.flixster.com/r6J4zM-NmTf34l6D0F3zjODT2Wk=/206x305/v2/https://resizing.flixster.com/J9N40ppDLANT7dVxjdcx4hfm7J0=/ems.ZW1zLXByZC1hc3NldHMvbW92aWVzL2IyYjgwM2JmLTUwM2MtNDhkYS1iMzYzLWMyMGRlMzhiZDE0Zi53ZWJw,The Long Dumb Road,100,28,2018.0,Comedy,0 days 01:30:00.000000000,23
66,90,https://resizing.flixster.com/4jTX2A9jn4wJgKmkm-ocV8BuodI=/206x305/v2/https://resizing.flixster.com/MsGk-DPsP0B9Be3mic06wpv8_pc=/ems.ZW1zLXByZC1hc3NldHMvbW92aWVzLzNlZGIyYzA2LTYzODMtNDlkYi04ODc5LTFjNjAyZjExMzc4NS53ZWJw,Mandy,2500,246,2018.0,Horror/Mystery and thriller,0 days 02:01:00.000000000,24
69,87,https://resizing.flixster.com/7VwIE47ZmzC6GCbJ34WfK5qFEAI=/206x305/v2/https://resizing.flixster.com/COB-XTjhBloJV6qj77kgT16Biug=/ems.ZW1zLXByZC1hc3NldHMvbW92aWVzLzE1YjUyNDFmLTYxNTYtNDQyMi1hMWVkLTllNGRhYzg1N2I1MS53ZWJw,Colette,1000,217,2018.0,Drama/History,0 days 01:51:00.000000000,18
50,72,https://resizing.flixster.com/JNOx2vOxI0SfqfuPwmIyY2DqHXA=/206x305/v2/https://resizing.flixster.com/aHwvEQUOGl0oHYlybjFbT0aUUeY=/ems.ZW1zLXByZC1hc3NldHMvbW92aWVzLzE1NGQ5YjMyLThhNTEtNDVlNy04NTM5LWJkMDU3NGI0ZWZkMy53ZWJw,The Happy Prince,250,137,2018.0,Gay and lesbian/Drama,0 days 01:45:00.000000000,22
67,89,https://resizing.flixster.com/WfJ5yYbSq_GOLIOBl_aIyRz1fGU=/206x305/v2/https://resizing.flixster.com/ZeJLg7bJ9E_pAaZmV9yf4SiEzW8=/ems.ZW1zLXByZC1hc3NldHMvbW92aWVzLzBlZjk3ZGY1LTVjYmMtNDRmOC04MGY3LTM3NTVjODE2NTEyNS53ZWJw,Hereditary,10000,379,2018.0,Horror/Mystery and thriller,0 days 02:07:00.000000000,22
62,72,,Lords of Chaos,500,76,2018.0,Comedy/Drama,0 days 01:52:00.000000000,10
45,51,https://resizing.flixster.com/A9f08uVe3SM7sUGAAGqbWhVwZ-A=/206x305/v2/https://resizing.flixster.com/PT3S0y0bPhpfBn_hk6BqyiDc2mY=/ems.ZW1zLXByZC1hc3NldHMvbW92aWVzLzNlZTIzNDZlLTZjMDEtNDM1NS05NTU3LTZhMTY3OTJmOTA0My53ZWJw,Superfly,500,102,2018.0,Crime/Action,0 days 01:56:00.000000000,6
87,88,https://resizing.flixster.com/YcWY1AYO2wFl1gWgrYe7Z3971Js=/206x305/v2/https://resizing.flixster.com/zOWurrHdO41SwazozMqv4vDk0_Y=/ems.ZW1zLXByZC1hc3NldHMvbW92aWVzL2JhMDYzYThiLTA5ZmUtNDgwYi1hNTQ5LTYwZGZmYzcyMDlkMi53ZWJw,Upgrade,5000,192,2018.0,Horror/Action,0 days 01:35:00.000000000,1
66,69,,Adrift,1000,200,2018.0,Romance/Drama,0 days 02:00:00.000000000,3
63,80,,Operation Red Sea,250,10,2018.0,Action/Adventure,0 days 02:19:00.000000000,17
76,62,https://resizing.flixster.com/F3DKT4e9eS-knJDZiKXk2QpTkuw=/206x305/v2/https://resizing.flixster.com/2y3LZZxtMowBRrED5qgmFLG1suM=/ems.ZW1zLXByZC1hc3NldHMvbW92aWVzL2YyZjgzMWI0LTA5ZmUtNDhhMC1hZTVlLTQzMDU0ZjFiYWFlYy53ZWJw,Dog Days,500,68,2018.0,Romance,0 days 01:53:00.000000000,-14
65,58,https://resizing.flixster.com/p2NVXWR4a9lXM8AC4IfDLft5uyQ=/206x305/v2/https://resizing.flixster.com/XIxWdZd3Oos_HpAQxqRygFccVtk=/ems.ZW1zLXByZC1hc3NldHMvbW92aWVzLzEwMDhkZjdhLWM1YjAtNDQ0NS1iOWNhLTJjN2Y1NGViYTI0Ni53ZWJw,Time Trap,500,12,2017.0,Mystery and thriller/Sci fi,0 days 01:27:00.000000000,-7
62,93,,The Old Man & the Gun,2500,269,2018.0,Comedy/Drama,0 days 01:33:00.000000000,31
76,86,,The Miseducation of Cameron Post,1000,186,2018.0,Gay and lesbian/Drama,0 days 01:31:00.000000000,10
70,93,https://resizing.flixster.com/JhTSpNevglTUeu_eWAHCi8vYoh8=/206x305/v2/https://resizing.flixster.com/qlLBG30cunKKKFyutJSoRrPkpfg=/ems.ZW1zLXByZC1hc3NldHMvbW92aWVzLzkyNjRkOTI2LWIwNTgtNDZkYi1hZTlmLWE1YTc3MzhhMzlkNi53ZWJw,Sorry to Bother You,5000,307,2018.0,Sci fi/Comedy,0 days 01:45:00.000000000,23
29,11,https://resizing.flixster.com/xccbg_5kbvVkdoVWc-mLwp2Bdzk=/206x305/v2/https://resizing.flixster.com/QQ6CWU3FnsjmZdVRSTTX1fvsAI0=/ems.ZW1zLXByZC1hc3NldHMvbW92aWVzL2QxZTQ0MTUxLWFjNTQtNDM2OC04YTEwLTk1ZWVjMmUwYWE5OC53ZWJw,Welcome Home,100,9,2018.0,Mystery and thriller,0 days 01:37:00.000000000,-18
33,20,,Furlough,50,5,2018.0,Comedy,0 days 01:23:00.000000000,-13
69,17,,A Wizard's Tale,1,6,2018.0,Comedy/Kids and family,0 days 01:37:00.000000000,-52
64,82,https://resizing.flixster.com/ZI5PFKXjK9HsvS1CoGbbgY31Ots=/206x305/v2/https://resizing.flixster.com/T21ADT8y1YsjN31AX-x2taLnzhY=/ems.ZW1zLXByZC1hc3NldHMvbW92aWVzLzE2Mzk3YTZlLTczYzAtNDI2ZC1hNDhmLTQ3ZDU0ODY0ZjVhNC53ZWJw,Scary Stories,50,11,2018.0,Documentary,0 days 01:22:00.000000000,18
40,70,https://resizing.flixster.com/-qJP4ClMXhYuD1krJeCmTXmMLqc=/206x305/v2/https://resizing.flixster.com/gS35335mnyp2i2U-YXDwfX-Az3M=/ems.ZW1zLXByZC1hc3NldHMvbW92aWVzLzUzNzZmY2I5LTMxODgtNGM1OC1hNDlmLTRiOTRiMmM3ZjlhYS53ZWJw,Wildling,500,47,2018.0,Fantasy/Horror,0 days 01:33:00.000000000,30
79,83,,Creed II,5000,305,2018.0,Drama,0 days 02:10:00.000000000,4
30,20,https://resizing.flixster.com/D4InWkO1kfMF0GTGnQ4Qqkqg4u0=/206x305/v2/https://resizing.flixster.com/NVe6kiKKarUpkUHFNRBBuH4CNPY=/ems.ZW1zLXByZC1hc3NldHMvbW92aWVzLzk0ODAxZDc0LWVmMDktNDc2MC1hMTMzLTU1N2E3YTNlMTliZS53ZWJw,Serenity,1000,196,2019.0,Drama/Mystery and thriller,0 days 01:43:00.000000000,-10
67,73,https://resizing.flixster.com/jEwBTIgB4uI8YlPdK-5Etgncgs8=/206x305/v2/https://resizing.flixster.com/1c0uoJleGUs-lMrHAMqlsJRkZK0=/ems.ZW1zLXByZC1hc3NldHMvbW92aWVzL2Q1MGE2MjliLWU1ZGEtNDA4ZS1hNzA3LTYwZTRhODA3ZDhkZC53ZWJw,The Apparition,50,44,2018.0,Drama/Mystery and thriller,0 days 02:24:00.000000000,6
60,83,https://resizing.flixster.com/hrwHHuNeXfTnXCDx96ZIPhsSUfk=/206x305/v2/https://resizing.flixster.com/D-BkjgL0xu3xhFGMl4vuIaN8RL4=/ems.ZW1zLXByZC1hc3NldHMvbW92aWVzL2Y0YTc5NThhLTI5YmMtNGU5Mi1hMDA5LWFlODAzZjlkMDk5YS53ZWJw,That Summer,100,40,2017.0,Documentary,0 days 01:20:00.000000000,23
38,19,https://resizing.flixster.com/1PzC_lNvgqot4rM1wBN2KI1TI4o=/206x305/v2/https://resizing.flixster.com/7sKVrydiIiiQOz6pKvwKHtKdjnA=/ems.ZW1zLXByZC1hc3NldHMvbW92aWVzLzI1NmU2ZjUxLTAwZjUtNDg2My1hODhhLWNlY2QyYzlhNDVmNS53ZWJw,The Aspern Papers,1,26,2018.0,Drama,0 days 01:31:00.000000000,-19
42,71,,The Tribe,1,7,2018.0,Comedy,0 days 01:30:00.000000000,29
71,80,,Errementari: The Blacksmith and the Devil,100,10,2017.0,Fantasy/Horror,0 days 01:38:00.000000000,9
77,78,https://resizing.flixster.com/qkpIkv9EKCFximDN6_cOb9Wzr9U=/206x305/v2/https://resizing.flixster.com/RHe4LyH22bwY9jT0RaR5BYIAnfg=/ems.ZW1zLXByZC1hc3NldHMvbW92aWVzLzU5MTllMzBjLTk1MjAtNDY2NS1hYjBkLWJiZGQxYWFhMmIxNy53ZWJw,Black '47,500,55,2018.0,Drama/Mystery and thriller,0 days 01:40:00.000000000,1
54,8,https://resizing.flixster.com/GyJdQhv5LJ-tXiDdqND0DpZCdu0=/206x305/v2/https://resizing.flixster.com/yJkZJ-zBxzxxBfGJg_93vrXjXBk=/ems.ZW1zLXByZC1hc3NldHMvbW92aWVzL2UzYzg0NjEyLWM1YTYtNDQ3Zi04ZWM4LTdjMWExODJlNTEwNS53ZWJw,I Still See You,250,13,2018.0,Mystery and thriller,0 days 01:36:00.000000000,-46
64,90,https://resizing.flixster.com/g6h118XKZUEI8b3ITkOe_pHrSs8=/206x305/v2/https://resizing.flixster.com/_zP_wvvYCrxz8chdgO_Wu_WsqcM=/ems.ZW1zLXByZC1hc3NldHMvbW92aWVzL2Q4MjRiYjc1LTJiMDctNGVhMy1hYTU5LWIyN2RmMDZlMTIyYi53ZWJw,Never Grow Old,100,21,2019.0,Western/Action,0 days 01:40:00.000000000,26
55,80,,Dovlatov,50,15,2018.0,Drama,0 days 02:06:00.000000000,25
80,96,https://resizing.flixster.com/eKTW36_dPSKC3hWM5-DAeSmxVKE=/206x305/v2/https://resizing.flixster.com/OpjuHVAcH6i9wgYozXajmy1x0pQ=/ems.ZW1zLXByZC1hc3NldHMvbW92aWVzLzU2ZGE4OGRlLTg0MTQtNDc0OC1iOWVlLTE3MGZjOGIxZTg4Ni53ZWJw,Becoming Astrid,100,28,2018.0,Drama/History,0 days 02:03:00.000000000,16
76,38,https://resizing.flixster.com/5uJDm2A2LhbIFXmH997M-sDq6yY=/206x305/v2/https://resizing.flixster.com/ZnK7oil1RMRHXvjV3l2ToupBpus=/ems.ZW1zLXByZC1hc3NldHMvbW92aWVzLzE0MmYzYjRhLTY5YzQtNGFiZi1hZWI3LWQwNjZhY2FmNGE5MS53ZWJw,Unbroken: Path to Redemption,250,26,2018.0,Drama/History,0 days 01:38:00.000000000,-38
75,88,https://resizing.flixster.com/_NjO-QKLy3EbN4o7Ul8RRi5BhUQ=/206x305/v2/https://resizing.flixster.com/9MHZfZsIsWZYs_STgYkMW9BbIzQ=/ems.ZW1zLXByZC1hc3NldHMvbW92aWVzLzFiZTQzOTY3LWIyNWItNGVlNC1hOWJjLTA2ODFmZDk2YjA3ZC53ZWJw,Whitney,500,161,2018.0,Documentary/Music,0 days 02:00:00.000000000,13
77,86,,The Wife,1000,224,2017.0,Drama,0 days 01:40:00.000000000,9
71,59,https://resizing.flixster.com/PRPk_yEyPfN-V9VoZ2Q-_xGhrrY=/206x305/v2/https://resizing.flixster.com/NXeRStX36Mw_39idlzqXsridDP0=/ems.ZW1zLXByZC1hc3NldHMvbW92aWVzLzM0YTgyZjM4LWM3M2ItNGQ4OS04MTNkLWRhZWZlMTVlY2M5YS53ZWJw,A Dog's Way Home,1000,79,2019.0,Kids and family/Adventure,0 days 01:36:00.000000000,-12
54,21,https://resizing.flixster.com/Zf94O16s7AO1lVK0USjWayXXL2o=/206x305/v2/https://flxt.tmsimg.com/NowShowing/187989/187989_aa.jpg,Miss Bala,500,112,2019.0,Action/Mystery and thriller,0 days 01:44:00.000000000,-33
53,88,https://resizing.flixster.com/uAaVaN6BKZ1zh9RTLn639PW0uHc=/206x305/v2/https://resizing.flixster.com/z1yLbMvqszQpmbmSpW-mmiLrfuE=/ems.ZW1zLXByZC1hc3NldHMvbW92aWVzLzNhZDJlYzA1LTJiZTYtNDNhZi1iMjc2LTliMzVlNDZjZTNjOC53ZWJw,Room for Rent,100,8,2017.0,Comedy/Mystery and thriller,0 days 01:29:00.000000000,35
92,67,,Beautifully Broken,100,6,2018.0,Drama,0 days 01:48:00.000000000,-25
79,95,,The Bill Murray Stories: Life Lessons Learned From a Mythical Man,250,21,2018.0,Documentary,0 days 01:10:00.000000000,16
45,67,https://resizing.flixster.com/Wfc_WwbwGgFVzyhnd26J09Lz-5c=/206x305/v2/https://resizing.flixster.com/0Sw6UwVRC1zEFZFxJzb2twN96z0=/ems.ZW1zLXByZC1hc3NldHMvbW92aWVzLzJkZThlZmM0LWMxNGEtNDVjOS05MTFlLWJiOGRmNGY4YTE3Ni53ZWJw,The Seagull,100,126,2018.0,Drama,0 days 01:38:00.000000000,22
55,87,,The Night Eats the World,250,45,2018.0,Horror/Mystery and thriller,0 days 01:33:00.000000000,32
82,100,,The Bleeding Edge,250,19,2018.0,Documentary,0 days 01:39:00.000000000,18
54,73,https://resizing.flixster.com/A4QbGaM8VJCxDKYRxmJYN9wQnj8=/206x305/v2/https://resizing.flixster.com/cHoJnGwPKf5xJR6ORJMgpUx11ow=/ems.ZW1zLXByZC1hc3NldHMvbW92aWVzLzBhZDA1ZDgzLWMyMzctNGY3MC04Y2FkLTVhNzRhNTFlMzE3MC53ZWJw,Galveston,250,52,2018.0,Crime/Drama,0 days 01:31:00.000000000,19
21,70,https://resizing.flixster.com/CDokDMsU7NEayS-cVee7V6JyDOc=/206x305/v2/https://resizing.flixster.com/rZJCLWzlp8K6gtQq4Sgw8-AB-P4=/ems.ZW1zLXByZC1hc3NldHMvbW92aWVzLzQwNjU3MzllLTlmOGItNGUyZi05ZGExLWViOGU1ZmMzMDZmNi53ZWJw,Don't Leave Home,250,20,2018.0,Horror/Mystery and thriller,0 days 01:26:00.000000000,49
72,100,https://resizing.flixster.com/UZIlM53RoE0pJ9-8av5wx-11z0g=/206x305/v2/https://resizing.flixster.com/lfZC_HljDKUhog33huau9q-j7rs=/ems.ZW1zLXByZC1hc3NldHMvbW92aWVzLzE2MjdhMGE2LTM3NmMtNDhjNy1hMzBkLTZiM2NkNDljM2NkYy53ZWJw,Mario,250,13,2018.0,Romance/Gay and lesbian,0 days 01:59:00.000000000,28
63,88,https://resizing.flixster.com/Gd2kp9hcr4m044xX6M05WIGzK5A=/206x305/v2/https://resizing.flixster.com/uqMvZOH-GpunbY8r4st6zMz5hXk=/ems.ZW1zLXByZC1hc3NldHMvbW92aWVzLzVlY2UzYWNhLWZmYWMtNDc0Ni04NTJmLTM4ZDkwMWIzMTRkOS53ZWJw,A Private War,1000,144,2018.0,Drama/War,0 days 01:50:00.000000000,25
35,71,https://resizing.flixster.com/CBsRgD0pl5iiyGyJAF1u5w_-gs8=/206x305/v2/https://resizing.flixster.com/XbYWpwbDO8gGrdHphUHbR1MlhF4=/ems.ZW1zLXByZC1hc3NldHMvbW92aWVzLzA1YzA2NDJjLWIxMDktNDVlOS04OWVjLTk4OWEzYzgxMzRkOS53ZWJw,Final Score,250,34,2018.0,Action/Mystery and thriller,0 days 01:45:00.000000000,36
73,88,https://resizing.flixster.com/3d8yBmaRDZ-fmv4Ul0kvRI4PnKw=/206x305/v2/https://resizing.flixster.com/_r2ELk6Q-Sv1LqeFcs5kp1-8GEc=/ems.ZW1zLXByZC1hc3NldHMvbW92aWVzLzFlODkzOTEzLTQyZWQtNGRlMy04N2Y3LTMwZTFlMGU5MjAxYS53ZWJw,Social Animals,100,17,2018.0,Documentary,0 days 01:26:00.000000000,15
47,6,https://resizing.flixster.com/QKf_hvsLKfm8XZGuYmVyPVzengg=/206x305/v2/https://resizing.flixster.com/P69thO5pt1xQmz4YW_Umsa5mkWk=/ems.ZW1zLXByZC1hc3NldHMvbW92aWVzLzlmODJlYzg5LTAzMDMtNDlhYi1hY2ZlLTkyZjcyYjcyOTcyZC53ZWJw,The Amityville Murders,100,16,2018.0,Horror/Mystery and thriller,0 days 01:38:00.000000000,-41
81,96,https://resizing.flixster.com/l5mnAa6zltBBgzccpb5MxA7clxs=/206x305/v2/https://resizing.flixster.com/XoVJINAVrK6G3ooSKr_wSXP2gug=/ems.ZW1zLXByZC1hc3NldHMvbW92aWVzL2I3NjU1ZDM0LTM4MDgtNGE0Ni05OGI4LTUyYzAyZjcxZGQ2Yy53ZWJw,1985,250,49,2018.0,Gay and lesbian/Drama,0 days 01:25:00.000000000,15
70,88,https://resizing.flixster.com/0lQ6xKMUoGlmUcuMklOcRfQnbJ4=/206x305/v2/https://resizing.flixster.com/I_XFKhKBBpmprnOCw4xZnjDiGWE=/ems.ZW1zLXByZC1hc3NldHMvbW92aWVzL2ZiYjkxNGJhLTBjMzUtNDEzYi1iYzUzLTM4MTIxMWFiNjI2Yy53ZWJw,Prospect,1000,50,2018.0,Mystery and thriller/Sci fi,0 days 01:38:00.000000000,18
48,54,https://resizing.flixster.com/IJjY1IBop6a1w2lZUU0-02p8vOI=/206x305/v2/https://resizing.flixster.com/Rqql8JBFUfe5EIAx9pzHEhZKVjo=/ems.ZW1zLXByZC1hc3NldHMvbW92aWVzLzhlYThjODRlLWYyNzMtNDIyNS1hMGVjLTcxY2NiNTRiZGUwNi53ZWJw,At First Light,50,13,2018.0,Sci fi/Mystery and thriller,0 days 01:31:00.000000000,6
72,100,https://resizing.flixster.com/nDDpTONkh_k6Be6GXjegIkiV6GQ=/206x305/v2/https://resizing.flixster.com/cYTCAIplf2zKtfeJARSYkwDfXrk=/ems.ZW1zLXByZC1hc3NldHMvbW92aWVzL2E2MTFkMGYzLTFlOTktNDJmOS1iMGNlLWVmY2RiMWYxMDUyYy53ZWJw,The World Before Your Feet,100,31,2018.0,Documentary,0 days 01:35:00.000000000,28
48,90,https://resizing.flixster.com/EyLxqdehxRQdtpADnwRtvBvcF28=/206x305/v2/https://flxt.tmsimg.com/NowShowing/193984/193984_aa.jpg,A Vigilante,250,40,2018.0,Drama,0 days 01:31:00.000000000,42
39,60,https://resizing.flixster.com/sKkKYF_L1UUnnV23ezASWb9zb6k=/206x305/v2/https://resizing.flixster.com/ev1QBm5_v9ANcETy7i9Ar6Lp4Ys=/ems.ZW1zLXByZC1hc3NldHMvbW92aWVzL2U0OTExNzNlLTUxNjQtNDdhZS04NzJlLTFiZGM3NDRmZDE2YS53ZWJw,Unfriended: Dark Web,1000,119,2018.0,Horror/Mystery and thriller,0 days 01:28:00.000000000,21
43,50,https://resizing.flixster.com/h6BijfuM_xiOlY9GaaNgozRg17k=/206x305/v2/https://resizing.flixster.com/wV1gCVEO9y3b3w17jCWMuKjgH9A=/ems.ZW1zLXByZC1hc3NldHMvbW92aWVzLzAxZDBlMDE4LTNkYTAtNGEwMC04Mjg4LTU5YTdjMDczM2UxMy53ZWJw,Blood Fest,100,20,2018.0,Comedy/Horror,0 days 01:30:00.000000000,7
89,83,https://resizing.flixster.com/8sfpMPP_dXwklrXj12Fq4-85Xsg=/206x305/v2/https://resizing.flixster.com/ieqUhJxIuKr9wyMm8jpOVEON08c=/ems.ZW1zLXByZC1hc3NldHMvbW92aWVzLzEzM2Q5ZDlmLTNlZjItNGRkYS05OWMzLTUyZDM2MzZjZDU1NC53ZWJw,Daughters of the Sexual Revolution: The Untold Story of the Dallas Cowboys Cheerleaders,50,6,2018.0,Documentary,0 days 01:18:00.000000000,-6
83,94,,A Band Called Impaled Rektum,250,31,2018.0,Comedy/Music,0 days 01:32:00.000000000,11
75,97,https://resizing.flixster.com/EVEtctNwTaKUCJ-Bcj67q1oAD-s=/206x305/v2/https://resizing.flixster.com/3BWmZBOUNWw6YwAinPH1U6ksuN4=/ems.ZW1zLXByZC1hc3NldHMvbW92aWVzLzQzZGM0MDJhLTg3ZWEtNGU1Zi04ZmI3LWRiNTMzZjc1ZGY0NC53ZWJw,People's Republic of Desire,100,33,2018.0,Documentary,0 days 01:35:00.000000000,22
73,94,https://resizing.flixster.com/N_crkK_Ewl3OyioUQK_DqdpawwY=/206x305/v2/https://flxt.tmsimg.com/assets/p15378795_p_v13_aa.jpg,Number 37,100,16,2018.0,Mystery and thriller,0 days 01:40:00.000000000,21
79,91,https://resizing.flixster.com/v0Yui4sDUwR2QbBEW_t-HPa1pRQ=/206x305/v2/https://resizing.flixster.com/U34nyeP2-gCQnV_9Km6Kr4GXdUA=/ems.ZW1zLXByZC1hc3NldHMvbW92aWVzLzQ5MzI1NDU3LTExMDgtNGI2NS04MzMyLTk0ZjZiOGYzMzhkMi53ZWJw,All Square,100,11,2018.0,Comedy,0 days 01:33:00.000000000,12
81,91,https://resizing.flixster.com/pcBFpztzZwGACiUCzY-G2CipIOM=/206x305/v2/https://resizing.flixster.com/5UVj6HsQt9CO-GA3xfuxowW9w30=/ems.ZW1zLXByZC1hc3NldHMvbW92aWVzLzcwOTk1MWZiLWMyMDktNGMzYi1hMjM5LTAxYTQyNzUxMTMyNy53ZWJw,Jinn,100,22,2018.0,Drama,0 days 01:31:00.000000000,10
76,81,,Unlovable,100,16,2018.0,Comedy/Drama,0 days 01:20:00.000000000,5
81,100,https://resizing.flixster.com/9lvUsYr6S1h_yQsxHNFXYfVPraY=/206x305/v2/https://resizing.flixster.com/YWlv7koRX68N6NWGXslE4PIaG3g=/ems.ZW1zLXByZC1hc3NldHMvbW92aWVzL2Q0YzY2YzY0LThhYTUtNGMyMi05NDdlLTE3ZWE4MjU2YTRkYS53ZWJw,A Tuba to Cuba,100,11,2018.0,Documentary/Music,0 days 01:24:00.000000000,19
66,91,https://resizing.flixster.com/i1Elv-WVwG2D9DWMn5dtzYyRUIA=/206x305/v2/https://resizing.flixster.com/_1s0ByYkcIaS8rD7vualXq04UWM=/ems.ZW1zLXByZC1hc3NldHMvbW92aWVzLzUwNDQ3ZmZiLTI4YzctNDgzMy04YzMwLTQ5OThiMzZmNTY0YS53ZWJw,The Unicorn,100,11,2018.0,Comedy,0 days 01:28:00.000000000,25
71,91,,Gonjiam: Haunted Asylum,250,11,2018.0,Horror/Mystery and thriller,0 days 01:33:00.000000000,20
92,96,https://resizing.flixster.com/JxXTylJ9RuWb60i5A8nb6b3Eeeo=/206x305/v2/https://resizing.flixster.com/T5FZJrWwTFN_PHCixQre5ADjjfM=/ems.ZW1zLXByZC1hc3NldHMvbW92aWVzL2I2MmUwN2FkLWZhNDUtNGE4Mi04NWVhLWU4YTU3M2VlZTFlMi53ZWJw,Thunder Road,1000,83,2018.0,Comedy/Drama,0 days 01:32:00.000000000,4
40,61,https://resizing.flixster.com/8cnbTxhLzFk90F7RKm5QjwIyTYo=/206x305/v2/https://resizing.flixster.com/LNFb5tTmgLZMEDdPycbqL9GBmtY=/ems.ZW1zLXByZC1hc3NldHMvbW92aWVzLzA0OTY1ZGQwLTEyMWYtNGNiMi1iZDYyLTMyOTRlYmVmNDEzNC53ZWJw,The New Romantic,100,31,2018.0,Romance,0 days 01:22:00.000000000,21
42,46,https://resizing.flixster.com/g5VxNt4G-LuMgcoMSNpZmjciWys=/206x305/v2/https://resizing.flixster.com/tAHEs5duxHNTf_Em0D8hqfz58yY=/ems.ZW1zLXByZC1hc3NldHMvbW92aWVzLzJmMGJlZmU3LWQ3OWUtNGRmOC04OTRmLWQ2ODY1ZjFlMzMxMy53ZWJw,The Laws of Thermodynamics,1,13,2017.0,Romance/Comedy,0 days 01:40:00.000000000,4
40,0,https://resizing.flixster.com/nAoR1XjirDNWLFWCwZ7AeiyeM0U=/206x305/v2/https://resizing.flixster.com/aLIbAvXYtT31HpJNhRLriubK1yc=/ems.ZW1zLXByZC1hc3NldHMvbW92aWVzLzAzN2M4ZTJjLTE2NGUtNDQyOC04ODBmLTIwMDFhYWFkZGNmYy53ZWJw,The Con Is On,100,6,2018.0,Comedy,0 days 01:30:00.000000000,-40
51,87,https://resizing.flixster.com/tUfr1vttQTotTapOP3qRgZStBik=/206x305/v2/https://resizing.flixster.com/yoDp4r42_MCRM5txBYM9FBG52DU=/ems.ZW1zLXByZC1hc3NldHMvbW92aWVzLzYwNDg2YzI0LThmZDUtNGY2MC05Y2Y3LWE1OTJlZTA3Mjk1My53ZWJw,The Breaker Upperers,250,47,2018.0,Comedy,0 days 01:30:00.000000000,36
86,100,,Chi-Town,50,6,2018.0,Documentary,0 days 01:22:00.000000000,14
43,83,https://resizing.flixster.com/N6FiFEqlUdOqgPFGv3b2kznte8A=/206x305/v2/https://resizing.flixster.com/Gem1Tif7nwIHrZRFbyc8Fmp_w0c=/ems.ZW1zLXByZC1hc3NldHMvbW92aWVzL2I1MTZmNDBlLTZkYjQtNDhhYy05NzhiLWJmZTRiZGIxZjdjNC53ZWJw,What Keeps You Alive,500,52,2018.0,Gay and lesbian/Horror,0 days 01:39:00.000000000,40
25,83,https://resizing.flixster.com/V5fdizqqUDk0pdsk5RaBhw9y0NQ=/206x305/v2/https://resizing.flixster.com/npFozoIJbv2_l9Kd9Lh1nwkaZ4k=/ems.ZW1zLXByZC1hc3NldHMvbW92aWVzLzYxMDkxZDdiLWZmOTEtNDFmOS04MjlhLTRjNjIzYzJmNWM3OS53ZWJw,Luciferina,50,6,2018.0,Horror/Mystery and thriller,0 days 01:51:00.000000000,58
55,56,,Ghostland,500,27,2018.0,Horror,0 days 01:31:00.000000000,1
41,94,,Time for Ilhan,50,18,2018.0,Documentary,0 days 01:28:00.000000000,53
71,17,https://resizing.flixster.com/x7OsfXNWhewSrYb_evKE5rxN6AA=/206x305/v2/https://resizing.flixster.com/nwZ0C1sBGWbWTtqEsD8vNbfLEHc=/ems.ZW1zLXByZC1hc3NldHMvbW92aWVzL2EzNzA1ZDhmLTE2ZDYtNDVhMy1iOTQxLWZiNzI5YTI0Y2Q3OC53ZWJw,Blood Brother,50,6,2018.0,Crime/Action,0 days 01:25:00.000000000,-54
33,11,,Replicas,1000,56,2018.0,Sci fi/Mystery and thriller,0 days 01:47:00.000000000,-22
25,29,,The Silence,250,35,2019.0,Sci fi/Horror,0 days 01:30:00.000000000,4
83,13,https://resizing.flixster.com/aFDboHvg7qk-F_gD4AQ4sWTe67Y=/206x305/v2/https://resizing.flixster.com/C6nsgo3bqNFRK_4ojoTcXM3iuyw=/ems.ZW1zLXByZC1hc3NldHMvbW92aWVzLzI3ZWUyZjBlLTAxZGYtNDFkYi1iZWZmLTlkNDljMTMyNThiMC53ZWJw,Life Itself,1000,153,2018.0,Romance/Comedy,0 days 01:58:00.000000000,-70
75,80,,Catwalk: Tales From The Cat Show Circuit,1,5,2018.0,,,5
71,12,https://resizing.flixster.com/Upr_CgaG0ll5LIWY5GHL4CLV-gk=/206x305/v2/https://resizing.flixster.com/_53B6rvGSpBvGUma2Jz71H0Eyzk=/ems.ZW1zLXByZC1hc3NldHMvbW92aWVzL2Q3Mzk1NTZjLTY2OWUtNDA5NS05OGM3LWRjNDBhZTY5NjMxZS53ZWJw,Peppermint,2500,150,2018.0,Action/Mystery and thriller,0 days 01:42:00.000000000,-59
39,52,https://resizing.flixster.com/nV-fve04XOLdFv3uVf--1YFzcDI=/206x305/v2/https://resizing.flixster.com/SI5Y0QHd_9Hx5sCFkJZuVIR25T8=/ems.ZW1zLXByZC1hc3NldHMvbW92aWVzLzE1MzRmYzJlLTYyY2EtNGUyOC05N2I0LWYxNjQ1OWRlNjY4MC53ZWJw,Elizabeth Harvest,100,21,2018.0,Sci fi/Mystery and thriller,0 days 01:48:00.000000000,13
76,83,https://resizing.flixster.com/Kw10tE-inz08t2tLPJP_ih2EdMk=/206x305/v2/https://resizing.flixster.com/NRC1OjoMxs1V93sdZT584c6524U=/ems.ZW1zLXByZC1hc3NldHMvbW92aWVzLzdkMzc5ZGE5LTJmYWYtNDZjMC04NTYwLTBjMWZiZGQwYjUzZS53ZWJw,After Everything,100,18,2018.0,Romance,0 days 01:35:00.000000000,7
98,55,https://resizing.flixster.com/WAazAout_9wSK2mVEcjmtiDQKoY=/206x305/v2/https://resizing.flixster.com/UoJsY--O2XvoSTdiVv903Hm8XCY=/ems.ZW1zLXByZC1hc3NldHMvbW92aWVzL2UzZjE4ZDI3LTdiNmItNDQyMy1iY2NjLWZiZWQzZWI0MjM4Ni53ZWJw,Back Roads,1000,29,2018.0,Drama/Mystery and thriller,0 days 01:41:00.000000000,-43
38,55,https://resizing.flixster.com/MlYSeSDQTjsVVS4-QYKAofc6d6Y=/206x305/v2/https://resizing.flixster.com/JUsG-GoVHv-jnXqtzPODglyu2MY=/ems.ZW1zLXByZC1hc3NldHMvbW92aWVzLzQ5N2FkMzE1LTRkMzMtNDk5OS04NGY1LTE2NzM1ZDg1YjBkYy53ZWJw,Maine,1,11,2018.0,Drama,0 days 01:26:00.000000000,17
59,27,https://resizing.flixster.com/DfAgh9J_Rrh1TNwuUJLWu_Yrj1g=/206x305/v2/https://resizing.flixster.com/LYDaEJZmTK7gpOw6XR8etkpmFFE=/ems.ZW1zLXByZC1hc3NldHMvbW92aWVzLzEyYzBhNThlLTlmMmMtNDYyNC1iMjY1LTE0NTVhMWEzY2ZiMy53ZWJw,A-X-L,500,22,2018.0,Sci fi/Adventure,0 days 01:40:00.000000000,-32
20,48,https://resizing.flixster.com/tD_9QDnk5hGTWBpV6rV4C02JV7Q=/206x305/v2/https://resizing.flixster.com/cBkdhHdDRxwc_c_mCMTSQJUwsQA=/ems.ZW1zLXByZC1hc3NldHMvbW92aWVzL2I0OGZlYWNmLWNkMWYtNGNmNi05NmY3LWViMDhlMDZiYTZkNy53ZWJw,Down a Dark Hall,250,27,2018.0,Horror/Mystery and thriller,0 days 01:36:00.000000000,28
77,60,,American Circumcision,100,5,2017.0,Documentary,0 days 01:41:00.000000000,-17
81,86,https://resizing.flixster.com/9XWDQq2C03-s-ePsj85uiNFkuu0=/206x305/v2/https://resizing.flixster.com/5iA2vgG2jvyy3o4khay9Bbq5yTQ=/ems.ZW1zLXByZC1hc3NldHMvbW92aWVzLzI2NzQwZjBmLTQ3ZjEtNDkxNC1iOTFjLWNkZTM1NDVhOTk0Yi53ZWJw,The 12th Man,500,21,2017.0,Drama/Adventure,0 days 02:11:00.000000000,5
86,92,,In Search of Greatness,100,26,2018.0,Documentary,0 days 01:20:00.000000000,6
79,99,https://resizing.flixster.com/WESFR4dH16DxCMNS-scmXntAdHg=/206x305/v2/https://resizing.flixster.com/KC2fKFQkDLvj4BIjhifjU_NzVko=/ems.ZW1zLXByZC1hc3NldHMvbW92aWVzLzI3NmY4MGViLWM5NDYtNDdhZC1hNTAwLWM4MmNiZTM1MTZjOS53ZWJw,McQueen,500,124,2018.0,Documentary,0 days 01:51:00.000000000,20
43,45,https://resizing.flixster.com/M9M9m1NIA5PWjmIq4IuyITktDzA=/206x305/v2/https://resizing.flixster.com/IPaj9ptWvXLRKqgiBH9eFfG-MSk=/ems.ZW1zLXByZC1hc3NldHMvbW92aWVzL2JlZWEzMDcyLWQyNWItNDliYi05ZGFiLTkwODk0ZjVlOGUwNC53ZWJw,Just a Breath Away (Dans la brume),50,11,2018.0,,,2
83,96,https://resizing.flixster.com/ETM6C4jI8Ur1zsycEB1x083q0qA=/206x305/v2/https://resizing.flixster.com/5jn3ug6gN1r47FDnR1pLT1SsbkE=/ems.ZW1zLXByZC1hc3NldHMvbW92aWVzLzNiNDllODgwLTdiZGMtNDc5MS1iMDMyLTBjNDRjYTViNDQ4MC53ZWJw,BlacKkKlansman,10000,443,2018.0,Crime/Comedy,0 days 02:14:00.000000000,13
48,52,,An Evening With Beverly Luff Linn,100,50,2018.0,Comedy,0 days 01:48:00.000000000,4
45,43,https://resizing.flixster.com/afpFWdA1ve_zK2kx-Pjck44dvKQ=/206x305/v2/https://resizing.flixster.com/7k2HytX6BQ4HyOQ67nGwJPK4d9M=/ems.ZW1zLXByZC1hc3NldHMvbW92aWVzL2E1NWU2ZjdhLTQ4ZGYtNDU1Ny1hNzhiLWZiYjkxZDQ1MTE4My53ZWJw,Arizona,250,37,2018.0,Comedy,0 days 01:25:00.000000000,-2
54,32,https://resizing.flixster.com/UdctbzmqwDTeZYjlDH7BVhudAas=/206x305/v2/https://resizing.flixster.com/VmwvQfSw5usHP1z-585qtlCZnc8=/ems.ZW1zLXByZC1hc3NldHMvbW92aWVzLzdmNmFhNGU1LWZlODItNDE4MC05Zjc2LTJmMjU3Yzc4MzgzNC53ZWJw,Zoe,100,25,2018.0,Romance/Sci fi,0 days 01:44:00.000000000,-22
83,100,https://resizing.flixster.com/rMYJ-BYjaHthqpSDJj5e5TDvmbg=/206x305/v2/https://resizing.flixster.com/hcuya8l0qqcniOlyK5qceal49co=/ems.ZW1zLXByZC1hc3NldHMvbW92aWVzL2FkYWEwNWE1LWRjYmQtNDMzYy1hMDIyLWYzYmU3MThkY2FlYi53ZWJw,Venus,1,7,2017.0,Comedy/Drama,0 days 01:35:00.000000000,17
49,37,,Johnny English Strikes Again,1000,109,2018.0,Adventure/Comedy,0 days 01:28:00.000000000,-12
86,74,https://resizing.flixster.com/_R3QUpoj39BbKCAnCifzAw_G9wY=/206x305/v2/https://resizing.flixster.com/sL2ZmhsG2z_GclzZymYpVNX5k1M=/ems.ZW1zLXByZC1hc3NldHMvbW92aWVzLzc1MTM0ZmZmLWI5OTktNDljMS1hOWMzLTQ3OWExYTk4MWQ4NC53ZWJw,Indivisible,250,19,2018.0,Drama/War,0 days 01:59:00.000000000,-12
60,78,https://resizing.flixster.com/MTBddx5TddfCe_2DQCnsgEfw2yY=/206x305/v2/https://resizing.flixster.com/hYMr_wHQhpRPh14TeGl7TyE1oFA=/ems.ZW1zLXByZC1hc3NldHMvbW92aWVzLzkxNDRkM2RlLWQ5MDMtNDU4Yy04M2U0LTQ3NDA3NzA3YjZkNS53ZWJw,Everybody Knows,500,177,2018.0,Crime/Drama,0 days 02:13:00.000000000,18
35,58,,Hotel Artemis,1000,179,2018.0,Action/Mystery and thriller,0 days 01:33:00.000000000,23
18,8,,Reprisal,100,13,2018.0,Action/Mystery and thriller,0 days 01:29:00.000000000,-10
82,88,https://resizing.flixster.com/Eq0VmMI674YHgpFXxRzThakJGp4=/206x305/v2/https://resizing.flixster.com/tyiku1LwGAMpj8itAxhS1wtyMrI=/ems.ZW1zLXByZC1hc3NldHMvbW92aWVzL2M1ODRkZGU0LTZiZGItNGYzYS1hZGExLTFjZTEwYWEzNWFiNi53ZWJw,"Love, Gilda",250,89,2018.0,Documentary,0 days 01:26:00.000000000,6
100,100,https://resizing.flixster.com/MvRxkh-AlpHtVVQjxBYaj1JswzY=/206x305/v2/https://resizing.flixster.com/4eOhoR3emHdohdo2DNwKQZLX5oU=/ems.ZW1zLXByZC1hc3NldHMvbW92aWVzLzU2N2ZlODE2LWZiZDQtNGU4ZC04ZTBhLWYyYjViZmE5NWZkZC53ZWJw,Charm City,1,16,2018.0,Documentary,0 days 01:48:00.000000000,0
12,23,https://resizing.flixster.com/BVIs9ezNg8wgE3Jdk7UuhFpaskA=/206x305/v2/https://resizing.flixster.com/EIOep5Ez7lzktmlo-BZ2-035xL0=/ems.ZW1zLXByZC1hc3NldHMvbW92aWVzLzM5ZmY4OTBkLTEzYTktNDcwNC05NjlkLWEyZjcxN2NjNDY3Ni53ZWJw,Here and Now (Blue Night),50,22,2018.0,,,11
50,91,https://resizing.flixster.com/BRLIa0MdTn6ybtZcCYNfx5hl7to=/206x305/v2/https://resizing.flixster.com/DfWN7ROTTtUXasKAaqYi_8Lco14=/ems.ZW1zLXByZC1hc3NldHMvbW92aWVzLzdjYTZkNjJmLTAwN2YtNDNmZi1hYjlhLWQ2OWEzOTY4MGU5OS53ZWJw,Ghostbox Cowboy,50,11,2018.0,Comedy/Drama,0 days 01:30:00.000000000,41
26,33,https://resizing.flixster.com/__xutw1SfDYRBaeUJronPQP-aas=/206x305/v2/https://resizing.flixster.com/qidV_lAqU9VfE9mKqcJ4p3RByBA=/ems.ZW1zLXByZC1hc3NldHMvbW92aWVzL2IwNTQyMmI2LWNjZjgtNDE0Yi05MDFhLTg3Nzg0OGY4YmEzMi53ZWJw,King of Thieves,250,84,2018.0,Comedy/Drama,0 days 01:48:00.000000000,7
46,88,,Diane,100,8,2017.0,Horror,0 days 01:22:00.000000000,42
16,37,https://resizing.flixster.com/N0UA0QQl6dU4tqK4nqY75_hgUBw=/206x305/v2/https://resizing.flixster.com/KUQK-UlXEDJxZk6-L09IuZ9uNpw=/ems.ZW1zLXByZC1hc3NldHMvbW92aWVzLzI1Y2M4M2NjLWUwZjktNDg2NC1hNGFkLTFlYTc3NWRlOTdjYy53ZWJw,State Like Sleep,100,30,2018.0,Drama/Mystery and thriller,0 days 01:44:00.000000000,21
60,88,https://resizing.flixster.com/UrpxmqJOY97K8_7gwkwp-HV89nk=/206x305/v2/https://resizing.flixster.com/ts4ulEfjoS2KaGQubiPP1R9RsvA=/ems.ZW1zLXByZC1hc3NldHMvbW92aWVzLzE1NmVjNDVlLTc0Y2YtNDg5Yi1hZTk0LTViYmJkOTQyY2MxYS53ZWJw,Braid,250,24,2018.0,Horror/Mystery and thriller,0 days 01:22:00.000000000,28
57,61,,Jonathan,100,28,2018.0,Sci fi/Drama,0 days 01:41:00.000000000,4
49,70,https://resizing.flixster.com/yylVaJxB8lq42FziYKRPW_5nZu8=/206x305/v2/https://resizing.flixster.com/NIfRI8fPkIw7LqZ3OU0cTLAICw8=/ems.ZW1zLXByZC1hc3NldHMvbW92aWVzL2QwY2U5YTBiLTNmMzctNGM5ZC04ZGMyLWE1NjEyNDM5NjZhNS53ZWJw,Puppet Master: The Littlest Reich,100,46,2018.0,Horror,0 days 01:30:00.000000000,21
42,60,https://resizing.flixster.com/i9q8i0c0mSSdhgY-zbTgMkXKug0=/206x305/v2/https://resizing.flixster.com/xB5P0VrnPkEBYgn4SKJGiFPCYUg=/ems.ZW1zLXByZC1hc3NldHMvbW92aWVzL2E4NGUxNjhiLTYxZWQtNDgyNC1hMjMzLWUwN2ZiZDE1YTk5Ny53ZWJw,In a Relationship,100,15,2018.0,Romance,0 days 01:32:00.000000000,18
39,100,,Egg,100,11,2018.0,Comedy,0 days 01:23:00.000000000,61
66,60,,An Interview With God,100,5,2018.0,Drama,0 days 01:37:00.000000000,-6
64,83,https://resizing.flixster.com/Uu6ZoFwsQJMy_nfKgndL8CEoBMo=/206x305/v2/https://resizing.flixster.com/c83JSqyb7dfRqNjjQTfg14SUZ7g=/ems.ZW1zLXByZC1hc3NldHMvbW92aWVzLzgyY2M1MjIyLTdhN2EtNDU4My04NjQ5LWFkN2NmNWQyOGM1Yi53ZWJw,All These Small Moments,50,18,2018.0,Drama,0 days 01:25:00.000000000,19
77,98,,Nothing Like a Dame,500,88,2018.0,Documentary,0 days 01:23:00.000000000,21
100,91,https://resizing.flixster.com/OY12WSfZtBtOup2G3Cn8K_lMuYE=/206x305/v2/https://resizing.flixster.com/RDV8vIedycPssBUAIWJHV6uknhQ=/ems.ZW1zLXByZC1hc3NldHMvbW92aWVzLzVhYTVlM2U1LTQyZDEtNDYzMS04MDNhLWQ1ZTBhYmYwMDFlMy53ZWJw,Every Act of Life,1,11,2018.0,Documentary/Biography,0 days 01:32:00.000000000,-9
65,65,,Suspiria,2500,327,2018.0,Horror/Mystery and thriller,0 days 02:32:00.000000000,0
100,100,https://resizing.flixster.com/nS5KBT1sCjmRX9WEN64hmPJtBVg=/206x305/v2/https://flxt.tmsimg.com/assets/p15777483_p_v7_aa.jpg,Momentum Generation,50,6,2018.0,Documentary,0 days 01:43:00.000000000,0
69,93,https://resizing.flixster.com/XK289xMIoE6Bh_neINvRKSMkq1s=/206x305/v2/https://resizing.flixster.com/-c_go1TvPv1zGb0CwUI3RoGeIT0=/ems.ZW1zLXByZC1hc3NldHMvbW92aWVzLzFlMzZkODlmLTc0YzktNGQ5Ni05MjQ4LTBjM2VjYzBkYzc0MS53ZWJw,Diane,50,97,2018.0,Drama,0 days 01:35:00.000000000,24
29,100,,Kim Possible,250,6,2019.0,Comedy/Kids and family,0 days 01:32:00.000000000,71
55,88,https://resizing.flixster.com/S-V_21w5je1qnCQoFIkYlYBV5rM=/206x305/v2/https://resizing.flixster.com/tiTlB6m4Pydf3mlnNSMLmh9-XvA=/ems.ZW1zLXByZC1hc3NldHMvbW92aWVzLzRmZTcxZDNhLWQ5MjEtNDM4Zi1iNjViLTA2NTI3N2YzMGVhMi53ZWJw,The Dark,500,25,2018.0,Horror,0 days 01:35:00.000000000,33
85,81,https://resizing.flixster.com/YFtqHj3v45tuCzOwYvtNxQcrVVk=/206x305/v2/https://resizing.flixster.com/3GOCZulKG-yt3jSgw9gsGKs4V5Q=/ems.ZW1zLXByZC1hc3NldHMvbW92aWVzLzhjNDM4NGUxLWE5YzctNDY3NC1hZTM0LTE5YzI0NTU4MzM2YS53ZWJw,Active Measures,500,16,2018.0,Documentary,0 days 01:52:00.000000000,-4
97,94,,The American Meme,1000,31,2018.0,Documentary,0 days 01:30:00.000000000,-3
81,18,https://resizing.flixster.com/C3BXc_CcM5tDe-YX0J1rzC80swA=/206x305/v2/https://resizing.flixster.com/rZy4mfZS4zGUq3zSL8FG4xwYXdU=/ems.ZW1zLXByZC1hc3NldHMvbW92aWVzLzQwNmI2OTcwLTgwZmUtNDIwNi1iYjM1LWIzMmI5NmJmMzQ2MS53ZWJw,Distorted,500,11,2018.0,Mystery and thriller,0 days 01:27:00.000000000,-63
58,100,,Say Her Name: The Life and Death of Sandra Bland,1,10,2018.0,Documentary,0 days 01:45:00.000000000,42
79,90,,Arctic,1000,150,2018.0,Drama/Adventure,0 days 01:37:00.000000000,11
59,93,https://resizing.flixster.com/VHGL7Yfk-O1bz9OLwoCjp9Yl5bo=/206x305/v2/https://resizing.flixster.com/S2tuVOVa1x4-Myimy6g1kItVlmM=/ems.ZW1zLXByZC1hc3NldHMvbW92aWVzL2MyZWMxMmM0LTdmOTMtNDU3OC05MThiLTk2OTU5YjFkZDhjZi53ZWJw,Us,10000,547,2019.0,Horror/Mystery and thriller,0 days 01:56:00.000000000,34
28,63,https://resizing.flixster.com/WMRjurQPtq4yET-B7mWPXExRNJs=/206x305/v2/https://resizing.flixster.com/G52PP7bQAlqfSMQk3hhbqTIh4qY=/ems.ZW1zLXByZC1hc3NldHMvbW92aWVzLzM0ZmQ2ZDY2LTQ5N2UtNDM2NC1hZDRhLTg0ZmNlMTM3ODdkNC53ZWJw,Our House,100,27,2018.0,Sci fi/Horror,0 days 01:31:00.000000000,35
47,41,https://resizing.flixster.com/4pe7vxlJx4Ru0wjkavsZnytMVr8=/206x305/v2/https://resizing.flixster.com/rKFTB3jhMMorOTpq5D08le-OV3Y=/ems.ZW1zLXByZC1hc3NldHMvbW92aWVzLzU2MTYxNGZkLTNkMTQtNGQ5Yi1iYWY1LTgzOWFjZGE2MjJlOC53ZWJw,Under the Eiffel Tower,50,17,2018.0,Romance,0 days 01:27:00.000000000,-6
76,97,,Border,1000,128,2018.0,Romance/Horror,0 days 01:48:00.000000000,21
81,92,https://resizing.flixster.com/F-53vQi7zlIIrQulPlhG3Q07Nxk=/206x305/v2/https://resizing.flixster.com/u99AOtkgTQAmLIyUuvSt16iJB9Q=/ems.ZW1zLXByZC1hc3NldHMvbW92aWVzLzU0NWY2ZTk0LTc5ZTYtNGQzMi1iMGM0LWE0YjJmNjNjZmZhYy53ZWJw,Cold War,1000,248,2018.0,Romance/Drama,0 days 01:28:00.000000000,11
17,12,https://resizing.flixster.com/DsnzDWyMk_TSlJPXsePcThW3ZAY=/206x305/v2/https://resizing.flixster.com/-YsF4iGyebcrCjyKDOCYTnlEidc=/ems.ZW1zLXByZC1hc3NldHMvbW92aWVzL2I3ZjJhMjdiLTI4NGMtNGFhOC05NTE1LWY5ZTM0MmFhMjQwZi53ZWJw,Siberia,250,49,2018.0,Romance/Mystery and thriller,0 days 01:44:00.000000000,-5
73,85,,Girl,250,61,2018.0,Drama,0 days 01:40:00.000000000,12
93,90,https://resizing.flixster.com/t7ng9Iv49R9CgmTDTcVf37W9pv4=/206x305/v2/https://resizing.flixster.com/5DAJ00461aXLK6bA95Gm56MQ1tE=/ems.ZW1zLXByZC1hc3NldHMvbW92aWVzL2JjMGVlOTAxLTY4NDYtNGQwNS1hMDVlLWM2MTQwMzk1MmU0MS53ZWJw,Capernaum,1000,176,2018.0,Drama,0 days 02:10:00.000000000,-3
28,11,,"Berlin, I Love You",50,18,2019.0,Romance,0 days 02:00:00.000000000,-17
62,95,https://resizing.flixster.com/Ajs2GG_NP-G_1HJKoVM-5jSvTeU=/206x305/v2/https://flxt.tmsimg.com/assets/p15955900_p_v13_aa.jpg,The World Is Yours,100,20,2018.0,Crime/Comedy,,33
91,99,,Shoplifters,1000,226,2018.0,Crime/Drama,0 days 02:01:00.000000000,8
81,91,,Happy as Lazzaro,250,89,2018.0,Sci fi/Fantasy,0 days 02:05:00.000000000,10
82,32,,Between Worlds,500,22,2018.0,Mystery and thriller,0 days 01:30:00.000000000,-50
79,90,,Mirai,500,84,2018.0,Fantasy/Kids and family,0 days 01:38:00.000000000,11
44,73,https://resizing.flixster.com/qXiSkEpm53T4p-7lMN67HaL714k=/206x305/v2/https://resizing.flixster.com/F1a3BfvtDCYcDgCc17iEWcgWLlk=/ems.ZW1zLXByZC1hc3NldHMvbW92aWVzLzA0MGFhZjNhLWE2M2UtNGFhZi1iNjYwLTk2MTI4NGE4YTJlNy53ZWJw,The Devil's Doorway,100,26,2018.0,Horror,0 days 01:17:00.000000000,29
80,95,https://resizing.flixster.com/gFaIAiYlLdHRQCsNqukZ7wQ3zgo=/206x305/v2/https://resizing.flixster.com/zll4-0_srhGVX2pdFye-vEFm1sI=/ems.ZW1zLXByZC1hc3NldHMvbW92aWVzL2FmNjc0MmVhLTA0NTgtNDA3Ni1hYmRkLWQyZmVmMjMyMjk1MS53ZWJw,Burning,1000,194,2018.0,Drama/Mystery and thriller,0 days 02:28:00.000000000,15
59,14,https://resizing.flixster.com/RY-Xi9DDuXRNCCuNjY7UBqa4xAE=/206x305/v2/https://resizing.flixster.com/tazekqaYWhm4mNG8H-tU1STHIVs=/ems.ZW1zLXByZC1hc3NldHMvbW92aWVzLzBhMGNmNWI2LTcxNjUtNGFhNS05MGIyLTNiYTBhOWFjM2ViNS53ZWJw,Damascus Cover,100,22,2017.0,Action/Mystery and thriller,0 days 01:33:00.000000000,-45
100,65,,Calling All Earthlings,1,17,2018.0,Documentary,0 days 01:14:00.000000000,-35
23,22,https://resizing.flixster.com/M2LTyuBnSdvg4keHHdhy0yzUCxI=/206x305/v2/https://resizing.flixster.com/_83CYTguV2GPUDk9w1-sfp3TbtY=/ems.ZW1zLXByZC1hc3NldHMvbW92aWVzL2Q0YmU3MjA1LTdiODQtNDhhMi1hZTQ5LWI3NjJjZDJjYjRlNC53ZWJw,14 Cameras,100,9,2018.0,Horror/Mystery and thriller,0 days 01:30:00.000000000,-1
70,0,https://resizing.flixster.com/itABrjstuRuwo34gC2m9euWZsDw=/206x305/v2/https://resizing.flixster.com/bbf4VHa-TS1GArUhyrC3x9PG9Fc=/ems.ZW1zLXByZC1hc3NldHMvbW92aWVzL2VlNjAyNTMzLTg1MzAtNDE3Yi05ZTM0LWI3MmZlMjIwOTBkZC53ZWJw,Breaking & Exiting,100,6,2018.0,Romance,0 days 01:18:00.000000000,-70
33,47,,A Christmas Prince: The Royal Wedding,100,17,2018.0,Romance,0 days 01:30:00.000000000,14
56,24,,Luis and the Aliens,50,17,2018.0,Comedy/Sci fi,0 days 01:26:00.000000000,-32
79,52,,Five Feet Apart,500,126,2019.0,Romance/Drama,0 days 01:56:00.000000000,-27
80,90,https://resizing.flixster.com/l-FdhverVu-cPJ3y7RTy2BPOT6A=/206x305/v2/https://resizing.flixster.com/dP6uD_CUhrvzKaB-3px-mV8t0Xk=/ems.ZW1zLXByZC1hc3NldHMvbW92aWVzLzA4ZmUyMDQyLTM1YzEtNDJjNC1iMTk2LTdmMjQ5NDUyMTkxNy53ZWJw,Always Be My Maybe,1000,96,2019.0,Romance,0 days 01:42:00.000000000,10
88,50,https://resizing.flixster.com/B-1cTyeNpODb76xxUcgbg_toofU=/206x305/v2/https://resizing.flixster.com/AtrPuZ8GhylDhAA1Rp0eeVbdR7o=/ems.ZW1zLXByZC1hc3NldHMvbW92aWVzL2VhYmYxZmEyLWU5NDEtNDUzMi05MjdiLTA3ZTllMGQ5MzM4OC53ZWJw,Occupation,1000,20,2018.0,Action/Sci fi,0 days 02:00:00.000000000,-38
80,100,,Rock Rubber 45s,1,8,2018.0,Documentary,0 days 01:36:00.000000000,20
48,34,https://resizing.flixster.com/NHk8CI-xN9HmpjdN9dTzq9zSVwQ=/206x305/v2/https://resizing.flixster.com/kIdIcWfa4hTyksRgSPlw-wYDXu4=/ems.ZW1zLXByZC1hc3NldHMvbW92aWVzL2U4NTAzMzRiLWNmNjItNDU5OC1hNDJiLWExY2VhOTE4YjJhYS53ZWJw,Welcome to Marwen,1000,167,2018.0,Fantasy/Comedy,0 days 01:56:00.000000000,-14
35,26,https://resizing.flixster.com/E43j6CdQkkQmUOFG2xz5l2BkdIA=/206x305/v2/https://resizing.flixster.com/igLI163FUeyqgX8odt1J2dhKHlA=/ems.ZW1zLXByZC1hc3NldHMvbW92aWVzLzgxOTBlYTAyLWU1MWQtNDc4ZS1hZTlhLWU3ODI5ZWRlZGRmZC53ZWJw,Nobody's Fool,500,43,2018.0,Romance,0 days 01:50:00.000000000,-9
62,50,https://resizing.flixster.com/4MCjZrlmD4UofN3V9KItUI2j4r0=/206x305/v2/https://resizing.flixster.com/G0OIyolWUQfueqySF_4g-VBoYdE=/ems.ZW1zLXByZC1hc3NldHMvbW92aWVzLzhlZWE1NjUyLTM3OGUtNDk2MC05MWQ4LWI0NzI3ZDBiN2U3ZS53ZWJw,Something,1,6,2018.0,Horror/Drama,0 days 01:26:00.000000000,-12
69,30,https://resizing.flixster.com/JcWNwQUsmU1Yk0ZsR3R1MBeb4EU=/206x305/v2/https://resizing.flixster.com/q4uU0IwP3ELh8P7_kLn7Uf2qBfk=/ems.ZW1zLXByZC1hc3NldHMvbW92aWVzL2NjZDM5MGVmLTQ2MWEtNGE0NS04MDc0LTczODliNWMzMGMzNi53ZWJw,Little Women,100,27,2018.0,Drama,0 days 01:52:00.000000000,-39
46,46,https://resizing.flixster.com/-ogWjCi_mFdKB4c9-utXoGkcuv0=/206x305/v2/https://resizing.flixster.com/Afuz_ORWXOpRTh1qKZ9W6z85nR8=/ems.ZW1zLXByZC1hc3NldHMvbW92aWVzL2M5ODQzYmIwLTdlMTgtNDQ2ZC1hNDcyLTk2ZjcwODA2YzI3MS53ZWJw,Like Father,500,41,2018.0,Comedy/Drama,0 days 01:43:00.000000000,0
60,33,https://resizing.flixster.com/nUFDbT7CJTIeB2JRwKErDyRvJOE=/206x305/v2/https://flxt.tmsimg.com/assets/p15651182_p_v10_aa.jpg,Boarding School,100,9,2018.0,Horror/Mystery and thriller,0 days 01:50:00.000000000,-27
39,59,,The Front Runner,500,228,2018.0,Drama/Biography,0 days 01:53:00.000000000,20
89,100,https://resizing.flixster.com/T9eTY5YXbwrtlVueXp2suUr-Vfo=/206x305/v2/https://resizing.flixster.com/RgjLDWz3Nf2uRey9aCbYaQwK8z4=/ems.ZW1zLXByZC1hc3NldHMvbW92aWVzLzU2ZDU5MmVlLTY1OTEtNDQ4Mi05YmQyLTA1ZDNiMDJlZTQwMS53ZWJw,Antiquities,50,5,2018.0,Comedy,0 days 01:34:00.000000000,11
86,96,https://resizing.flixster.com/3RK-Qbb-5gQmE2jRzyUNLLRrDwE=/206x305/v2/https://resizing.flixster.com/GHI1U1qQoR2zQH7ek2F6zGSSQRQ=/ems.ZW1zLXByZC1hc3NldHMvbW92aWVzL2Y1OGVjZTFkLWUxYjktNGFhZC1iNmI3LWFhZTUzNDE5MTQ0Mi53ZWJw,To All the Boys I've Loved Before,2500,69,2018.0,Romance/Drama,0 days 01:39:00.000000000,10
79,33,,An Actor Prepares,50,9,2018.0,Comedy,0 days 01:37:00.000000000,-46
30,73,https://resizing.flixster.com/KT-DJSiClAXs-y3YqEg0smzf82M=/206x305/v2/https://resizing.flixster.com/KBBV1kYAXnFksLsUw264R2F_gTU=/ems.ZW1zLXByZC1hc3NldHMvbW92aWVzLzI0NDQ4ODUyLTZmYTktNDhiOS05ZGY4LTlhYTVlYzkyNzQ3MC53ZWJw,Lost & Found,1,15,2017.0,Comedy,0 days 01:32:00.000000000,43
17,17,https://resizing.flixster.com/TmIreYp8Gtd0sKxzWUMv8pk7KIs=/206x305/v2/https://resizing.flixster.com/kWL3CTIfNY572Q2zZ9OHS8x1AEU=/ems.ZW1zLXByZC1hc3NldHMvbW92aWVzL2UwOGMzOGY0LWU2OTktNDUyMC05MTRlLWY0M2Q3Y2MzYmM1Yi53ZWJw,How It Ends,1000,18,2018.0,Action/Sci fi,0 days 01:53:00.000000000,0
67,80,https://resizing.flixster.com/dUtkQh0QZQaS03StxLSnORfhLFw=/206x305/v2/https://resizing.flixster.com/1P1_6Yx_cw4Ji9b0SNVZ3Ubj1GY=/ems.ZW1zLXByZC1hc3NldHMvbW92aWVzL2IzZmYxZWIzLTZmZTktNGMzNC1iMDgzLWRhNzhkYTA1OWVjZS53ZWJw,Flavors of Youth,100,5,2018.0,Romance/Drama,0 days 01:14:00.000000000,13
28,81,https://resizing.flixster.com/WY_Vwa2APVdHQA9nxXJJQ9P4wpk=/206x305/v2/https://resizing.flixster.com/p0OXydEPwIZ0gzCJd1B6dCmUVUM=/ems.ZW1zLXByZC1hc3NldHMvbW92aWVzL2RiYTY1YmEzLTFmYzktNGViMi04ODcwLTNhZWZiMTQ3MTgyYS53ZWJw,Await Further Instructions,500,21,2018.0,Horror/Mystery and thriller,0 days 01:31:00.000000000,53
31,88,https://resizing.flixster.com/t7Yd7FGE2YP6JvNvICnJSSCZGLE=/206x305/v2/https://resizing.flixster.com/JZYiAKy6XuBGgxUrG4tYiWbI-3I=/ems.ZW1zLXByZC1hc3NldHMvbW92aWVzLzZiY2NmODRiLTE4YmQtNGVlNS1iYWVhLTNkMDAyNTZhMzBkNy53ZWJw,Hope Springs Eternal,100,8,2018.0,Comedy/Drama,0 days 01:18:00.000000000,57
36,42,https://resizing.flixster.com/2Vw6DXwZmdYnGqloshqDZr2SDrY=/206x305/v2/https://resizing.flixster.com/qlg1-nWS5YSSLdkdmnrePTZSj2A=/ems.ZW1zLXByZC1hc3NldHMvbW92aWVzLzk1YWRmYjhlLTdjYTEtNDMxNi1hNzExLTZiNDU5OWIwN2FhZC53ZWJw,The Prodigy,500,81,2019.0,Horror/Mystery and thriller,0 days 01:32:00.000000000,6
50,0,,Father of the Year,250,11,2018.0,Comedy,0 days 01:30:00.000000000,-50
61,82,https://resizing.flixster.com/2rcI_FIv2UvTnMfihZKA_qTW9LY=/206x305/v2/https://resizing.flixster.com/Zs8NfKmq2k2wgsztdbgSAhx1N0I=/ems.ZW1zLXByZC1hc3NldHMvbW92aWVzL2NhMWYxZTI0LWI3ZDMtNDYxYS1iNmRjLWVlNDQ1NDBkY2Y4Mi53ZWJw,Fahrenheit 11/9,2500,185,2018.0,Documentary,0 days 02:08:00.000000000,21
87,100,https://resizing.flixster.com/T5fAdTTOetWHiyCRToeranvdN3E=/206x305/v2/https://flxt.tmsimg.com/assets/p15736533_p_v10_aa.jpg,Jim Gaffigan: Noble Ape,100,8,2018.0,Comedy,0 days 01:10:00.000000000,13
85,92,https://resizing.flixster.com/V1HgxNfls25bMQMCEVkuJNvqI80=/206x305/v2/https://resizing.flixster.com/xwOm290qT4kQxmz70FoYh0DWpVw=/ems.ZW1zLXByZC1hc3NldHMvbW92aWVzLzY3NzkwNTFkLWQ5ODMtNDQzNi04YjA0LTMzMDUzOWNjOGZjMC53ZWJw,The Death of Superman,250,13,2018.0,Animation/Action,0 days 01:21:00.000000000,7
33,38,https://resizing.flixster.com/K3Xqy2RhoZNEPpAa9JW5fwlinlI=/206x305/v2/https://flxt.tmsimg.com/assets/p13749934_p_v10_ab.jpg,I Am Vengeance,1,8,2018.0,Action,0 days 01:32:00.000000000,5
80,39,https://resizing.flixster.com/rf9bR_hxtnCR_ZgJEbX64SYc4Ms=/206x305/v2/https://resizing.flixster.com/hI2sQbt7EYxB6Ct9-yD63Qt4NNg=/ems.ZW1zLXByZC1hc3NldHMvbW92aWVzLzY5MTU0ZDc4LTMxMTctNGY3Yi1hNjdjLTFhNWRlNjNmZTM0Ni53ZWJw,Blue Iguana,100,28,2018.0,Comedy,0 days 01:48:00.000000000,-41
48,23,,Rim of the World,250,13,2019.0,Action/Adventure,0 days 01:38:00.000000000,-25
26,29,https://resizing.flixster.com/H0hTmApCGtf-vCNg3t7kLpVmj4I=/206x305/v2/https://resizing.flixster.com/fvtCWeHWCPg-8P1le5b8hnL-jsU=/ems.ZW1zLXByZC1hc3NldHMvbW92aWVzLzM4OTQ0M2MzLTUyMjYtNGQxMS04NGVkLWQ3MzViZjc3MzEyNC53ZWJw,The Last Summer,50,7,2019.0,Romance,0 days 01:49:00.000000000,3
48,90,https://resizing.flixster.com/pDr8hVdc0AVaMfZk4S5d7GZsCKc=/206x305/v2/https://resizing.flixster.com/7U5-Lr7Jf9TbjLWfa_H6rEV1EuI=/ems.ZW1zLXByZC1hc3NldHMvbW92aWVzLzQzOWUzNTQwLTFjZjYtNGNhMy1iMGM2LWNiN2U5MDJmM2U2ZC53ZWJw,What Still Remains,250,10,2018.0,Drama/Mystery and thriller,0 days 01:32:00.000000000,42
59,54,https://resizing.flixster.com/5R0TpMYDtz47MnMso6vBNBWG_Bk=/206x305/v2/https://resizing.flixster.com/gLfMRHMWwnjk89Pa0ijcxx5Nht0=/ems.ZW1zLXByZC1hc3NldHMvbW92aWVzL2QzNzc0MTEyLTY5NGUtNDI3Ni1hMDE3LTJjNzkxYzg1OTE5Ni53ZWJw,Swimming With Men,100,46,2018.0,Comedy,0 days 01:37:00.000000000,-5
26,0,https://resizing.flixster.com/CTWjhYFoTGEsVGj1NDQ_NIxc4HM=/206x305/v2/https://resizing.flixster.com/3ADYheLxZjO7eTMQZTlPgr0xAX8=/ems.ZW1zLXByZC1hc3NldHMvbW92aWVzLzhkYTE3Y2YyLWQxN2YtNDQ3Ni1iZjYzLWQ1MzJkMjg2M2QzNy53ZWJw,Solis,100,6,2018.0,Mystery and thriller/Sci fi,0 days 01:33:00.000000000,-26
51,90,https://resizing.flixster.com/18IG7og1RCJtJxjvDR96en_AI28=/206x305/v2/https://resizing.flixster.com/BNJZV79vuPba4qMZRc_j2WSNO6E=/ems.ZW1zLXByZC1hc3NldHMvbW92aWVzL2MyNTVkMmUwLTE4YzAtNGRmMy1iYTcxLTJkNDA4MzRlYmFmNi53ZWJw,Possum,250,41,2018.0,Horror/Drama,0 days 01:25:00.000000000,39
51,74,https://resizing.flixster.com/IpU7VCb2nGlcKGsG3qzPjpImfqA=/206x305/v2/https://resizing.flixster.com/zd8SRWX7LADtsCkL6wx_0q1aETk=/ems.ZW1zLXByZC1hc3NldHMvbW92aWVzLzljYTNmZTA5LWY1ODEtNDg3Mi1iMTdhLTFiYTI2NjQ4ZTZhYi53ZWJw,The Man Who Killed Hitler and Then the Bigfoot,500,94,2018.0,Drama/Adventure,0 days 01:38:00.000000000,23
69,93,https://resizing.flixster.com/4WHgBinxOfnyqmo5X78KDW1HWPA=/206x305/v2/https://resizing.flixster.com/gAtvV5PxTa7BnYmuQyEmayraeDo=/ems.ZW1zLXByZC1hc3NldHMvbW92aWVzLzk4NTJmNjE1LTE4YjEtNDY1OC1iMWViLTg1YTFhYzJjOGM5Yy53ZWJw,The Favourite,5000,413,2018.0,Drama/Comedy,0 days 02:00:00.000000000,24
66,80,https://resizing.flixster.com/F-PAVw2Fkis5QjAYjsTZOgwvGC0=/206x305/v2/https://resizing.flixster.com/kJvSzOELJkml-rbX5CRQLoAbdw4=/ems.ZW1zLXByZC1hc3NldHMvbW92aWVzLzU5MTIxMjM5LTE1YzktNDQ1Yi04NmI0LTA5NjFlODQ2YmI5My53ZWJw,A Crooked Somebody,50,10,2017.0,Mystery and thriller,0 days 01:42:00.000000000,14
71,71,https://resizing.flixster.com/jyWQ_kgu67YT6v9nFMObocgixZM=/206x305/v2/https://resizing.flixster.com/GVlLepNVrFaiHwETaVSn2vULY9Q=/ems.ZW1zLXByZC1hc3NldHMvbW92aWVzLzYyZDhmNTk1LWRkZTMtNGQyYi04ODg4LTg0MTc4YmMyYzNlNy53ZWJw,Long Time Coming: A 1955 Baseball Story,1,7,2018.0,Documentary/Drama,0 days 01:27:00.000000000,0
27,78,https://resizing.flixster.com/mCM8qGoO0y_q0g3KTAvZwaBB7UE=/206x305/v2/https://flxt.tmsimg.com/assets/p15819224_p_v10_ab.jpg,Tales From the Hood 2,100,9,2018.0,Horror,0 days 01:51:00.000000000,51
50,75,/assets/pizza-pie/images/poster_default.c8c896e70c3.gif,Alone (Solo),1,8,2018.0,,,25
49,42,,The Package,250,19,2018.0,Comedy,0 days 01:34:00.000000000,-7
70,38,,Cruise,100,8,2018.0,Romance/Drama,0 days 01:30:00.000000000,-32
52,17,,Look Away,250,12,2018.0,Mystery and thriller,0 days 01:43:00.000000000,-35
43,38,https://resizing.flixster.com/Wnd1Z46dDdshH_J6R15hK6N9TCA=/206x305/v2/https://resizing.flixster.com/arsm0hVAoDmEK9atnzg2_9C-nl0=/ems.ZW1zLXByZC1hc3NldHMvbW92aWVzLzVkNmNiMDcwLTkwOWMtNGQxNS05MmRkLTMxNTIyNDViY2QzMy53ZWJw,Tell Me Your Name,50,8,2018.0,Horror/Mystery and thriller,0 days 01:29:00.000000000,-5
61,79,https://resizing.flixster.com/gYi0x4gpQI2CgJrdwTIILDZBpqc=/206x305/v2/https://resizing.flixster.com/C-eUcmN9n_XuVy3GFi1LOxnRYa0=/ems.ZW1zLXByZC1hc3NldHMvbW92aWVzL2I5N2M0NGE0LTI4ODgtNGEzMS04MmY0LTAwOTI0YTJjMzU1My53ZWJw,Mega Time Squad,100,19,2018.0,Action/Adventure,0 days 01:26:00.000000000,18
80,80,https://resizing.flixster.com/hGl3BxbsNQNWMck-8Rlcg_WENSM=/206x305/v2/https://resizing.flixster.com/SW1GxozlB4VqUy2pyOLC8VR7QmU=/ems.ZW1zLXByZC1hc3NldHMvbW92aWVzL2Q0YzgzNGZiLTIwMmUtNGJhNS04NzMyLWRjNGZmZGFmZWRiOC53ZWJw,Killer Bees,1,5,2017.0,Documentary,0 days 01:25:00.000000000,0
56,13,https://resizing.flixster.com/gVjSSnqyQQNS6ZhRQA8kg8RCs0o=/206x305/v2/https://resizing.flixster.com/0tg-sd1WXWVDT5h7Kt2dMkGMsOw=/ems.ZW1zLXByZC1hc3NldHMvbW92aWVzLzBjNjkxOTE5LTZkOGMtNDg5Mi1hZTY1LWY5MjIwODViYzNjZS53ZWJw,Little Italy,250,23,2018.0,Romance,0 days 01:42:00.000000000,-43
21,43,https://resizing.flixster.com/_GC-SOOVmJTDdvHv2cQFrfy0Q0A=/206x305/v2/https://resizing.flixster.com/VYJQho9LuUtp45cT8lUi84_cRlU=/ems.ZW1zLXByZC1hc3NldHMvbW92aWVzLzFkYmRlZTM0LTE3NjUtNDVhZC04MzI4LTU2MTAyZjZmYzAwMi53ZWJw,White Chamber,1,7,2018.0,Drama,0 days 01:29:00.000000000,22
30,13,https://resizing.flixster.com/X0rXD-FunFVyQSbFJ1S2qFXhqQo=/206x305/v2/https://resizing.flixster.com/_11wlAEH0O9PuCJjyahSF86S8AY=/ems.ZW1zLXByZC1hc3NldHMvbW92aWVzL2FlODk3NWFhLWNjMjYtNDU0MC05MzMwLTJjYzM5NGM3YWI3ZS53ZWJw,Viking Destiny,50,8,2018.0,Action/Adventure,0 days 01:31:00.000000000,-17
94,71,https://resizing.flixster.com/r7TPrvsV5_xmXTKJHb3Iv6oOCRg=/206x305/v2/https://flxt.tmsimg.com/assets/p15587036_p_v10_aa.jpg,Snapshots,100,7,2018.0,Drama,0 days 01:35:00.000000000,-23
39,79,https://resizing.flixster.com/K2vAKI_a3P2eV1L6mmLPoInln_A=/206x305/v2/https://resizing.flixster.com/8F1tFsMYtOAOL2XlpnqdyOqx9HY=/ems.ZW1zLXByZC1hc3NldHMvbW92aWVzL2Q0MTAxMmJlLWJhZTEtNGUxZi04YzFjLTQyZGQ5NjVlM2I5Zi53ZWJw,Buffalo Boys,100,34,2018.0,Western/Action,0 days 01:42:00.000000000,40
53,93,https://resizing.flixster.com/FCH11Esx7I9gHRysQpD2RDxwNso=/206x305/v2/https://resizing.flixster.com/q5Hxo9FW_2XFaj5LRBm7kaEqC4o=/ems.ZW1zLXByZC1hc3NldHMvbW92aWVzLzlhMTczMWQ4LTBkYzYtNGI0NC1iNDc4LWEwYzlkODZiYWM1YS53ZWJw,Cam,1000,99,2018.0,Horror/Mystery and thriller,0 days 01:34:00.000000000,40
44,80,,Rondo,1,10,2019.0,Mystery and thriller,0 days 01:30:00.000000000,36
49,70,https://resizing.flixster.com/cA1zzKy9LurkIzO1h4h05F3R_W4=/206x305/v2/https://flxt.tmsimg.com/assets/p15082066_p_v8_aa.jpg,Paterno,250,40,2018.0,Drama/Biography,0 days 01:45:00.000000000,21
58,87,https://resizing.flixster.com/ZZxLHZAqDeD7PFrOqOWkT3e49hE=/206x305/v2/https://resizing.flixster.com/qcwQV_UuL4g7o4RxeXiBCjLqyBI=/ems.ZW1zLXByZC1hc3NldHMvbW92aWVzLzExMGRhNDlhLTFjMjQtNGZmNS1iODBjLThiYzdiNDhmNjhmZi53ZWJw,Lifechanger,50,23,2018.0,Horror/Mystery and thriller,0 days 01:24:00.000000000,29
87,0,https://resizing.flixster.com/mkktnFQjLjke9AQmWOtbiVH7soQ=/206x305/v2/https://resizing.flixster.com/E9GQn8_97FnYUkZ3oGSgwhkW8ls=/ems.ZW1zLXByZC1hc3NldHMvbW92aWVzLzRiM2IwY2Y0LTJjOGYtNDJjMi04ZWFiLTJhMWE3Mjk2NTQ3OC53ZWJw,The After Party,250,5,2018.0,Comedy/Music,0 days 02:00:00.000000000,-87
66,60,https://resizing.flixster.com/54X4i0woVBvP3LR5m4F2TgBfFqo=/206x305/v2/https://resizing.flixster.com/7-uB4NVyfwYUQzsTfqTuHqpi3CM=/ems.ZW1zLXByZC1hc3NldHMvbW92aWVzLzBiZDJiNzk3LTNkMWEtNDEzNy1iY2NjLThkYTQzMzQyYzY5OS53ZWJw,Iliza: Elder Millennial,1,5,2018.0,,,-6
80,80,https://resizing.flixster.com/s87_IyBngh91Nmp217952NPT7ds=/206x305/v2/https://resizing.flixster.com/KIgkHq_CROKvEZvQvQV-HDVQUVo=/ems.ZW1zLXByZC1hc3NldHMvbW92aWVzLzg3NWJlMWFlLTI3MDctNDFlOC1hMGQ5LTA5ZGI5MTU5ZjliMC53ZWJw,Mid90s,2500,225,2018.0,Comedy/Drama,0 days 01:24:00.000000000,0
54,95,https://resizing.flixster.com/7FzU0RhAKbHnbBNrnI8BJ3A7Zxs=/206x305/v2/https://resizing.flixster.com/880YXc4_NUlIcSoFKFqVDyjMcNQ=/ems.ZW1zLXByZC1hc3NldHMvbW92aWVzLzU3OGFjY2E3LTMyMWEtNDk2ZC05YzkxLTIzYzEwMDJiMWY0My53ZWJw,Tucked,50,19,2018.0,Drama,0 days 01:20:00.000000000,41
76,71,,Bleach,500,7,2018.0,Action/Fantasy,0 days 01:48:00.000000000,-5
90,99,https://resizing.flixster.com/4wB_xZbJgcuzvz7O5LYjRkRweK0=/206x305/v2/https://resizing.flixster.com/8O77zeSA3C8OTP4_4sGk2Vw4LLA=/ems.ZW1zLXByZC1hc3NldHMvbW92aWVzL2JjN2I5ZWQwLTc4NDQtNGIwOS1hYzI2LWUyODkwZTZjYWUxYS53ZWJw,Apollo 11,1000,185,2019.0,Drama/History,0 days 01:33:00.000000000,9
81,39,https://resizing.flixster.com/3tbMNGlNl7HbP4hq3zj1UB8orj8=/206x305/v2/https://resizing.flixster.com/B-0rmu17mmomoeeY_QpNh_hUmek=/ems.ZW1zLXByZC1hc3NldHMvbW92aWVzL2ZlMzgxYjE3LTQ3MjQtNGNkYS1iMTEyLTViMmM3ZDI0YzdlZC53ZWJw,MFKZ,100,18,2017.0,Action/Sci fi,0 days 01:30:00.000000000,-42
40,62,https://resizing.flixster.com/vjJO8YxmaBti94OEV7mLsuF4aYA=/206x305/v2/https://resizing.flixster.com/3hs7YYeYFJljZwyeyQKz2as5MaY=/ems.ZW1zLXByZC1hc3NldHMvbW92aWVzL2Y3NDAyN2Q0LTIzNDYtNGIxNC05M2EwLWNkMzZjNjFmNjlhYi53ZWJw,The Oath,250,92,2018.0,Other/Comedy,0 days 01:33:00.000000000,22
65,78,https://resizing.flixster.com/4y0Z-osXSc6EOc7GvY8EN_xkB0M=/206x305/v2/https://resizing.flixster.com/lPWyg119oESpjnqvHHAkMOuXR0I=/ems.ZW1zLXByZC1hc3NldHMvbW92aWVzLzdiM2IzOTU1LWY1NzUtNDYxMy04M2FkLTRlNzFmMzBhOGJjNy53ZWJw,At Eternity's Gate,1000,186,2018.0,Drama/History,0 days 01:50:00.000000000,13
54,78,,Apostle,1000,69,2018.0,Horror/Mystery and thriller,0 days 02:09:00.000000000,24
38,33,,Better Start Running,1,6,2018.0,Comedy/Adventure,0 days 01:32:00.000000000,-5
68,50,https://resizing.flixster.com/vY0tE2DMFd7WPUAaC7LHEgqP1e8=/206x305/v2/https://resizing.flixster.com/TfMwizb73dII9eJ5tqzbMlSP6ws=/ems.ZW1zLXByZC1hc3NldHMvbW92aWVzL2I1OTc5MGRlLWYzZmUtNGFiNC04OWQ0LTY5NTY5MmI4YzNjNy53ZWJw,Age of Summer,50,6,2018.0,Comedy,0 days 01:29:00.000000000,-18
69,82,https://resizing.flixster.com/sWNIRvT4cXV3BGub6h7UAPqfDD8=/206x305/v2/https://resizing.flixster.com/1KOuCYPoedk82RrggQHMzYtiQQM=/ems.ZW1zLXByZC1hc3NldHMvbW92aWVzLzQ1ZTk2YTg4LTFkZjQtNGQyZC1iN2Y1LTY4ZGE0YjY0NTFkNC53ZWJw,Ben Is Back,1000,218,2018.0,Drama/Mystery and thriller,0 days 01:43:00.000000000,13
36,27,https://resizing.flixster.com/azAIU_BEAcpsFMltCrRCFrgH3aw=/206x305/v2/https://resizing.flixster.com/mull8eW9mdZTYn8aa1ZtVU2mRlk=/ems.ZW1zLXByZC1hc3NldHMvbW92aWVzLzJkYWFkMTlmLTY5OGEtNGFhZC05ZThlLTE1YWQyMmU5MDczZS53ZWJw,The Last Sharknado: It's About Time,100,11,2018.0,Sci fi/Horror,0 days 01:30:00.000000000,-9
45,83,https://resizing.flixster.com/wMEMHpGT23fPJJriGE5Q1zFMB_M=/206x305/v2/https://resizing.flixster.com/mHXYoXBDpMLGv8EKnu8qwJ1On2Q=/ems.ZW1zLXByZC1hc3NldHMvbW92aWVzL2E0MTM4N2Y3LTI2NGEtNDIyOS04ZDAyLTJiY2ZkM2I3MzI5YS53ZWJw,The Land of Steady Habits,250,41,2018.0,Comedy/Drama,0 days 01:38:00.000000000,38
72,95,https://resizing.flixster.com/2juCd8Nxky_ed6eJLrR-zPGyj0M=/206x305/v2/https://resizing.flixster.com/hwVK0NhACArzPALP3jIRqDCW2Pw=/ems.ZW1zLXByZC1hc3NldHMvbW92aWVzL2VjODI2ODU5LTQ4MWYtNGM2Yi04NmY5LWZhNzlhOGY3YTVkYi53ZWJw,Roma,5000,393,2018.0,Drama,0 days 02:15:00.000000000,23
24,28,,Mara,100,18,2018.0,Horror/Mystery and thriller,0 days 01:38:00.000000000,4
68,77,https://resizing.flixster.com/YMvQHmGe4AgSU4qLTkZVvuF5dVQ=/206x305/v2/https://resizing.flixster.com/B9LpecfJN2OzreWV6hvyd3eYPgY=/ems.ZW1zLXByZC1hc3NldHMvbW92aWVzLzQ4MWJlZmQxLTZlZDItNGVhZi1iNzhkLTMxMTI3Mzc1MTBhMi53ZWJw,Pledge,500,31,2018.0,Horror/Mystery and thriller,0 days 01:18:00.000000000,9
36,57,https://resizing.flixster.com/gQ2fhNrYDnwh4eX6TS0Cb6ZZYf4=/206x305/v2/https://resizing.flixster.com/Zae1ZvVG3n_5RS4xSxaxagJYik4=/ems.ZW1zLXByZC1hc3NldHMvbW92aWVzL2JmOGNkMmRjLWNlMmQtNDRhMS05YjRjLWE5NmRlOTBhMGY5ZS53ZWJw,Slice,100,23,2018.0,Comedy/Horror,0 days 01:23:00.000000000,21
0,9,,Maximum Impact,1,11,2018.0,Action/Adventure,0 days 01:50:00.000000000,9
30,56,https://resizing.flixster.com/zxL7Q8gDjzRPtuNvOyN_PPH6JpA=/206x305/v2/https://resizing.flixster.com/mbrLoCM8thwnm3ENQtcSERHJNfY=/ems.ZW1zLXByZC1hc3NldHMvbW92aWVzLzg4YTYzOTM3LWFjNWYtNGNlZS1hY2Y0LTdjMTY3ZjNhOTA1NS53ZWJw,The Beach Bum,500,124,2019.0,Comedy,0 days 01:35:00.000000000,26
73,33,https://resizing.flixster.com/HJy1VahGgf47Uo2mLBA3HNTfrJE=/206x305/v2/https://resizing.flixster.com/oS2GoFGvwXykRhJ0TfFWUwls8hk=/ems.ZW1zLXByZC1hc3NldHMvbW92aWVzLzYzNjg4MGUwLTExNDgtNDY1ZS05MGVmLTkxMjUzYjUwY2YxZC53ZWJw,e-Demon,1,6,2018.0,Horror/Mystery and thriller,0 days 01:26:00.000000000,-40
68,77,,The Clovehitch Killer,500,35,2018.0,Mystery and thriller,0 days 01:50:00.000000000,9
21,39,,Don't Go,1,23,2018.0,Mystery and thriller,0 days 01:32:00.000000000,18
84,82,,Quincy,100,33,2018.0,Documentary/Music,0 days 02:04:00.000000000,-2
61,0,https://resizing.flixster.com/lTVsWdJGC0plQt9jF-qPcj0xBIg=/206x305/v2/https://resizing.flixster.com/b08FrBwiw6-fCbuX8JKmknhrLJM=/ems.ZW1zLXByZC1hc3NldHMvbW92aWVzLzA1ZTIzYzA3LTNlMzEtNGI2Ni1hNTliLTkyMTIyN2Q2YzJmYS53ZWJw,American Dresser,1,7,2018.0,Drama,0 days 01:37:00.000000000,-61
77,55,https://resizing.flixster.com/ofGi9bdmahCVTXHv0rMZtsJEQAU=/206x305/v2/https://resizing.flixster.com/Dl3JulA0bmXQztTi0Phl8JeVCBE=/ems.ZW1zLXByZC1hc3NldHMvbW92aWVzLzZjNjY4ZWRhLTI4MWQtNGJmZC1hZWY4LWMxY2M1NWRiYWQ0OC53ZWJw,Tatterdemalion,50,11,2017.0,Drama/Mystery and thriller,0 days 01:45:00.000000000,-22
64,40,,The Super,250,10,2017.0,Mystery and thriller,0 days 01:30:00.000000000,-24
91,78,https://resizing.flixster.com/MP0Cv1L9co4P83HJx7gzTohOO78=/206x305/v2/https://resizing.flixster.com/-PIfsK327N5FMEJooCg8XJ0TK14=/ems.ZW1zLXByZC1hc3NldHMvbW92aWVzLzM5ZGFmNTRhLThhM2EtNDM3Ny1iOGViLTk1ZDBhNWJiZTg0Ni53ZWJw,Green Book,10000,357,2018.0,Comedy/Drama,0 days 02:10:00.000000000,-13
67,80,,Next Gen,500,5,2018.0,Comedy/Sci fi,0 days 01:44:00.000000000,13
93,92,https://resizing.flixster.com/V6hyQX6B-v1isSdki30ZeI8fC80=/206x305/v2/https://resizing.flixster.com/E3dJuppbZqxn-utI7pwrGubGHg0=/ems.ZW1zLXByZC1hc3NldHMvbW92aWVzLzk4MTllNTU4LTNkMjctNGUxZC1hMTI4LTE2YjM5NzUyYzU3Yi53ZWJw,Crime + Punishment,50,25,2018.0,Documentary,0 days 01:52:00.000000000,-1
61,75,,The Angel,100,12,2018.0,Drama/Mystery and thriller,0 days 01:30:00.000000000,14
33,67,https://resizing.flixster.com/s3ZKLPtmEtQjJTvAqvPBZ3U3Yt8=/206x305/v2/https://resizing.flixster.com/1OHKYY0UB60WijdxRGXrTikV-2o=/ems.ZW1zLXByZC1hc3NldHMvbW92aWVzLzY4ODdiNWQ4LTIzN2UtNGQwOC05MWVkLWRlZjIzNTdhNmEwMy53ZWJw,Alright Now,1,6,2018.0,Comedy/Drama,0 days 01:35:00.000000000,34
49,69,https://resizing.flixster.com/jEmJswJLRPAglpWf4VDhIQYoMDQ=/206x305/v2/https://resizing.flixster.com/L-j0gxuhM5nO2dBsVIW8xsoxAyI=/ems.ZW1zLXByZC1hc3NldHMvbW92aWVzL2QyZTUxZmJmLTE1ZGUtNGVhZi04NjMwLWNmMmE0ZGRmMjE0NS53ZWJw,Cold Pursuit,2500,184,2019.0,Mystery and thriller/Action,0 days 01:58:00.000000000,20
32,70,https://resizing.flixster.com/UZb1nrgFhp-KeI2pgbGHUD46E5M=/206x305/v2/https://resizing.flixster.com/yNWnkIGTuegp8b4KCAylUA8j6yY=/ems.ZW1zLXByZC1hc3NldHMvbW92aWVzLzk1Yjc1ZDE5LWI2NmYtNDgwOC1iMzViLWQyNjRlZWI4ZTAwMC53ZWJw,Hold the Dark,1000,84,2018.0,Adventure/Mystery and thriller,0 days 02:05:00.000000000,38
40,56,https://resizing.flixster.com/nS-F32lc5dQDN-AssUc7nts1bc4=/206x305/v2/https://resizing.flixster.com/Nu7PjibqGOqWWKaSbbveG_PVBZ4=/ems.ZW1zLXByZC1hc3NldHMvbW92aWVzLzFhNjI0NTM0LWMxOWItNGY5MS05NjNiLWM0OWU4MTg2NzQzYS53ZWJw,J.T. LeRoy,50,84,2018.0,Drama,0 days 01:48:00.000000000,16
69,80,https://resizing.flixster.com/j86y9p-Sl5GLMtjnG9W3XxLHNgM=/206x305/v2/https://resizing.flixster.com/Gqe5TLn0fp7vHtmJ7ZrXQfeKFr8=/ems.ZW1zLXByZC1hc3NldHMvbW92aWVzLzVlN2MyYjY1LTdjMTMtNDk1OC04NWIyLWNjYjJlMDMzYWEyNC53ZWJw,22 July,500,128,2018.0,Drama,0 days 02:23:00.000000000,11
77,89,,The Ballad of Buster Scruggs,2500,231,2018.0,Western/Comedy,0 days 02:12:00.000000000,12
37,61,https://resizing.flixster.com/DcikxKNmuEe_IUEzJHkQ-a6i3GM=/206x305/v2/https://resizing.flixster.com/hlDYR6YdvopyDLCHT47VVC-6v14=/ems.ZW1zLXByZC1hc3NldHMvbW92aWVzLzU5ZjM0YWY4LWJmNTQtNGY3Ni05NzdlLTFiZWNlM2RhNzdhYy53ZWJw,Vox Lux,1000,248,2018.0,Drama/Music,0 days 01:50:00.000000000,24
60,65,https://resizing.flixster.com/buhJiT2O6YwjFv0F6JkNTuwg1Ko=/206x305/v2/https://resizing.flixster.com/iYr6BmUatCjPGihiW3hdE4UR9Sc=/ems.ZW1zLXByZC1hc3NldHMvbW92aWVzL2FlZDhlM2E2LWM0YjYtNDg4Yy05Y2FjLTQyMGMwNGM3ZDE2ZC53ZWJw,Vice,5000,365,2018.0,Comedy/Drama,0 days 02:12:00.000000000,5
59,84,https://resizing.flixster.com/buTj8gXujBglvTiJZcq_zp3lvTw=/206x305/v2/https://resizing.flixster.com/igyvAwpVRrbDY5Bb_31FVcL77ZQ=/ems.ZW1zLXByZC1hc3NldHMvbW92aWVzLzU5ZjQ2Y2M1LThjNTEtNDdhOC04OWZkLThjZmIyZDBjZWQwOC53ZWJw,The Other Side of the Wind,250,98,2018.0,Comedy/Drama,0 days 02:02:00.000000000,25
93,97,https://resizing.flixster.com/LZMB0_vKgcyjL-GDdDHAwizOvA4=/206x305/v2/https://resizing.flixster.com/RkDYmSa1ZIYISV4clSMxyrUAcRA=/ems.ZW1zLXByZC1hc3NldHMvbW92aWVzLzg1MjFjMzI2LTA5NmYtNDlhYS05OTQyLTUxMzZmNjJhOGY3Ny5qcGc=,Free Solo,2500,154,2018.0,Documentary,0 days 01:40:00.000000000,4
80,83,https://resizing.flixster.com/kdHaF1B3fYzIxkMrZcTD5UeHtVw=/206x305/v2/https://resizing.flixster.com/MBFz0A6ilcvmNLpCCPljQMvQjaM=/ems.ZW1zLXByZC1hc3NldHMvbW92aWVzL2QyNGMxMjMwLThkZTQtNDlkZC1hMmNiLWJmZTQ2Y2ZlZTBhMS53ZWJw,My Dinner With Hervé,500,23,2018.0,Drama/Biography,0 days 01:46:00.000000000,3
64,67,,Lasso,1,9,2018.0,Horror,0 days 01:37:00.000000000,3
90,100,https://resizing.flixster.com/sev0qboMMUrb0sLmSfqQzEZh3kI=/206x305/v2/https://resizing.flixster.com/jh43lVScN8hjqq7lUMF7l5PbouU=/ems.ZW1zLXByZC1hc3NldHMvbW92aWVzLzRjMWQ5MWFiLWE2ZDUtNGM4NS1iZGFmLWJmM2RjNzQ5NTZmZC53ZWJw,Bathtubs Over Broadway,100,36,2018.0,Documentary,0 days 01:27:00.000000000,10
31,86,https://resizing.flixster.com/J9vw_ELNs9Ydr5AfG0Gv1txXUC0=/206x305/v2/https://flxt.tmsimg.com/assets/p15922289_p_v13_aa.jpg,The Most Assassinated Woman in the World,1,7,2018.0,Mystery and thriller,0 days 01:42:00.000000000,55
43,86,https://resizing.flixster.com/jggppkjTryOPtuXtzkh6xm1s3Uo=/206x305/v2/https://resizing.flixster.com/ZWZJAWkMuZ1_T6GpiDF2NIBQxdY=/ems.ZW1zLXByZC1hc3NldHMvbW92aWVzLzZjMTliMDNmLTNlNmYtNGFjOS1hMmU5LThmNjMxZjkyMzhlNC53ZWJw,The Golem,250,28,2018.0,Horror/Mystery and thriller,0 days 01:35:00.000000000,43
35,64,https://resizing.flixster.com/ecgHr0wKOJwM1o85md2zB4pdy3M=/206x305/v2/https://resizing.flixster.com/bHYeITGIDPNOQVAm-jU7U2jztHs=/ems.ZW1zLXByZC1hc3NldHMvbW92aWVzL2EwNDEzMDk2LWM2YjEtNDBmNS04NDQxLTI2MmMyNWU0N2YxNi53ZWJw,St. Agatha,100,25,2018.0,Horror/Mystery and thriller,0 days 01:30:00.000000000,29
89,94,,The Great Buster: A Celebration,100,47,2018.0,Documentary,0 days 01:42:00.000000000,5
38,100,,Extremity,1,5,2018.0,Horror,0 days 01:38:00.000000000,62
13,0,,Air Strike,100,5,2018.0,History/War,0 days 01:37:00.000000000,-13
81,92,https://resizing.flixster.com/4hXL7IDTfzRpEP1CNbEhnBbJ2Ds=/206x305/v2/https://resizing.flixster.com/9D8CMbZuqoxJHISmhYQg_HH-fbc=/ems.ZW1zLXByZC1hc3NldHMvbW92aWVzLzliOTE4ZmU1LWEzMmQtNGRlNy05NzQzLWNmM2I3OGYyNDMzOC53ZWJw,They'll Love Me When I'm Dead,100,37,2018.0,Documentary,0 days 01:38:00.000000000,11
65,71,,Pokémon the Movie: The Power of Us,100,7,2018.0,Action/Fantasy,0 days 01:53:00.000000000,6
63,88,,Reversing Roe,50,8,2018.0,Documentary,0 days 01:39:00.000000000,25
69,76,https://resizing.flixster.com/zGFaobCE0ja7KXJ4HmiICWspiUY=/206x305/v2/https://resizing.flixster.com/qVry77qByXHYJtPSk0r-ZPZlrKc=/ems.ZW1zLXByZC1hc3NldHMvbW92aWVzLzQ4N2RiZGM5LTVmYTktNDRiMi05MjhiLWI0MTljZDQ0NjA2Yi53ZWJw,Dragged Across Concrete,500,146,2018.0,Crime/Drama,0 days 02:39:00.000000000,7
46,83,,Mission of Honor,50,6,2018.0,History/War,0 days 01:47:00.000000000,37
85,93,https://resizing.flixster.com/UT4ryvxzqnJYN1dEwsmC0356HjI=/206x305/v2/https://resizing.flixster.com/sFaRgJNRBvtqZsPYizR92a0_Lp4=/ems.ZW1zLXByZC1hc3NldHMvbW92aWVzLzdjM2ZlOGJjLWI0MGMtNGI3NS05ZGQ0LTI5MGVmNDhhYzAzNi53ZWJw,Giant Little Ones,250,59,2018.0,Drama,0 days 01:34:00.000000000,8
46,91,,Gloria Bell,500,205,2018.0,Romance,0 days 01:42:00.000000000,45
42,60,,Greta,500,276,2018.0,Drama/Mystery and thriller,0 days 01:38:00.000000000,18
86,76,,Hotel Mumbai,1000,215,2018.0,Mystery and thriller/Drama,0 days 02:05:00.000000000,-10
62,53,https://resizing.flixster.com/jUr-Qu_r2np5QszNl9vCyHOXaEs=/206x305/v2/https://resizing.flixster.com/Kqk_5uzIJSamhpb-AdrCizu6ZP8=/ems.ZW1zLXByZC1hc3NldHMvbW92aWVzL2JlMzU2ZDM5LWFmOGQtNDVmZi1hMTdhLTZhNDllMzM4N2M3Yi53ZWJw,Tell It to the Bees,50,55,2018.0,Romance/Gay and lesbian,0 days 01:46:00.000000000,-9
65,78,,The Standoff at Sparrow Creek,250,50,2018.0,Mystery and thriller,0 days 01:29:00.000000000,13
50,81,https://resizing.flixster.com/10_3ihCarn3oVz1P4FUX3OvycwA=/206x305/v2/https://resizing.flixster.com/1U051huHMBkXkLC8uWicVEqYcjQ=/ems.ZW1zLXByZC1hc3NldHMvbW92aWVzLzM1NGYxNTBmLWFmNjgtNDcyZC1hY2JlLTYzYjQ3MjEyMjU1MS53ZWJw,The Wind,100,70,2018.0,Western/Horror,0 days 01:26:00.000000000,31
36,37,,Out of Blue,1,67,2018.0,Crime/Drama,0 days 01:50:00.000000000,1
74,65,https://resizing.flixster.com/IXInzGgpz1jrVF8nwrVEqVyE71A=/206x305/v2/https://resizing.flixster.com/jPbnlDQX2B22dICQlut4h64ilRI=/ems.ZW1zLXByZC1hc3NldHMvbW92aWVzLzQ1MGY2Mjg3LTNiOWYtNDQ4Yy05MmNiLWRjZTFlMmVhZWQ2OS53ZWJw,Stella's Last Weekend,50,20,2018.0,Romance/Drama,0 days 01:42:00.000000000,-9
57,71,,Killer Kate!,50,7,2018.0,Horror/Mystery and thriller,0 days 01:20:00.000000000,14
59,71,https://resizing.flixster.com/t9GojoIFf3ihw7FGYVyaxD-HxjY=/206x305/v2/https://resizing.flixster.com/orveqfDkNbQgZSqToWWVlrIg5uM=/ems.ZW1zLXByZC1hc3NldHMvbW92aWVzLzU4MmFkMzVkLTA4ZGMtNDM0Ny1iZjRiLWNjM2ZjZGViNzQ5MS53ZWJw,Aniara,100,51,2018.0,Drama/Sci fi,0 days 01:46:00.000000000,12
88,54,https://resizing.flixster.com/rlEMXw3fcGI9W0e_uT8Aov-SAPk=/206x305/v2/https://resizing.flixster.com/WSqzxw7RAzxwpRH4c3zWK1LoWag=/ems.ZW1zLXByZC1hc3NldHMvbW92aWVzLzE0MDNmOGZjLTMxNmQtNDgwOC1iNmNlLTI2ZGRmMWE3NTE1ZS53ZWJw,Clara,50,26,2018.0,Sci fi/Drama,0 days 01:45:00.000000000,-34
79,90,,Divide and Conquer: The Story of Roger Ailes,100,51,2018.0,Documentary,0 days 01:47:00.000000000,11
36,46,https://resizing.flixster.com/qPrNWgRi5lmatoXxb0Uyi5ICHRc=/206x305/v2/https://resizing.flixster.com/Fk7V7C4-DDUd-ap2tlgNY4qg-BI=/ems.ZW1zLXByZC1hc3NldHMvbW92aWVzLzI0NTM0NWZlLTA5OTUtNGRjOS1iYWEzLWVkZGRhOWMzZWU2MC53ZWJw,Asher,50,13,2018.0,Action,0 days 01:44:00.000000000,10
34,39,,Donnybrook,50,46,2018.0,Drama/Mystery and thriller,0 days 01:42:00.000000000,5
100,100,,Invisible Essence: The Little Prince,1,6,2018.0,Documentary,0 days 01:29:00.000000000,0
58,40,,Brampton's Own,1,5,2018.0,Romance/Drama,0 days 01:30:00.000000000,-18
94,94,https://resizing.flixster.com/CST_OXGJcfsx0QaH_hby1QCD_X4=/206x305/v2/https://resizing.flixster.com/buFfSaXb8qMRxjJDq8sSJ2FS5Qc=/ems.ZW1zLXByZC1hc3NldHMvbW92aWVzL2FjZTIxYWRmLTczMDYtNGEwYS1iYmQ0LWQyNThiYzI3MjQ5YS53ZWJw,Screwball,50,32,2018.0,Documentary,0 days 01:45:00.000000000,0
42,75,,Book of Monsters,50,8,2018.0,Comedy/Horror,0 days 01:24:00.000000000,33
72,88,https://resizing.flixster.com/5FqTu-X5SzIkNwaVMqpUuk96e04=/206x305/v2/https://flxt.tmsimg.com/assets/p16493464_p_v13_aa.jpg,Soni,1,16,2018.0,Drama,0 days 01:37:00.000000000,16
48,70,https://resizing.flixster.com/ddRFHNB9YmyMhOSE6p_0am0SDUw=/206x305/v2/https://resizing.flixster.com/n1GSxijLvfSo7mX6e07q-bCjhhg=/ems.ZW1zLXByZC1hc3NldHMvbW92aWVzLzk5MDkzOWI2LWUxZDUtNDBjZi1iODY4LWRjZGQyZGI5YTA4My53ZWJw,Welcome to Mercy,50,10,2018.0,Mystery and thriller,0 days 01:44:00.000000000,22
49,11,,Change in the Air,50,9,2018.0,Drama,0 days 01:34:00.000000000,-38
50,91,https://resizing.flixster.com/dj-2zmhFLMLMMnMooCh_HyIhTl4=/206x305/v2/https://resizing.flixster.com/_RSc19HxBUz6cbgHKYksEi2Pz30=/ems.ZW1zLXByZC1hc3NldHMvbW92aWVzL2RlYTI4NTAyLTdmNDAtNDg0Ny05M2I2LTQxYmM3ODhmZjM2ZC53ZWJw,High Flying Bird,100,134,2019.0,Drama,0 days 01:30:00.000000000,41
75,22,https://resizing.flixster.com/yB3VvDwG2r1-Y08x_xpMGmB6egU=/206x305/v2/https://resizing.flixster.com/4QESH9-wSiSl9i_nKdfPHudujjE=/ems.ZW1zLXByZC1hc3NldHMvbW92aWVzLzZkZjA4MDQ3LWY0OTQtNDY5OC05Njg5LTU0MDVjZTU5ZGNhZi53ZWJw,River Runs Red,250,9,2018.0,Crime/Drama,0 days 01:35:00.000000000,-53
73,86,https://resizing.flixster.com/LLVULO6hNLmXlxpARn5_0vOETxQ=/206x305/v2/https://resizing.flixster.com/qhJ3LHOJwoPqR9MvYU6om7eM9s0=/ems.ZW1zLXByZC1hc3NldHMvbW92aWVzLzIzNjZlYmU3LWUwODYtNGMzYy1hYmUxLWM4ZTQ2NWZhOTdmNi53ZWJw,Dumplin',1000,64,2018.0,Comedy/Drama,0 days 01:50:00.000000000,13
65,74,https://resizing.flixster.com/GHBsFU5k0dB60mrnrPQn6FFYhK0=/206x305/v2/https://resizing.flixster.com/wgsqbFqJ7Cxev1mj9XZabmwRxGk=/ems.ZW1zLXByZC1hc3NldHMvbW92aWVzL2ViZTRlY2NlLTY2ZjQtNDA5My1iZWVlLTUyZTI3OGVmODBjNy53ZWJw,Ghost Light,1,23,2018.0,Comedy,0 days 01:42:00.000000000,9
14,40,https://resizing.flixster.com/E5VW2UHWBRLBSMU3IbshWvLqsRU=/206x305/v2/https://resizing.flixster.com/Els9FJBTYc-Xf0UQFY0kcWuzroc=/ems.ZW1zLXByZC1hc3NldHMvbW92aWVzLzE3NTQwOTUxLTg2ODUtNGMxOS04NGExLTc4MjBkODI1NWM3Mi53ZWJw,Thriller,1,25,2018.0,Horror/Mystery and thriller,0 days 01:26:00.000000000,26
59,22,https://resizing.flixster.com/0bziC66_qZOoyFxnfI_gcBugzCU=/206x305/v2/https://resizing.flixster.com/pjL8PZjkObMkT5E-txXy1NvUQgM=/ems.ZW1zLXByZC1hc3NldHMvbW92aWVzLzQ2MWQzYTExLTNlODgtNDBkZS04NzMzLWNhNDgwZjZjYTAzZC53ZWJw,Big Kill,50,9,2018.0,Western/Action,0 days 02:09:00.000000000,-37
66,89,,Lez Bomb,100,9,2018.0,Other/Gay and lesbian,0 days 01:29:00.000000000,23
48,60,https://resizing.flixster.com/QS5oiax18NuUmbWI0tJFZIfUyl4=/206x305/v2/https://resizing.flixster.com/XAbdX0iG84u6ymtwpXnCfJfXOe8=/ems.ZW1zLXByZC1hc3NldHMvbW92aWVzLzJhZDgxNjM4LTBhNDYtNGE4YS05MGUzLWYyODk5MGRjNmYxOS53ZWJw,You Might Be the Killer,100,20,2018.0,Horror,0 days 02:00:00.000000000,12
46,87,,Starfish,100,62,2018.0,Horror/Drama,0 days 01:39:00.000000000,41
57,72,https://resizing.flixster.com/90iyoFgKjJDSpYF9gfdEA6653aA=/206x305/v2/https://resizing.flixster.com/-p2XQSEoAXdbX5MgY1NcEIb1PAQ=/ems.ZW1zLXByZC1hc3NldHMvbW92aWVzL2U3ZWEwYzNkLWUxODktNGNkOC1iNTZmLTkwZDM0NzAwZDE3Zi53ZWJw,The Perfection,500,95,2018.0,Horror/Mystery and thriller,0 days 01:30:00.000000000,15
56,85,https://resizing.flixster.com/W5Ll1Y-LNqs2qlhTHxxaDX9-ZXY=/206x305/v2/https://resizing.flixster.com/mSjXxpMEY8qYRsvAX_N7zVnJmj8=/ems.ZW1zLXByZC1hc3NldHMvbW92aWVzL2U0NmRkNDRmLTFlOTctNDhjNi04ZWYxLTk3NjBjYzJjYjk3OS53ZWJw,The Quake,250,40,2018.0,Mystery and thriller/Action,0 days 01:48:00.000000000,29
64,83,,Level 16,100,23,2018.0,Sci fi/Mystery and thriller,0 days 01:42:00.000000000,19
58,71,,Happy Death Day 2U,2500,207,2019.0,Comedy/Horror,0 days 01:40:00.000000000,13
67,100,,Softness of Bodies,1,7,2018.0,Comedy,0 days 01:15:00.000000000,33
57,77,,May the Devil Take You,100,13,2018.0,Horror,0 days 01:50:00.000000000,20
46,80,https://resizing.flixster.com/KFR2ZgNjGOAqIOeCfGRJLNj4cEg=/206x305/v2/https://resizing.flixster.com/ROXPMPULGYughqDS82s5LzQ2Q2A=/ems.ZW1zLXByZC1hc3NldHMvbW92aWVzLzFjYzgxMjI5LTM0YWItNDkwYS1iYjJmLWUzOTdkZjlkMjFlMS53ZWJw,The Bouncer,100,5,2018.0,Action/Mystery and thriller,0 days 01:22:00.000000000,34
44,68,https://resizing.flixster.com/BI5CAsmXyArZ_ua2kDGVjTxyJUg=/206x305/v2/https://resizing.flixster.com/yelG1w2V_BsW9cSPqj1x_IAh_oE=/ems.ZW1zLXByZC1hc3NldHMvbW92aWVzL2Y0M2RmYTcyLWU5NTEtNGE0Yi05OTZmLTc4ODA4ZTJhZTYxOC53ZWJw,Head Count,100,19,2018.0,Horror/Mystery and thriller,0 days 01:30:00.000000000,24
13,80,,Intensive Care,1,5,2018.0,Crime/Action,0 days 01:20:00.000000000,67
41,11,https://resizing.flixster.com/_1LOqE3i0-Rc0njXx75nQTWG2iw=/206x305/v2/https://resizing.flixster.com/UsiOvzuu8Uth2EwHtwhCdzz1Gmc=/ems.ZW1zLXByZC1hc3NldHMvbW92aWVzLzRhNTFmMTU0LWFkYmMtNGM2YS1iODg0LTVkMDUxMmE0MDFjMy53ZWJw,Renegades,5000,19,2017.0,Action/Mystery and thriller,0 days 01:46:00.000000000,-30
28,0,https://resizing.flixster.com/NIRTzMzGFHDe4RbW6scx977Abas=/206x305/v2/https://resizing.flixster.com/xUdxzZL3i0plD2w0Mz8PES3ksEw=/ems.ZW1zLXByZC1hc3NldHMvbW92aWVzL2U2NWM1OThiLWQxNmItNGQ4Ny1hMmQxLWI5ZTkwMTI1NjY1ZS53ZWJw,Speed Kills,100,17,2018.0,Crime/Action,0 days 01:42:00.000000000,-28
66,70,https://resizing.flixster.com/6dHZRVUsJDtkFBfzrq_PoUG4QKs=/206x305/v2/https://resizing.flixster.com/adhhoTVrRlknHSP3W2iNDsL5m_M=/ems.ZW1zLXByZC1hc3NldHMvbW92aWVzLzMwMzEwZmZlLTE4ZWMtNDU4ZS05ZmM3LTcwMjI4YjlkNjkyNS53ZWJw,The Mule,2500,189,2018.0,Crime/Drama,0 days 01:56:00.000000000,4
69,92,https://resizing.flixster.com/Ta0cIW9syjt8mQk5iOvT9kdSs_Y=/206x305/v2/https://resizing.flixster.com/AxfAbZZgruXjer1GV5nvxlX-d28=/ems.ZW1zLXByZC1hc3NldHMvbW92aWVzL2I0YzQ1NmQ4LWQzNGMtNDc3OS1iMGU3LTA1YmExOGE2NmZhZi53ZWJw,Been So Long,100,12,2018.0,Musical,,23
17,55,https://resizing.flixster.com/coFYirthRXnhOY-kSBc7fQwYnv8=/206x305/v2/https://resizing.flixster.com/JAg_dLUAregvg_lIPCEIlvjEIsY=/ems.ZW1zLXByZC1hc3NldHMvbW92aWVzLzljYTVmYjhlLTYxYWUtNDBjZC1hZGM1LTQ1NWY4ZGU2NTFiMi53ZWJw,Malevolent,250,11,2018.0,Horror/Mystery and thriller,0 days 01:28:00.000000000,38
55,55,https://resizing.flixster.com/bP30laQzyP6paEmuNwQSj4sSYdU=/206x305/v2/https://resizing.flixster.com/D0Gcya1ZmvrmF25ZfYS4gHYNWHM=/ems.ZW1zLXByZC1hc3NldHMvbW92aWVzL2M2MDIyMjhmLTc0MjQtNDczNi05YjYwLTk4NTkxNzkyOTM3Ny53ZWJw,Once Upon a Deadpool,1000,60,2018.0,Action/Adventure,0 days 01:58:00.000000000,0
58,80,https://resizing.flixster.com/N1V2vJgD8ZiP46YEsClM7ZCXBno=/206x305/v2/https://resizing.flixster.com/xrugQn4XSZDOy_zHbjcp1gBceXg=/ems.ZW1zLXByZC1hc3NldHMvbW92aWVzL2E1MTk2ZTE3LWZkNTEtNDI2OS04ZTRiLWJkMjNhMDQ3NzU0MS53ZWJw,Feminists: What Were They Thinking?,50,5,2018.0,Documentary,0 days 01:27:00.000000000,22
88,71,https://resizing.flixster.com/srHlCEiwjcJ3aTJoeKgR9L9MgUQ=/206x305/v2/https://flxt.tmsimg.com/assets/p15678369_p_v13_aa.jpg,The Go-Getters,1,7,2018.0,Comedy/Adventure,0 days 01:23:00.000000000,-17
84,53,https://resizing.flixster.com/c5kA6ays01VHcJl7KQ5oyXKDvtI=/206x305/v2/https://resizing.flixster.com/163qDz-kt7Y4pD3bpfSxGpkM-o4=/ems.ZW1zLXByZC1hc3NldHMvbW92aWVzL2FmMTFhOGI3LTg3NDMtNDc0Mi1iZDM0LWMyYmZiYjI1ZjhjYy53ZWJw,Ashes in the Snow,250,15,2018.0,History/Drama,0 days 01:39:00.000000000,-31
75,67,,The Christmas Chronicles,1000,58,2018.0,Fantasy/Other,0 days 01:44:00.000000000,-8
25,9,,Backtrace,100,11,2018.0,Mystery and thriller/Action,0 days 01:27:00.000000000,-16
34,80,https://resizing.flixster.com/NnpZUgV-XrHPdryqpJtgUEmRNO0=/206x305/v2/https://resizing.flixster.com/Q-Uo3052XcwNFEw2uJ14_d0q5kc=/ems.ZW1zLXByZC1hc3NldHMvbW92aWVzLzljZWI5ZThlLTY1ZjctNDAyOC05MDNkLTY0MDc3YjU4MDQ0Mi53ZWJw,30 Miles From Nowhere,100,10,1970.0,,,46
91,90,https://resizing.flixster.com/DZoI4Kqe0xcXS87TyE_Xyhcuc1U=/206x305/v2/https://resizing.flixster.com/z7zszgN2dN1W3dk4NExpeCcLNE4=/ems.ZW1zLXByZC1hc3NldHMvbW92aWVzLzBlYzAzOTA4LWI4NjEtNGZkNy1hNmE5LTMwNWZmYTc4NGEzYy53ZWJw,Adam Sandler: 100% Fresh,500,20,2018.0,,,-1
96,56,https://resizing.flixster.com/HGY7ll71Pw8lv1Dezi3pP0CEkLE=/206x305/v2/https://resizing.flixster.com/l72JWSJojOFCSjF7-ImFJXgF3YE=/ems.ZW1zLXByZC1hc3NldHMvbW92aWVzLzA0OWFlMjFmLTgxNTktNDMyZS1iNTBhLTA4YzY3ZDQwYzQwYy53ZWJw,Pimp,250,9,2018.0,Crime/Drama,0 days 01:50:00.000000000,-40
59,17,,Swiped,1000,6,2018.0,Comedy,0 days 01:33:00.000000000,-42
52,76,https://resizing.flixster.com/BhvzW_ed7WorMdfPwgvewm7ByFs=/206x305/v2/https://flxt.tmsimg.com/assets/p16143545_p_v13_ag.jpg,Monster Party,100,21,2018.0,Horror/Mystery and thriller,0 days 01:29:00.000000000,24
44,20,https://resizing.flixster.com/ErmrxklnMfdxqpqLk70vCFSkgm8=/206x305/v2/https://resizing.flixster.com/KzV74iZEa_CY1uYcQaJDI5_w578=/ems.ZW1zLXByZC1hc3NldHMvbW92aWVzLzc3ZmE5NmNjLWMyYTUtNDY3My1iOTY5LTdiMWMwMGU2MTVjMi53ZWJw,Hospitality,1,5,2018.0,Mystery and thriller,0 days 01:20:00.000000000,-24
25,73,https://resizing.flixster.com/wJ66FNgpAQWhJ6PeMQXRnU7iL68=/206x305/v2/https://resizing.flixster.com/p-0boJzRtMoJB3E-LGZwyjRvvD8=/ems.ZW1zLXByZC1hc3NldHMvbW92aWVzLzg3YTk0YWNiLWFmNjUtNDM3MC04OGE5LWUzZmI4MTg3NzNlNC53ZWJw,The Final Wish,250,11,2018.0,Horror/Mystery and thriller,0 days 01:35:00.000000000,48
51,51,,Escape Room,2500,157,2019.0,Horror/Mystery and thriller,0 days 01:40:00.000000000,0
39,33,https://resizing.flixster.com/FMVH1_VlZGvyVq04pTTii5nnlm0=/206x305/v2/https://resizing.flixster.com/Zdb9cdFQH1WA-P2T7CcbqNfmkxk=/ems.ZW1zLXByZC1hc3NldHMvbW92aWVzLzk5MmFkYzU3LWE0MmMtNGNlNC04ZWYxLTc1ZDQ3NDEwZDRkNy53ZWJw,The Holiday Calendar,100,6,2018.0,Romance/Other,0 days 01:34:00.000000000,-6
83,40,,Run the Race,250,10,2018.0,Drama,0 days 01:41:00.000000000,-43
57,64,https://resizing.flixster.com/vEdWD5JLBiRuHF99LQb1vxMjnCA=/206x305/v2/https://resizing.flixster.com/UHXfYNLDqLdHdulYTnDILH-qReY=/ems.ZW1zLXByZC1hc3NldHMvbW92aWVzL2MyZWM4MjVhLWQ2MTYtNDEwMy05ZDI5LWNmNjI5Y2Q0MzU1Ny53ZWJw,Bird Box,5000,162,2018.0,Sci fi/Horror,0 days 02:04:00.000000000,7
41,20,https://resizing.flixster.com/o7ktAb0i5Hv8ETOnIWTHgwRjHAw=/206x305/v2/https://resizing.flixster.com/WYN0j4T8igHsMxuylT1Notjm1zY=/ems.ZW1zLXByZC1hc3NldHMvbW92aWVzLzY4ODdmMjkwLTYyNTEtNGJkYy1hMWJmLTkyNTNlODRlZDJkMS53ZWJw,Bob Lazar: Area 51 & Flying Saucers,100,5,2018.0,Documentary,0 days 01:37:00.000000000,-21
77,100,https://resizing.flixster.com/Qbc2eZGRRaeQy68C64JvWsKL-dI=/206x305/v2/https://resizing.flixster.com/n4nHtpgbmHTS5AIWuOLMV7Clnkw=/ems.ZW1zLXByZC1hc3NldHMvbW92aWVzL2MxYTg5OTE0LWY4NTgtNGZhNi05OGYwLTE2ZmYwMjZhNTNjYy53ZWJw,John Leguizamo's Latin History For Morons,100,7,2018.0,,,23
27,13,https://resizing.flixster.com/ySl5y3E306c9YbWkxvjz1khH1fY=/206x305/v2/https://resizing.flixster.com/tMUYu0YUBxWg9-V5QjjjIep5RMw=/ems.ZW1zLXByZC1hc3NldHMvbW92aWVzLzdjYTZkNWFiLTNiOWEtNGU2NS04OGQ3LTI2M2ViYjc2ZDM5YS53ZWJw,No manches Frida 2,100,8,2019.0,Comedy,0 days 01:42:00.000000000,-14
44,44,https://resizing.flixster.com/sneULPWR9yVTy22MkVez7A3ZPZE=/206x305/v2/https://resizing.flixster.com/pFoxtoSc4ciR8SVPd10ZrmL-2A8=/ems.ZW1zLXByZC1hc3NldHMvbW92aWVzL2YwOTQ4ZmZkLTY0MDEtNDk0MS1iZmY5LTI0OTNhMGY4Zjg0Zi53ZWJw,Leprechaun Returns,100,9,2018.0,Comedy/Horror,0 days 01:32:00.000000000,0
22,23,https://resizing.flixster.com/g3fi8u_Xb4uNkXZyeC4J093aB7Y=/206x305/v2/https://resizing.flixster.com/gBsfWCoIbmI5dntoI-zlLPu5-tA=/ems.ZW1zLXByZC1hc3NldHMvbW92aWVzLzI2MGY2ZjJjLWUyZjgtNDc5ZS05YTg2LTllM2JkNzJkNzQyYS53ZWJw,All the Devil's Men,50,13,2018.0,Action/Mystery and thriller,0 days 01:40:00.000000000,1
29,19,https://resizing.flixster.com/Mr6Yqayg70pc_FyurvD7w8-9msg=/206x305/v2/https://resizing.flixster.com/mdojaakPFlAIZYrjbCMx98kWyAs=/ems.ZW1zLXByZC1hc3NldHMvbW92aWVzLzY2ZjIzNDEwLWM3YTUtNDI5My1iMTIxLTE5ZjYxMWEwNmI4Ny53ZWJw,The Haunting of Sharon Tate,100,32,2019.0,Horror/Mystery and thriller,0 days 01:34:00.000000000,-10
62,100,https://resizing.flixster.com/aWGbnuVVAMbeVpgoecG_9uTW0OE=/206x305/v2/https://resizing.flixster.com/Z6tIa1g4pP_dXRHQ5QKBhvHQ2rw=/ems.ZW1zLXByZC1hc3NldHMvbW92aWVzLzA3NDk3NzZkLWFhMmItNGZjMC05NWNlLTY1NjFlYTk0M2EzOC53ZWJw,Your Son,1,5,2018.0,Drama/Mystery and thriller,0 days 01:43:00.000000000,38
62,84,https://resizing.flixster.com/bVqb0cIUngRT69slUneU1wCWFcY=/206x305/v2/https://resizing.flixster.com/G4ugPSMu0TQT7SWosSJNCghZXIo=/ems.ZW1zLXByZC1hc3NldHMvbW92aWVzLzIwZjlkNjg1LTY4NTUtNGY5NC1hODdhLWUwM2EzN2NkMjc3Yi53ZWJw,Rust Creek,500,44,2018.0,Mystery and thriller,0 days 01:48:00.000000000,22
86,89,https://resizing.flixster.com/oNc2FzFLgvZv72GnTbwDTSzaQc4=/206x305/v2/https://resizing.flixster.com/j2yZUNVQXf6dv48AeqRww9rlTKk=/ems.ZW1zLXByZC1hc3NldHMvbW92aWVzLzBmMDQ0MGRlLTFmMGEtNGRjOS04YjQzLThlMmZmZWY0MTJlNy53ZWJw,Dear Ex,50,9,2018.0,Romance/Comedy,0 days 01:40:00.000000000,3
50,69,https://resizing.flixster.com/0wF25cv2483RnzjNrJsTLJufFjA=/206x305/v2/https://resizing.flixster.com/aZ_OHONbrbGtvDbwHCdmFRv42Bk=/ems.ZW1zLXByZC1hc3NldHMvbW92aWVzLzFiNDcyNmQ2LTAxZjktNDg2MC1iNWZhLTgyNzU4ZjBmMWQ0Ni53ZWJw,The Princess Switch,500,13,2018.0,Other/Romance,0 days 01:41:00.000000000,19
87,86,https://resizing.flixster.com/erMkmR0oV7Q8QGn3F28cyGLQRcc=/206x305/v2/https://resizing.flixster.com/sr_-q3FCw1bFNNvheQpUDTUrlC8=/ems.ZW1zLXByZC1hc3NldHMvbW92aWVzLzY5NmZmZDZiLWY4Y2YtNDdkZC1iMmJkLTZmMWZlM2Q2OTI3NC53ZWJw,The Boy Who Harnessed the Wind,250,63,2019.0,Drama,0 days 01:53:00.000000000,-1
48,85,,The Vanishing,500,39,2018.0,Action/Mystery and thriller,0 days 01:47:00.000000000,37
57,44,,American Hangman,100,9,2019.0,Mystery and thriller,0 days 01:39:00.000000000,-13
85,67,https://resizing.flixster.com/Uci_SjfX-amwhbfbJGUu96M0E08=/206x305/v2/https://flxt.tmsimg.com/assets/p15623402_p_v13_aa.jpg,Scotch: A Golden Dream,1,9,2018.0,Documentary,0 days 01:27:00.000000000,-18
92,82,https://resizing.flixster.com/vMZu5i0SIT9EZSOzrbjnrULDPkw=/206x305/v2/https://resizing.flixster.com/77n3abb3uY0kV6U5qtHZE9oDKOM=/ems.ZW1zLXByZC1hc3NldHMvbW92aWVzLzI0ZmNlNjMwLTFmOWMtNDBiNC1hNWYwLTI0MjRjYjViY2FhNy5qcGc=,Dragon Ball Super: Broly,2500,56,2018.0,Action/Anime,0 days 01:41:00.000000000,-10
73,75,,Mirage (Durante la tormenta),250,8,2018.0,,,2
74,95,,The Mustang,250,133,2019.0,Drama,0 days 01:36:00.000000000,21
88,22,,Sgt. Will Gardner,250,9,2019.0,Drama,0 days 02:05:00.000000000,-66
96,96,https://resizing.flixster.com/oKNxnaXO3a0cTcTvec4aNe6Zn_k=/206x305/v2/https://resizing.flixster.com/L-k1FUkpySURzeyBcZQ2P_4BAeM=/ems.ZW1zLXByZC1hc3NldHMvbW92aWVzLzExNTJmZWEwLTcxMzMtNDA2NC1iYzIwLTY1NWUxZTA2N2FiYS53ZWJw,Springsteen on Broadway,100,24,2018.0,,,0
57,54,https://resizing.flixster.com/fTGWZcW_Y8GjmzZ8_uOzMpqjzWI=/206x305/v2/https://resizing.flixster.com/24c11a07S0RK01YiOeT2I_jhN9o=/ems.ZW1zLXByZC1hc3NldHMvbW92aWVzLzc4ZjRiMWE1LTg0YjItNGQ3YS1hMTU3LTZhZWI2YmI2MTRkZS53ZWJw,"Extremely Wicked, Shockingly Evil and Vile",1000,182,2019.0,Biography/Drama,0 days 01:50:00.000000000,-3
81,22,,I Hate Kids,100,9,2018.0,Comedy,0 days 01:29:00.000000000,-59
74,100,https://resizing.flixster.com/Unw3SyB1XNEsY4YhVJgu580IAkM=/206x305/v2/https://resizing.flixster.com/NEpfLzqQJtaxIOOVn2DwuyruUW4=/ems.ZW1zLXByZC1hc3NldHMvbW92aWVzLzIzYmI2NGE0LWJmYzctNGI1My05MmE3LTI0NTA1N2FmY2MyZi53ZWJw,When Jeff Tried to Save the World,1,5,2018.0,Comedy,0 days 01:33:00.000000000,26
55,71,https://resizing.flixster.com/3JlYG7M53j7pxGp0u-SbQfy46ko=/206x305/v2/https://resizing.flixster.com/hj4rKyOnEcq8GQIKG_JvHHm_UxY=/ems.ZW1zLXByZC1hc3NldHMvbW92aWVzLzA5MWQ2MzcxLTc4NWYtNDQyNC04ZjUyLWU3ZTVkZDUyY2Q5NC53ZWJw,Triple Frontier,1000,135,2019.0,Mystery and thriller/Action,0 days 02:05:00.000000000,16
73,58,https://resizing.flixster.com/Oj3jif8Y7Yn7Ebuv5lGXKIY_zZk=/206x305/v2/https://resizing.flixster.com/YVb3c_NSqsgra7OWdns1y9Zv_AE=/ems.ZW1zLXByZC1hc3NldHMvbW92aWVzLzJkNDcxM2JhLThiNDUtNDIyZC1hZThiLTI5ODg4MjQyNzY2Yy53ZWJw,The Highwaymen,1000,139,2019.0,Crime/Drama,0 days 02:12:00.000000000,-15
43,64,https://resizing.flixster.com/S13CxfyEQZIHC_gnfXdMhjNN8Rc=/206x305/v2/https://resizing.flixster.com/hf5GvaTUEERXWMq-_c6gGAiegqs=/ems.ZW1zLXByZC1hc3NldHMvbW92aWVzLzk3ZWRmYWE4LWEyZGItNDM1Ni1iNzFlLWNlZmRhOTZkOTUzMC53ZWJw,Dead Ant,1,14,2017.0,Comedy,0 days 01:27:00.000000000,21
86,92,,Fyre,500,93,2019.0,Documentary,0 days 01:37:00.000000000,6
98,64,,Rockaway,100,11,2017.0,Drama/Adventure,0 days 01:30:00.000000000,-34
44,27,/assets/pizza-pie/images/poster_default.c8c896e70c3.gif,Outlaws,1,11,2017.0,Crime/Drama,0 days 01:32:00.000000000,-17
10,99,https://resizing.flixster.com/a-RiKtzHM2ugeqB6fm2Y7t1Ut7k=/206x305/v2/https://resizing.flixster.com/bIAgN-TmG3Rfe5suQtLVUQvJcq8=/ems.ZW1zLXByZC1hc3NldHMvbW92aWVzL2NhZjYwNGRlLTBmOGUtNGM0ZC1iZWUyLWQ5OTgxOGYxNzdkZC53ZWJw,Knock Down the House,5000,103,2019.0,Documentary,0 days 01:26:00.000000000,89
83,67,https://resizing.flixster.com/-bSBMHyFITek4wh1vFOocqI3a3w=/206x305/v2/https://resizing.flixster.com/1dFuwyiFX5LVWTkRUZBTarK44I8=/ems.ZW1zLXByZC1hc3NldHMvbW92aWVzL2Q4MDg2NzMzLTNjMmEtNDkzNy1hNmFhLWY4MDc3MTExMjhhNi53ZWJw,The Isle,500,9,2018.0,Horror/Mystery and thriller,0 days 01:36:00.000000000,-16
67,40,,Heartlock,1,5,2018.0,Crime/Drama,0 days 01:36:00.000000000,-27
78,81,,A Boy Called Sailboat,50,16,2018.0,Comedy/Kids and family,0 days 01:32:00.000000000,3
64,100,,Justice League vs the Fatal Five,100,8,2019.0,Fantasy/Animation,0 days 01:17:00.000000000,36
35,61,https://resizing.flixster.com/xCaLRWmL1wNrr6DAvxVXjOWZ3Pg=/206x305/v2/https://resizing.flixster.com/Phwle3ENeX_0G_ZCgNUqenLYlzc=/ems.ZW1zLXByZC1hc3NldHMvbW92aWVzLzBhOTJkYjk5LTBhMzAtNGQ3ZS1hZTlhLWIwZmM4ZWM1YmUzMC53ZWJw,Velvet Buzzsaw,1000,189,2019.0,,,26
35,37,https://resizing.flixster.com/SSUtyfZcxabp_J17lDFv2WUROLE=/206x305/v2/https://resizing.flixster.com/RhETuqUki_9lo2GJit8rkWjIiWo=/ems.ZW1zLXByZC1hc3NldHMvbW92aWVzLzhiNTUzNmJhLTYwZjktNGFiMC05NGRiLWVmM2FmZjg4MWJkNS53ZWJw,Close,250,35,2019.0,Action/Mystery and thriller,0 days 01:34:00.000000000,2
28,40,,Godzilla: The Planet Eater,50,5,2018.0,Action/Sci fi,0 days 01:31:00.000000000,12
36,53,https://resizing.flixster.com/_2eFcyW-1K22r14AYIYRyGCELII=/206x305/v2/https://resizing.flixster.com/qV8AdCJfvxq8X1Z0SeRaRLHlnAU=/ems.ZW1zLXByZC1hc3NldHMvbW92aWVzL2M1ODJhYzNmLTM1OGMtNGQyOS04ZjVhLWMzMGEzMDJhZGIyOC53ZWJw,The Last Laugh,100,15,2019.0,Comedy,0 days 01:38:00.000000000,17
72,44,https://resizing.flixster.com/lu5p4APE60nyuaQO38bXKtJs-D8=/206x305/v2/https://resizing.flixster.com/BxB6DWiz0hA5Go8uTZvE6RU1Xlk=/ems.ZW1zLXByZC1hc3NldHMvbW92aWVzL2FhYTJmZGVjLWU3ZTItNDJmNy04NWUzLWEzNGI3YzliN2ZmNC53ZWJw,A Violent Man,100,9,2017.0,Crime/Drama,0 days 01:47:00.000000000,-28
33,0,,Trading Paint,50,12,2018.0,Action,0 days 01:28:00.000000000,-33
70,19,https://resizing.flixster.com/k8tQdaOPe0T_EnW-zj3VK_j0d98=/206x305/v2/https://resizing.flixster.com/llu4xAsiGjbE7BycnWER7WqaiwE=/ems.ZW1zLXByZC1hc3NldHMvbW92aWVzL2ZjYWYwZTA5LTJjOGItNGJmYi1iZmQ1LTUyMDVmZmUwZTk0Zi53ZWJw,Polar,2500,47,2019.0,Action/Mystery and thriller,0 days 01:58:00.000000000,-51
48,83,https://resizing.flixster.com/6-lCXDTy1akotIqF72pqG1ZJpZs=/206x305/v2/https://resizing.flixster.com/v0uH019E1wRGSqitJBzsLU5GQXU=/ems.ZW1zLXByZC1hc3NldHMvbW92aWVzL2QwZTZkNjRjLTVlMTktNDFjZC1iOTlkLWMyMTcyYTk0YWJhNy53ZWJw,The Hole in the Ground,250,89,2019.0,Horror/Mystery and thriller,0 days 01:30:00.000000000,35
94,92,https://resizing.flixster.com/nlFue5EEt9ONnjF1By3qXx1utn4=/206x305/v2/https://resizing.flixster.com/wka1RMEfNiKzJMiJYZU3f8y1nlY=/ems.ZW1zLXByZC1hc3NldHMvbW92aWVzL2NiMDE3MGNkLTQzYmYtNDZlYS04ZGZiLWQzZTJlZDRlODMzYS53ZWJw,Ask Dr. Ruth,50,83,2019.0,Documentary,0 days 01:40:00.000000000,-2
100,92,https://resizing.flixster.com/3hHwcWkSfXAEnlL88FtFUNMrUhk=/206x305/v2/https://resizing.flixster.com/82GcQYoMoauNwyTjHbrh8-UIC08=/ems.ZW1zLXByZC1hc3NldHMvbW92aWVzLzU4Yzc5OTQ1LTgzY2ItNGY1Ni05ZTgyLTVkNjRlYWE4YTkwYS53ZWJw,Stay Human,1,12,2018.0,Documentary,0 days 01:34:00.000000000,-8
9,20,https://resizing.flixster.com/D-pq49d_7jja_4S8mE3nxSl6l5k=/206x305/v2/https://resizing.flixster.com/lajzwtOo0XdULGMgKj_XDUYSyow=/ems.ZW1zLXByZC1hc3NldHMvbW92aWVzLzkzZWRkMDJiLTExZTgtNGU3Zi04ZWZmLTg3NjcyNWE0YWMyYS53ZWJw,Beneath the Leaves,50,5,2019.0,Horror/Mystery and thriller,0 days 01:30:00.000000000,11
87,89,https://resizing.flixster.com/5i48oqMilsyIOv949kr-AAidz18=/206x305/v2/https://resizing.flixster.com/I_LNbQC6KgvK1iC5WFQLq47tErQ=/ems.ZW1zLXByZC1hc3NldHMvbW92aWVzL2U5MDQ4MjI2LWRhM2ItNGU3Ni04ODliLTZmMGQ0OTBkODMxNS53ZWJw,Paddleton,500,44,2019.0,Comedy/Drama,0 days 01:29:00.000000000,2
58,80,https://resizing.flixster.com/SCk4N1WBkFfylz3CAD0yNnV3Dvg=/206x305/v2/https://resizing.flixster.com/ESbIwarZJ1GR-egZfO7Q4u4X3bg=/ems.ZW1zLXByZC1hc3NldHMvbW92aWVzLzRjZjA4NjkzLTY1YzEtNDhmYy1iYzZjLTRlOTgyOTE1ZmRlMC53ZWJw,Fyre Fraud,100,30,2019.0,,,22
52,40,/assets/pizza-pie/images/poster_default.c8c896e70c3.gif,Revenger,50,5,2018.0,,,-12
63,46,,Finding Steve McQueen,50,28,2018.0,Crime/Drama,0 days 01:30:00.000000000,-17
61,72,,Nancy Drew and the Hidden Staircase,100,25,2019.0,Mystery and thriller/Adventure,0 days 01:29:00.000000000,11
75,91,,I Am Mother,1000,74,2019.0,Sci fi/Mystery and thriller,0 days 01:55:00.000000000,16
94,38,https://resizing.flixster.com/3sqRMb2hRC2sI0MvrYwERNvNnSk=/206x305/v2/https://resizing.flixster.com/FyKkNLN1bqf8_Njj27DFQOh6gcE=/ems.ZW1zLXByZC1hc3NldHMvbW92aWVzLzNjYzJmNWQ1LTQ5ZGEtNGU2Yy1hY2I1LWI0NWY1NDQwN2E4OC53ZWJw,The Dirt,5000,72,2019.0,Drama/Music,0 days 01:48:00.000000000,-56
65,83,https://resizing.flixster.com/P7T8gDLHfaxLjT0HggeTx_YfN3E=/206x305/v2/https://resizing.flixster.com/iyOPDsPSbpeEvLxow_ula22Lve0=/ems.ZW1zLXByZC1hc3NldHMvbW92aWVzLzg2NDc2OWNkLTg2MzQtNDhiNy1iNDFmLWUwMWYyMGMwMmMzNi53ZWJw,Someone Great,500,52,2019.0,Romance,0 days 01:32:00.000000000,18
30,66,https://resizing.flixster.com/T_syPBlZdA1eY4BZnju_osyDscc=/206x305/v2/https://resizing.flixster.com/KnjyQE76fkiBaqvRJLuSoHwJVKs=/ems.ZW1zLXByZC1hc3NldHMvbW92aWVzL2FhODY3NjE1LTQxZWQtNDI5Yy04ODZlLTkzODhjODEzZTNjNC53ZWJw,Wine Country,500,86,2019.0,Comedy,0 days 01:43:00.000000000,36
57,84,https://resizing.flixster.com/FblVaO6SrdG_-ShhT_EeFdUSuwc=/206x305/v2/https://resizing.flixster.com/Fg6eijuKYpwyXSaPFgYKlQFyao0=/ems.ZW1zLXByZC1hc3NldHMvbW92aWVzLzkwMmRlMjkyLTgwYmEtNDllZi04Y2EzLWY4MzllZjgzYmM5ZS53ZWJw,The Brink,1,101,2019.0,Documentary,0 days 01:31:00.000000000,27
83,100,https://resizing.flixster.com/WMyBYrmRTvLjIA6Jtkcm44cPZIg=/206x305/v2/https://resizing.flixster.com/cILayKqYnhtHPNTUSx0Y3g3aDrU=/ems.ZW1zLXByZC1hc3NldHMvbW92aWVzLzQ3ZDhlZjE2LTM5YmUtNDNhMC05ZWJiLWI0OTM2M2M1OWRkYy5qcGc=,ReMastered: The Two Killings of Sam Cooke,1,5,2019.0,,,17
64,80,,Kevin Hart's Guide to Black History,1,5,2019.0,,,16
84,100,https://resizing.flixster.com/4Wx80ndBGuCQhMA7-NzWCp2pAyM=/206x305/v2/https://resizing.flixster.com/s_7jKKpDycSj5-8RyDhkAKem3S4=/ems.ZW1zLXByZC1hc3NldHMvbW92aWVzL2MyOTNmMzJhLWE5MmYtNGIxMi04ZTQ1LTJhYTg4MmFiNzNhMC53ZWJw,American Relapse,1,8,2019.0,Documentary,0 days 01:45:00.000000000,16
56,17,,Crypto,100,6,2019.0,Mystery and thriller,0 days 01:45:00.000000000,-39
17,67,https://resizing.flixster.com/68tKtCW8y00SznXF0FzROAxdjVE=/206x305/v2/https://resizing.flixster.com/Ts4ymXudU3ow6ZD-M6o97U5JNlk=/ems.ZW1zLXByZC1hc3NldHMvbW92aWVzLzY4ZjY5M2JlLTk1MjItNGNlOC1iMjdlLTUzMjM0ZjU2MWEyYS53ZWJw,Body at Brighton Rock,50,42,2019.0,Mystery and thriller,0 days 01:27:00.000000000,50
67,60,,The Cannibal Club,1,15,2018.0,Comedy/Horror,0 days 01:21:00.000000000,-7
46,44,https://resizing.flixster.com/S5zc0qF9xQ4wppjY-WhSec3ULbU=/206x305/v2/https://resizing.flixster.com/Ut9-TARlmU7QD7M79PCf1aoepnM=/ems.ZW1zLXByZC1hc3NldHMvbW92aWVzLzI4ZGQ5OGJiLWFkZWEtNDM1ZS1hNDg5LTEyMmYwMWFkNDk0Yi53ZWJw,The Kid,250,45,2019.0,Western/Drama,0 days 01:40:00.000000000,-2
39,76,https://resizing.flixster.com/iYNBBCBEKci6bdlqwezi7WORkT4=/206x305/v2/https://resizing.flixster.com/Noxnl3vo7GxRk5RMdfhBD2AUkx4=/ems.ZW1zLXByZC1hc3NldHMvbW92aWVzL2NiNGVjOTk5LWZjNTAtNDA3Yy04ZDNmLTVhYzhhNDNjZTFlNy53ZWJw,I Trapped the Devil,100,37,2019.0,Other/Horror,0 days 01:22:00.000000000,37
54,100,https://resizing.flixster.com/Qm-Wkq24DEjQSpjDB_KbdHrIcW8=/206x305/v2/https://resizing.flixster.com/i83fXZh3koQ_frxZ2nkNZZ1ewkk=/ems.ZW1zLXByZC1hc3NldHMvbW92aWVzL2Y2ZGI1NzZhLTFjZDktNDJiNi1iNTllLTkxOWFiMGU3YWIzZS53ZWJw,The Head Hunter,250,14,2018.0,Fantasy/Horror,0 days 01:12:00.000000000,46
19,56,,Stray,1,9,2019.0,Fantasy/Mystery and thriller,0 days 01:29:00.000000000,37
87,86,,Period. End of Sentence.,50,7,2018.0,Documentary,0 days 00:26:00.000000000,-1
50,50,,We Are Boats,1,6,2018.0,Fantasy/Drama,0 days 01:48:00.000000000,0
8,79,https://resizing.flixster.com/y4HR3PIquBQqKT1-AnHSk6uOzTA=/206x305/v2/https://resizing.flixster.com/C-z01I0C6W0_aQEx1eti6hpgnT4=/ems.ZW1zLXByZC1hc3NldHMvbW92aWVzLzBjMTMxMmExLTQ5ZTctNDdjZi04NTQ3LTY1MTgwODQxYzdhOC53ZWJw,Amy Schumer Growing,100,14,2019.0,Comedy,0 days 01:00:00.000000000,71
92,73,https://resizing.flixster.com/Clh_I2aGDcYSkCv5OrDGAKNdCvM=/206x305/v2/https://resizing.flixster.com/UHKJ-P0RE9Z3FL0fkS2I1GrJdMo=/ems.ZW1zLXByZC1hc3NldHMvbW92aWVzLzY0NDVjMzdhLTFlZGEtNGJhYS04ZWNiLTA1ZDdiNGUxZTExYy53ZWJw,Sprinter,1,11,2018.0,Drama,0 days 01:54:00.000000000,-19
41,43,https://resizing.flixster.com/LYvy_XaTVCirSSCyIpGUh72kD4I=/206x305/v2/https://flxt.tmsimg.com/assets/p16623276_p_v13_aa.jpg,Paris Is Us,1,7,2019.0,Romance/Drama,0 days 01:24:00.000000000,2
63,82,https://resizing.flixster.com/3Aq66FSBBSKNMbt_SHTRWrpYb7E=/206x305/v2/https://resizing.flixster.com/nct36JtfNz9lTheHLquJLn69T4c=/ems.ZW1zLXByZC1hc3NldHMvbW92aWVzLzkxMzA1YmViLWVlOTItNDlkNC05YzNkLWU0YWZjZTZjMWEyYi53ZWJw,Juanita,100,17,2019.0,Drama,,19
89,100,https://resizing.flixster.com/UygNh61AizfrjYlV5drvMXplTUA=/206x305/v2/https://flxt.tmsimg.com/assets/p16720608_p_v13_aa.jpg,The River and the Wall,1,15,2019.0,Documentary,0 days 01:37:00.000000000,11
37,67,https://resizing.flixster.com/18s7rbUkOtgXvvZgZLctBQjTD9w=/206x305/v2/https://resizing.flixster.com/Z0kgsDJy31txJCJWJybaC00q5iU=/ems.ZW1zLXByZC1hc3NldHMvbW92aWVzLzA0MTZkODJlLWY2OWYtNDQ1MS1hZDUwLTcyNDMxZjllYzg4ZS53ZWJw,The Perfect Date,500,18,2019.0,Romance,0 days 01:30:00.000000000,30
42,75,https://resizing.flixster.com/gF1B_5fQoGQlJ5-A_sjlvAAo4P0=/206x305/v2/https://resizing.flixster.com/yhxXcuUDCaWvrP4-_R7rDWfIUKc=/ems.ZW1zLXByZC1hc3NldHMvbW92aWVzLzg4YWNjMGFmLTE1NTUtNGVhNC1iMjViLWU2MTc2NWIwNDM3NS53ZWJw,Sobibor,50,16,2018.0,Drama/Biography,0 days 02:00:00.000000000,33
76,75,https://resizing.flixster.com/jcIofrq099PSSqixrD6fA-wsvZ0=/206x305/v2/https://resizing.flixster.com/OzXaMLYV3nlW--gAwjl1U9QOAV4=/ems.ZW1zLXByZC1hc3NldHMvbW92aWVzLzAzOWMxZmJiLTA0ZGItNGEwMi05YjUyLWU3OGQ5YjMzYjk1Yy53ZWJw,Long Lost,50,12,2018.0,Mystery and thriller,0 days 01:35:00.000000000,-1
68,90,https://resizing.flixster.com/sp5GSZhQMCftLQ7pwRW9dCe2nmY=/206x305/v2/https://flxt.tmsimg.com/NowShowing/195563/195563_aa.jpg,Framing John DeLorean,100,48,2019.0,Documentary,0 days 01:49:00.000000000,22
16,40,,Backdraft 2,50,5,2019.0,Drama/Action,0 days 01:42:00.000000000,24
38,83,,Room for Rent,50,12,2019.0,Mystery and thriller,0 days 01:21:00.000000000,45
69,84,https://resizing.flixster.com/fo693hw6kL77l3i3Vjm1wInBm3Y=/206x305/v2/https://resizing.flixster.com/GSLAOOPEXwxnBh8hVt484IZPR0c=/ems.ZW1zLXByZC1hc3NldHMvbW92aWVzL2Q0YzUwNjU4LThjZDgtNDkxNS1hNDZhLWJiMjBjOTY3NmFiNS53ZWJw,Avengement,100,19,2019.0,Action,0 days 01:27:00.000000000,15
76,83,https://resizing.flixster.com/EC4JE6VupzoEBuurOA4-95PTCxk=/206x305/v2/https://flxt.tmsimg.com/assets/p15829831_p_v10_ab.jpg,A Fortunate Man,50,6,2018.0,Drama/History,0 days 02:42:00.000000000,7
43,100,https://resizing.flixster.com/oCgOLaO9XHjdu3MyXJMZPJBEkwA=/206x305/v2/https://resizing.flixster.com/FZ1aozuwHoXtpLZROdZZ6c4oxc4=/ems.ZW1zLXByZC1hc3NldHMvbW92aWVzLzZiNGJiMGI4LTBjY2UtNDYwOS05MjE5LWE3MTRiZWNhZTRkYS5qcGc=,Kevin Hart: Irresponsible,1,6,2019.0,Comedy/Stand up,,57
11,67,https://resizing.flixster.com/l8d6gDavUumHWpE1LsneXWDVFK0=/206x305/v2/https://resizing.flixster.com/P0d8kQWf5pncnOcBRc5oewFV75Q=/ems.ZW1zLXByZC1hc3NldHMvbW92aWVzL2Y1MTA3YmVkLTg5NzItNDBlMS1iYjY4LWM3MTY1NWYzMjI2ZS53ZWJw,Black Site,1,9,2018.0,Sci fi/Action,0 days 01:27:00.000000000,56
25,7,https://resizing.flixster.com/qrr66tK6_mEjsKLsI58gLuaoBe0=/206x305/v2/https://resizing.flixster.com/2J8x44N2lceFT0mFlFHmjq8M1Rg=/ems.ZW1zLXByZC1hc3NldHMvbW92aWVzLzJmNGU0YzgwLWYyYWEtNDc5Zi1iNDVmLTc1Y2YxY2NhYzIzZi53ZWJw,Isabelle,1,15,2018.0,Horror/Mystery and thriller,0 days 01:20:00.000000000,-18
60,56,https://resizing.flixster.com/SlOMVofSbZsVQmhW2E1HjtH9IEE=/206x305/v2/https://resizing.flixster.com/tKq-0kFvD1jk6AkyGyomfQhd2mY=/ems.ZW1zLXByZC1hc3NldHMvbW92aWVzLzc1MzFkM2M3LTdhYjYtNDMzOS04MjIzLWNkYWVmZmEyNzNmYS53ZWJw,Changeland,100,9,2019.0,Comedy/Drama,,-4
84,17,https://resizing.flixster.com/k__Zx7u298NpgNNTHYlMffDJybg=/206x305/v2/https://resizing.flixster.com/hp_73d197yxNWraPzZM5XVo9yzo=/ems.ZW1zLXByZC1hc3NldHMvbW92aWVzLzBiZmI5NjMzLTYzMTctNGQ1OC04ZTk4LWNlYjgwNjcwZjM5ZC53ZWJw,A Violent Separation,1,12,2019.0,Mystery and thriller/Crime,0 days 01:46:00.000000000,-67
76,10,https://resizing.flixster.com/kpbgbQmmkwnFIqjmsQP0ZpQtlbc=/206x305/v2/https://resizing.flixster.com/fVDsjwhK8TNABAryQIGTssLXe1A=/ems.ZW1zLXByZC1hc3NldHMvbW92aWVzLzcwNTRmZTMyLTBjYjctNDQwMy05ZDZlLWZiZjgwNWZhN2U3Yi53ZWJw,The Professor,500,20,2018.0,Comedy/Drama,0 days 01:30:00.000000000,-66
80,88,https://resizing.flixster.com/YuAnD-fxnjw4N15jp1KmMz-StNE=/206x305/v2/https://resizing.flixster.com/WKwJaLcSj6SU_qKJXmE9423DO6k=/ems.ZW1zLXByZC1hc3NldHMvbW92aWVzLzg1MDA1ODc1LWJmNzgtNGY1MS04M2Y5LTBhZTVlMWZiZDg3OC53ZWJw,Plus One,250,64,2019.0,Romance,0 days 01:39:00.000000000,8
18,34,https://resizing.flixster.com/ivGa3qjEKOnDoqYms3KoNz_Tpw0=/206x305/v2/https://resizing.flixster.com/qC6Js3PTjyqLkffnnQIHIe2qfHA=/ems.ZW1zLXByZC1hc3NldHMvbW92aWVzL2Q0NGE2NmI2LTE1YTEtNGJlMy05MTliLWU1NjEyNzUyM2JlMS53ZWJw,Domino,50,71,2019.0,Mystery and thriller/Drama,0 days 01:29:00.000000000,16
87,98,,Homecoming: A Film by Beyoncé,1000,55,2019.0,,,11
86,100,https://resizing.flixster.com/iByzVMtHS0oGFO-x_svIAkgL1Xg=/206x305/v2/https://flxt.tmsimg.com/assets/p16705952_p_v13_aa.jpg,Batman Vs. Teenage Mutant Ninja Turtles,250,13,2019.0,Sci fi/Action,0 days 01:24:00.000000000,14
75,74,https://resizing.flixster.com/npKr8pUwNBfLIRtjtwz1UvE8PA0=/206x305/v2/https://resizing.flixster.com/n7fFUMD_ynq9Zuyfnpi2MqjRuRM=/ems.ZW1zLXByZC1hc3NldHMvbW92aWVzLzdkZTA2M2E0LTNhNWYtNGQzNS05Mzc0LWU1NDM1YmE5YmUzYS53ZWJw,Guava Island,250,42,2019.0,Comedy/Mystery and thriller,0 days 00:55:00.000000000,-1
100,67,https://resizing.flixster.com/iQUe0HMFynQKaDJF4l6bv460KYg=/206x305/v2/https://resizing.flixster.com/FneBqkj6McrkQklv1igIwLIAMhg=/ems.ZW1zLXByZC1hc3NldHMvbW92aWVzLzFhZmFiMmJjLTQyNGUtNGQ5Ny1iOGFiLWUxZjA4Y2VjM2QwZC53ZWJw,Just Say Goodbye,1,9,2017.0,Drama,0 days 01:46:00.000000000,-33
25,20,,A pesar de todo,1,5,2019.0,Comedy,0 days 01:18:00.000000000,-5
42,44,,Murder Mystery,1000,68,2019.0,Comedy/Action,0 days 01:37:00.000000000,2
44,22,https://resizing.flixster.com/OezVtf-n-0Cy-lWi27aCLJrYiIA=/206x305/v2/https://resizing.flixster.com/2LjAoagCwMcs40PFG6FtIPzqBAs=/ems.ZW1zLXByZC1hc3NldHMvbW92aWVzL2ZkODIzMzk3LTk0YzEtNDU2Zi1hNzIyLTE3NjI4NGIzMGFjZC53ZWJw,Daughter of the Wolf,50,9,2019.0,Action/Mystery and thriller,0 days 01:31:00.000000000,-22
52,67,,I'll Take Your Dead,1,15,2018.0,Horror,0 days 01:23:00.000000000,15
91,100,,At the Heart of Gold: Inside the USA Gymnastics Scandal,50,27,2019.0,Documentary,0 days 01:31:00.000000000,9
65,50,https://resizing.flixster.com/-67k8kz4TPQdQ8iWcvokv7e6E3k=/206x305/v2/https://resizing.flixster.com/SV-t12uAPgqY_Q8upXSUWH22zeo=/ems.ZW1zLXByZC1hc3NldHMvbW92aWVzLzQzZDA4MzY4LTY2NTctNDM3Zi05OWRmLTEwNjZmN2YyZjZjYi53ZWJw,Good Sam,1,6,2019.0,Comedy,0 days 01:29:00.000000000,-15
27,14,https://resizing.flixster.com/l_b3-6gY9u3p_6NwQEmCl1alMVs=/206x305/v2/https://resizing.flixster.com/KFecCszJiSbWQdT6jwKecolmicc=/ems.ZW1zLXByZC1hc3NldHMvbW92aWVzL2M5M2I3ZDdjLWI1NmYtNDEyZC1iOTk0LTE5ZTY3ZjA0NDAzMC53ZWJw,The Child Remains,1,7,2017.0,Horror/Mystery and thriller,0 days 01:47:00.000000000,-13
60,75,,Jonas Brothers: Chasing Happiness,1,8,2019.0,,,15
36,50,https://resizing.flixster.com/6NhckpC0p5_Gknr7E-kM8qJb-90=/206x305/v2/https://resizing.flixster.com/zLr1FnwRpaHViK-sUcaUZgcI6Wk=/ems.ZW1zLXByZC1hc3NldHMvbW92aWVzLzI1ZDBkMDRkLTk5NzYtNGIzYi1iNmMzLTM1Njg4NDE1OGUwNS53ZWJw,The Outsider,1,18,2019.0,Western,0 days 01:26:00.000000000,14
14,0,https://resizing.flixster.com/93m4jxIgFHZmgJP2H-IXiUo76rw=/206x305/v2/https://resizing.flixster.com/icuPtMPLBsHMUCQ2nTDB4l99lYQ=/ems.ZW1zLXByZC1hc3NldHMvbW92aWVzLzNkYmU3N2M2LTVlNTEtNDM2NC1iZjBiLWE0YzRiOGY2YmE0NS53ZWJw,Loqueesha,1,7,2019.0,Comedy,0 days 01:38:00.000000000,-14
79,17,https://resizing.flixster.com/iYwo9TKB8MUdeEdUC-MIPmB-xb0=/206x305/v2/https://resizing.flixster.com/l1VlmujL2ORlygWivkD5sXAXIYU=/ems.ZW1zLXByZC1hc3NldHMvbW92aWVzL2EyZDY5MGI2LWQ2ZGYtNDdiNy1hMjFhLWUxZTExNDQzMmFmNy53ZWJw,Chopsticks,1,6,2018.0,Drama,,-62
61,100,,All Is Good,1,12,2018.0,Drama,0 days 01:33:00.000000000,39
72,100,https://resizing.flixster.com/h6WzXR1mlJKQAS0aQ3npANMrPjA=/206x305/v2/https://flxt.tmsimg.com/assets/p16941244_p_v13_aa.jpg,Life Overtakes Me,1,5,2019.0,Documentary,0 days 00:39:00.000000000,28
0,83,https://resizing.flixster.com/9lIJhcRyxAC6l3H8wwJnlPW_9LM=/206x305/v2/https://resizing.flixster.com/5xryuON9vZDHWfmUfAgkvKodp1Q=/ems.ZW1zLXByZC1hc3NldHMvbW92aWVzLzUxZjM3ZTEyLWI4OGUtNGE4Zi05YTk2LWU2YjAzNjhkZTIzYi53ZWJw,The Heretics,1,6,2017.0,Fantasy/Horror,0 days 01:27:00.000000000,83
100,100,https://resizing.flixster.com/sMnoK6UKVtiuQgM-TasQDqaxlJI=/206x305/v2/https://resizing.flixster.com/r2mdRiueWNcZVS0G7si6e5enWi8=/ems.ZW1zLXByZC1hc3NldHMvbW92aWVzLzdiZjg2MzQyLTg0MWYtNDAwZS04MDU2LWEwMjllMjBlM2QxNi53ZWJw,Cherzoso The Silent Film,1,5,2019.0,Drama,0 days 00:06:00.000000000,0
65,60,https://resizing.flixster.com/So7ahbipHtlmZX5qaZFbHKjflcw=/206x305/v2/https://flxt.tmsimg.com/assets/p4147_p_v10_aa.jpg,Cold Turkey,500,15,1971.0,Comedy,0 days 01:39:00.000000000,-5
87,89,https://resizing.flixster.com/u8o5W2qsQoaeCIiyxp8ghwK3F2c=/206x305/v2/https://resizing.flixster.com/WBaxy_-Mr67tTDgX4mVBnzCq70c=/ems.ZW1zLXByZC1hc3NldHMvbW92aWVzLzI1NzNkMDc3LWEyNWEtNDMyOC05MWQwLTQ2M2IxYWJhMDdiMi53ZWJw,Maurice,5000,27,1987.0,Romance/Gay and lesbian,0 days 02:20:00.000000000,2
88,89,https://resizing.flixster.com/bhkadvps1U5vqhZZJvi-g4tmYO4=/206x305/v2/https://resizing.flixster.com/40yQZyY7IgD-gz7cb-HSPTQ3EI0=/ems.ZW1zLXByZC1hc3NldHMvbW92aWVzL2M3ZjJjYjNhLTFjZDMtNGQwYS05M2UyLTFhODVhMjA5OWNjOS53ZWJw,King of Hearts,2500,18,1966.0,Comedy,0 days 01:42:00.000000000,1
83,100,https://resizing.flixster.com/NztU2MWrj5K15LJI0cYYtxkX_jU=/206x305/v2/https://resizing.flixster.com/w9PDZuSjXtBED0dHB82naS7vZl4=/ems.ZW1zLXByZC1hc3NldHMvbW92aWVzLzkwZmIxNmRkLWYwNzMtNDg2Yy05NWQ4LWVmZjE2Zjg3ZjQyOS53ZWJw,La Belle Noiseuse,500,29,1991.0,Drama,0 days 03:58:00.000000000,17
86,100,/assets/pizza-pie/images/poster_default.c8c896e70c3.gif,Funeral Parade,500,19,1969.0,Drama,0 days 01:47:00.000000000,14
57,33,https://resizing.flixster.com/sh0GGC0adqWS8QGKWAvae5-4X6I=/206x305/v2/https://flxt.tmsimg.com/assets/p3548_p_v8_aa.jpg,The Reincarnation of Peter Proud,500,6,1975.0,Horror,0 days 01:44:00.000000000,-24
92,100,https://resizing.flixster.com/lQL1nM1MJifgSg79ISBkTSI0GEM=/206x305/v2/https://flxt.tmsimg.com/assets/p56218_p_v8_aa.jpg,The Two of Us,500,15,1968.0,Drama,0 days 01:26:00.000000000,8
87,80,https://resizing.flixster.com/UyPL3OOPhZ8rqL89_jq-icyB7KQ=/206x305/v2/https://flxt.tmsimg.com/assets/p3807_p_v10_aa.jpg,Love With the Proper Stranger,1000,10,1963.0,Comedy/Drama,0 days 01:42:00.000000000,-7
86,100,https://resizing.flixster.com/lYrLHXn9G8NxZCOt3DRiUtYJFWU=/206x305/v2/https://flxt.tmsimg.com/assets/p1604_p_v8_aa.jpg,The Breaking Point,250,10,1950.0,Drama,0 days 01:37:00.000000000,14
50,67,https://resizing.flixster.com/EfJ_8QeIbcN1615V3D3jhtfNBxc=/206x305/v2/https://flxt.tmsimg.com/assets/p172370_p_v10_aa.jpg,The Poughkeepsie Tapes,25000,6,2007.0,Horror/Mystery and thriller,0 days 01:26:00.000000000,17
56,79,https://resizing.flixster.com/sEerZL_IiMiRTR8PeSRUiqVS2QY=/206x305/v2/https://resizing.flixster.com/5tilnEM4susTS2BC8PeIcd4-yas=/ems.ZW1zLXByZC1hc3NldHMvbW92aWVzLzZkYmM5MmI0LWNiYmEtNGMzNC04YmQxLWVjZmMxYmVhZGNkNy53ZWJw,Heat and Dust,500,14,1983.0,Drama,0 days 02:13:00.000000000,23
61,61,https://resizing.flixster.com/6JeJW_izad1RtLrd0wmWooom2xw=/206x305/v2/https://flxt.tmsimg.com/assets/p169243_p_v10_ab.jpg,Arctic Tale,10000,99,2007.0,Documentary,0 days 01:36:00.000000000,0
79,90,/assets/pizza-pie/images/poster_default.c8c896e70c3.gif,Comradeship,100,10,1931.0,Drama,0 days 01:33:00.000000000,11
50,89,https://resizing.flixster.com/cjmHu7hjPF8sFGQe5s0VXJJF1g4=/206x305/v2/https://flxt.tmsimg.com/assets/p58151_p_v10_aa.jpg,The Covered Wagon,100,9,1923.0,Western,0 days 01:38:00.000000000,39
72,100,https://resizing.flixster.com/u8saDBiU7eh7fbzoPI85RuB2ogc=/206x305/v2/https://flxt.tmsimg.com/assets/p39836_p_v10_aa.jpg,Moonrise,250,10,1948.0,Drama,0 days 01:30:00.000000000,28
79,100,,Variety,50,7,1925.0,Drama,0 days 01:19:00.000000000,21
63,89,https://resizing.flixster.com/8Mqby0Vgi8OCpP-080bbo-p2EwQ=/206x305/v2/https://resizing.flixster.com/NNXO6AvHP2G5pNUsDTNckamQlQc=/ems.ZW1zLXByZC1hc3NldHMvbW92aWVzLzhiZWRlMDNjLWVhN2YtNDE2OC1hOTg3LWUyZjFhOGZiYjZiNi53ZWJw,Shakespeare Wallah,100,9,1965.0,Drama,0 days 02:00:00.000000000,26
86,100,https://resizing.flixster.com/ciQI4JGZemHmur_05O_XGr43Ybc=/206x305/v2/https://resizing.flixster.com/NSkDhSWGenucTevEDijeHR4R-lk=/ems.ZW1zLXByZC1hc3NldHMvbW92aWVzLzk2NzA0MmM2LTcwZWYtNGRjYS04NTNmLTE2YTFkNjljNDJiYy53ZWJw,Daughter of the Nile,100,6,1987.0,Drama,0 days 01:33:00.000000000,14
78,90,,Peppermint Soda,50,10,1979.0,Comedy/Drama,0 days 01:37:00.000000000,12
45,16,https://resizing.flixster.com/1V0CkrtEcnz75ean9IAx7Q3Sdxw=/206x305/v2/https://resizing.flixster.com/pRt3REGz9rwt0izQ9N-_AmeSTdw=/ems.ZW1zLXByZC1hc3NldHMvbW92aWVzLzE2M2IwNGRiLWM3NTktNGNhMy05MWNhLWU5M2JiMTM0MGMxZS53ZWJw,The Dark Tower,25000,275,2017.0,Action/Fantasy,0 days 01:35:00.000000000,-29
32,30,https://resizing.flixster.com/nF7riBysPb6FJPaSY0LVjqvKXhA=/206x305/v2/https://resizing.flixster.com/LTTLBrtprsXBdquE040Q7398RB4=/ems.ZW1zLXByZC1hc3NldHMvbW92aWVzLzBhMThiMjJkLTM4MGItNDk0ZC04YmQ5LTkxMTg0NTYwM2U3ZC53ZWJw,Amityville: The Awakening,10000,20,2017.0,Horror/Mystery and thriller,0 days 01:25:00.000000000,-2
18,7,,The Snowman,10000,197,2017.0,Crime/Drama,0 days 01:59:00.000000000,-11
81,91,https://resizing.flixster.com/RTquziwH8BkseRjcJMIwgb7NeeI=/206x305/v2/https://flxt.tmsimg.com/assets/p9497005_p_v8_aa.jpg,Beyond the Hills,1000,107,2012.0,Drama,0 days 02:30:00.000000000,10
90,67,/assets/pizza-pie/images/poster_default.c8c896e70c3.gif,Long Shot: The Kevin Laue Story,100,6,2012.0,Documentary,0 days 01:33:00.000000000,-23
71,40,,Justice League,100000,400,2017.0,Fantasy/Action,0 days 01:59:00.000000000,-31
61,29,,Pirates of the Caribbean: Dead Men Tell No Tales,100000,287,2017.0,Action/Fantasy,0 days 02:03:00.000000000,-32
51,72,,Ferdinand,5000,120,2017.0,Animation/Comedy,0 days 01:48:00.000000000,21
39,52,,The Sea,50,21,2013.0,Drama,0 days 01:26:00.000000000,13
87,92,https://resizing.flixster.com/gIjga3Wby4Tof7gt2Lpk9hsOIIs=/206x305/v2/https://resizing.flixster.com/JwIeXwQ26fpkxO2r3rmGHWvVHBI=/ems.ZW1zLXByZC1hc3NldHMvbW92aWVzLzI3MmIzNGJhLTUxMDAtNDliMS1iMjZkLTc2YzQxM2E3OTFiYi53ZWJw,Spider-Man: Homecoming,100000,391,2017.0,Action/Fantasy,0 days 02:13:00.000000000,5
35,16,,The Mummy,25000,313,2017.0,Horror/Fantasy,0 days 01:47:00.000000000,-19
53,58,,Despicable Me 3,50000,196,2017.0,Animation/Comedy,0 days 01:30:00.000000000,5
84,94,https://resizing.flixster.com/K1eBF0b03Pw7vaNRE57VuwYM5jM=/206x305/v2/https://resizing.flixster.com/aBb69GSI06eCcMSHIPoJlnJZCtE=/ems.ZW1zLXByZC1hc3NldHMvbW92aWVzLzhmOTU4ZmNiLTM1ZTEtNDcyNS1iNzg1LTBjMzZlMTZiMDUzMC53ZWJw,War for the Planet of the Apes,50000,355,2017.0,Adventure/Action,0 days 02:22:00.000000000,10
44,14,,The Nut Job 2: Nutty by Nature,5000,63,2017.0,Animation/Comedy,0 days 01:31:00.000000000,-30
84,96,https://resizing.flixster.com/A3Viif6xxIZn4Bsuv4bkLIfIK8I=/206x305/v2/https://resizing.flixster.com/VrI7ip-aaWb3-q-UGj0LWvF7RJs=/ems.ZW1zLXByZC1hc3NldHMvbW92aWVzLzA1NTI2NTliLTUzNzAtNGI3NC04YTg5LTYyOWZkNjc2Y2YyNy53ZWJw,Dealt,500,25,2017.0,Documentary,0 days 01:25:00.000000000,12
69,95,https://resizing.flixster.com/nJ4K83OrO68cuIoS_lus5xbjjTQ=/206x305/v2/https://resizing.flixster.com/0roF82zRmVVXHV5oIkSkE6tVUaI=/ems.ZW1zLXByZC1hc3NldHMvbW92aWVzLzg5Mzg2ZDdmLTYzYTMtNDMwNi1iZDNiLTk2MzhiYTAzOTMxNS53ZWJw,Notes on Blindness,1000,40,2016.0,Documentary,0 days 01:30:00.000000000,26
55,65,https://resizing.flixster.com/48fxUgpjUJblVCowofroD9pbAFM=/206x305/v2/https://resizing.flixster.com/jJmdAzuqv38qH0zF5b67O0iFtMo=/ems.ZW1zLXByZC1hc3NldHMvbW92aWVzL2Q0ZmY5MzAzLWYxNzAtNGYyOS1iMzQwLWIzYTM3YTg5NmVjNy53ZWJw,Alien: Covenant,50000,403,2017.0,Horror/Mystery and thriller,0 days 02:02:00.000000000,10
78,91,,Girls Trip,10000,174,2017.0,Comedy,0 days 02:02:00.000000000,13
36,52,https://resizing.flixster.com/u79d4wpUPE7kJdytdT04pVXyIV0=/206x305/v2/https://resizing.flixster.com/H_w2vBphXEggGaG3IDS8ztqBwGU=/ems.ZW1zLXByZC1hc3NldHMvbW92aWVzLzA0MjJmN2ZmLWU1MzEtNDdmNi1iMWNkLWY3OGVkMTA1YWU1ZC53ZWJw,In the Deep,10000,159,2017.0,Adventure/Horror,0 days 01:29:00.000000000,16
35,16,https://resizing.flixster.com/5unH538Lts1G5BwGmYWuN611ZI4=/206x305/v2/https://resizing.flixster.com/3zURduuF8sHCHLwgAbM945GPW3E=/ems.ZW1zLXByZC1hc3NldHMvbW92aWVzLzUyZGQyZDg3LWIyMTctNDIyMy1hODVlLWMzNzMxZWQ0MjdlNC53ZWJw,Geostorm,10000,91,2017.0,Adventure/Sci fi,0 days 01:49:00.000000000,-19
46,56,https://resizing.flixster.com/LtHqKsFwzjWR8GpAgqVQPjPKbYU=/206x305/v2/https://resizing.flixster.com/28GXiQNuCMppxUUVe6sZ_MQXaUg=/ems.ZW1zLXByZC1hc3NldHMvbW92aWVzLzdkN2RhMjIxLWY0NDUtNGQ0ZS04ODZhLTFmMzQ5NmE4ZGYyZS53ZWJw,The LEGO NINJAGO Movie,10000,135,2017.0,Comedy/Kids and family,0 days 01:41:00.000000000,10
61,87,,Captain Underpants: The First Epic Movie,10000,134,2017.0,Animation/Comedy,0 days 01:29:00.000000000,26
68,23,https://resizing.flixster.com/FqoxDbZHJa_MZF_-iZ_kEw8GiKU=/206x305/v2/https://resizing.flixster.com/YsxX6wKP84zrftPH-bxaYIahWjk=/ems.ZW1zLXByZC1hc3NldHMvbW92aWVzLzE0NjAwZTRhLWI0NDQtNGEyYi1iYjZkLWVjOGZjYWI2NzdhMi53ZWJw,Birth of the Dragon,5000,53,2016.0,Action/Sports and fitness,0 days 01:31:00.000000000,-45
51,53,https://resizing.flixster.com/lCTJL9R3AAvelmo2iNzjnvixlaQ=/206x305/v2/https://resizing.flixster.com/vffoar4_1VzrH57EGklEyMf2eQc=/ems.ZW1zLXByZC1hc3NldHMvbW92aWVzL2E3NGI4Yzk1LTZjZjYtNGE4NS04YjkxLWI0MTAyMzQxOTBlNS53ZWJw,The Boss Baby,25000,180,2017.0,Animation/Comedy,0 days 01:37:00.000000000,2
42,90,/assets/pizza-pie/images/poster_default.c8c896e70c3.gif,Star Wars: The Last Jedi,100000,476,2017.0,Fantasy/Action,0 days 02:32:00.000000000,48
38,43,https://resizing.flixster.com/r9-Gjtdq3gUWK9zI7G22u1Rc_Fo=/206x305/v2/https://resizing.flixster.com/FOYMp_Fikk45gloX2qmXZX0Dks8=/ems.ZW1zLXByZC1hc3NldHMvbW92aWVzLzVhNjMxOWY3LTU2MTktNGM0ZS1iZTZjLWRlZmU1YTViMGJjNS53ZWJw,Pacific Rim Uprising,25000,258,2018.0,Fantasy/Action,0 days 01:51:00.000000000,5
38,83,https://resizing.flixster.com/D5AOCpIqCHYHvJgHfmYo1hqBKDw=/206x305/v2/https://resizing.flixster.com/KQkRDPThQlcmD7HarD0HXRUD3OI=/ems.ZW1zLXByZC1hc3NldHMvbW92aWVzLzE0N2U3YTA2LTcxMjItNDI1Yy04YTUwLWQwNGE1ZDU2MWM4MS53ZWJw,The Cleanse,500,23,2016.0,Comedy/Horror,0 days 01:21:00.000000000,45
87,85,https://resizing.flixster.com/oP_F1ucdzEJvfGwf3lcxUP7_IEg=/206x305/v2/https://resizing.flixster.com/7CsTxYUC9oxLtXmVVSpKp0UCos8=/ems.ZW1zLXByZC1hc3NldHMvbW92aWVzL2IyMWJmYzgxLWMxZGQtNDdjYS1iYTUzLTVkNmQ0YjJkODk1OC53ZWJw,Guardians of the Galaxy Vol. 2,100000,417,2017.0,Action/Fantasy,0 days 02:15:00.000000000,-2
69,75,https://resizing.flixster.com/f3x9F5ZOQO5NTrtgyvhHOSs6hdE=/206x305/v2/https://resizing.flixster.com/IkK6QaqYBwtBKbs2cKZU3CwDZz8=/ems.ZW1zLXByZC1hc3NldHMvbW92aWVzLzQ1MzFmMmM3LTZjYzYtNGY3MC05ODI2LTUxYWFkNDU1YzRjMS53ZWJw,Kong: Skull Island,50000,387,2017.0,Fantasy/Action,0 days 01:58:00.000000000,6
30,0,https://resizing.flixster.com/TdB9MPlegaoMgaCUErUdDrDDWCY=/206x305/v2/https://flxt.tmsimg.com/assets/p11082439_p_v8_aa.jpg,Saving Christmas,10000,19,2014.0,Other/Comedy,0 days 01:20:00.000000000,-30
79,98,https://resizing.flixster.com/SFsuqcpAEWinkl-iHEyyLGtEK4c=/206x305/v2/https://flxt.tmsimg.com/assets/p11606685_p_v10_ab.jpg,Court,500,60,2014.0,Drama,0 days 01:55:00.000000000,19
40,40,https://resizing.flixster.com/-bCKRH5dvQy2US_rXwfnPmZ7sfg=/206x305/v2/https://resizing.flixster.com/KCw_RRGHzQvkJNkcM-v-81y-BKs=/ems.ZW1zLXByZC1hc3NldHMvbW92aWVzLzgwOGIzZTgyLThlOTQtNGExNi04NTcxLWYxOWU1MmM5ZGIwMS53ZWJw,Casanova Variations,1,5,2014.0,Drama,0 days 01:58:00.000000000,0
50,35,,Kidnap,10000,94,2017.0,Mystery and thriller/Action,0 days 01:22:00.000000000,-15
83,93,https://resizing.flixster.com/pdX-tBUlkKrCrFbU_1x79VVxcU4=/206x305/v2/https://resizing.flixster.com/vKAav-oQBb-3HgIpH8Ke9D_2PSY=/ems.ZW1zLXByZC1hc3NldHMvbW92aWVzL2MxZDQ5MzJmLTMxMzMtNDQxYS1iNmNhLTE3NWFiN2Q1ZjFmZi53ZWJw,Wonder Woman,100000,463,2017.0,Action/Fantasy,0 days 02:21:00.000000000,10
76,46,https://resizing.flixster.com/aB4khYo4mvwpjd0oVEKkpiAvADM=/206x305/v2/https://resizing.flixster.com/_8S7fuTDuyWMgNqAjx8lCa2-MMM=/ems.ZW1zLXByZC1hc3NldHMvbW92aWVzLzQ2NGZhNGQyLThlOTAtNDM2OS04ZmJjLWJiZDlhZWZmODM2Ny53ZWJw,My Little Pony: The Movie,5000,65,2017.0,Comedy/Kids and family,0 days 01:39:00.000000000,-30
81,20,,Blood Ransom,500,5,2014.0,Romance/Mystery and thriller,0 days 01:41:00.000000000,-61
86,40,,Same Kind of Different as Me,2500,10,2017.0,Drama,0 days 01:59:00.000000000,-46
79,96,,Black Panther,50000,519,2018.0,Action/Fantasy,0 days 02:14:00.000000000,17
87,93,https://resizing.flixster.com/PaXG3aSyftFQymxjrQOzmC86vaI=/206x305/v2/https://resizing.flixster.com/bUks3oAqlmWdDCbYfiyUkZ5GNH4=/ems.ZW1zLXByZC1hc3NldHMvbW92aWVzLzI0NDdkYmJhLTY2MmEtNDY5My04MzMzLTFjMzZhYmM4MDkzZC53ZWJw,Thor: Ragnarok,50000,430,2017.0,Adventure/Fantasy,0 days 02:10:00.000000000,6
47,38,https://resizing.flixster.com/JYJxwRwjDWbuCn6J73QfaaEVQjg=/206x305/v2/https://resizing.flixster.com/kQuOycBlE2IGrpT64tON4ZwC82Y=/ems.ZW1zLXByZC1hc3NldHMvbW92aWVzLzBhODZkODBkLWZhZjUtNGU3Yi04MTkwLTkyNmZmYTVlYjZlNi53ZWJw,The Mountain Between Us,10000,173,2017.0,Romance/Drama,0 days 01:44:00.000000000,-9
86,57,https://resizing.flixster.com/wjSdnJOczagOlWi5iybrOKvbbE4=/206x305/v2/https://resizing.flixster.com/0YPly1Hs94e5hWRLqD60Mk2d5zU=/ems.ZW1zLXByZC1hc3NldHMvbW92aWVzL2RiNWFjZDQwLTNjNDktNDAzZS1iODc1LTIxZjRmMTdlZjlhNy53ZWJw,The Greatest Showman,25000,263,2017.0,History/Drama,0 days 01:45:00.000000000,-29
51,43,https://resizing.flixster.com/Bo1uyAiTv3s5kZvRT9Q-f6mPB8M=/206x305/v2/https://resizing.flixster.com/JQIhpISUCgpp4mHijGcThDUvLmY=/ems.ZW1zLXByZC1hc3NldHMvbW92aWVzLzNiZDkzYzUwLWJjYjItNGUzMS05OGUyLWZkMDRkZDcyMGUzYi53ZWJw,Ghost in the Shell,25000,296,2017.0,Action/Sci fi,0 days 01:47:00.000000000,-8
33,40,,Hackney's Finest,1,5,2014.0,Crime/Action,0 days 01:29:00.000000000,7
77,72,https://resizing.flixster.com/xZuA5q3Npvu4MhdMz6d_8NasHTs=/206x305/v2/https://resizing.flixster.com/358ZCkN4ogFsBOZGsVVeyW5_5o8=/ems.ZW1zLXByZC1hc3NldHMvbW92aWVzLzMwN2EyNzk3LWY1OTAtNGU4OS1hYmE3LWM4ODMyNWI0YTVkZi53ZWJw,Ready Player One,25000,437,2018.0,Fantasy/Action,0 days 02:20:00.000000000,-5
21,0,/assets/pizza-pie/images/poster_default.c8c896e70c3.gif,The Layover,1000,18,2016.0,Romance/Comedy,0 days 01:35:00.000000000,-21
58,43,,Maze Runner: The Death Cure,10000,171,2018.0,Mystery and thriller/Action,0 days 02:22:00.000000000,-15
37,11,https://resizing.flixster.com/KtP9H2JneSXbRt7Cb-doYCqyt7U=/206x305/v2/https://resizing.flixster.com/PN_LaALsWm2P4K8IVFbKBhUlrWc=/ems.ZW1zLXByZC1hc3NldHMvbW92aWVzLzEzZGUzNDIxLWFhYzYtNGNkMy04ZDAxLTU2NTUxZWI3ZjE5ZS53ZWJw,Fifty Shades Freed,5000,195,2018.0,Romance/Drama,0 days 01:45:00.000000000,-26
78,86,https://resizing.flixster.com/8IBQCSSLYzLlQA4QJA7elsxt1Vc=/206x305/v2/https://resizing.flixster.com/59a9W4u5nyw3BXmTlcf_EsWB2EI=/ems.ZW1zLXByZC1hc3NldHMvbW92aWVzLzZiMGNhOTdjLTA3MGYtNDk4Yi1iYzMxLTJkNjhhZTNkNGY3OC53ZWJw,American Made,25000,269,2017.0,Comedy/Drama,0 days 01:55:00.000000000,8
32,0,,Age of Kill,1,6,2015.0,Action,0 days 01:26:00.000000000,-32
41,42,https://resizing.flixster.com/5op7Otyle_2j24YE9ILSjb0Z9rE=/206x305/v2/https://resizing.flixster.com/UWWRiVYcSY_NJYyECNrIQCnWQwE=/ems.ZW1zLXByZC1hc3NldHMvbW92aWVzLzQ3ZTA1OTU4LTY5YzUtNDFkNi1iZWJhLWZjM2YyODMzODIzOC53ZWJw,Goon: Last of the Enforcers,2500,62,2017.0,Comedy,0 days 01:41:00.000000000,1
53,47,https://resizing.flixster.com/e_aHqNf5BYMB4gVgHRMukNAifEY=/206x305/v2/https://resizing.flixster.com/hB6Qb5Eb7-PPeKR2hPgOYAnuwTs=/ems.ZW1zLXByZC1hc3NldHMvbW92aWVzLzUwM2EwYjkwLWU0ZjAtNDQ0Ni05NzZkLTU1NTYzN2YzMGZhNi53ZWJw,Valerian and the City of a Thousand Planets,25000,295,2017.0,Action/Sci fi,0 days 02:17:00.000000000,-6
100,64,https://resizing.flixster.com/iFkA9xe3LD19JEJy-Z_wZ5CsI64=/206x305/v2/https://flxt.tmsimg.com/assets/p12825856_p_v10_aa.jpg,Sin Alas,50,11,2015.0,Drama,0 days 01:30:00.000000000,-36
43,29,https://resizing.flixster.com/XNHY1VDKVRlaI6IOEtl-4P-X_ME=/206x305/v2/https://resizing.flixster.com/1jPYPmraOaOuEGI5Sz0rmyEtFiw=/ems.ZW1zLXByZC1hc3NldHMvbW92aWVzL2VkMTZiODk2LWUxZTktNDA3NS04MzI4LWJjMzg3Yjc5NTUyZC53ZWJw,Pitch Perfect 3,10000,149,2017.0,Comedy/Musical,0 days 01:34:00.000000000,-14
71,90,https://resizing.flixster.com/TXD5VN26PPMIcsFGS8YcvVZPU1Q=/206x305/v2/https://flxt.tmsimg.com/assets/p11874202_p_v10_ac.jpg,Thank You for Playing,100,10,2015.0,Biography,0 days 01:20:00.000000000,19
21,15,https://resizing.flixster.com/_A_lpGrgbWIL83RHEAt6w0ZdAQI=/206x305/v2/https://resizing.flixster.com/PnbAWEHC-6hkI7BVtouZdLaPQ6M=/ems.ZW1zLXByZC1hc3NldHMvbW92aWVzLzZlNDEyMmU3LWY3MTEtNDVlMS05MWFkLTZlYmY4YzJlZGM4Yi53ZWJw,The Circle,10000,144,2017.0,Drama/Mystery and thriller,0 days 01:50:00.000000000,-6
54,58,,LBJ,2500,85,2016.0,Drama/History,0 days 01:38:00.000000000,4
33,8,https://resizing.flixster.com/ytpjDn4xhJnrpRq_5-JKkxkM72I=/206x305/v2/https://resizing.flixster.com/EaCP9OGEdMGwTDlw5Qg9vZ-ROLE=/ems.ZW1zLXByZC1hc3NldHMvbW92aWVzLzQyOTUzYzU1LWY4ZTctNDc1NS1iMTA0LTZiZDEwZjMzYmI0Mi53ZWJw,The Last Face,500,49,2016.0,Drama,0 days 02:11:00.000000000,-25
80,87,https://resizing.flixster.com/ZJux7mkgyuVnFw7eq3nltLeepHE=/206x305/v2/https://resizing.flixster.com/MEklkRymjuQcWlR0rS7idEGrYxU=/ems.ZW1zLXByZC1hc3NldHMvbW92aWVzLzk2OWY1MzE0LThkZjAtNGE1ZS04ZjNlLWE2YmNjZGVkNTA3YS53ZWJw,First They Killed My Father,1000,71,2017.0,Drama/History,0 days 02:16:00.000000000,7
86,92,https://resizing.flixster.com/bqbhmZLVtUaUrdyNBqLzPKqLGeY=/206x305/v2/https://resizing.flixster.com/wcnZwJKjL2YL-NNi_WJ3fd7Ku8g=/ems.ZW1zLXByZC1hc3NldHMvbW92aWVzL2QwZmU3ZDZlLTRhMmItNDgxMy04NjM1LWViNmE3ZjkzNjhkNC53ZWJw,Baby Driver,50000,389,2017.0,Action/Mystery and thriller,0 days 01:53:00.000000000,6
87,76,https://resizing.flixster.com/fL5VSwphpTqxDge29x39CcCf-bs=/206x305/v2/https://resizing.flixster.com/PXVW-3qa3ZOWceSBKQ-lT0J_3eU=/ems.ZW1zLXByZC1hc3NldHMvbW92aWVzLzA3NTEzOWU0LThkYWQtNDI3Mi05ZThjLWVlMzdhMDc4ZDMzNi53ZWJw,Jumanji: Welcome to the Jungle,25000,235,2017.0,Action/Fantasy,0 days 01:59:00.000000000,-11
70,42,https://resizing.flixster.com/bq-YefAtImiyq5J48LlIJcX_X6s=/206x305/v2/https://resizing.flixster.com/KwfnrFuagBWscUeaBsRIRaKwGBk=/ems.ZW1zLXByZC1hc3NldHMvbW92aWVzLzljYTE0Nzc1LTU5MDYtNDA5OC1iZTNjLTFjYzE4YjQ0MmQ3Ny53ZWJw,The Star,2500,52,2017.0,Other/Adventure,0 days 01:26:00.000000000,-28
34,18,https://resizing.flixster.com/h5LWBQbh3g4TIZv3mBWPOCCf9QI=/206x305/v2/https://resizing.flixster.com/x_uXhWsLk-fkMwVZ4QirA2d2jPw=/ems.ZW1zLXByZC1hc3NldHMvbW92aWVzLzhkMDhhYjhiLWNjMjktNDFkMi04ZTEzLTU1ODkxYzMzMWQzYS53ZWJw,Queen of the Desert,1000,79,2015.0,Drama/History,0 days 02:08:00.000000000,-16
15,17,,The Titan,500,29,2017.0,Sci fi/Romance,0 days 01:37:00.000000000,2
64,92,https://resizing.flixster.com/Q-HkJF0u-_vylX-TK3Ray2Of7AU=/206x305/v2/https://resizing.flixster.com/Q4E8AK7Q8TV-uyE6A58g8bSZS9E=/ems.ZW1zLXByZC1hc3NldHMvbW92aWVzLzM4ODdmYzUzLWViNWItNDI1Mi05N2RlLWI0N2E1ZmUwYjc3MC53ZWJw,The Devil's Candy,5000,51,2015.0,Horror/Mystery and thriller,0 days 01:20:00.000000000,28
94,97,,Coco,25000,347,2017.0,Comedy/Kids and family,0 days 01:49:00.000000000,3
62,29,https://resizing.flixster.com/WGPvapVh5WiQkUnQ5NyfDT6sO6Y=/206x305/v2/https://resizing.flixster.com/z3rtFGF4QFv9_IT44gLb9nnDjKo=/ems.ZW1zLXByZC1hc3NldHMvbW92aWVzLzU0N2JiOGM4LWZlMWItNDExOS04ZWQzLTMwMGYyMDU3ZGJiOS53ZWJw,Rebel in the Rye,500,89,2017.0,Drama/History,0 days 01:46:00.000000000,-33
67,13,https://resizing.flixster.com/sMboqU_-I1fhEAivu3hTosF6rPk=/206x305/v2/https://resizing.flixster.com/vqJvDsgJJUuYCQnFUBaW4iLfD-E=/ems.ZW1zLXByZC1hc3NldHMvbW92aWVzLzZiMzM5OWExLTU3ZDItNGFjZS1iMTQzLTgwZTQxYjJkODEzZC53ZWJw,Brain on Fire,500,16,2016.0,Drama/Biography,0 days 01:35:00.000000000,-54
75,87,,Sleeping Giant,250,23,2015.0,Drama,0 days 01:29:00.000000000,12
55,92,https://resizing.flixster.com/8KR0_yD-NK2ggUvq5uFin5MLEoc=/206x305/v2/https://resizing.flixster.com/beY8D6f4_8IL6oSSrpMXGmydqd8=/ems.ZW1zLXByZC1hc3NldHMvbW92aWVzLzA4NzkxMjJjLWQxYjAtNDdjNi1hZGEyLWI2OThkNWEzNjQ0Yi53ZWJw,Demon,1000,71,2015.0,Horror/Mystery and thriller,0 days 01:34:00.000000000,37
81,92,https://resizing.flixster.com/-O33A0udc47to3YGKWRd_NQ28Qk=/206x305/v2/https://resizing.flixster.com/EELTBoC1bnQ2xZ-Sfbja5hKvvg8=/ems.ZW1zLXByZC1hc3NldHMvbW92aWVzLzYxYjZlMDAwLWQxZTctNDYyNS04YTRlLTc5YjcxY2VmYmFlZC53ZWJw,Dunkirk,50000,458,2017.0,History/War,0 days 01:47:00.000000000,11
61,72,https://resizing.flixster.com/tYqprvaFnwfu1ICI2KpkeS6KNbA=/206x305/v2/https://resizing.flixster.com/KNYrOq1uPzeyQHN4EWvGqenLGok=/ems.ZW1zLXByZC1hc3NldHMvbW92aWVzLzQ4ZTgwNGU5LWY1N2YtNGJiZi05OTdlLWUyZDU4Y2Y1YWE0Yy53ZWJw,The Babysitter,1000,29,2017.0,Comedy/Horror,0 days 01:25:00.000000000,11
24,17,,Father Figures,2500,48,2017.0,Comedy,0 days 01:53:00.000000000,-7
84,85,https://resizing.flixster.com/EGrzAh8q1m1TLwnICXJqoqL5-Mg=/206x305/v2/https://flxt.tmsimg.com/assets/p12132902_p_v10_ag.jpg,The Music of Strangers: Yo-Yo Ma & the Silk Road Ensemble,1000,59,2015.0,Documentary/Music,0 days 01:36:00.000000000,1
40,55,,The Commuter,5000,213,2018.0,Action/Mystery and thriller,0 days 01:44:00.000000000,15
85,73,,Gifted,10000,179,2017.0,Drama,0 days 01:41:00.000000000,-12
62,90,,Marjorie Prime,1000,91,2017.0,Sci fi/Comedy,0 days 01:39:00.000000000,28
69,69,,Cars 3,25000,230,2017.0,Animation/Comedy,0 days 01:49:00.000000000,0
80,90,https://resizing.flixster.com/uFEUyvGgw4XwLQeBuX7L3il2p0I=/206x305/v2/https://resizing.flixster.com/rMMn_oZ1TMbIThlcpGbL3mCQOnY=/ems.ZW1zLXByZC1hc3NldHMvbW92aWVzLzE0YTBmNDM3LWIzZmYtNDczZi05ZDc3LWY3ZDU0NDE1Mzk4MS53ZWJw,Stronger,10000,193,2017.0,Drama/Biography,0 days 01:59:00.000000000,10
66,96,https://resizing.flixster.com/90QNEe0DCCiPhp_-5C8GEJBZEnw=/206x305/v2/https://resizing.flixster.com/BjaJuvaAD44OvHMRBZPf7OJAhiY=/ems.ZW1zLXByZC1hc3NldHMvbW92aWVzL2VmODk5MWU4LTc2MmQtNDVjYy1hYWQ0LTE1NWIwNzgwNzFlNS53ZWJw,The Survivalist,5000,45,2015.0,Drama/Mystery and thriller,0 days 01:44:00.000000000,30
59,81,https://resizing.flixster.com/XKcY-0btlMgAn0eJQcMmi3OUHVA=/206x305/v2/https://resizing.flixster.com/jTLs2S9zVFcwNOTiHWPXfe54mOg=/ems.ZW1zLXByZC1hc3NldHMvbW92aWVzL2FmN2MwMzI1LTVkOWItNDc3Mi1hN2M2LWQzZTc0Y2FkMjRjMC53ZWJw,Colossal,10000,260,2016.0,Fantasy/Comedy,0 days 01:50:00.000000000,22
64,78,https://resizing.flixster.com/t77F5vDXf9ne4r3OmpSyMIXxwOk=/206x305/v2/https://resizing.flixster.com/r5-FqZlmyYwikdcOaBsMNAvT764=/ems.ZW1zLXByZC1hc3NldHMvbW92aWVzL2Q2MmI4ZDI5LWYwZDktNDQ1OC1hMjc1LTNjMTNjMTE0ODk0ZS53ZWJw,Atomic Blonde,25000,362,2017.0,Action/Mystery and thriller,0 days 01:55:00.000000000,14
64,51,https://resizing.flixster.com/Ef2FjBL2Qc5jbiInmFsW1juDBr0=/206x305/v2/https://resizing.flixster.com/h3pXs6sPC2D4QZbV-wD3sB2g6mA=/ems.ZW1zLXByZC1hc3NldHMvbW92aWVzLzVhY2I1NGQwLWE2MzItNDhmYy05NmRjLWEyZjM4YWM2ZmYzOS53ZWJw,Kingsman: The Golden Circle,25000,307,2017.0,Adventure/Comedy,0 days 02:21:00.000000000,-13
30,36,https://resizing.flixster.com/2J50XdH8js-7sf27AO_I6jnalSc=/206x305/v2/https://resizing.flixster.com/DpSqRx2OjD-e0qaN2A3Cy8bJru8=/ems.ZW1zLXByZC1hc3NldHMvbW92aWVzLzg4ZmJhMjYwLThjNzctNGE5ZS1hOTRhLWQ2YzdkMGVlNmQwNi53ZWJw,Snatched,10000,213,2017.0,Comedy/Adventure,0 days 01:30:00.000000000,6
89,97,https://resizing.flixster.com/nwFySnDUGQ_985zWXJhS0MN519o=/206x305/v2/https://resizing.flixster.com/FAIDA3fCw5xnz2r_IuNKjIitH0I=/ems.ZW1zLXByZC1hc3NldHMvbW92aWVzLzYxZTE2NmQyLWJiNzgtNDNhNi05ZDE5LWVjNWU5ZmNlMDgzNi53ZWJw,Harold and Lillian: A Hollywood Love Story,100,33,2015.0,Documentary,0 days 01:34:00.000000000,8
56,70,,Buster's Mal Heart,1000,50,2016.0,Drama/Mystery and thriller,0 days 01:38:00.000000000,14
28,14,,Top Cat Begins,100,7,2015.0,Animation/Comedy,0 days 01:29:00.000000000,-14
39,36,https://resizing.flixster.com/NDkhXJFYTou3-9uCpc6Nfj0TCso=/206x305/v2/https://resizing.flixster.com/l81CsAGZWe4DdQPF1btYWCWr0s4=/ems.ZW1zLXByZC1hc3NldHMvbW92aWVzL2ViM2ViMWUxLTVlYjgtNDJiNC05ZTM0LTEyMDZiMzIwMTZiOC53ZWJw,Mark Felt: The Man Who Brought Down the White House,1000,115,2017.0,Drama/History,0 days 01:43:00.000000000,-3
67,43,https://resizing.flixster.com/yek1x5nPDKqKuvAE24w735d8ifU=/206x305/v2/https://resizing.flixster.com/vuxJNOALMSObgd4RMyfnDDDnYQA=/ems.ZW1zLXByZC1hc3NldHMvbW92aWVzLzg5ZDZkOGJmLTUwNDItNDIxOS1iMDRjLTE3YjRjZDNkYjRkOC53ZWJw,The Hitman's Bodyguard,25000,225,2017.0,Action/Comedy,0 days 01:58:00.000000000,-24
35,20,https://resizing.flixster.com/byJ9MVuNlEHQi_o1-u7PpwMKM_8=/206x305/v2/https://resizing.flixster.com/OyS5On3Jk2PVM9JPOiThWpS4kRw=/ems.ZW1zLXByZC1hc3NldHMvbW92aWVzL2EwNTkwNzRkLWNiM2YtNDFhMS05NjVkLTZkZTZlZjBhYTU3OS53ZWJw,The House,10000,82,2017.0,Comedy,0 days 01:28:00.000000000,-15
35,27,https://resizing.flixster.com/m5qCFIWeXU6GWncNJay_Fe1S8oI=/206x305/v2/https://resizing.flixster.com/URU3uaz_RbYsAKeCcSYVOCZmmrQ=/ems.ZW1zLXByZC1hc3NldHMvbW92aWVzL2RkM2MwMGU2LTM5OGUtNDlhYS04ZDBlLTAzNWU2Mjg1N2FlOS53ZWJw,Sherlock Gnomes,1000,67,2018.0,Comedy/Kids and family,0 days 01:26:00.000000000,-8
52,69,https://resizing.flixster.com/_-56rSb5W-B33F1hMwHRTqqh1n4=/206x305/v2/https://resizing.flixster.com/HYChRlHYAqDkZZxMGoGt9-oxB58=/ems.ZW1zLXByZC1hc3NldHMvbW92aWVzLzRhZjBhZGQ1LTEzYTUtNDI4OC05MjNmLWE1MWFjNWVmYzY3OS53ZWJw,Free Fire,5000,236,2016.0,Action/Comedy,0 days 01:26:00.000000000,17
71,85,,Battle of the Sexes,10000,313,2017.0,Comedy/Drama,0 days 02:01:00.000000000,14
55,68,https://resizing.flixster.com/4qGo6WzpEmew65iwRMM6tuhNVNU=/206x305/v2/https://resizing.flixster.com/N_0dJ2G64-bnfq5cEVFRLB9vo9c=/ems.ZW1zLXByZC1hc3NldHMvbW92aWVzL2ZlYjNlOTI1LTIyMmItNDdkZC05MDcwLTc1ZWIxMDVjNjEyNy53ZWJw,Wonderstruck,2500,225,2017.0,Drama/Adventure,0 days 01:57:00.000000000,13
63,22,https://resizing.flixster.com/6n58s8DPSbNj7zl89uAERPsvEUE=/206x305/v2/https://resizing.flixster.com/klKeoV7mpuxRtp-J4MJrS248040=/ems.ZW1zLXByZC1hc3NldHMvbW92aWVzL2E3MzExMjM0LWM0NDktNDgxZC05ZWVmLTBhZDMxODBkYzk2Zi53ZWJw,The Book of Henry,5000,146,2017.0,Drama/Mystery and thriller,0 days 01:40:00.000000000,-41
46,22,https://resizing.flixster.com/xiWGigS_1rlS6FGu1ZXX6uTqDPg=/206x305/v2/https://resizing.flixster.com/IQTVMTn0np1kkhx9i6B-Zk5TXMg=/ems.ZW1zLXByZC1hc3NldHMvbW92aWVzLzYyMTM0MDQ2LWMzNGItNDAxNy04NmVlLTI2NTVhNzRiM2EyMC53ZWJw,Step Sisters,100,9,2018.0,Comedy,0 days 01:44:00.000000000,-24
53,60,https://resizing.flixster.com/LfFddIwWu8uPfF3Vo6gmjl9Lv5U=/206x305/v2/https://resizing.flixster.com/213atPAigjlibYPVxQMgRPH91Sk=/ems.ZW1zLXByZC1hc3NldHMvbW92aWVzLzdhYzBkZGJkLTJiZWYtNGNiYS04NTYyLTA1MjczMTljZjhiOC53ZWJw,Murder on the Orient Express,25000,295,2017.0,Crime/Drama,0 days 01:54:00.000000000,7
76,50,,The Legend of Ben Hall,100,12,2016.0,Drama/Western,0 days 02:19:00.000000000,-26
85,91,/assets/pizza-pie/images/poster_default.c8c896e70c3.gif,The Disaster Artist,10000,348,2017.0,Drama/Comedy,0 days 01:43:00.000000000,6
41,95,https://resizing.flixster.com/DiRT_gkuUGHRD4k5_R2i5GGar1o=/206x305/v2/https://resizing.flixster.com/Crzpw1weeG3JlvSxtxU297kuzsc=/ems.ZW1zLXByZC1hc3NldHMvbW92aWVzLzFlNDQ2ZDU1LTZjOWUtNDMxNi1hNmY0LTUwYWI2YmFmZmQ0Yy53ZWJw,The Treasure,500,37,2015.0,Comedy,0 days 01:29:00.000000000,54
16,46,https://resizing.flixster.com/4bk0L5ts_jLLEFyIPSMToatfBxM=/206x305/v2/https://resizing.flixster.com/kqOBYbh3kOERAi4uDoX5qNscoPM=/ems.ZW1zLXByZC1hc3NldHMvbW92aWVzLzk1YmE1YjQyLTRmODAtNDk4MC04YzE3LTc2OGNlNzE3ZWVkMy53ZWJw,The Dinner,1000,142,2017.0,Drama/Mystery and thriller,0 days 02:00:00.000000000,30
56,63,https://resizing.flixster.com/O5MmGjNkq0MLDT0lPNG5jtNmbOA=/206x305/v2/https://resizing.flixster.com/BoljEONgoO0lSkM7_fpjxoTx95M=/ems.ZW1zLXByZC1hc3NldHMvbW92aWVzLzU0YmY4NTExLTA2MzktNDBkNS1iZDFkLWM5Y2JmYWM3NjdhNi53ZWJw,Peter Rabbit,2500,146,2018.0,Fantasy/Comedy,0 days 01:35:00.000000000,7
51,92,,Certain Women,5000,192,2016.0,Drama,0 days 01:47:00.000000000,41
52,83,https://resizing.flixster.com/ustvtaVEFxto089tBTaRTqfWL9g=/206x305/v2/https://resizing.flixster.com/kRe7ZSsfKYov9uQJMdrzBE-eAnw=/ems.ZW1zLXByZC1hc3NldHMvbW92aWVzLzhjZDY5YTE5LTcwZGItNGQ0Zi04N2EzLTU2M2M1ODYwNGJjNC53ZWJw,Kiki,250,29,2016.0,Documentary/Gay and lesbian,0 days 01:35:00.000000000,31
52,78,https://resizing.flixster.com/stfKSfTVJv8oi35OEfaPXPTYs7o=/206x305/v2/https://resizing.flixster.com/0Aph2clu9sKeP028VpcHICStoko=/ems.ZW1zLXByZC1hc3NldHMvbW92aWVzLzQwNjJiZGU5LTg0MGUtNGM2MS1hZjM0LWRmYjg2Yzk3NTllNi53ZWJw,Sleight,5000,45,2016.0,Drama/Mystery and thriller,0 days 01:30:00.000000000,26
84,80,https://resizing.flixster.com/5FSAXfaiSUUMne1c_16LE7WHuhA=/206x305/v2/https://resizing.flixster.com/basLe6Jf9jT-GSmS2Df9Xbi-YSo=/ems.ZW1zLXByZC1hc3NldHMvbW92aWVzLzEwODlmZmVjLTRlYjgtNDNjMy04MzA0LWVlZDI3MzkwOTllOC53ZWJw,Marshall,5000,148,2017.0,Drama/History,0 days 01:58:00.000000000,-4
43,15,https://resizing.flixster.com/mLUE4HQtYLRVTg6xPR0W02OglOg=/206x305/v2/https://resizing.flixster.com/E4_L4F0gBioB4edo03-Bp5fuP7M=/ems.ZW1zLXByZC1hc3NldHMvbW92aWVzLzQ4NTAyMjM3LWNhZWYtNDc4ZC1iMGQ4LThiYzVhZGM2YjFmZS53ZWJw,Transformers: The Last Knight,25000,252,2017.0,Fantasy/Action,0 days 02:28:00.000000000,-28
84,81,https://resizing.flixster.com/BJdgJrCDQcOoIkqUfmU2dFqPvUo=/206x305/v2/https://resizing.flixster.com/ap-OjvQ_bBMq_Wg6lMY8qvs6Z3o=/ems.ZW1zLXByZC1hc3NldHMvbW92aWVzLzEzNzEwNzIwLTg5NTctNDQ2ZS1iODhjLWJjOTBkMTE4NzJiZS53ZWJw,Molly's Game,10000,299,2017.0,Drama/Biography,0 days 02:21:00.000000000,-3
51,68,https://resizing.flixster.com/-gVaOLHQnrhCT6zv9P4GjpetoNE=/206x305/v2/https://flxt.tmsimg.com/assets/p13809835_p_v10_ao.jpg,mother!,25000,376,2017.0,Horror/Mystery and thriller,0 days 02:00:00.000000000,17
69,18,https://resizing.flixster.com/NkIO0xom3RlObB-MHVOilocP44U=/206x305/v2/https://resizing.flixster.com/7lMukeKGiiaT0BA6YdnGCGFY_CQ=/ems.ZW1zLXByZC1hc3NldHMvbW92aWVzLzJmMWYyMjlkLTU4ODYtNGUzOC04ZjVhLTYxNzhjYTljNGU5Yi53ZWJw,Baywatch,10000,245,2017.0,Action/Comedy,0 days 01:56:00.000000000,-51
48,38,,Backstabbing for Beginners,100,24,2018.0,Drama/Mystery and thriller,0 days 01:48:00.000000000,-10
79,99,https://resizing.flixster.com/CmD0J-DN-uBKKJeMbhz6po38fso=/206x305/v2/https://resizing.flixster.com/1f9bH_99aSYNgLROtrUDzyuN8ek=/ems.ZW1zLXByZC1hc3NldHMvbW92aWVzLzI4MjU0NjdiLTMwYTQtNDVmNy1hYjdjLWYwNTk5NTc0MGQ3MC53ZWJw,Lady Bird,10000,394,2017.0,Comedy/Drama,0 days 01:34:00.000000000,20
35,37,,Anon,500,49,2018.0,Sci fi/Mystery and thriller,0 days 01:40:00.000000000,2
28,17,https://resizing.flixster.com/YCNKuI_J-uSSGaJ8fI60nYigdMw=/206x305/v2/https://resizing.flixster.com/wccqLLGpqcgaRUywCicCpPwHppo=/ems.ZW1zLXByZC1hc3NldHMvbW92aWVzL2ZhMTNiOGM1LTZkZjUtNDAwMy1iNDg1LWIwNmU4NmZmMWEwMy53ZWJw,Unfriend,5000,76,2016.0,Horror/Mystery and thriller,0 days 01:32:00.000000000,-11
57,47,https://resizing.flixster.com/VtByHt3AIfm3G8eHHSSfWgGsdfo=/206x305/v2/https://resizing.flixster.com/_o1B5OygRvYt3qAA25M8CIlQmPY=/ems.ZW1zLXByZC1hc3NldHMvbW92aWVzLzMwZWFhMGYyLTUyYjItNGJiNi05ZTg2LTVlNjI2OTNiN2Y2OS53ZWJw,Going in Style,10000,171,2017.0,Comedy,0 days 01:36:00.000000000,-10
22,0,,Showdown in Manila,1,6,2016.0,Action,0 days 01:26:00.000000000,-22
81,88,https://resizing.flixster.com/CQTOIexk1A3T4J3d6iTItWb3fsM=/206x305/v2/https://resizing.flixster.com/JSQhj07oIhsYdTaPu6iZ_ldKJa8=/ems.ZW1zLXByZC1hc3NldHMvbW92aWVzL2RlNzI0MGQyLTQ2ZTktNGMyYi05N2VmLTFjMDhiY2VlMDQ2Ni53ZWJw,Blade Runner 2049,50000,439,2017.0,Sci fi/Mystery and thriller,0 days 02:44:00.000000000,7
75,70,https://resizing.flixster.com/_xdlnj7ULWpda2h89IjGQMCB_yw=/206x305/v2/https://resizing.flixster.com/TOVL4BwFA1UP01VF_PEQcqQZa6A=/ems.ZW1zLXByZC1hc3NldHMvbW92aWVzLzFmZTAyYTZkLWZmOWQtNDdkZS05NTNiLTAxMWRiYWI0NDU3MC53ZWJw,Hostiles,5000,223,2017.0,Western/Drama,0 days 02:13:00.000000000,-5
26,42,https://resizing.flixster.com/c1qw9GgmM6HS8AAQIzULFFkhcKc=/206x305/v2/https://resizing.flixster.com/H_dh-w7ebHDfJQjAK7iUBE2vKl8=/ems.ZW1zLXByZC1hc3NldHMvbW92aWVzL2Q3YTA0NzVlLWRkM2UtNDAyZS05MWViLTNjOGFhMDAyZGIxNy53ZWJw,A Wrinkle in Time,5000,338,2018.0,Kids and family/Fantasy,0 days 01:49:00.000000000,16
49,76,https://resizing.flixster.com/Oh8umoDmpsYNjrNYnK2e0SRiI9I=/206x305/v2/https://resizing.flixster.com/2SVvpf5CAtXDiOLmqvh3d63KvXM=/ems.ZW1zLXByZC1hc3NldHMvbW92aWVzLzFiZjM3OWE2LTNmNzgtNGNhOC1iMTE2LTAzZmMxYjMxODY4NC53ZWJw,Una,1000,110,2016.0,Drama,0 days 01:36:00.000000000,27
67,80,,Eva Hesse,100,20,2016.0,Documentary/Drama,0 days 01:45:00.000000000,13
99,55,https://resizing.flixster.com/4f4Jq-tnApqKqfI-4PVFQIZCBU4=/206x305/v2/https://resizing.flixster.com/ZD4A9BTmAe1dqNQILIcGxauAeTI=/ems.ZW1zLXByZC1hc3NldHMvbW92aWVzL2Y3MzVkMjA1LWNhZTItNGNmNi1hNjA1LWVkMDI5YTRmNjM2OC53ZWJw,Pali Road,1000,11,2015.0,Romance/Drama,0 days 01:32:00.000000000,-44
51,100,https://resizing.flixster.com/Yc1WQhh26l0kfzXH9vUjklQ20Vw=/206x305/v2/https://resizing.flixster.com/QeVquk28WT3K0G8Qv3HkElAyjtw=/ems.ZW1zLXByZC1hc3NldHMvbW92aWVzLzYyNzZjM2Q3LTIxYjctNGU4OS05ZDdhLWVkNGZhNDM2YTZkZS53ZWJw,Teenage Cocktail,250,5,2016.0,Gay and lesbian/Drama,0 days 01:28:00.000000000,49
23,47,https://resizing.flixster.com/HJ3Lu0WCdCUuNU5SKqapA-OAS1Y=/206x305/v2/https://resizing.flixster.com/VHF7oI5XDyHK-WsUdV2RePnN634=/ems.ZW1zLXByZC1hc3NldHMvbW92aWVzL2NkMzljODM0LWQ5MjQtNDA4Yi1hZTkyLTJlNjUxNWIyNGJiOS53ZWJw,Downsizing,5000,300,2017.0,Sci fi/Fantasy,0 days 02:15:00.000000000,24
67,91,,Miss Stevens,500,23,2016.0,Comedy/Drama,0 days 01:25:00.000000000,24
49,66,https://resizing.flixster.com/nt7ZaqYWUyBtCHMpKlrTFpAy5mg=/206x305/v2/https://resizing.flixster.com/djaoJn8V6ifQA91v0qDoxiZSn0U=/ems.ZW1zLXByZC1hc3NldHMvbW92aWVzL2VmOWU5ZGRiLTJmYjItNGUxNy1hMjEyLTRiY2MxZWRkNmJlMy53ZWJw,The Polka King,250,35,2017.0,Comedy/Drama,0 days 01:35:00.000000000,17
60,34,https://resizing.flixster.com/qTH71EIVSr3hnOHfVSWsNK2cwVI=/206x305/v2/https://resizing.flixster.com/6dSQMsj3jyCHfMUyCpoAhSADbbg=/ems.ZW1zLXByZC1hc3NldHMvbW92aWVzL2VhOTRjZWM4LTk1YTEtNGRlYi1hZTc2LTc1NjJlZDI0NjA3Ny53ZWJw,American Assassin,10000,178,2017.0,Action/Mystery and thriller,0 days 01:51:00.000000000,-26
65,84,,Mayhem,1000,61,2017.0,Action/Horror,0 days 01:26:00.000000000,19
87,90,,"Three Billboards Outside Ebbing, Missouri",10000,406,2017.0,Crime/Comedy,0 days 01:55:00.000000000,3
33,28,https://resizing.flixster.com/jlBHWO2_Mol792nMMSJB78M1aOA=/206x305/v2/https://resizing.flixster.com/tSDTd0ITMf9SDH5mTqkEntFvXyw=/ems.ZW1zLXByZC1hc3NldHMvbW92aWVzLzA0MWM2ZDYxLTM2NzgtNDc3MC05NmU2LTRhNWY4OWMyNjVjMi53ZWJw,Unforgettable,5000,119,2017.0,Mystery and thriller,0 days 01:40:00.000000000,-5
67,71,,Annabelle: Creation,10000,189,2017.0,Horror/Mystery and thriller,0 days 01:49:00.000000000,4
83,28,https://resizing.flixster.com/4eK1pLhYIys02V0_ceuV78pHb-4=/206x305/v2/https://resizing.flixster.com/ChZoaHjyx-JrL8iyqUK5CMK_2jM=/ems.ZW1zLXByZC1hc3NldHMvbW92aWVzLzg2ZTg5NGRjLWI2MzAtNGM5OC1iZjhlLWE2ZDFlYjRhODI4Yy53ZWJw,Bright,10000,112,2017.0,Action/Fantasy,0 days 01:57:00.000000000,-55
17,100,,Everybody Knows... Elizabeth Murray,1,6,2016.0,Documentary,0 days 01:00:00.000000000,83
62,91,https://resizing.flixster.com/uoH_cWCrzwBjs-ptAH8lI8b1b2s=/206x305/v2/https://resizing.flixster.com/LYD-B3i_RHvQT9rjqSWyIaDYjoA=/ems.ZW1zLXByZC1hc3NldHMvbW92aWVzLzAyOWYzNDQ3LWQwMTUtNGQ2OC05MjVjLWY3ODcxYjc1NjEwNS53ZWJw,Do Not Resist,250,44,2016.0,Documentary,0 days 01:13:00.000000000,29
79,100,https://resizing.flixster.com/2VapX4Yjrcq2Q8yM_RWsK4-P1c8=/206x305/v2/https://resizing.flixster.com/vqFZU53EYz5h62hou0Gh4NsHfLE=/ems.ZW1zLXByZC1hc3NldHMvbW92aWVzLzFjMjJkYjQyLWZhYzQtNDRiMy05MzI5LTI4NDhhMzhlMWM4OS53ZWJw,Betting on Zero,500,16,2016.0,Documentary,0 days 01:39:00.000000000,21
71,67,https://resizing.flixster.com/2MJx4AB1S5A2L_AruFjPCj7UkgE=/206x305/v2/https://resizing.flixster.com/wWOEBuENid4Yf2W_NZjdx5AIUvk=/ems.ZW1zLXByZC1hc3NldHMvbW92aWVzL2MwYjQ1YjlhLTEzN2EtNDhjMi1hZjliLTEyMWM2MTI4Yjg3MC53ZWJw,A Futile and Stupid Gesture,500,43,2018.0,Comedy/Biography,0 days 01:41:00.000000000,-4
45,33,,Wolves,100,27,2016.0,Drama,0 days 01:50:00.000000000,-12
62,65,https://resizing.flixster.com/SKxSEElbrNYIHQP2aMaujCCzw48=/206x305/v2/https://resizing.flixster.com/kYcaazBMWcq4wU3TWNYoZ6o4lyA=/ems.ZW1zLXByZC1hc3NldHMvbW92aWVzL2I5OWZiODY5LTlmYWUtNDQ3Ni1hYWNmLTZhZWRlOTQxZjY5NC53ZWJw,The Final Master,250,20,2015.0,Action/Drama,0 days 01:49:00.000000000,3
74,86,https://resizing.flixster.com/4yDVgdeolwe7ecs0LfoHO3BLdwc=/206x305/v2/https://resizing.flixster.com/Dzqvw-K18lA81sJ5RpTqDBCppBI=/ems.ZW1zLXByZC1hc3NldHMvbW92aWVzLzIwZmFiM2VjLTY2NDgtNGEzMC04ZGQ1LTRhY2U3NjM3ZjFjMy53ZWJw,Shin Godzilla,5000,73,2016.0,Action/Sci fi,0 days 02:00:00.000000000,12
84,86,https://resizing.flixster.com/GBnHHBY88ShhGNT6XbORsGHDbj0=/206x305/v2/https://resizing.flixster.com/mNHqkBWJl6dUF09i8Zw2m-iohUU=/ems.ZW1zLXByZC1hc3NldHMvbW92aWVzLzI4NmNjMDE3LTJmNWYtNGM2MC04N2JlLTY4OGRiMzQxZjg3Ny53ZWJw,It,50000,383,2017.0,Horror/Mystery and thriller,0 days 02:15:00.000000000,2
43,10,https://resizing.flixster.com/e7wGwtEsoB79xKJ507h_ucQnWvI=/206x305/v2/https://resizing.flixster.com/LUkiRVFqkbI4aBjgiAVSU-Lzq84=/ems.ZW1zLXByZC1hc3NldHMvbW92aWVzL2NjYWZiY2IxLWRlNDAtNDQwYi1iZGUxLTA3NGRlOTIxOTAyYS53ZWJw,Tulip Fever,5000,60,2017.0,Romance/Drama,0 days 01:47:00.000000000,-33
68,87,https://resizing.flixster.com/rsocwLkACgpGS7SIqc-C31f0J-k=/206x305/v2/https://resizing.flixster.com/HXmRGXSmOp5EPRnAp7AbvfqWf6g=/ems.ZW1zLXByZC1hc3NldHMvbW92aWVzLzJiMDc3ZTU1LTliZmEtNDU3Mi1iMmM3LTBjNjM1ZTdlZDdlMC53ZWJw,Thoroughbreds,2500,164,2017.0,Comedy/Mystery and thriller,0 days 01:30:00.000000000,19
55,52,https://resizing.flixster.com/Lz-9kPHf75IkBUg4whu9zwNClIo=/206x305/v2/https://resizing.flixster.com/t0gwx3Ece5F51cKt7k_igHh7SWA=/ems.ZW1zLXByZC1hc3NldHMvbW92aWVzL2Q1MTI2YTc2LTBiOTktNDEwNi1iZGUyLTE0NzA0NTkwNzQ5Mi53ZWJw,Tomb Raider,10000,318,2018.0,Adventure/Action,0 days 01:58:00.000000000,-3
84,87,https://resizing.flixster.com/--oHeOfRoc5nqJ0FiyAoBengAnU=/206x305/v2/https://resizing.flixster.com/320njNM9gLubEmsMZqA9syKkI4c=/ems.ZW1zLXByZC1hc3NldHMvbW92aWVzL2FjZDQ1YzE1LTAyMzYtNDBlYy1hZjhlLWIxN2VkYjZiZTY0Zi53ZWJw,Mr. Gaga,250,30,2015.0,Documentary,0 days 01:40:00.000000000,3
47,71,,The Unknown Girl,500,91,2016.0,Mystery and thriller/Crime,0 days 01:53:00.000000000,24
28,48,https://resizing.flixster.com/A7ye6V1tK_X2gBK4emwUZrrShYw=/206x305/v2/https://flxt.tmsimg.com/assets/p14341687_p_v13_ac.jpg,Killing Gunther,1000,23,2017.0,Action/Comedy,0 days 01:32:00.000000000,20
80,78,https://resizing.flixster.com/nad0xc25kFt_lQSFOIJYSTGKNOk=/206x305/v2/https://resizing.flixster.com/Uv2JFcVPVXtJiPflC_W7l93FnrE=/ems.ZW1zLXByZC1hc3NldHMvbW92aWVzLzM5N2Y0MDE5LTNjNmItNGFjZC1hOWRlLTY2NGFjYTJkYzA3My53ZWJw,Midnight Return: The Story of Billy Hayes and Turkey,1,9,2016.0,Documentary,0 days 01:39:00.000000000,-2
71,68,https://resizing.flixster.com/gR0SlWmTHAwLkXA6bLha0jsspsw=/206x305/v2/https://resizing.flixster.com/rHTn115foAQbg4h78rlOlVXNE2I=/ems.ZW1zLXByZC1hc3NldHMvbW92aWVzL2VmMDFhOGZlLTk0ZmMtNDU2Yy1hNjEwLTMzODk1ZmMzZTViOS53ZWJw,Breathe,2500,168,2017.0,Romance/Drama,0 days 01:57:00.000000000,-3
85,92,,"I, Daniel Blake",5000,182,2016.0,Drama,0 days 01:40:00.000000000,7
74,90,https://resizing.flixster.com/JHyR4g-E0SACsiRd_ZOAee34VDk=/206x305/v2/https://resizing.flixster.com/UsRurFXUxGiadKLPgiQh2pgR2tA=/ems.ZW1zLXByZC1hc3NldHMvbW92aWVzLzk4NmFkZjdkLTExOGItNDMwNC05ZTVkLWUxMmIwZjJkMGViYS53ZWJw,L'économie du couple,250,50,2016.0,Drama,0 days 01:40:00.000000000,16
60,94,https://resizing.flixster.com/tk9VF-ewguFe3nzb9uRBXAH-_NI=/206x305/v2/https://resizing.flixster.com/RAeaFTVB_9rw_KTjxSTbhGY_Q34=/ems.ZW1zLXByZC1hc3NldHMvbW92aWVzL2EzNTRkMzdhLTVmZDctNGU1Yi04MDc0LTNlNTA3MjVkMDI4Ny53ZWJw,Old Stone,100,31,2016.0,Drama/Mystery and thriller,0 days 01:20:00.000000000,34
76,92,https://resizing.flixster.com/gauNDQ6dL1JqrjlaPJNWkQioqHs=/206x305/v2/https://resizing.flixster.com/iPSB0SshbqEj7j3cKh_6cNU-Fbs=/ems.ZW1zLXByZC1hc3NldHMvbW92aWVzL2ZhNDc0OTZmLWQxMTAtNDk5NC1iYzIyLWQ5MTIyNDhlYzJiZC53ZWJw,Logan Lucky,25000,283,2017.0,Crime/Comedy,0 days 01:59:00.000000000,16
81,93,https://resizing.flixster.com/M2TOJumbn3dNyxrGu5SpPRIzwMs=/206x305/v2/https://resizing.flixster.com/0vfQw44QtQyzYTXH764bLptrHUg=/ems.ZW1zLXByZC1hc3NldHMvbW92aWVzLzNjYmY2MmE5LWI1NjQtNDFjZS04ZTc5LWUxMjYxOTlmNDNmNC53ZWJw,Endless Poetry,1000,61,2016.0,Biography,0 days 02:08:00.000000000,12
78,90,https://resizing.flixster.com/LdMj6Zan-YkpkzVeMr1yIRNlRMM=/206x305/v2/https://resizing.flixster.com/Rz_66ruQb0MGWtyL15PxBgXEizM=/ems.ZW1zLXByZC1hc3NldHMvbW92aWVzLzdkZGMzZTcwLWVlYTItNGZlMS1hOTU1LTEwMjI0YzBhM2U5Mi53ZWJw,One Week and a Day,100,29,2016.0,Drama,0 days 01:38:00.000000000,12
77,100,https://resizing.flixster.com/qk-jxrbnzk9ChSnc3uYnn-TKrnY=/206x305/v2/https://resizing.flixster.com/eio7DmoyoiH2fPxAfTumEjZsPUo=/ems.ZW1zLXByZC1hc3NldHMvbW92aWVzLzgzYjFkYWUzLWExZjktNDE5Zi05ODYxLTE5MDYzY2FiYmUxYy53ZWJw,Harmonium,100,39,2016.0,Drama,0 days 01:58:00.000000000,23
56,38,https://resizing.flixster.com/kac-M1GkpadYoM8CvEYm-B_Lz1g=/206x305/v2/https://resizing.flixster.com/dGlE-eY7oVz5SCxEJwGSww-EG5U=/ems.ZW1zLXByZC1hc3NldHMvbW92aWVzLzhlZDgwOTU1LWY2ZmItNDc0Ny05OTYwLTkzNTQ4MDE2ZTU1OS53ZWJw,The Leisure Seeker,500,109,2017.0,Comedy/Drama,0 days 01:52:00.000000000,-18
90,88,,Wind River,25000,250,2017.0,Crime/Drama,0 days 01:51:00.000000000,-2
80,96,,After the Storm,1000,138,2016.0,Drama,0 days 01:57:00.000000000,16
87,95,https://resizing.flixster.com/4bL-4O7F-7ij6SshJ6UOOCSMu6c=/206x305/v2/https://resizing.flixster.com/hdAR23r_WMIRVxIhN1S44nXGIKQ=/ems.ZW1zLXByZC1hc3NldHMvbW92aWVzL2IzYWNmNWE0LTRjMDYtNGVlNi05MGE0LWZiMDhjNTMxNWYyYi53ZWJw,The Breadwinner,1000,105,2017.0,Drama/Animation,0 days 01:34:00.000000000,8
51,33,,Insidious: The Last Key,5000,112,2018.0,Horror/Mystery and thriller,0 days 01:43:00.000000000,-18
67,78,https://resizing.flixster.com/sokgPu5EsKnfd9hu9ZaHfyqdIjo=/206x305/v2/https://resizing.flixster.com/XuoiW0k_gMCfI2fhVUHIP7IDAoM=/ems.ZW1zLXByZC1hc3NldHMvbW92aWVzL2EyOTZjOTk4LTExNjYtNDMwMy1iMzRkLTUyMDMzNTQ3ZDFkMC53ZWJw,Small Town Crime,500,37,2017.0,Crime/Drama,0 days 01:31:00.000000000,11
49,45,,Red Sparrow,2500,299,2018.0,Mystery and thriller,0 days 02:19:00.000000000,-4
56,50,https://resizing.flixster.com/y_u8EWq5hXKUtNaK9-r5BEqQXKY=/206x305/v2/https://flxt.tmsimg.com/assets/p14549381_p_v10_aa.jpg,The Man From Earth: Holocene,250,6,2017.0,Sci fi,0 days 01:38:00.000000000,-6
79,100,https://resizing.flixster.com/Hc2K91NlFZoFMm56zvUY0eR3Q8Y=/206x305/v2/https://resizing.flixster.com/W_ZY_Htf9ADE19vTggCYM9JcIQo=/ems.ZW1zLXByZC1hc3NldHMvbW92aWVzL2NkMGVkNGY5LTYyYTktNDJkMC1iMzZkLTFlYzg1Y2NjNjFhZS53ZWJw,11:55,250,5,2016.0,Crime/Drama,0 days 01:20:00.000000000,21
45,76,,My Cousin Rachel,5000,155,2017.0,Romance/Drama,0 days 01:46:00.000000000,31
71,86,,The Night Watchmen,100,7,2016.0,Comedy/Horror,0 days 01:20:00.000000000,15
68,67,,Tommy's Honour,1000,83,2016.0,Drama/History,0 days 01:52:00.000000000,-1
61,39,,How to Be a Latin Lover,5000,31,2017.0,Comedy,0 days 01:55:00.000000000,-22
88,86,https://resizing.flixster.com/kWay698oPcc2texkWrEOyhblGO4=/206x305/v2/https://resizing.flixster.com/20ceDPvpxnBZ_ZXq86DWELyiU7A=/ems.ZW1zLXByZC1hc3NldHMvbW92aWVzL2VhYWEzMzQ4LTQ5ZjYtNDVmYS04OWE2LWY2ZTYxYmEwOGYwNi53ZWJw,Wonder,10000,189,2017.0,Drama,0 days 01:53:00.000000000,-2
29,45,https://resizing.flixster.com/I3W3obGQJFanlxdeRXj9Am-GfQ8=/206x305/v2/https://resizing.flixster.com/VAI-81I8HO9YPQFCZ9cCuuBptis=/ems.ZW1zLXByZC1hc3NldHMvbW92aWVzLzAzZjgzZWVkLWQxYjItNDZmNC1iYjY5LWE2ZDc0YzEyYzIxZi53ZWJw,Rough Night,10000,173,2017.0,Comedy,0 days 01:36:00.000000000,16
68,100,https://resizing.flixster.com/PyHRV6U1w_ra9Z7gSEIVBRQIXRU=/206x305/v2/https://resizing.flixster.com/9Xu_Kmbp7kYFdNbjt7BRn4oYs7k=/ems.ZW1zLXByZC1hc3NldHMvbW92aWVzL2I0YWEyNTE0LTA0MGQtNDNiOC1iMmFlLWFiMjBlNWJjNjlkYi53ZWJw,Red Dog: True Blue,250,13,2016.0,Comedy/Drama,0 days 01:28:00.000000000,32
65,68,https://resizing.flixster.com/gIU1dy26TmbKtlfAWsEtZSJ0S9c=/206x305/v2/https://resizing.flixster.com/UNL05vylF8yrjzYc9Jx_-XGDoIc=/ems.ZW1zLXByZC1hc3NldHMvbW92aWVzLzBmNTY3MjQxLTczMDMtNDA3Ny04YjVlLTgyZDk3NjFlZjY0NS53ZWJw,The Journey,500,90,2016.0,Drama,0 days 01:34:00.000000000,3
94,63,https://resizing.flixster.com/ZdFPDxvpznZJ9kKz12htb8BApIM=/206x305/v2/https://resizing.flixster.com/ywWJqSGMsELeFxUUhv5CxF0bAsw=/ems.ZW1zLXByZC1hc3NldHMvbW92aWVzLzhiYWJlNWFjLTFlMmEtNDhjNS04OGE5LTk4NjYwZmRjMjhiMy53ZWJw,Man in Red Bandana,50,8,2017.0,Documentary,0 days 01:25:00.000000000,-31
30,46,https://resizing.flixster.com/f95uVIW11I_VzW9XdYsC23EYG0g=/206x305/v2/https://resizing.flixster.com/MQm1JPqzWgjeI30QmntyfAlDwo0=/ems.ZW1zLXByZC1hc3NldHMvbW92aWVzLzc3ZjljNzE1LTYyZWEtNDAxMS04ZDg5LWJlOTgyNTE5ZjM4NC53ZWJw,The Bad Batch,2500,99,2016.0,Horror/Mystery and thriller,0 days 01:58:00.000000000,16
79,82,,Detroit,10000,301,2017.0,Crime/Drama,0 days 02:23:00.000000000,3
49,42,,Whisky Galore!,100,26,2016.0,Comedy,0 days 01:39:00.000000000,-7
42,32,https://resizing.flixster.com/TMAbyLDv5-_tvc1aWB0XxV93kZI=/206x305/v2/https://resizing.flixster.com/XQ0hI35knmyJlbcYbhKLnys_dps=/ems.ZW1zLXByZC1hc3NldHMvbW92aWVzLzgwMjc2OTVkLTE4Y2ItNGZiNy1iOWM5LTQ2YWJjN2VhMGI1OS53ZWJw,Wonder Wheel,1000,200,2017.0,Drama,0 days 01:41:00.000000000,-10
64,83,https://resizing.flixster.com/Jj-Vyxuxxke14I6ImVHJ-tZBbqA=/206x305/v2/https://resizing.flixster.com/Vp1uzYTuTmJhghZn6KE8tO2Y18A=/ems.ZW1zLXByZC1hc3NldHMvbW92aWVzL2Y0OGRmM2M5LWFhNjctNDQ1Yi1iMDc3LTQxZTk3MzEzN2ZlMy53ZWJw,Don't Call Me Son,100,18,2016.0,Drama,0 days 01:22:00.000000000,19
37,100,https://resizing.flixster.com/-lmpc1_b5U6S6b2yn-yCAx3OiE0=/206x305/v2/https://resizing.flixster.com/qF3UBBBMFGsVEwbX4rJifvScMec=/ems.ZW1zLXByZC1hc3NldHMvbW92aWVzL2E3MzhjN2JhLTAzMDAtNDE3ZS1iMWRlLTgxMWMzZTNiMjdjNC53ZWJw,Seoul Station,250,23,2016.0,Horror/Animation,0 days 01:32:00.000000000,63
73,100,https://resizing.flixster.com/vtYnoDSFGkLeBGzVRmgWKUgxV-g=/206x305/v2/https://resizing.flixster.com/4s1CfSwJjLIvEQSi452eMnZefeU=/ems.ZW1zLXByZC1hc3NldHMvbW92aWVzL2NiZTZlMWE5LWY3ZjMtNDVmYy1hN2Q4LWY4ZDA4NmNlZGUzZS53ZWJw,The Sunshine Makers,250,9,2015.0,Documentary,0 days 01:30:00.000000000,27
37,7,https://resizing.flixster.com/Zzx8kpnWuEtSrkbpwplGccIQ3gU=/206x305/v2/https://resizing.flixster.com/BlgS3piW9R1ljkIO0A9Z6Jij8zM=/ems.ZW1zLXByZC1hc3NldHMvbW92aWVzLzRlNzI3MTU2LTkwMmEtNGZmOS1iMWE1LWI4OThlMmRjYzBkZS53ZWJw,The Emoji Movie,25000,134,2017.0,Kids and family/Adventure,0 days 01:26:00.000000000,-30
10,4,,Just Getting Started,500,23,2017.0,Other/Comedy,0 days 01:31:00.000000000,-6
72,66,https://resizing.flixster.com/mJfzrkhZc9ft53V8XivKbkgiXhA=/206x305/v2/https://resizing.flixster.com/LFdAfXH27rwxEArSfebCj3enVUI=/ems.ZW1zLXByZC1hc3NldHMvbW92aWVzL2RmOWI4MTVmLTcyZDMtNGUzOS1iNWQxLWJkYzFkMGRhOThlNC53ZWJw,The Foreigner,10000,125,2017.0,Action/Mystery and thriller,0 days 01:54:00.000000000,-6
75,88,https://resizing.flixster.com/kvLCC68yZGBZaVYmrhKCA9PmjDY=/206x305/v2/https://resizing.flixster.com/EodmZrbFWZPqNJMd343homnk0Os=/ems.ZW1zLXByZC1hc3NldHMvbW92aWVzLzUzZDFmNmJkLWE0ZmMtNDg2MC05YzU4LTgzZDk3N2Q1MGY2ZC53ZWJw,Our Souls at Night,1000,43,2017.0,Drama,0 days 01:43:00.000000000,13
32,4,https://resizing.flixster.com/XGOcHOBqQXHnGXGD28bAWL-XR74=/206x305/v2/https://resizing.flixster.com/0o8JczVUlRKNX6zSbS-aiztDTSg=/ems.ZW1zLXByZC1hc3NldHMvbW92aWVzLzY3MzBjMDA5LTAwZTEtNDA3NS05MDBhLTFkYzQ2M2M0ZTEwOS53ZWJw,Flatliners,10000,76,2017.0,Sci fi/Mystery and thriller,0 days 01:48:00.000000000,-28
55,79,,Brad's Status,2500,174,2017.0,Comedy/Drama,0 days 01:42:00.000000000,24
72,92,,The Meyerowitz Stories (New and Selected),5000,185,2017.0,Comedy,0 days 01:50:00.000000000,20
76,92,,Raw,5000,190,2016.0,Horror/Mystery and thriller,0 days 01:38:00.000000000,16
69,30,https://resizing.flixster.com/ANkYtClpFy5eisGtMx8E9kaki9E=/206x305/v2/https://resizing.flixster.com/6vJ_ABFMT6NIAA2WUV0s9BFRS9M=/ems.ZW1zLXByZC1hc3NldHMvbW92aWVzLzRlY2M5MGNmLTc0ODUtNDBhNi04MWNkLWNjNTYxMDY1OWFkZS53ZWJw,King Arthur: Legend of the Sword,25000,274,2017.0,Fantasy/Adventure,0 days 02:06:00.000000000,-39
89,33,,Jigsaw,25000,89,2017.0,Horror/Mystery and thriller,0 days 01:32:00.000000000,-56
19,48,https://resizing.flixster.com/53OlW7x1yxbOP_Dg6nSJfE1N1vA=/206x305/v2/https://resizing.flixster.com/VDTL6-npMKnaeWrza1hBGLRxC6I=/ems.ZW1zLXByZC1hc3NldHMvbW92aWVzL2E5NGNmZWQ3LTkzOTMtNDcyNi1iYzRkLWNhM2ZjNGE2NTE0YS53ZWJw,Red Christmas,100,21,2016.0,Other/Horror,0 days 01:22:00.000000000,29
84,93,https://resizing.flixster.com/IJdd-_Xb6EU4v5OdHWCqtxP7t_M=/206x305/v2/https://resizing.flixster.com/j-kNPCk5iVNRJsC9CeWyF0pl0ZY=/ems.ZW1zLXByZC1hc3NldHMvbW92aWVzL2I0MDRkZDI2LTFhZjQtNDU2Yy1hMmM1LTYwOGY1ZWE3NWY0ZS53ZWJw,Seed: The Untold Story,100,14,2016.0,Documentary,0 days 01:34:00.000000000,9
79,100,https://resizing.flixster.com/dNPdnsJUzyO59sedWfcblddoO28=/206x305/v2/https://resizing.flixster.com/3HyUwiEU92l6slNPS1m3MpSux4c=/ems.ZW1zLXByZC1hc3NldHMvbW92aWVzLzZhODE0MTVmLTdjZmQtNDlkMi05MjZlLWM5ZTlhMDRlYTM3OS53ZWJw,Aida's Secrets,250,15,2016.0,Documentary,0 days 01:30:00.000000000,21
67,75,https://resizing.flixster.com/eOYR1VRcsoU4tQsL1paA14ZJ5G0=/206x305/v2/https://flxt.tmsimg.com/assets/p11173087_p_v8_aa.jpg,Equal Means Equal,50,8,2014.0,Documentary,0 days 01:34:00.000000000,8
31,18,https://resizing.flixster.com/z-BgzCv671kSfsOmhrN6Rgmjt9s=/206x305/v2/https://resizing.flixster.com/MXfvgsvt4TgYKuhVj3OsB8c51Kc=/ems.ZW1zLXByZC1hc3NldHMvbW92aWVzLzg4MjUwMDExLWI2NjctNDcxNi1hZTgxLThmYzc1OWJhMGU2NS53ZWJw,Diary of a Wimpy Kid: The Long Haul,5000,72,2017.0,Comedy/Kids and family,0 days 01:31:00.000000000,-13
94,98,https://resizing.flixster.com/iNqFy9HRjsY6VGyG8J1P_4lVrsY=/206x305/v2/https://resizing.flixster.com/S1SfANQIIQcyAfS7aCdBFR-AK2g=/ems.ZW1zLXByZC1hc3NldHMvbW92aWVzLzRhODUxNzRmLWM1M2QtNGVkMy05ODFmLWM2NGNjNzM5ZDFiNy53ZWJw,Your Name,10000,117,2016.0,Romance/Fantasy,0 days 01:46:00.000000000,4
52,77,https://resizing.flixster.com/6boc4QvS9rAaEy7E-dWu1eoRsEA=/206x305/v2/https://resizing.flixster.com/s2IZL46j_2nxRfcrMGAX2GYiyEY=/ems.ZW1zLXByZC1hc3NldHMvbW92aWVzL2I3OTc5YWJiLTRiZDAtNDBkYS1iNGI2LTc2NDhhNmVhNGExZi53ZWJw,Realive,250,31,2016.0,Sci fi,0 days 01:48:00.000000000,25
60,79,https://resizing.flixster.com/qDaZmtivCZYIrvg7giq2fE9rJXg=/206x305/v2/https://resizing.flixster.com/Ch07mqEGTaTJfUymOpbHeraYnIg=/ems.ZW1zLXByZC1hc3NldHMvbW92aWVzLzBiM2Y4MWZkLWRjZGYtNDU2YS1hMDQ0LWJhZDEwYTEzMjE5ZC53ZWJw,Jesús,50,14,2016.0,Drama,0 days 01:25:00.000000000,19
82,96,,Sami Blood,250,28,2016.0,Drama,0 days 01:48:00.000000000,14
65,86,https://resizing.flixster.com/FB2JWHGSV4CR_Od2tYtPvWNkJl0=/206x305/v2/https://resizing.flixster.com/hgvN24FrfG4NesJ_QdhoLklo-7M=/ems.ZW1zLXByZC1hc3NldHMvbW92aWVzLzYxOGRjM2ZiLWU2ODYtNDljOS05NzVmLTM1NWI4OWFhYTg1Yy53ZWJw,The Wedding Plan,2500,74,2016.0,Romance,0 days 01:50:00.000000000,21
84,91,https://resizing.flixster.com/VoFVjhz_yYLsCFZzqD5e0BKa5jc=/206x305/v2/https://resizing.flixster.com/ufyqp2EA4dyqbGLAi1K24K2W5L4=/ems.ZW1zLXByZC1hc3NldHMvbW92aWVzLzc2N2I1OWJiLTNiYjgtNGQ2Ny1iYzhlLWNlZGM2NzBkZTQzOS53ZWJw,Frantz,2500,138,2016.0,Drama/History,0 days 01:53:00.000000000,7
88,89,https://resizing.flixster.com/ZNqNGqmicH0Ot7FNvz5GS1R0LJI=/206x305/v2/https://resizing.flixster.com/U8OtOFwVbSOBqZgL-1G6aEye6sA=/ems.ZW1zLXByZC1hc3NldHMvbW92aWVzLzY5YjE2N2NkLTJmOTgtNGM3OS1iOWRiLWE1Y2FjMWM2OWY4MS53ZWJw,Maudie,5000,151,2016.0,Romance/Drama,0 days 01:55:00.000000000,1
66,92,https://resizing.flixster.com/5qSynxYiBVloVQbgm7TwQXxCE3Q=/206x305/v2/https://resizing.flixster.com/NQOxmlYIiMg0nkpOoGjgzrU3B1Y=/ems.ZW1zLXByZC1hc3NldHMvbW92aWVzLzExMTUwNzAyLWViMzAtNGMwMy04YTBhLThjZTAxY2NhZGM4Ny53ZWJw,Heal the Living,250,59,2016.0,Drama,0 days 01:43:00.000000000,26
52,72,https://resizing.flixster.com/Z3HoUl7X41z0PyRCkPcKQkycBNM=/206x305/v2/https://resizing.flixster.com/GB9GlfPuNjbPXhbGVkSTQG-bMdk=/ems.ZW1zLXByZC1hc3NldHMvbW92aWVzL2I5OTU4ZjA0LTg4ZmItNDA4OC05NDY3LTlmMzRkYWY3YWRkZi53ZWJw,Wakefield,5000,69,2016.0,Drama,0 days 01:49:00.000000000,20
67,87,https://resizing.flixster.com/saOu3p-eOiwoPTIiGbTKYdF9ztY=/206x305/v2/https://resizing.flixster.com/OuTaTsrFiPcOFQZr4NA8B9BQElY=/ems.ZW1zLXByZC1hc3NldHMvbW92aWVzLzI1MzJkNzY5LTNjZGYtNDY3NS05N2VmLWQ2YWM2MTA3YzRmYy53ZWJw,Lost in Paris,1000,60,2016.0,Comedy,0 days 01:25:00.000000000,20
82,84,https://resizing.flixster.com/Izqwjp834HQ_RAvSSBnWtc8rquM=/206x305/v2/https://resizing.flixster.com/MakUUy7RNGXqN42pWaalkZtyEjw=/ems.ZW1zLXByZC1hc3NldHMvbW92aWVzLzg3MjhlMzc3LTczMWEtNDliZi05MjA1LThlNTU3Zjk3MWRmZi53ZWJw,Darkest Hour,10000,314,2017.0,War/Drama,0 days 02:05:00.000000000,2
49,45,https://resizing.flixster.com/cnrsHK5l1kaXjXOwjaR8UbcnaI8=/206x305/v2/https://flxt.tmsimg.com/assets/p14426186_p_v10_aa.jpg,Message From the King,250,11,2016.0,Action/Mystery and thriller,0 days 01:42:00.000000000,-4
68,66,,Victoria & Abdul,5000,198,2017.0,Drama/History,0 days 01:50:00.000000000,-2
71,88,https://resizing.flixster.com/Uacz2k_GhPiJJN1VZ1WBmWBnAWk=/206x305/v2/https://resizing.flixster.com/a7g3c3X2i2Sb0xR5BNV_EXCZnds=/ems.ZW1zLXByZC1hc3NldHMvbW92aWVzLzg1ZTRmY2NjLWVjMzItNDI0ZS04Zjc1LWZkMTNhNGQ5Nzk1MS53ZWJw,Lady Macbeth,5000,197,2016.0,Drama/History,0 days 01:29:00.000000000,17
71,91,https://resizing.flixster.com/i4rynDm5l2fZcUzToPfMLAe5ayE=/206x305/v2/https://resizing.flixster.com/c6bg-TFXhEgdcRUiMlw3ZeChMik=/ems.ZW1zLXByZC1hc3NldHMvbW92aWVzLzUzYjUyMzY1LWRhNzMtNDcyYS05ZjY4LWVmMzA0MjA5ZTY5Yy53ZWJw,Phantom Thread,5000,351,2017.0,Romance/Drama,0 days 02:10:00.000000000,20
70,36,https://resizing.flixster.com/kw56UON8-7vgkFZW2toEuRlK4uo=/206x305/v2/https://resizing.flixster.com/Ssm2LfIflElysNGE2F4VCOs4nvs=/ems.ZW1zLXByZC1hc3NldHMvbW92aWVzL2U5MzNjNGZlLTE4OWUtNGRiOS05NTllLTIzNDVmOGMyNWZlYS53ZWJw,The Secret Scripture,250,39,2016.0,Romance/Drama,0 days 01:48:00.000000000,-34
31,29,https://resizing.flixster.com/CEbKX9nGrjpryCX9ISEbCNJlyxc=/206x305/v2/https://resizing.flixster.com/hSiRK2Nf9_ldprFwPeHzLYyJfSs=/ems.ZW1zLXByZC1hc3NldHMvbW92aWVzLzE3NjBlYjhjLTA1ZDctNGUyZS1hOTJjLTQ4OWVjMGM3NDEzNi53ZWJw,All I See Is You,1000,56,2016.0,Drama,0 days 01:50:00.000000000,-2
55,74,https://resizing.flixster.com/GHKXEbmGwGwy5w062j0Ir1QaS20=/206x305/v2/https://resizing.flixster.com/BBXY4Upg9QBmiO8unPHJU3C7Cys=/ems.ZW1zLXByZC1hc3NldHMvbW92aWVzL2U5NWRlODFjLTM1Y2EtNGMyYi04NGQxLWU5MzlkYTNlNzFjMi53ZWJw,The Limehouse Golem,1000,78,2016.0,Mystery and thriller,0 days 01:49:00.000000000,19
55,85,https://resizing.flixster.com/cuIYipKFROmYii8vm8eId10e-gU=/206x305/v2/https://resizing.flixster.com/AyVZV03nk_5f0Sri6bGmpFBC2DE=/ems.ZW1zLXByZC1hc3NldHMvbW92aWVzL2M4ZGY4NWQ2LTA5MjctNDg4My05MTUwLTA3MTgxMmU4ODQ4OC53ZWJw,My Entire High School Sinking Into the Sea,500,71,2016.0,Animation/Comedy,0 days 01:12:00.000000000,30
50,53,,Daguerrotype,1,17,2016.0,Fantasy/Horror,0 days 02:11:00.000000000,3
92,51,https://resizing.flixster.com/arHPiLnkygEIirY33zDp4mnzKW8=/206x305/v2/https://resizing.flixster.com/xJouZdHNJ_VGiEvhR2RFZFowO5g=/ems.ZW1zLXByZC1hc3NldHMvbW92aWVzLzY3MGM1ODYyLTMyMzQtNGViZC1hYjU5LWMzNjRjOTk4ZGRmZC53ZWJw,The Promise,10000,160,2016.0,Romance/Drama,0 days 02:14:00.000000000,-41
33,89,https://resizing.flixster.com/h5l4nwy1X6E00XxdXn6KpFxW9g8=/206x305/v2/https://resizing.flixster.com/15HQmKPobC4sbbEuK6fMJWUpvnE=/ems.ZW1zLXByZC1hc3NldHMvbW92aWVzL2VkYWY3OWFkLTE0YTUtNDZkZC1hYmMzLTAxNWQxY2NjOWQ3ZS53ZWJw,Soul on a String,1,9,2016.0,Drama/Mystery and thriller,0 days 02:22:00.000000000,56
39,47,https://resizing.flixster.com/_HZCZ3-PtOOybipHvDfEBHAr68s=/206x305/v2/https://resizing.flixster.com/tvpXJiNxE5NBPQmKMKwiMOLS4-0=/ems.ZW1zLXByZC1hc3NldHMvbW92aWVzLzVjNTk3MTFlLTY0ZjItNDFkOS1iNTE2LTViMWVhM2EyNTRiYy53ZWJw,Paris Can Wait,2500,115,2016.0,Romance,0 days 01:32:00.000000000,8
53,18,https://resizing.flixster.com/kUt5b1q-_bDJ2wkEH3h3abettlY=/206x305/v2/https://resizing.flixster.com/JhZQyi5F97RPlaBWDIDrGnLPW5Y=/ems.ZW1zLXByZC1hc3NldHMvbW92aWVzLzFlNDlmZmM4LTAxYzAtNGFiZC1hMzIzLTQxMTIxNDk5MzZmNy53ZWJw,All Eyez on Me,10000,92,2017.0,Drama/Music,0 days 02:20:00.000000000,-35
67,73,https://resizing.flixster.com/QxxC5DjZ9NYg2eyMlaU3OUF5Sgg=/206x305/v2/https://resizing.flixster.com/FLESqDNtF1YhlaRw-GXXO48hwXM=/ems.ZW1zLXByZC1hc3NldHMvbW92aWVzL2NiMjY3MTAwLTNhNzctNGZmZi04NGI4LWNjYjA5YzE3YjEyMy53ZWJw,The Exception,2500,60,2016.0,Romance/War,0 days 01:47:00.000000000,6
40,52,https://resizing.flixster.com/HvQg1rNuc1NZoI6yzAmQG1_VoKM=/206x305/v2/https://resizing.flixster.com/ON96PSMPrydpAftgNKYJ6dBLU1g=/ems.ZW1zLXByZC1hc3NldHMvbW92aWVzLzAxYTE1MDIyLTNiMGMtNDljYy05YjMyLTUyNzU5MDNjN2Y5Mi53ZWJw,Porto,50,31,2016.0,Drama/Romance,0 days 01:16:00.000000000,12
71,96,https://resizing.flixster.com/5FTtQzdB6lceoHT3mum1Bz0L5h0=/206x305/v2/https://resizing.flixster.com/n3vJiDG1Z52wtyki3xoUZwjxB3M=/ems.ZW1zLXByZC1hc3NldHMvbW92aWVzLzFmZmU0MmZlLWQ2MDgtNDE1ZC1hODkwLWIwNTY0NWRhMThiMy53ZWJw,Karl Marx City,100,26,2016.0,Documentary,0 days 01:29:00.000000000,25
48,25,https://resizing.flixster.com/sEPrESgGP8qtJHUpaoHiAqLho_E=/206x305/v2/https://resizing.flixster.com/t9e7DHl8oJb9X_idUx-VCFl2iJo=/ems.ZW1zLXByZC1hc3NldHMvbW92aWVzL2ZhYWJjMDNmLWY0NzctNDFkYS1hYjM0LTg0M2JhOWEwMGVmNi53ZWJw,"Literally, Right Before Aaron",250,20,2017.0,Romance,0 days 01:42:00.000000000,-23
65,89,https://resizing.flixster.com/Am5o33oEH6PggwmwukiqwTH_IeY=/206x305/v2/https://resizing.flixster.com/bJ18CKh5BgTg9ObX3HhUgkGKuq8=/ems.ZW1zLXByZC1hc3NldHMvbW92aWVzL2M3MGM1YjgwLTIxNGEtNGIxZi04MTlmLTM3MzhmODRhZGVkZC53ZWJw,Better Watch Out,2500,64,2016.0,Other/Horror,0 days 01:29:00.000000000,24
52,63,,The Odyssey,100,19,2016.0,Drama/Adventure,0 days 02:03:00.000000000,11
48,64,https://resizing.flixster.com/5KV6I9wHnRLoB4YzK6HOQ5IAFBQ=/206x305/v2/https://resizing.flixster.com/u42sqQkqWFzkmsoVdXHQxYLR35s=/ems.ZW1zLXByZC1hc3NldHMvbW92aWVzLzhmYzMwOTk0LWQzYTUtNGM1ZS04NjA2LTAyYWFlYjM1NWRiMi53ZWJw,Kaleidoscope,100,22,2016.0,Mystery and thriller,0 days 01:40:00.000000000,16
21,23,,Don't Knock Twice,500,26,2016.0,Horror/Mystery and thriller,0 days 01:33:00.000000000,2
78,56,https://resizing.flixster.com/Tp-5FCbKDg8AW84ymK6RESyom7U=/206x305/v2/https://resizing.flixster.com/ZcpimlkLfoG4c6rU3KF87-lRSwg=/ems.ZW1zLXByZC1hc3NldHMvbW92aWVzLzI1OWI0MmNkLWU1YmEtNDYyNC1hNWIwLWRjNGJjMjhjNzljZC53ZWJw,Kepler's Dream,1,9,2016.0,Western/Mystery and thriller,0 days 01:30:00.000000000,-22
77,84,https://resizing.flixster.com/ASO3FONni3GqLYzMngCDzIX8clc=/206x305/v2/https://resizing.flixster.com/H4GoARGBt8UlQ87f7_NPg2OH1sU=/ems.ZW1zLXByZC1hc3NldHMvbW92aWVzLzRiNDVjMzZiLTliMmItNDA2MS04ZmQ2LWE5MTZhM2FjNDBlYS53ZWJw,Heartstone,250,25,2016.0,Gay and lesbian/Drama,0 days 02:09:00.000000000,7
77,100,https://resizing.flixster.com/pe94eCP_Q3T87ypPXylDNk866NU=/206x305/v2/https://resizing.flixster.com/MkjH8zu6jmqAq-oShq9Psaf-XxU=/ems.ZW1zLXByZC1hc3NldHMvbW92aWVzL2Q5NGMzMGU3LWJjY2YtNGNjYy05ZTljLTJkZDc1ZGI1ZDhiYS53ZWJw,The Promise,100,9,2016.0,Documentary,0 days 02:10:00.000000000,23
49,81,https://resizing.flixster.com/9Nnili2-UHv6ysqqb_cDwtKisbs=/206x305/v2/https://resizing.flixster.com/wfHpbBdjikdkLAYXRlhXs93H2Lg=/ems.ZW1zLXByZC1hc3NldHMvbW92aWVzL2E3ZDc4OGE1LWY1YTQtNDAzMS05MDQ5LTViOWEwOTM5ZWE3Yy53ZWJw,Early Man,1000,175,2018.0,Animation/Comedy,0 days 01:29:00.000000000,32
60,43,https://resizing.flixster.com/5tHVLnFlKzXgs6K7GnOSeSBEPLc=/206x305/v2/https://resizing.flixster.com/dXdWKdGZ62KgxTUxA2JKKfvdwYU=/ems.ZW1zLXByZC1hc3NldHMvbW92aWVzL2M4MWVjYzE1LWNlOTAtNDQxMC05YTYxLTFjOWI1Yjc5YzE2NC53ZWJw,Love Is Thicker Than Water,1,7,2016.0,Romance,0 days 01:41:00.000000000,-17
75,76,https://resizing.flixster.com/H_BVQiz3XIdWDUCVAlC8Uhx30_A=/206x305/v2/https://resizing.flixster.com/GlI9Ylrr9RvcjmL50ZOqf4BbfCA=/ems.ZW1zLXByZC1hc3NldHMvbW92aWVzLzQ4NmEwZGJjLWFmYjYtNDUwNS04ZmYyLTY2OTA0MmU3NDg2YS53ZWJw,Chasing Trane: The John Coltrane Documentary,500,42,2016.0,Documentary/Music,0 days 01:39:00.000000000,1
67,95,https://resizing.flixster.com/V7-D1m5k_S5WPmJsdLlcbVf2E_Q=/206x305/v2/https://resizing.flixster.com/FvfnftMWDONOMxB4bZ7RhZ6Vk6o=/ems.ZW1zLXByZC1hc3NldHMvbW92aWVzL2Q4ZWQ3MjNjLWZkOWItNDFjNy1iMzlkLWRhOTMwMTVmMGEyNC53ZWJw,Citizen Jane: Battle for the City,500,57,2016.0,Documentary,0 days 01:32:00.000000000,28
65,32,https://resizing.flixster.com/Qmp21QtSp4HerbtiIXDsgKcZNrw=/206x305/v2/https://resizing.flixster.com/iRpo1UWT3ndFWDctEgJtCAqNsMA=/ems.ZW1zLXByZC1hc3NldHMvbW92aWVzLzQzN2RlMjhjLTFmZjgtNGVkNS04M2QxLWM4ODE2NDk2YzA1ZC53ZWJw,From the Land of the Moon,250,56,2016.0,Romance/Drama,0 days 02:00:00.000000000,-33
67,65,https://resizing.flixster.com/jITUo2zhvpMoUz0hYSwEYLlNGhw=/206x305/v2/https://resizing.flixster.com/X_TGPqqgIgFuigOik5ty8DmnhAg=/ems.ZW1zLXByZC1hc3NldHMvbW92aWVzLzdkNWQ4M2YxLTc3MjEtNGEwOS04ZjQ5LTUyNmMwOTRmMDQzOS53ZWJw,WolfCop II,100,17,2016.0,Comedy/Horror,0 days 01:22:00.000000000,-2
77,96,https://resizing.flixster.com/hdiWBJYc4asOnCyrXwQFQfL1a6o=/206x305/v2/https://resizing.flixster.com/afueZZt84PkAnnvU243y4JNOAg4=/ems.ZW1zLXByZC1hc3NldHMvbW92aWVzLzY2MDI2NmU4LWE4NWEtNDZiMi05NmFjLWZlMWQ5NGQwYmUzYS53ZWJw,The Women's Balcony,1000,47,2016.0,Comedy/Drama,0 days 01:36:00.000000000,19
56,57,,Crooked House,500,30,2017.0,Crime/Drama,0 days 01:55:00.000000000,1
46,62,https://resizing.flixster.com/b6i9EPMfyAGrc95XsSTn5nP9-Xs=/206x305/v2/https://resizing.flixster.com/NG9frOBrkmCdPlvKEpZzYFiusKk=/ems.ZW1zLXByZC1hc3NldHMvbW92aWVzLzJhMWRkZjBkLTQ1NTgtNDQzMy05NjYwLTIzOTBkNzc2ZDM5Yi53ZWJw,The Osiris Child,1000,21,2016.0,Action/Sci fi,0 days 01:35:00.000000000,16
60,92,,A Dark Song,1000,39,2016.0,Horror/Drama,0 days 01:40:00.000000000,32
35,71,,The Housemaid: Co Hau Gai,50,14,2016.0,Romance/Horror,0 days 01:45:00.000000000,36
33,85,,Hermia & Helena,100,26,2016.0,Comedy/Drama,0 days 01:27:00.000000000,52
66,7,,Fallen,1000,14,2016.0,Romance/Fantasy,0 days 01:27:00.000000000,-59
64,86,https://resizing.flixster.com/mxySQOR6H8sWR_yZMBwL_sHatHk=/206x305/v2/https://resizing.flixster.com/U0by0JZ20pJdJN_SBEmTNLZdQLE=/ems.ZW1zLXByZC1hc3NldHMvbW92aWVzL2JkYWE1NTAyLTYzYmYtNGQzMi1iZTY1LWUzM2JjNWVjOTJmNy53ZWJw,Girl Flu,100,7,2016.0,Comedy/Drama,0 days 01:32:00.000000000,22
80,55,,From a House on Willow Street,1000,11,2016.0,Horror,0 days 01:30:00.000000000,-25
83,91,https://resizing.flixster.com/9yAPzZUR6lgADTbfqV2GUqSB4mI=/206x305/v2/https://resizing.flixster.com/fKhvzO-W9JMWU5BHw_hA2KtxlaE=/ems.ZW1zLXByZC1hc3NldHMvbW92aWVzLzVmMjJhYzIyLWVkNGUtNGJjMC1hMGYyLTgxMjQxZmFkOGM4My53ZWJw,Score: A Film Music Documentary,1000,33,2016.0,Documentary/Music,0 days 01:34:00.000000000,8
37,50,https://resizing.flixster.com/jy93vvaKb3yqdP0zBFUVjqc54lg=/206x305/v2/https://resizing.flixster.com/amt_a5mhL6TrP-CGQzhlFI_cJSQ=/ems.ZW1zLXByZC1hc3NldHMvbW92aWVzLzA0MWJlZmU5LTVjZmYtNGFiYy1iYWQ5LTBmZmZmNDZhMjQwYS53ZWJw,Brave New Jersey,100,20,2016.0,Comedy,0 days 01:31:00.000000000,13
38,67,https://resizing.flixster.com/p4TewZ4pNvVNXe0wMGl09gwtoy4=/206x305/v2/https://resizing.flixster.com/kV3uMlhr82iTsMBKIoBe2nJQIvs=/ems.ZW1zLXByZC1hc3NldHMvbW92aWVzL2JlYjJkMTZlLWFjODEtNDZhNi04NjhmLTI2NDFkMTc0NGJiMi53ZWJw,It Stains the Sands Red,250,15,2016.0,Horror/Mystery and thriller,0 days 01:32:00.000000000,29
64,86,https://resizing.flixster.com/GckSrt9ENTWNHT-PcoxxlijPkqg=/206x305/v2/https://resizing.flixster.com/WKOWXPDYvMGo6tE3xtu5hYzL928=/ems.ZW1zLXByZC1hc3NldHMvbW92aWVzLzFjM2Q5MGMwLTRhYTctNGJkMS1iY2RlLWI1MTllOTY4ZGI5Zi53ZWJw,Tomorrow Ever After,100,7,2016.0,Comedy/Sci fi,0 days 01:35:00.000000000,22
41,38,https://resizing.flixster.com/UboqDEnhVyRKP-x-DGS26u8aMt8=/206x305/v2/https://resizing.flixster.com/2pnm-t1Pcq-zgjaVGDCfWjtmukc=/ems.ZW1zLXByZC1hc3NldHMvbW92aWVzLzU2YjhjZGU1LWVkZDQtNGQ2NS1iMzkxLWE4ZTBiNjE3MzMzMi53ZWJw,Social Animals,50,8,2018.0,Romance,0 days 01:27:00.000000000,-3
19,18,,One Last Heist,100,17,2017.0,Crime/Drama,0 days 01:40:00.000000000,-1
84,83,,The King's Choice,500,24,2016.0,History/War,0 days 02:13:00.000000000,-1
71,90,https://resizing.flixster.com/4kRPzCJ7tmMJSgrEee8j65cHIfI=/206x305/v2/https://resizing.flixster.com/Op2k_06mdgKVH6p8BfCu5Dp6V7w=/ems.ZW1zLXByZC1hc3NldHMvbW92aWVzLzkxNzY3M2VjLTM4OWYtNDUwMS05YjAzLTA0OTliZDNmY2VlMi53ZWJw,Their Finest,5000,170,2016.0,Romance/Drama,0 days 01:57:00.000000000,19
53,100,https://resizing.flixster.com/XSRBVwoEeVXyciXcVYOnTlGyf1o=/206x305/v2/https://resizing.flixster.com/VprQJLEbUccgQIXzbB6pmKD7lMk=/ems.ZW1zLXByZC1hc3NldHMvbW92aWVzLzg3MmIyNmZjLTQ5ZGEtNDc1NS05OTEzLTk4MDFlOWMwOTgzNS53ZWJw,My Journey Through French Cinema,250,41,2016.0,Documentary,0 days 03:15:00.000000000,47
42,52,https://resizing.flixster.com/MbKVm71MuUVwVAkSjMtOMns3wz8=/206x305/v2/https://resizing.flixster.com/z01qbA4mpdnDGxmYm3PyYidYbqo=/ems.ZW1zLXByZC1hc3NldHMvbW92aWVzL2Q4MTg4MmExLWU1MGUtNDIxYi1iZmNmLTQ1OThiY2YwZDA5MC53ZWJw,The Forgiven,100,23,2017.0,Drama/Mystery and thriller,0 days 01:55:00.000000000,10
48,79,,The Beguiled,10000,325,2017.0,Drama/History,0 days 01:34:00.000000000,31
15,50,https://resizing.flixster.com/X6b0TiE5yEyqUCxStCZOiyAap6E=/206x305/v2/https://flxt.tmsimg.com/NowShowing/173382/173382_aa.jpg,The Drowning,100,14,2016.0,Drama/Mystery and thriller,0 days 01:35:00.000000000,35
69,58,,Please Stand By,500,38,2017.0,Comedy/Drama,0 days 01:33:00.000000000,-11
33,33,https://resizing.flixster.com/EthOOLw-qTYMrU6sCWwgHW9Knoo=/206x305/v2/https://resizing.flixster.com/e0CxpSgDtQsGxsjS0U4TH57RmWk=/ems.ZW1zLXByZC1hc3NldHMvbW92aWVzLzI1YjUxMGRkLTgyMzQtNGJiZi1iYjllLTNkMjdiNWIwNmI1ZS53ZWJw,Dark Signal,50,6,2016.0,Horror/Mystery and thriller,0 days 01:38:00.000000000,0
73,51,https://resizing.flixster.com/fHVFjsh-65Zu8VqAQUlEJV7OvII=/206x305/v2/https://resizing.flixster.com/fwpEdiTfv6dcx6MKsCRAVZ5QVaU=/ems.ZW1zLXByZC1hc3NldHMvbW92aWVzL2NiOGVkNDJkLTM4MWUtNDk3Mi1hZGMxLWFmNGI4OGJmMWQ5MC53ZWJw,Rampage,10000,280,2018.0,Action/Sci fi,0 days 01:47:00.000000000,-22
79,74,https://resizing.flixster.com/OC8Tx1WFEiZQDpqtGqc6oh8B9xo=/206x305/v2/https://resizing.flixster.com/HtKnF93zqWRxDPXuiBtlSLP8hhI=/ems.ZW1zLXByZC1hc3NldHMvbW92aWVzLzQ2ZDRmMzJlLTQ1NWItNDBlOS1iNjVlLWM4MzMwMjE2MDc1Yi53ZWJw,Bernard and Huey,100,19,2017.0,Comedy/Drama,0 days 01:30:00.000000000,-5
81,92,https://resizing.flixster.com/9hvLYoJwQ7A2tPWFTfDAf_x5nCE=/206x305/v2/https://resizing.flixster.com/YyXpOAmexLHB-rJzh3kA1FvjZ-4=/ems.ZW1zLXByZC1hc3NldHMvbW92aWVzLzE4MmY5NzRiLWJlMzItNDY4Ni1iZGIzLWU2NjY3MDQ1NGE0Mi53ZWJw,Good Time,5000,238,2017.0,Crime/Drama,0 days 01:41:00.000000000,11
42,65,https://resizing.flixster.com/mZGLGC2ulbZLoulp3oAhR_L83VU=/206x305/v2/https://resizing.flixster.com/NgHamJC-i5IxalQqVMOLkqglZyM=/ems.ZW1zLXByZC1hc3NldHMvbW92aWVzL2E5NzIwNDljLTFhODUtNGZhYS05N2Y3LWRlOGI4Yjg5ZDFkYy53ZWJw,The Wall,5000,125,2017.0,Mystery and thriller/War,0 days 01:30:00.000000000,23
79,78,https://resizing.flixster.com/bXhkaMUcY2ancJuLMKeVAgQHezE=/206x305/v2/https://resizing.flixster.com/VisiMrSHXx9k3biZnRucpw1Hp48=/ems.ZW1zLXByZC1hc3NldHMvbW92aWVzL2VjN2YxZmNiLTEwNDgtNGEzNy05ZmM5LWE3NjFmNDFkOGI0ZS53ZWJw,The Tiger Hunter,500,18,2016.0,Comedy/Drama,0 days 01:34:00.000000000,-1
74,84,https://resizing.flixster.com/25k7xstePPBr0Gt8bWNZZ-vabMU=/206x305/v2/https://resizing.flixster.com/dhLekZJt_fE8mbMDIIJGn-MItRs=/ems.ZW1zLXByZC1hc3NldHMvbW92aWVzL2YzNmFhZDg2LWU4ZTEtNDFhZC04YjM0LTdjZjk5YmQ1NmNiZS53ZWJw,Borg vs. McEnroe,1000,145,2017.0,Drama,0 days 01:48:00.000000000,10
57,57,https://resizing.flixster.com/pAf5jLguAlz3JCTG8pECe-dqWbs=/206x305/v2/https://resizing.flixster.com/_m69wUPWSK0qeOA6aJYECTkJaI8=/ems.ZW1zLXByZC1hc3NldHMvbW92aWVzL2M3OGE2MTc5LTYyZmQtNDY0MS04NzEyLTczNTFiMGZkMTdmZi53ZWJw,1:54,100,7,2016.0,Gay and lesbian/Drama,0 days 01:46:00.000000000,0
43,26,https://resizing.flixster.com/zDWIBwWBKQTZZESg7N3ybjb7lak=/206x305/v2/https://resizing.flixster.com/Jy7EuvT24GTQ2gJztWvVSpRUOY0=/ems.ZW1zLXByZC1hc3NldHMvbW92aWVzLzNjYjE4MmQwLTA4ZTctNDM4NC1hYjc2LTY4YzYxZjliMmJjYy53ZWJw,Unlocked,1000,57,2017.0,Action/Mystery and thriller,0 days 01:38:00.000000000,-17
85,98,https://resizing.flixster.com/bNCDJxgUOK_0k-8DwrSRsjuDc3A=/206x305/v2/https://resizing.flixster.com/Hot78b8bxfIQ5-zyF1awutOlmM0=/ems.ZW1zLXByZC1hc3NldHMvbW92aWVzL2M4YTljZDgzLWI5ZWUtNGI2Yy04NmNiLTNhNDM0YmU4NDE2Yy53ZWJw,Kedi,5000,128,2016.0,Documentary,0 days 01:20:00.000000000,13
61,45,https://resizing.flixster.com/4kZMTEyWHUpSG3JypcXAPVcdg9k=/206x305/v2/https://resizing.flixster.com/y4lC78Gl3b2diGqsk5i4Mml6VFY=/ems.ZW1zLXByZC1hc3NldHMvbW92aWVzL2Y3MDJiYzM3LTYwOTMtNDc3My05NjAxLWU4YTQzNmZiZjc4Ny53ZWJw,"Everything, Everything",5000,122,2017.0,Romance/Drama,0 days 01:36:00.000000000,-16
81,59,https://resizing.flixster.com/Zd6s826MCLsc3T7x9m27UVnrkjc=/206x305/v2/https://resizing.flixster.com/wrQM9BqPBzw2zxdjRoabvvMQwug=/ems.ZW1zLXByZC1hc3NldHMvbW92aWVzL2QxYWIzZTYxLWEyNGItNDk2NC1hNTUyLTE4MDRlZTIxNGM0Zi53ZWJw,The Case for Christ,50,27,2017.0,Drama/Biography,0 days 01:52:00.000000000,-22
51,19,https://resizing.flixster.com/oERUZ5BgZDZvFawl3OP0rPRciNw=/206x305/v2/https://resizing.flixster.com/sPS9F1yDt3OftWiSpemaVVOtqMI=/ems.ZW1zLXByZC1hc3NldHMvbW92aWVzLzRmZWRhMGMzLWFlZDEtNDljNi1hOWVkLTA3OTIzYWI2ZjNmOS53ZWJw,The Ottoman Lieutenant,500,36,2017.0,Romance/War,0 days 01:50:00.000000000,-32
24,25,https://resizing.flixster.com/HTb8Fus_Wq8GTTljFGMaiA_71wQ=/206x305/v2/https://resizing.flixster.com/T-H_WKktkC5QGkukNEooVCdqAgA=/ems.ZW1zLXByZC1hc3NldHMvbW92aWVzLzRiODE0YjAzLTMwOWItNGQwNC04ODYyLTdhZmVkMGNkNjM5OC53ZWJw,Woodshock,1000,56,2017.0,Drama,0 days 01:41:00.000000000,1
72,50,https://resizing.flixster.com/jcVWZrcuOE6r451YrJ8Psyg7dJo=/206x305/v2/https://flxt.tmsimg.com/assets/p14665346_p_v10_aa.jpg,Conor McGregor: Notorious,250,14,2017.0,Documentary,0 days 01:35:00.000000000,-22
44,32,https://resizing.flixster.com/0yIEmBK3G_w7LNDEBhzM8fONpj4=/206x305/v2/https://resizing.flixster.com/shnU1C4E49wYOnEdErtfJmJt_68=/ems.ZW1zLXByZC1hc3NldHMvbW92aWVzLzIzN2I5NWMzLWJmYTEtNGEyYi1iMTFiLWVjYTQ2NTRhODBhZC53ZWJw,Home Again,5000,139,2017.0,Romance,0 days 01:37:00.000000000,-12
25,47,https://resizing.flixster.com/uBzwmnF5NT3-AQu48BOItKWlUII=/206x305/v2/https://resizing.flixster.com/-QFgDcro0eSd6de81wzIGl5qgso=/ems.ZW1zLXByZC1hc3NldHMvbW92aWVzL2ExNzViNzBkLWYwN2YtNDRkNy1iMTk0LTE2ZDExNTlmN2U2Ni53ZWJw,Bushwick,500,74,2017.0,Action/Adventure,0 days 01:34:00.000000000,22
44,32,https://resizing.flixster.com/ScYbpGdY-ikg4yxp2VOf47IXm5s=/206x305/v2/https://resizing.flixster.com/Qz9gUB647MRfM1X6IwWCtWAd1FM=/ems.ZW1zLXByZC1hc3NldHMvbW92aWVzL2I3MGVhOTM2LTQwYzQtNDg5MS04NjI5LTlmZjRmNmIxNGE3My53ZWJw,A Bad Moms Christmas,10000,129,2017.0,Other/Comedy,0 days 01:44:00.000000000,-12
62,42,,Leap!,5000,62,2016.0,Adventure/Comedy,0 days 01:26:00.000000000,-20
72,57,https://resizing.flixster.com/FZh3mPB7x3gDnWe6O45b2SoTaRI=/206x305/v2/https://resizing.flixster.com/iTYGZ0M7hQUNtYtemDjeYW3Tl8I=/ems.ZW1zLXByZC1hc3NldHMvbW92aWVzLzM0Y2I0ZGRiLWRlYzEtNDJkNS1hODNjLWRkY2IyMWYxNDJiMi53ZWJw,Chasing the Dragon,250,7,2017.0,Crime/Drama,0 days 02:08:00.000000000,-15
55,21,https://resizing.flixster.com/FBZpxtbpDbs0uej3I0bq95iYOyw=/206x305/v2/https://resizing.flixster.com/qCGkAXIwQYSQssUhzC2ZTQeOxsE=/ems.ZW1zLXByZC1hc3NldHMvbW92aWVzLzA2ZTA1Y2VmLWZkN2EtNGNkNy1iYzNlLTBjMmE4Yjc3OWIzZC53ZWJw,Midnight Sun,1000,63,2018.0,Romance/Drama,0 days 01:31:00.000000000,-34
88,98,https://resizing.flixster.com/xmqVa1H4wUAhc1Z7tDUNPqEvS7w=/206x305/v2/https://resizing.flixster.com/uj2A2BB9Z_W3DByTf_rJVkGujWo=/ems.ZW1zLXByZC1hc3NldHMvbW92aWVzL2MzMjVhNWUxLWRmOGMtNGFiNS1hMTg2LTUxMTdmYjFkNjJkZi53ZWJw,The Big Sick,25000,302,2017.0,Romance,0 days 02:00:00.000000000,10
35,32,https://resizing.flixster.com/A_moIrTI3BgvMKfNwZiSeUnzBH8=/206x305/v2/https://resizing.flixster.com/-6t51k_uNELwjLM0dvMqn_3cmxY=/ems.ZW1zLXByZC1hc3NldHMvbW92aWVzL2IzZjgxYjU2LTAwMWUtNGY4OC04Y2NhLTJjYjkyMTAxODNmNi53ZWJw,Fun Mom Dinner,250,28,2017.0,Comedy,0 days 01:21:00.000000000,-3
65,88,https://resizing.flixster.com/rhG-jU1l08lvDTTCEvMJlChdw-4=/206x305/v2/https://resizing.flixster.com/B1hL9vpd760A3c8LJfbYskUvAoM=/ems.ZW1zLXByZC1hc3NldHMvbW92aWVzLzg5NTNmM2U5LTQ3NzMtNDA4MS1hODU4LTc2MjFmNDdhZGE3Yi53ZWJw,The Incredible Jessica James,500,60,2017.0,Comedy,0 days 01:25:00.000000000,23
52,81,https://resizing.flixster.com/K5-xGNr4nkmRSpSCjL0x0WsRvE8=/206x305/v2/https://resizing.flixster.com/E-shHOlN-Kez9IBExFWQe8FWTT4=/ems.ZW1zLXByZC1hc3NldHMvbW92aWVzL2ZmNjQ0Zjk2LTZlMmItNDMxNS04ZGQxLTdiMmE1NjlmNmMwZS53ZWJw,Where Is Kyra?,250,53,2017.0,Drama,0 days 01:38:00.000000000,29
41,40,https://resizing.flixster.com/tAeYr1xT7-nJRAt-JN90eULA24A=/206x305/v2/https://resizing.flixster.com/naMBTS5vPizjv0rsokyqD4hhj1c=/ems.ZW1zLXByZC1hc3NldHMvbW92aWVzLzFhZDFhYTUwLWYyYzgtNDI4Zi1iN2YwLTA1YWZjNzM1N2NkYy53ZWJw,Black Butterfly,500,20,2017.0,Mystery and thriller,0 days 01:33:00.000000000,-1
49,78,https://resizing.flixster.com/IVAUeOgl0lRXYVcGcgylpUxfqBM=/206x305/v2/https://resizing.flixster.com/B-QRnaBrgKFoL37MzKNXGZqRd-E=/ems.ZW1zLXByZC1hc3NldHMvbW92aWVzLzAzYTFhY2VhLTcyMTItNGY0My1hMzViLTkyNzEyN2YwOGNiOS53ZWJw,The Little Hours,5000,128,2017.0,Comedy,0 days 01:30:00.000000000,29
64,96,https://resizing.flixster.com/jm8svXUGElqU9U5pTvff8M-Ph94=/206x305/v2/https://resizing.flixster.com/XTBC_SZbwQ0GxiiIBLgk3cKMvIA=/ems.ZW1zLXByZC1hc3NldHMvbW92aWVzLzhiYjQwZmZlLTNhYTktNGJmZC04MzRiLTJjMGFlNDI5OTVlOC53ZWJw,Menashe,1000,118,2017.0,Comedy/Drama,0 days 01:22:00.000000000,32
69,65,https://resizing.flixster.com/mp3FycE-N4O5sIiwpdtNPHQbrdI=/206x305/v2/https://resizing.flixster.com/gSJFZB-j2D1NiCsjSgZcxsIpCLs=/ems.ZW1zLXByZC1hc3NldHMvbW92aWVzLzk5ZWRkNjI4LWExNzQtNDk0Yy05NTBlLTIxYzc3N2YzMjIyZC53ZWJw,It Happened in L.A.,50,17,2017.0,Romance,0 days 01:37:00.000000000,-4
66,91,https://resizing.flixster.com/IlwrV3ixOqNBEOcoaiIA2YHmA4A=/206x305/v2/https://resizing.flixster.com/gryJwvonzc7jN_kbYwhe4Z8EXDg=/ems.ZW1zLXByZC1hc3NldHMvbW92aWVzLzc0MzkwZGUwLWMyZWQtNDJiZS04YjVjLTdlYjYwYzllZDNhZi53ZWJw,A Ghost Story,10000,276,2017.0,Fantasy/Romance,0 days 01:30:00.000000000,25
64,71,https://resizing.flixster.com/-KjPfiwryDkjzrnRW3AmTNbnTA0=/206x305/v2/https://resizing.flixster.com/xLcrRpQ04GKVv_vjUosXlGJD51E=/ems.ZW1zLXByZC1hc3NldHMvbW92aWVzLzM1MjZiZDFiLWM2NDItNDhlOS04NmQ1LTRlOGZjMWFlNTgzNy53ZWJw,To the Bone,2500,65,2017.0,Comedy/Drama,0 days 01:47:00.000000000,7
64,74,https://resizing.flixster.com/tWIhEgqNM83T9ihqOgPUGXuQRbI=/206x305/v2/https://resizing.flixster.com/IjA1t5uvR9kum2s1nWAmH4k0BYg=/ems.ZW1zLXByZC1hc3NldHMvbW92aWVzLzFlNDViYjdmLWRkZTMtNDlmNi1hODU1LTk3NmE4NTE4NjBlMC53ZWJw,Landline,2500,129,2017.0,Comedy/Drama,0 days 01:33:00.000000000,10
38,67,https://resizing.flixster.com/mk8R06ZiiDWr3hyqYru_qys3l9U=/206x305/v2/https://resizing.flixster.com/fbf3vlQBP2RIpS4k5I7lxD9AXmY=/ems.ZW1zLXByZC1hc3NldHMvbW92aWVzL2RiMzYyNDM2LThmMDUtNGUxNi04NTRhLTQ4Y2FkMGUyZTM3OC53ZWJw,Golden Exits,100,52,2017.0,Drama,0 days 01:34:00.000000000,29
30,67,,Bitch,100,39,2017.0,Comedy,0 days 01:36:00.000000000,37
79,88,https://resizing.flixster.com/8J53S-C2jcrTG1Oepc64KEHVU10=/206x305/v2/https://resizing.flixster.com/tOXJl71wD6VEruW2acHdpbQMwEQ=/ems.ZW1zLXByZC1hc3NldHMvbW92aWVzLzlmMTNhYTM2LWZiYTgtNGJmMi1iZTBjLWRmOTRlMmE5MmNkMS53ZWJw,78/52,1000,86,2017.0,Documentary,0 days 01:31:00.000000000,9
47,52,,Person to Person,50,46,2017.0,Comedy/Drama,0 days 01:24:00.000000000,5
84,94,https://resizing.flixster.com/I_mkQWPlGWlWVXU2CLS5bqLL2Oo=/206x305/v2/https://resizing.flixster.com/CDvffp3OwLNdyPm0KUVHrRipd-k=/ems.ZW1zLXByZC1hc3NldHMvbW92aWVzL2MwMDUxZWYyLTg1YWYtNGU1Yy1hMmNmLWU0YWFlNWI3ZWZhOS53ZWJw,Gook,1000,54,2017.0,Comedy/Drama,0 days 01:35:00.000000000,10
78,74,,Take Every Wave: The Life of Laird Hamilton,250,23,2017.0,Documentary,0 days 01:58:00.000000000,-4
84,97,https://resizing.flixster.com/apftxER5cRP0OtO3Hw63Vn1ePWs=/206x305/v2/https://resizing.flixster.com/rbmAweioKTEpeuq5Gcyv9TnYJD4=/ems.ZW1zLXByZC1hc3NldHMvbW92aWVzL2ZhMGU3MDk1LWIyN2YtNDI1Yy1iNTlkLTNkMjNlN2I4YzI5OS53ZWJw,Mudbound,5000,198,2017.0,Drama/History,0 days 02:14:00.000000000,13
57,100,https://resizing.flixster.com/oe60G7rVPgToEmROTzaMxzgXJ_E=/206x305/v2/https://resizing.flixster.com/Ebte0d0fTBuOYsxhZr4wFWiHJo8=/ems.ZW1zLXByZC1hc3NldHMvbW92aWVzLzNkNTQ3YjFmLTk1NmYtNGZiZS1iYzc2LWQ2ZjNlNTNmMmE3NS53ZWJw,Strong Island,500,48,2017.0,Documentary,0 days 01:47:00.000000000,43
89,100,,Chasing Coral,500,31,2017.0,Documentary,0 days 01:33:00.000000000,11
56,90,https://resizing.flixster.com/DOttGzYMj4SMIYNtq1mfm7gpaSU=/206x305/v2/https://resizing.flixster.com/MFvNHWLj6iLO562zv0BgjM5sTaY=/ems.ZW1zLXByZC1hc3NldHMvbW92aWVzL2IyNjU4N2U4LTRmMjUtNDE5OC05ODdiLTU0MWM3NDg3MGJiYS53ZWJw,Walking Out,500,50,2017.0,Drama/Adventure,0 days 01:35:00.000000000,34
62,70,https://resizing.flixster.com/0Y_Fbnbz7B5SbiEeAggM45pK1BQ=/206x305/v2/https://resizing.flixster.com/y2lCXfkfavOcGUWtSrvmFWenGPQ=/ems.ZW1zLXByZC1hc3NldHMvbW92aWVzLzZlNzJkZGRiLWEyZWEtNDllNS04ZTI5LWZjNmJkMzUyMjdiNy53ZWJw,Roxanne Roxanne,100,30,2017.0,Drama/Music,0 days 01:38:00.000000000,8
69,86,https://resizing.flixster.com/4rQnUZsVUJSkDgHK0iMoQ71Kcgo=/206x305/v2/https://resizing.flixster.com/QUsdl0qpnEhVWQpFJW7kKHGFseI=/ems.ZW1zLXByZC1hc3NldHMvbW92aWVzLzg1MDk2ZmU5LTlkODQtNGY0NS04MzNhLWQxZTlkNjA5MmE0Ni53ZWJw,Novitiate,1000,101,2017.0,Drama,0 days 02:03:00.000000000,17
71,86,/assets/pizza-pie/images/poster_default.c8c896e70c3.gif,Ingrid Goes West,5000,194,2017.0,Comedy/Drama,0 days 01:38:00.000000000,15
59,77,https://resizing.flixster.com/DRY8qOmkFfSDf5vUaHCHXkeF7ro=/206x305/v2/https://resizing.flixster.com/CmY0atrLnJe8PhGvga8JmdWaplI=/ems.ZW1zLXByZC1hc3NldHMvbW92aWVzL2JlNmU2N2Y3LTYwNDctNGI3NS1hZGQ1LTJjODVlZWZkYzA1ZS53ZWJw,The Hero,5000,114,2017.0,Drama,0 days 01:36:00.000000000,18
73,70,https://resizing.flixster.com/e2rO_JvmTSVXXNJh7b2etrSehQo=/206x305/v2/https://resizing.flixster.com/i9bBN2uYND5nFAh1_v067_lOQBY=/ems.ZW1zLXByZC1hc3NldHMvbW92aWVzL2M4ZGFjMmJkLWJhMTAtNGJmMC1iZDhkLWUxYWM2ZDIwOTAyYy53ZWJw,Buena Vista Social Club: Adiós,100,20,2017.0,Documentary/Music,0 days 01:50:00.000000000,-3
82,85,,Megan Leavey,10000,103,2017.0,Drama/War,0 days 01:56:00.000000000,3
55,55,https://resizing.flixster.com/ntdgvBBtTdF42CXn89ZC32fGX1o=/206x305/v2/https://resizing.flixster.com/fjaEl5NVgRoLAMul29Z0Il4JFYo=/ems.ZW1zLXByZC1hc3NldHMvbW92aWVzLzE3NzJiNGVkLWRiNjktNDg1Mi1iYzcyLTFkYWZiNjg4MzgwZS53ZWJw,Half Magic,100,29,2018.0,Romance,0 days 01:40:00.000000000,0
39,75,https://resizing.flixster.com/kpEy8smzE0V1ke5y5_CQQpr_7DU=/206x305/v2/https://resizing.flixster.com/9xVBbPi0uBsjWHH9nSjTNfV-2Wg=/ems.ZW1zLXByZC1hc3NldHMvbW92aWVzL2Y5NGYwZTQ0LTA2ZjQtNDNhMS1iMjg3LWE2NDIxZmMyYzdlNC53ZWJw,Mom and Dad,1000,136,2017.0,Comedy/Horror,0 days 02:03:00.000000000,36
67,100,,The Good Postman,1,6,2016.0,Documentary,0 days 01:20:00.000000000,33
86,94,https://resizing.flixster.com/-EQDDvk3DpV6xOyB_lXmAREneGs=/206x305/v2/https://resizing.flixster.com/G5Z3kfHQp3woiySWNO3CISVNQr4=/ems.ZW1zLXByZC1hc3NldHMvbW92aWVzL2Y1YTA4ZDdiLThmYWUtNGE4YS05MWM4LTcwOWY2MWUxYzBmOC53ZWJw,Call Me by Your Name,10000,358,2017.0,Romance/Gay and lesbian,0 days 02:12:00.000000000,8
30,19,https://resizing.flixster.com/1Wr2AFIfNg_0Moo4AIXQQ7wvS-Q=/206x305/v2/https://resizing.flixster.com/5j9sWlhDJe7vrhgy33UQZ9D6XEg=/ems.ZW1zLXByZC1hc3NldHMvbW92aWVzL2I2MGY4NGEyLTE4MzYtNDdkNS1iMzllLTU0ZDRhYmVkYjliNi53ZWJw,Wish Upon,2500,94,2017.0,Horror/Mystery and thriller,0 days 01:29:00.000000000,-11
74,97,,Last Men in Aleppo,250,35,2017.0,Documentary/War,0 days 01:44:00.000000000,23
73,88,https://resizing.flixster.com/xD0FlYdmNgKWAM_wIrF-mX9Z-3c=/206x305/v2/https://resizing.flixster.com/US2DqDO3_7ich1-afOCaYYRn5YQ=/ems.ZW1zLXByZC1hc3NldHMvbW92aWVzLzhjZTFmNzZiLTVlYjktNDVmMC1iNjkzLTdlMDAxNjIwODJhMS53ZWJw,Band Aid,2500,72,2017.0,Comedy/Drama,0 days 01:34:00.000000000,15
86,82,https://resizing.flixster.com/pB7PYS3NRIAEA7TomFi2C41ki9A=/206x305/v2/https://resizing.flixster.com/ZfoQw4akyKlX0xprECGUhEcYwVY=/ems.ZW1zLXByZC1hc3NldHMvbW92aWVzLzNjZTYyMjcwLTI5ZmEtNDc4ZC1iNmRmLTVjYTYzZTkzMTUwMC53ZWJw,Brigsby Bear,2500,165,2017.0,Comedy,0 days 01:37:00.000000000,-4
57,85,https://resizing.flixster.com/9IwA4_PzQQtITAwPvXH6jRgtgRE=/206x305/v2/https://resizing.flixster.com/YMWhXY65cSPTZ1EFNu_a0W4U32k=/ems.ZW1zLXByZC1hc3NldHMvbW92aWVzL2UyNjVjZWU4LWQ3MDktNDYxMy04ZjkwLTFiZGVlMjhkMWUxOS53ZWJw,Beach Rats,2500,105,2017.0,Gay and lesbian/Drama,0 days 01:37:00.000000000,28
77,77,https://resizing.flixster.com/tv9XynsdNpzBdYWlUC8L0BcYuiE=/206x305/v2/https://resizing.flixster.com/MxNV0GDovTlh1EjLOrk8x6CwduI=/ems.ZW1zLXByZC1hc3NldHMvbW92aWVzL2JhYWE1MWFmLWYxYzgtNGI3My1hYjIwLTU2ZDY0YjQyY2I4My53ZWJw,Crown Heights,500,83,2017.0,Crime/Drama,0 days 01:36:00.000000000,0
94,92,,Icarus,2500,48,2017.0,Documentary,0 days 01:50:00.000000000,-2
61,71,https://resizing.flixster.com/MWT90lqN79meCrOpqBqUtBSyEyo=/206x305/v2/https://resizing.flixster.com/ldghYR6ncFvHHrxUz8Utg406boc=/ems.ZW1zLXByZC1hc3NldHMvbW92aWVzLzBlNTNhMGJmLWRhYzQtNDViMi1iMTlkLTIyMDc2ZjQwMjAzNS53ZWJw,Newness,250,17,2017.0,Drama,0 days 01:52:00.000000000,10
54,75,https://resizing.flixster.com/cNzxcwKWPvQsm1paXId6mk6_XgQ=/206x305/v2/https://resizing.flixster.com/aVqcIyAw6-zlpKc1NGn-lU9zApc=/ems.ZW1zLXByZC1hc3NldHMvbW92aWVzLzcwZWI3NGYxLWM1MjMtNGNiYi1iMWQ3LTI0Y2UwNzE0MGEwNy53ZWJw,Manifesto,1000,85,2015.0,Comedy/Drama,0 days 01:35:00.000000000,21
42,25,https://resizing.flixster.com/7Iun5nkqJJOrMcJFeIOOmY0T75U=/206x305/v2/https://resizing.flixster.com/h9YO9OL-6q_oVNKA_cRGf7rlqVs=/ems.ZW1zLXByZC1hc3NldHMvbW92aWVzL2FhNWQwNTdkLTMxZDYtNDFlYi04YjVhLWU4NTM2NjMyYWJkMS53ZWJw,Rememory,500,20,2017.0,Sci fi/Mystery and thriller,0 days 01:51:00.000000000,-17
78,11,,Sidney Hall,250,27,2017.0,Drama/Mystery and thriller,0 days 01:59:00.000000000,-67
71,92,,Bad Day for the Cut,250,13,2017.0,Mystery and thriller,0 days 01:39:00.000000000,21
45,74,https://resizing.flixster.com/rTlIkgKcDlt82FYxeapvrQXwoTA=/206x305/v2/https://resizing.flixster.com/klWL7KCeCi5a3V3_xdl46m6YV38=/ems.ZW1zLXByZC1hc3NldHMvbW92aWVzL2RjNDcxMjY5LTc4ZmYtNDA5ZS1iMDk4LTM4YTI3MDg1NWQ0Ny53ZWJw,Killing Ground,500,70,2016.0,Horror/Mystery and thriller,0 days 01:28:00.000000000,29
14,64,https://resizing.flixster.com/CRAaKnUBZsyk6HJ76kFFaf7xYu4=/206x305/v2/https://resizing.flixster.com/iYO1wynMZqPlMHTCoPR1EmYB8J0=/ems.ZW1zLXByZC1hc3NldHMvbW92aWVzLzk2NGY4NjIwLWJkYjMtNGJkNy04OGNmLWY3YmZhMDdhZjVlMS53ZWJw,Axolotl Overkill,50,11,2017.0,Comedy/Drama,0 days 01:34:00.000000000,50
87,98,https://resizing.flixster.com/4B2V0f5sw3-V65Tyh6FEiMaYMnQ=/206x305/v2/https://resizing.flixster.com/Ntunb2RutKvVuBjbPVm66_68w5k=/ems.ZW1zLXByZC1hc3NldHMvbW92aWVzLzYxYzRmZGFjLTA3ZjktNDg4NS04YjI1LWI2NGJiNWIzZTAyOC53ZWJw,God's Own Country,2500,128,2017.0,Romance/Drama,0 days 01:44:00.000000000,11
67,100,,Boston,50,8,2017.0,Documentary,0 days 02:03:00.000000000,33
62,95,https://resizing.flixster.com/99s1AQSeH1IeKRRfP7EhM3rjVf8=/206x305/v2/https://resizing.flixster.com/ojzyLb7E_nRV3tPH4di7rSkRPWQ=/ems.ZW1zLXByZC1hc3NldHMvbW92aWVzL2E2MWYwMDUzLWM2N2QtNDE2NS1hZGE2LWMzN2ZhNWNjNjZjYS53ZWJw,It's Not Yet Dark,100,20,2016.0,Documentary,0 days 01:17:00.000000000,33
89,91,,Rumble: The Indians Who Rocked the World,100,46,2017.0,Documentary/Music,0 days 01:43:00.000000000,2
50,79,https://resizing.flixster.com/W1N-hVvjfoYJN3uaT25iKIAu9mA=/206x305/v2/https://resizing.flixster.com/fWZbr32LxiLFUb7ZqAFwuKSY1rw=/ems.ZW1zLXByZC1hc3NldHMvbW92aWVzLzkyOTMwNzllLTAwNWYtNGE5Zi05OWRlLTdhZDY0NTEzYTJkNC53ZWJw,An Inconvenient Sequel: Truth to Power,5000,156,2017.0,Documentary,0 days 01:40:00.000000000,29
63,73,,The Wizard of Lies,1000,52,2017.0,Crime/Drama,0 days 02:13:00.000000000,10
67,58,https://resizing.flixster.com/k9iUEznPYd5K7rehArfnV9r6-Y8=/206x305/v2/https://flxt.tmsimg.com/assets/p14834865_p_v10_aa.jpg,The New Radical,1,12,2017.0,Documentary,,-9
71,52,https://resizing.flixster.com/JW5NG4VjAyiiejOSx5DpyINOlco=/206x305/v2/https://resizing.flixster.com/-h0WOn6Fji43q5MKmrc2vtbgzBs=/ems.ZW1zLXByZC1hc3NldHMvbW92aWVzLzM5OTk3YmRmLWMwNDgtNGFiOS1iMDU5LTUwMGIzYTllNzY2Ny53ZWJw,The Glass Castle,5000,164,2017.0,Drama/Biography,0 days 02:07:00.000000000,-19
51,21,https://resizing.flixster.com/2XZtJso8JBGZb7qxUsTwpQuuiLY=/206x305/v2/https://resizing.flixster.com/mhe7SisBYG0kJ5OAvGgglE6bX-M=/ems.ZW1zLXByZC1hc3NldHMvbW92aWVzL2IzMGViNGU2LTg2NjEtNDBmNi1iZjVkLTNkYjFlZDM1NTU2Zi53ZWJw,Daddy's Home 2,10000,129,2017.0,Other/Comedy,0 days 01:38:00.000000000,-30
14,33,https://resizing.flixster.com/ZRWAxNZbhG0fyS6CqQPRqpoW6AQ=/206x305/v2/https://resizing.flixster.com/Ibb1Zp_NphWSJEEbjUx9cthM4L8=/ems.ZW1zLXByZC1hc3NldHMvbW92aWVzLzc4YTcyNTM5LWU2NDMtNDdkOC04MDBkLThmMTRlMDcwMDMyNi53ZWJw,The Chamber,50,15,2016.0,Mystery and thriller,0 days 01:30:00.000000000,19
72,90,,Super Dark Times,2500,48,2017.0,Drama/Mystery and thriller,0 days 01:42:00.000000000,18
95,86,,A Very Sordid Wedding,1000,7,2017.0,Comedy/Gay and lesbian,0 days 01:49:00.000000000,-9
54,49,https://resizing.flixster.com/OvZJBJy6R2A9L9V_9v81yctnjk0=/206x305/v2/https://resizing.flixster.com/8mE4_gFdHRmFsiHhYBKecggRJxQ=/ems.ZW1zLXByZC1hc3NldHMvbW92aWVzLzliZTllOWY2LTlmNWQtNGQ2Zi05MTE5LTgwMjA0MzcxMmZhYi53ZWJw,Churchill,2500,116,2017.0,Drama/History,0 days 01:45:00.000000000,-5
44,87,https://resizing.flixster.com/0vxDCMRIMKN1wTN6BWLnchzGhyg=/206x305/v2/https://resizing.flixster.com/iOO0pQaStL7HBs8JVYrknnnna64=/ems.ZW1zLXByZC1hc3NldHMvbW92aWVzL2ExMjliMGEwLWVjNWYtNGEwNC1hNzU2LWRhNzcyNGZmY2M0Yi53ZWJw,It Comes at Night,10000,252,2017.0,Horror/Mystery and thriller,0 days 01:37:00.000000000,43
45,20,https://resizing.flixster.com/wYSg2bRFy2Buf-xbXgvX-4NOp38=/206x305/v2/https://resizing.flixster.com/iIpvKiInU6K9q5QTXYzY0VDGEOc=/ems.ZW1zLXByZC1hc3NldHMvbW92aWVzLzBlNjZlNzdkLWM3NWMtNDkyMS1iMGZhLWQ2NDNkNDYyODM5MS53ZWJw,All Summers End,100,5,2017.0,Drama,0 days 01:50:00.000000000,-25
45,25,,Proud Mary,1000,75,2018.0,Action/Mystery and thriller,0 days 01:28:00.000000000,-20
79,24,https://resizing.flixster.com/k0E1isHrZv65bW71QlvSklhqhx4=/206x305/v2/https://resizing.flixster.com/Ra7_jMaQG8Lg5vIH6dObYz5KsZE=/ems.ZW1zLXByZC1hc3NldHMvbW92aWVzLzQ5OGM0MDhkLWMyYTEtNGE3OC1hM2U5LTc5NDk0MjY0MGRkOC53ZWJw,Forever My Girl,1000,54,2018.0,Romance/Drama,0 days 01:48:00.000000000,-55
75,58,https://resizing.flixster.com/YNwAf-gceB6Os97gwZq5qHogrO0=/206x305/v2/https://resizing.flixster.com/vf7L2_94GC2XNcwLZy-C4kont0Q=/ems.ZW1zLXByZC1hc3NldHMvbW92aWVzLzkzNDMwM2Q4LWZiMDEtNDUwMS05NGE5LTFmMmYyNzVlNWY5ZS53ZWJw,Django,100,24,2017.0,Drama/Music,0 days 01:55:00.000000000,-17
60,85,https://resizing.flixster.com/VlqnttHs0FhV2WWPbm1vux1hcMw=/206x305/v2/https://resizing.flixster.com/NsGSZNupndYq4tzwF1G1zhlh8RI=/ems.ZW1zLXByZC1hc3NldHMvbW92aWVzLzc0YTQyYjIzLTcxMjgtNGE5ZS1iMTJjLTljNmRjOTk2YTc4Zi53ZWJw,Polina,250,52,2016.0,Drama,0 days 01:48:00.000000000,25
66,85,https://resizing.flixster.com/HnLV6k6GuFdjH4quRv4lKVujluY=/206x305/v2/https://resizing.flixster.com/6lCJEeWXE7Q0548QCwUyrxW7nyE=/ems.ZW1zLXByZC1hc3NldHMvbW92aWVzL2U2ZGZkODJmLTI1ZDQtNDM2ZC1iYTBlLTY5ZGM2ZjBiYmJlOS53ZWJw,Vazante,100,34,2017.0,Drama/History,0 days 01:56:00.000000000,19
86,33,https://resizing.flixster.com/eL2WZo8KhMfMUzMm5WkNr_FTQ-o=/206x305/v2/https://resizing.flixster.com/Q3AqYKFpBgyV_8hgPfj8tLLk8KU=/ems.ZW1zLXByZC1hc3NldHMvbW92aWVzL2UxOWMwMjkzLTE3MTYtNDkyOC04NmZlLTRjOGFiNmIyZTIxNy53ZWJw,Dalida,50,6,2016.0,Drama/Music,0 days 02:04:00.000000000,-53
70,84,https://resizing.flixster.com/gr_5JHq_D6Idp_YJpIvhHCMBWoQ=/206x305/v2/https://resizing.flixster.com/bmNZWc0JjKUb0CTRK4mXHyM0p9w=/ems.ZW1zLXByZC1hc3NldHMvbW92aWVzL2Y1NWU4Nzk1LTk2M2UtNDcwMi1hZjM1LWY2ZDdiYzE0MDc0OS53ZWJw,Tom of Finland,500,69,2017.0,Gay and lesbian/Drama,0 days 01:56:00.000000000,14
85,95,,Chavela,250,38,2017.0,Documentary/Music,0 days 01:31:00.000000000,10
66,73,https://resizing.flixster.com/1RJOCLJt-ZHpZavqNryRG9Bfmjo=/206x305/v2/https://resizing.flixster.com/L_0iwSVLGd9VF-0j3_-7wwK4JaI=/ems.ZW1zLXByZC1hc3NldHMvbW92aWVzL2M3YzM3MWI4LTAxMTEtNDAwMy1iZWYyLTY3MWRmZjZmNTBkMy53ZWJw,Viceroy's House,1000,80,2017.0,Drama/History,0 days 01:45:00.000000000,7
38,30,,The Queen of Spain,50,27,2016.0,Comedy,0 days 02:08:00.000000000,-8
78,94,https://resizing.flixster.com/-lQylhbl6XrQ_L0yiW8tbSG3-_0=/206x305/v2/https://resizing.flixster.com/vIoXg4mQJm9UzLSlGVGJ83AyxFg=/ems.ZW1zLXByZC1hc3NldHMvbW92aWVzLzQzNjM0MmZlLTg1OTItNDFiZi1hNzExLWFkNzhjZWE4NGQyZS53ZWJw,A Fantastic Woman,1000,221,2017.0,Gay and lesbian/Drama,0 days 01:43:00.000000000,16
70,61,https://resizing.flixster.com/HAWd3_RmEFLbtQzFu31wJ0xZvI4=/206x305/v2/https://resizing.flixster.com/DRO3yj3cBRsQ4sMltn9Yxm428OM=/ems.ZW1zLXByZC1hc3NldHMvbW92aWVzLzZkYzIzMzg3LTE3ODgtNDVkOC04ZjQyLTg3MDA2YmRjMjQ2Zi53ZWJw,The Young Karl Marx,250,49,2017.0,Drama/History,0 days 01:58:00.000000000,-9
61,82,https://resizing.flixster.com/7-DP-R3oO4AFvOocITodNamCjRo=/206x305/v2/https://resizing.flixster.com/r_5fizQBZo4Ofarsv5ySOQt4Mhg=/ems.ZW1zLXByZC1hc3NldHMvbW92aWVzLzFlODNkZDVmLTQzYjEtNDQ3YS1hMTUzLTBiYWE2NjgwYzFkNi53ZWJw,The Party,1000,160,2017.0,Comedy/Drama,0 days 01:11:00.000000000,21
71,92,,Some Freaks,500,12,2016.0,Romance/Comedy,0 days 01:37:00.000000000,21
68,53,https://resizing.flixster.com/0IvR3zZz5kONNBkof_MGBFtklG4=/206x305/v2/https://resizing.flixster.com/FkrgQ_wBkL7cmSWqHw1gRCSuNYY=/ems.ZW1zLXByZC1hc3NldHMvbW92aWVzL2U5MjkyMjc5LWI3NGUtNDQ3ZC1hMTdkLTc0YjkxMDJjNTcxYi53ZWJw,Freak Show,100,43,2017.0,Comedy/Drama,0 days 01:31:00.000000000,-15
43,55,https://resizing.flixster.com/UAEmlD-xITK89PWnogZXFlXL1-I=/206x305/v2/https://resizing.flixster.com/XstFgSus8r8S18ki6ttDCZSZKok=/ems.ZW1zLXByZC1hc3NldHMvbW92aWVzLzhiYTUxZjAyLTc4MmMtNDU2Yi05YTVlLTVlNTExY2Q2ZGYxYy53ZWJw,The Strange Ones,250,29,2017.0,Drama/Mystery and thriller,0 days 01:21:00.000000000,12
65,77,,American Folk,100,22,2017.0,Drama/Music,0 days 01:39:00.000000000,12
78,88,https://resizing.flixster.com/Tr9OsIFojLKIrCEteIYR6dRKMQs=/206x305/v2/https://resizing.flixster.com/tXkKC4SR0aGLMtORBE3IcNw_Qu4=/ems.ZW1zLXByZC1hc3NldHMvbW92aWVzLzZkYmI0ZDQ4LTU3Y2UtNGExZi1hMTgwLTFlMjAxMWNjYTZhYy53ZWJw,The Midwife,250,89,2017.0,Comedy/Drama,0 days 01:57:00.000000000,10
28,21,https://resizing.flixster.com/YkQhx4zp-AdN__1WYBU1aGiN4p8=/206x305/v2/https://resizing.flixster.com/S-vsXMvjscB29x1cO2zxjs-u91o=/ems.ZW1zLXByZC1hc3NldHMvbW92aWVzLzg2OGQ3YWQyLTE1YTItNDhiOS1hMGIwLWYwOGQ5OTg5ZDRhZC53ZWJw,Once Upon a Time in Venice,500,39,2017.0,Action/Comedy,0 days 01:34:00.000000000,-7
85,100,,March of the Penguins 2: The Call,1,6,2017.0,Documentary,0 days 01:22:00.000000000,15
69,92,https://resizing.flixster.com/-0GV45mTw8gqJr4T1Djb7WQAJbw=/206x305/v2/https://resizing.flixster.com/l2Wixrv2Dmu5rbGpUcGV366Fq9M=/ems.ZW1zLXByZC1hc3NldHMvbW92aWVzL2IwZjQzNjc3LTk0MDEtNDg0Ni04MWRjLTA4ZWM1N2RhMzI0Yi53ZWJw,On the Beach at Night Alone,250,51,2017.0,Drama,0 days 01:41:00.000000000,23
88,100,,Paddington 2,5000,245,2017.0,Comedy/Kids and family,0 days 01:43:00.000000000,12
70,69,https://resizing.flixster.com/moc-1hFJItsFfc1IZPMa-8TXfg0=/206x305/v2/https://flxt.tmsimg.com/assets/p14728891_p_v13_ae.jpg,Eric Clapton: Life in 12 Bars,100,35,2017.0,Documentary/Music,0 days 02:15:00.000000000,-1
29,78,https://resizing.flixster.com/sMPlqk5HN_j9tmbudfjAcklRK90=/206x305/v2/https://resizing.flixster.com/Qp6KfnTzeJdV5kK-ZSySswVqx1c=/ems.ZW1zLXByZC1hc3NldHMvbW92aWVzL2IwNzc2MmRiLTAyYzItNDYxNi1hNTQ1LWY2MmRiOGE5ZDFiMi53ZWJw,Discreet,50,9,2017.0,Gay and lesbian/Drama,0 days 01:21:00.000000000,49
23,0,https://resizing.flixster.com/EhOe4puiDMuDo_Ln9qSN_wI2420=/206x305/v2/https://flxt.tmsimg.com/assets/p14007022_p_v10_aa.jpg,November Criminals,500,11,2017.0,Crime/Drama,0 days 01:25:00.000000000,-23
63,61,https://resizing.flixster.com/nQ9BAODIk2L_CHANjPloTBUpa9M=/206x305/v2/https://resizing.flixster.com/18NNR083sv_WMkjEVErGh1fwPV4=/ems.ZW1zLXByZC1hc3NldHMvbW92aWVzLzJmM2RmYWM3LTRiZGItNDhiOC04OWQ0LTFmYjI4ZTFkMTVmMy53ZWJw,Mad to Be Normal,100,23,2017.0,Drama/History,0 days 01:46:00.000000000,-2
33,50,,The Night of the Virgin,1,12,2016.0,Fantasy/Comedy,0 days 01:56:00.000000000,17
40,42,https://resizing.flixster.com/NS_JSmmjgCoHp69O0nTbHsNIgEg=/206x305/v2/https://resizing.flixster.com/NZwhYYTWZwRVj9F5evip05nC6rk=/ems.ZW1zLXByZC1hc3NldHMvbW92aWVzL2YwY2IyNmU3LTVjNzQtNDMwNS05ZjY5LWY1NTI2MmFkZjBlNy53ZWJw,Phoenix Forgotten,1000,19,2017.0,Horror/Mystery and thriller,0 days 01:27:00.000000000,2
81,43,https://resizing.flixster.com/z2woKLBXXH4GuJCveR5SB1QXlLs=/206x305/v2/https://resizing.flixster.com/yvQ1kEDX3ERksCsR5p9XOXPXyuc=/ems.ZW1zLXByZC1hc3NldHMvbW92aWVzLzY2MjYwNjBhLTE1YWItNDhmOS1iZDNjLTEzODRkODQ0ZjliZC53ZWJw,The Good Catholic,100,14,2017.0,Romance/Drama,0 days 01:36:00.000000000,-38
80,100,,Dance Academy: The Movie,500,15,2017.0,Drama,0 days 01:41:00.000000000,20
48,93,,Most Beautiful Island,500,46,2017.0,Drama/Mystery and thriller,0 days 01:20:00.000000000,45
42,83,https://resizing.flixster.com/1u3BVtSuECP0xQIheWxLHlrNfYQ=/206x305/v2/https://resizing.flixster.com/ToPg6TsVC5zFLoq6Noqq_dkKjeI=/ems.ZW1zLXByZC1hc3NldHMvbW92aWVzL2NlNzljNTMxLWVlMzctNDEzOC1hYjYyLTdiNTc0ZTRkOTg3OC53ZWJw,The Price,50,18,2017.0,Drama,0 days 01:32:00.000000000,41
53,79,https://resizing.flixster.com/zk8ZMf3PoBPUsoPMn8XJp-eijY0=/206x305/v2/https://resizing.flixster.com/VQHOZ1BgPtaIV94CdkGtV4dOk6s=/ems.ZW1zLXByZC1hc3NldHMvbW92aWVzLzU3Y2M2M2Q2LTI2YmEtNGMzNy1hM2I5LTYwZDg4YjJiMGJjOC53ZWJw,The Ballad of Lefty Brown,500,29,2017.0,Western,0 days 01:51:00.000000000,26
44,69,https://resizing.flixster.com/j6l1P6PPJowfqONZ9xXZc_5bh00=/206x305/v2/https://resizing.flixster.com/klHfyk7kJAlz1n1kAxVRQKJDN78=/ems.ZW1zLXByZC1hc3NldHMvbW92aWVzLzVmZmQyMmRlLWQwOWMtNDU4Mi1iNzc5LTM3YWI3NTUwYmI0Ni53ZWJw,Savage Dog,100,13,2017.0,Drama/Action,0 days 01:35:00.000000000,25
23,33,,The Hunter's Prayer,250,21,2017.0,Action/Mystery and thriller,0 days 01:31:00.000000000,10
50,25,,Samson,500,16,2018.0,Action/Adventure,0 days 01:50:00.000000000,-25
62,42,https://resizing.flixster.com/zJYukToYW8TLrfU2FOOXleHXErs=/206x305/v2/https://resizing.flixster.com/A15GBu58xEbape0Y2lBoL_DgBBg=/ems.ZW1zLXByZC1hc3NldHMvbW92aWVzL2JiNTdiMTI5LTBhZDktNDU3ZC04ODc3LTkwOWI0NTdmZjlhYS53ZWJw,Den of Thieves,2500,137,2018.0,Crime/Action,0 days 02:20:00.000000000,-20
58,81,https://resizing.flixster.com/pZqCkbxX1NqoTY-qfXgqK1tk6hc=/206x305/v2/https://flxt.tmsimg.com/assets/p14365534_p_v10_az.jpg,Walk With Me,250,26,2017.0,Documentary,0 days 01:28:00.000000000,23
64,60,,Us and Them,100,20,2017.0,Crime/Drama,0 days 01:23:00.000000000,-4
41,72,https://resizing.flixster.com/6lY0HxM8T6OFj5h0_Yqn9-qfwiA=/206x305/v2/https://resizing.flixster.com/1i-dZMSp-3mBBA4xYg6AYyn2gn0=/ems.ZW1zLXByZC1hc3NldHMvbW92aWVzLzlkZTE2ZWU4LTRhODYtNDUxNy1iNjA5LWE2MjcxMTJkNWJiYy53ZWJw,Gemini,500,78,2017.0,Mystery and thriller,0 days 01:33:00.000000000,31
85,83,,The Archer,1,6,2017.0,Action/Drama,0 days 01:26:00.000000000,-2
55,85,https://resizing.flixster.com/TxBlwHKFvMAfG1P-OmrkAaJMAmQ=/206x305/v2/https://resizing.flixster.com/zWhdQ9sYZQO5uVpaZE-5SpB54iM=/ems.ZW1zLXByZC1hc3NldHMvbW92aWVzLzNhY2JjMDAzLTJlZWMtNDY5NS1hMTk2LWVkZmEzNjc4MzhmMC53ZWJw,Song of Granite,50,27,2017.0,Drama/Music,0 days 01:44:00.000000000,30
62,51,https://resizing.flixster.com/VEx40ye54cmdIRgq8x_3-eeJOn4=/206x305/v2/https://resizing.flixster.com/oBpZukBdvs4wmQ39a3wZTZYYcbc=/ems.ZW1zLXByZC1hc3NldHMvbW92aWVzLzA3OWM5ZTVjLWE3OWQtNGVhNi1hY2NkLWQ0ZGY2YmE1NDIxNS53ZWJw,12 Strong,5000,172,2018.0,Drama/War,0 days 02:10:00.000000000,-11
55,70,https://resizing.flixster.com/ZKdgBDK9RP-9ehyZ0oun32vTEZg=/206x305/v2/https://resizing.flixster.com/NjD1zRLixScr38-Mhlm6PFfUDYM=/ems.ZW1zLXByZC1hc3NldHMvbW92aWVzL2JhOTUxMjI0LTU3MjQtNDhmOS1iNTczLTQyYmEwOTdlMTE1My53ZWJw,68 Kill,500,23,2017.0,Drama/Crime,0 days 01:33:00.000000000,15
54,69,https://resizing.flixster.com/-UjfsmAZNC0tTo13NUz1ieUpA20=/206x305/v2/https://resizing.flixster.com/eqK3Wre4zffe5zDtsFBh0mB9Ev0=/ems.ZW1zLXByZC1hc3NldHMvbW92aWVzL2Q1MjQyYjVlLWY0YjctNGQ0ZS04NmMxLWU5N2I3OTY2MzhlZC53ZWJw,Like Me,250,29,2017.0,Horror/Mystery and thriller,0 days 01:20:00.000000000,15
90,45,,So B. It,100,11,2016.0,Drama,0 days 01:38:00.000000000,-45
73,95,,All Saints,2500,19,2017.0,Drama,0 days 01:48:00.000000000,22
86,80,https://resizing.flixster.com/hSZXEZysnD76IHqO7RlaM6h5bD4=/206x305/v2/https://resizing.flixster.com/yQi4bWjHmPPciJEPSkK3N9xo4OM=/ems.ZW1zLXByZC1hc3NldHMvbW92aWVzLzAyNTUzYWVjLTI3OTItNGEwOS04MTgxLWMwYmU1NWMzMjY3MC53ZWJw,M.F.A.,500,25,2017.0,Mystery and thriller,0 days 01:35:00.000000000,-6
27,29,,Overdrive,250,14,2017.0,Action/Mystery and thriller,0 days 01:33:00.000000000,2
40,76,https://resizing.flixster.com/it_qH2MmELEv0fRJNGjmSq39cQU=/206x305/v2/https://resizing.flixster.com/5VQu54-ruv0yew4tCI9ymzTvx8I=/ems.ZW1zLXByZC1hc3NldHMvbW92aWVzLzM5NWFlNjVjLTNiNzctNGY2NS1hOTlmLTMxNjkxOTAxMWM4MC53ZWJw,The Son of Bigfoot,250,21,2017.0,Adventure/Comedy,0 days 01:32:00.000000000,36
24,6,https://resizing.flixster.com/oc64dd2LOkQIBVOBa58h8yXFAHQ=/206x305/v2/https://resizing.flixster.com/qMU4P_Cw6phs35IyUiTOEaCrImQ=/ems.ZW1zLXByZC1hc3NldHMvbW92aWVzL2Y5MzIwOWQzLWZiOGEtNDM4ZC1hYjNjLTlhMjVlYjExNjdjZC53ZWJw,The Crucifixion,100,16,2017.0,Horror/Mystery and thriller,0 days 01:30:00.000000000,-18
47,21,https://resizing.flixster.com/Au2uIA8O4DXXy-m5ecst9hvaFLw=/206x305/v2/https://resizing.flixster.com/40TLRnUWVIWdgeNJCpufg0jwfc8=/ems.ZW1zLXByZC1hc3NldHMvbW92aWVzLzQ4ZGIxOWVkLTg3OTgtNDYzZC1hZTkxLTE4OWQyYzg1MDdlYy53ZWJw,Mute,1000,86,2017.0,Sci fi/Mystery and thriller,0 days 02:06:00.000000000,-26
24,38,https://resizing.flixster.com/bfjh7nGHvgOkv3LsTLnWHYm31tQ=/206x305/v2/https://resizing.flixster.com/MdQh1t0YeHJ5ipN4ZrIgbxc9RK0=/ems.ZW1zLXByZC1hc3NldHMvbW92aWVzLzAxM2FhYjE5LWVkMTEtNDE0ZC04MDAwLTk1YjE4NGUzNDhiZi53ZWJw,Death Note,5000,76,2017.0,Horror/Mystery and thriller,0 days 01:41:00.000000000,14
50,57,https://resizing.flixster.com/dXs0ADcfUHgD3E3wvJYlRli9ZpY=/206x305/v2/https://resizing.flixster.com/GPYWyTGYsL7TedAR1e_JXB3R71g=/ems.ZW1zLXByZC1hc3NldHMvbW92aWVzL2I0NDI4OTE3LWYwMWUtNDYzMy1iYTkyLWU3Yzc1MmYyNjBiZS53ZWJw,The Hippopotamus,100,14,2017.0,Comedy,0 days 01:29:00.000000000,7
72,77,,Thank You for Your Service,5000,115,2017.0,Drama/War,0 days 01:48:00.000000000,5
61,31,,Inconceivable,500,13,2017.0,Drama/Mystery and thriller,0 days 01:45:00.000000000,-30
47,43,https://resizing.flixster.com/VTEt97WWrB4FDR28DUtCTFLH1l8=/206x305/v2/https://resizing.flixster.com/dU5KiAqN66BUU9tX0P9YF8c6urM=/ems.ZW1zLXByZC1hc3NldHMvbW92aWVzLzg2OWNhYjM3LTc5MDctNDVlZC1iOTgyLThhNWFjY2EwMTJjMi53ZWJw,Resident Evil: Vendetta,500,7,2017.0,Action/Horror,0 days 01:37:00.000000000,-4
37,24,https://resizing.flixster.com/u8H0Ca5H9qD11o_EZ6f4bWdUj-k=/206x305/v2/https://resizing.flixster.com/aIbW4DniQUh1OweoGVIFsviNJ24=/ems.ZW1zLXByZC1hc3NldHMvbW92aWVzLzc1YmFkY2E5LWZhZjktNDEyMi04OWVjLWUxMzg4YWM4MTEyMC53ZWJw,7 Days in Entebbe,500,118,2018.0,Drama/Mystery and thriller,0 days 01:47:00.000000000,-13
20,9,https://resizing.flixster.com/J47p13iyZwBZRinv0Oe5yw5OGVU=/206x305/v2/https://resizing.flixster.com/cg_p-EfPkXqxEog4-dds4nllPzI=/ems.ZW1zLXByZC1hc3NldHMvbW92aWVzLzYyYmY0ODY2LTJhNzYtNDYzNS05MjkyLWIzZWQyNGE5ZDU4NS53ZWJw,Kill Switch,500,22,2017.0,Action/Sci fi,0 days 01:31:00.000000000,-11
31,0,,Naked,500,8,2017.0,Comedy,0 days 01:36:00.000000000,-31
28,67,https://resizing.flixster.com/Qh9pfnyuN4A73qHRa5HF3QXKC70=/206x305/v2/https://resizing.flixster.com/Uk5szkUzR3nyJRIypsIVYyXJ5dc=/ems.ZW1zLXByZC1hc3NldHMvbW92aWVzL2E2ZWMzODBkLTNkZGMtNGNmMS1hM2QwLTU3YmQ2MzAxM2ZkNC53ZWJw,Caught,50,6,2017.0,Horror/Mystery and thriller,0 days 01:26:00.000000000,39
76,78,,Easy Living,50,9,2017.0,Comedy/Drama,0 days 01:20:00.000000000,2
38,30,,Sharknado 5: Global Swarming,250,10,2017.0,Comedy/Mystery and thriller,0 days 01:30:00.000000000,-8
25,15,https://resizing.flixster.com/ror3os3qDqivFJ_X9zT7kL01g_E=/206x305/v2/https://resizing.flixster.com/HQuD_ZWgAJ7t5UCGjJY3lnY91Ik=/ems.ZW1zLXByZC1hc3NldHMvbW92aWVzLzk2NTU4ZjkzLThlZmItNGQ5NC1iYjFkLWQ0YzYwYTEzMzVkMS53ZWJw,First Kill,500,20,2017.0,Crime/Action,0 days 01:37:00.000000000,-10
71,63,https://resizing.flixster.com/OVgyiloTsABvBmspaMx74xsyqpU=/206x305/v2/https://resizing.flixster.com/NQDHCXeR4a_xJaSOhguwW2D6OJk=/ems.ZW1zLXByZC1hc3NldHMvbW92aWVzL2Y4OWQ2M2ViLTE5NTctNGJhZi1iNjMwLWNkNTgwMGQyMDM1ZC53ZWJw,Goodbye Christopher Robin,5000,179,2017.0,Drama/History,0 days 01:47:00.000000000,-8
80,100,https://resizing.flixster.com/4GiYm_UeJYRF2n7mHCNfm3xzo34=/206x305/v2/https://resizing.flixster.com/HapXtg2cferMYuTKnppxREbQkQ8=/ems.ZW1zLXByZC1hc3NldHMvbW92aWVzLzI5ODNlMjVkLTg5NTItNDE0NS1iMGIxLWI0ZDA0OTAyMWNiMy53ZWJw,One October,50,5,2017.0,Drama,0 days 00:56:00.000000000,20
75,93,,Saturday Church,100,29,2017.0,Gay and lesbian/Drama,0 days 01:22:00.000000000,18
66,92,,The Endless,2500,130,2017.0,Sci fi/Horror,0 days 01:51:00.000000000,26
59,79,https://resizing.flixster.com/ShSSnqNkZHppWAjWRVKmwqJs17Q=/206x305/v2/https://resizing.flixster.com/yEx-xrbq3Ezh4bf9DfpIDFSsbdI=/ems.ZW1zLXByZC1hc3NldHMvbW92aWVzL2JmZmY1MmEzLWE2ZTEtNGVkYy1iZmIzLTgxZTFiNmE2ZTMyNC53ZWJw,Sweet Virginia,1000,57,2017.0,Drama/Mystery and thriller,0 days 01:35:00.000000000,20
92,73,https://resizing.flixster.com/t4LKKYTpc2N4w8R5M2X7co-WtBU=/206x305/v2/https://resizing.flixster.com/MoT0I7dKhImwKa6NJRxXKo2Iwf4=/ems.ZW1zLXByZC1hc3NldHMvbW92aWVzLzcxYmE0NzEwLTEzYTQtNDY0Zi1iOTQ2LTM5YjNlMzY1N2JmMS53ZWJw,Abe & Phil's Last Poker Game,50,11,2017.0,Comedy/Drama,0 days 01:25:00.000000000,-19
43,75,https://resizing.flixster.com/12stYXh1ZCuwcZBJKc0D2qMTSm8=/206x305/v2/https://resizing.flixster.com/TLdwD2hnSgbnzxQaHuSTfkS0jRE=/ems.ZW1zLXByZC1hc3NldHMvbW92aWVzLzE4MWIzYTE1LTI2NjEtNDIxZC04YTgzLTRhNTQ3ZjBiYjU0Ny53ZWJw,Frank Serpico,50,8,2017.0,Documentary,0 days 01:39:00.000000000,32
87,60,https://resizing.flixster.com/IW_0oUJGYNVpYigOQIm0oSD4eEs=/206x305/v2/https://resizing.flixster.com/zx5Swe6K92mAQh0Ugvs_nZM0gAg=/ems.ZW1zLXByZC1hc3NldHMvbW92aWVzLzg0MTM0MmM5LTQyZGItNDg0OC1iYzNmLTg3N2ZjZjU4NWU4ZS53ZWJw,Copwatch,1,10,2017.0,Documentary,0 days 01:35:00.000000000,-27
31,23,https://resizing.flixster.com/NzuKnAOkqDJjXAI6l_zKnnDNZH0=/206x305/v2/https://resizing.flixster.com/z8YzDtWXBxs9zU-zy4oWslWm3Go=/ems.ZW1zLXByZC1hc3NldHMvbW92aWVzL2JlNjQ2MzA4LWYwY2YtNGY2OS1hZjA0LTc4ZjVlMWI0OTZlZS53ZWJw,The Clapper,250,26,2017.0,Comedy,0 days 01:29:00.000000000,-8
81,88,https://resizing.flixster.com/RDHfBqqHgPis6prsLb9_waYw0Fo=/206x305/v2/https://resizing.flixster.com/9p4r8Ydf-VHUC89C85T2lMt6Kuk=/ems.ZW1zLXByZC1hc3NldHMvbW92aWVzLzU0MTlhMzAyLThjZDgtNGQ0YS1hOTJhLTNlY2E4YzBjZDUxZi53ZWJw,A Suitable Girl,50,17,2017.0,Documentary,0 days 01:30:00.000000000,7
74,100,https://resizing.flixster.com/kB6mdzxoWvZ5NjSUQjaqEUtz-1M=/206x305/v2/https://resizing.flixster.com/fE7sxbdoDJIiTrpvxS-NsmD_-gc=/ems.ZW1zLXByZC1hc3NldHMvbW92aWVzLzkxZjIyZmU0LWE4ZTQtNDc4ZS1iMzliLTkwM2QzNGRkMzg2NS53ZWJw,Wasted! The Story of Food Waste,100,9,2017.0,Documentary,0 days 01:25:00.000000000,26
61,86,,My Friend Dahmer,5000,104,2017.0,Drama/Biography,0 days 01:47:00.000000000,25
72,96,https://resizing.flixster.com/iVf2ofa8mrJkWJHWmbu5uCGYiaA=/206x305/v2/https://resizing.flixster.com/ugruF1RHPBXc8db2PZlMzsGtmx8=/ems.ZW1zLXByZC1hc3NldHMvbW92aWVzL2M4YWVkNWI1LWUwNzYtNGQ0NS04OGI3LThjNTE1NzhkYWRjYi53ZWJw,The Death and Life of Marsha P. Johnson,100,28,2017.0,Documentary,0 days 01:45:00.000000000,24
85,100,,Hondros,100,10,2017.0,Documentary/War,0 days 01:26:00.000000000,15
72,92,https://resizing.flixster.com/rK21KIwEeMXCEXFH1wAiFYv-nSI=/206x305/v2/https://resizing.flixster.com/7xpFiFaJI7j_Mwred_S3BdD02fg=/ems.ZW1zLXByZC1hc3NldHMvbW92aWVzL2RmNjViZTE4LTQ1MGEtNDRhZC1hZTQwLWM4MTY4YTBmZmVlZi53ZWJw,The Shape of Water,25000,452,2017.0,Romance/Fantasy,0 days 02:03:00.000000000,20
56,67,https://resizing.flixster.com/f5LzlrB1sc5uD3dVenZwAOG_eQw=/206x305/v2/https://resizing.flixster.com/kPvTdjpzIte0WT-XapwSQQKes6E=/ems.ZW1zLXByZC1hc3NldHMvbW92aWVzLzVjNWY4YmY3LWZhZWItNDRiNS1iODQ5LWFiMjQ5YWRhYzUwMS53ZWJw,Shock Wave,100,9,2017.0,Action/Mystery and thriller,0 days 01:59:00.000000000,11
48,100,,The Evil Within,100,5,2017.0,Horror,0 days 01:38:00.000000000,52
63,80,https://resizing.flixster.com/DlnGW2yDx60d0LLRRcFflW2G54M=/206x305/v2/https://resizing.flixster.com/HwTyehhe41KfC_nInfLvZvmzjsU=/ems.ZW1zLXByZC1hc3NldHMvbW92aWVzL2E3N2EzNzEwLWI1MmItNGQyMC1iMDczLTE5NjdkZmY0NmE5ZC53ZWJw,The Killing of a Sacred Deer,10000,277,2017.0,Horror/Mystery and thriller,0 days 02:01:00.000000000,17
71,18,https://resizing.flixster.com/XKB4bj_z-rdZ5FfVEmoEq1GDs74=/206x305/v2/https://resizing.flixster.com/9HErzjuirrlKdhIaz2N_NQdPhCA=/ems.ZW1zLXByZC1hc3NldHMvbW92aWVzLzY3ZjM0MjEyLWYwNmUtNDFhZS05NDk4LTkwYTdjMGEwZGNkZS53ZWJw,Death Wish,5000,163,2018.0,Action/Mystery and thriller,0 days 01:47:00.000000000,-53
38,45,,Batman and Harley Quinn,500,11,2017.0,Animation/Action,0 days 01:16:00.000000000,7
25,28,,Suburbicon,5000,258,2017.0,Comedy/Mystery and thriller,0 days 01:45:00.000000000,3
67,72,https://resizing.flixster.com/ltkZ3yyZmmm6Y9sMf7pbRrPQ1go=/206x305/v2/https://resizing.flixster.com/nOqBrLyAN_3_lkSVLB1A5n-f3ew=/ems.ZW1zLXByZC1hc3NldHMvbW92aWVzL2I5MDk3N2FjLWZhMTItNDc4ZS04NzQ2LWRjYWYwYWRjNWJlYS53ZWJw,Happy Death Day,10000,158,2017.0,Horror/Mystery and thriller,0 days 01:36:00.000000000,5
64,83,https://resizing.flixster.com/kLgp4OzhwFM6x2quMRv0cJE4rUM=/206x305/v2/https://resizing.flixster.com/zIc24cXo5HV21x7-KrAA2QQvLiY=/ems.ZW1zLXByZC1hc3NldHMvbW92aWVzL2ZhZDUwOTUxLTEwZGEtNDlmMy1iMTkwLWNlOTg1OTcwODZiMC53ZWJw,The Trip to Spain,1000,107,2017.0,Comedy,0 days 01:50:00.000000000,19
60,100,,A Gray State,100,18,2017.0,Documentary,0 days 01:33:00.000000000,40
85,96,https://resizing.flixster.com/K9y6X6kFcNVew70TgZbAAkqXfFc=/206x305/v2/https://flxt.tmsimg.com/assets/p14433119_p_v8_aa.jpg,Bombshell: The Hedy Lamarr Story,1000,93,2017.0,Documentary,0 days 01:30:00.000000000,11
73,88,https://resizing.flixster.com/HFFt9EM0p17IK8QUdsckt-pTPus=/206x305/v2/https://resizing.flixster.com/wH2LPrs5dL8hOf4pynScAVjkHxk=/ems.ZW1zLXByZC1hc3NldHMvbW92aWVzL2Y2ZjMyMTdiLTg4ZDItNGQ5ZS05ZjA0LTVlYjdlMmNiZWZlZC53ZWJw,The Post,10000,400,2017.0,Drama/History,0 days 01:55:00.000000000,15
80,69,,Shot Caller,2500,49,2017.0,Crime/Drama,0 days 02:00:00.000000000,-11
22,50,https://resizing.flixster.com/m14kRHJIZZ8JZwmtKhDfjmAuS6w=/206x305/v2/https://resizing.flixster.com/IUVhZEKbVWfFSl1kxcj4QmRcuk0=/ems.ZW1zLXByZC1hc3NldHMvbW92aWVzLzk4ZDI5ZTZiLWJiZWUtNDM3Yi1hNWQ2LTk1M2ZhZDE3YzE4Zi53ZWJw,Ismael's Ghosts,100,78,2017.0,Romance/Drama,0 days 01:54:00.000000000,28
82,83,https://resizing.flixster.com/C7wytbylgYeOIA15aMXlii91zd4=/206x305/v2/https://resizing.flixster.com/HX25RnHe5fdcoGtRJVvp2m04cqc=/ems.ZW1zLXByZC1hc3NldHMvbW92aWVzLzQ3OGQ5MDgyLWU1NWYtNGRhNS05MGJlLTg1NzEwY2EzOTY5Yy53ZWJw,Love and Saucers,50,12,2017.0,Documentary/Mystery and thriller,0 days 01:07:00.000000000,1
34,27,https://resizing.flixster.com/sj1LbGLWi-kzX8bth5QasQq_TVk=/206x305/v2/https://resizing.flixster.com/O7bu_6M7K-peLAmI07HskJ9gBLw=/ems.ZW1zLXByZC1hc3NldHMvbW92aWVzLzdhZGNjNDc3LTQ0NTUtNDdjMy1hMGJjLTc4MzMxZjU1ODU1MS53ZWJw,The Week Of,500,26,2018.0,Comedy,0 days 01:56:00.000000000,-7
41,69,,Pilgrimage,250,39,2017.0,Drama/Adventure,0 days 01:36:00.000000000,28
69,87,https://resizing.flixster.com/iV2-bszQCcq12qThhkCiz8PkG-8=/206x305/v2/https://resizing.flixster.com/uVU6_Eif3ZrUcWUezAfovqSdIYk=/ems.ZW1zLXByZC1hc3NldHMvbW92aWVzLzVlYTVkMjkyLTg4NmEtNGQ2ZS05ZDlkLWRkMzU3MGU1NTQyZS53ZWJw,Blade of the Immortal,1000,92,2017.0,Action/Fantasy,0 days 02:31:00.000000000,18
78,88,,Anti Matter,2500,24,2016.0,Sci fi,0 days 01:49:00.000000000,10
63,83,https://resizing.flixster.com/O2oSPviMWFQDylCH8LG9sHm5NEc=/206x305/v2/https://resizing.flixster.com/ajtLwfmyL3Df86ARZV4MaczmW_s=/ems.ZW1zLXByZC1hc3NldHMvbW92aWVzLzFlN2NlZmRkLWE5NjUtNDIyNS05YmUyLWYyZjYxODY5NDYxNC53ZWJw,The Divine Order,100,54,2017.0,Drama/History,0 days 01:36:00.000000000,20
77,85,https://resizing.flixster.com/sKI5D7f6KK_cNRnq5niuO1SbuY4=/206x305/v2/https://resizing.flixster.com/VvjkMRs1X68mk6ZzXNQy7662uQo=/ems.ZW1zLXByZC1hc3NldHMvbW92aWVzL2NiNjUzYmQ4LTg0YWMtNDM3MS1hOGNiLTNlNWM5ZDhlNjdlZS53ZWJw,Game Night,5000,256,2018.0,Comedy/Action,0 days 01:40:00.000000000,8
25,38,https://resizing.flixster.com/qiqxg7pqfwnAQoNZjjY_mHCmMsI=/206x305/v2/https://flxt.tmsimg.com/assets/p14793031_p_v13_ab.jpg,Devil's Gate,100,16,2018.0,Mystery and thriller,0 days 01:35:00.000000000,13
46,18,,"Game Over, Man!",1000,17,2018.0,Comedy/Action,0 days 01:41:00.000000000,-28
53,80,https://resizing.flixster.com/sMc9CiesC_yJkvdENe7Sa6Yv6Fk=/206x305/v2/https://resizing.flixster.com/YuybotrrvAABqCHcz9Ry015y-8k=/ems.ZW1zLXByZC1hc3NldHMvbW92aWVzL2JhMmI4ZThlLTc5MTgtNDM0Ni05M2Q5LTAxMmU0MmJhNThlMS53ZWJw,God of War,250,10,2017.0,Drama/Adventure,0 days 01:57:00.000000000,27
43,11,,9/11,500,9,2017.0,Drama,0 days 01:30:00.000000000,-32
20,0,https://resizing.flixster.com/Ns08gKkEbgzpqnr6_SS5iGaAIWY=/206x305/v2/https://resizing.flixster.com/FOVXWh7tEASXjnm5RqFaNV47Zjo=/ems.ZW1zLXByZC1hc3NldHMvbW92aWVzLzA0NGE3Y2JiLWNmOWMtNDU3YS05ZmE1LTI5YmVkYzc0ZmMxZS53ZWJw,Stratton,100,36,2017.0,Action/Mystery and thriller,0 days 01:35:00.000000000,-20
83,95,https://resizing.flixster.com/xgs4WsaL5IWkqu6525OczJYUFn0=/206x305/v2/https://resizing.flixster.com/SPvpUgIdTnnBAREw3EoHqgfFSp8=/ems.ZW1zLXByZC1hc3NldHMvbW92aWVzL2EzZmE3ZjE4LThjMjgtNDM4MS1iYzZiLWNiM2EyY2M1ZTg1Ny53ZWJw,Loveless,1000,184,2017.0,Drama,0 days 02:07:00.000000000,12
32,86,https://resizing.flixster.com/xyNVbOTF14GuxkeDCfdA2IQfqmE=/206x305/v2/https://resizing.flixster.com/r-i13QkVZbiYdKBtXd9o6LC1WBc=/ems.ZW1zLXByZC1hc3NldHMvbW92aWVzLzQ2YTYxNTQxLTIyMmYtNDgxZS05NTJkLTBkNTc5MjZiOGFhNS53ZWJw,Let the Sunshine In,500,140,2017.0,Romance,0 days 01:35:00.000000000,54
18,57,,Hickok,100,7,2017.0,Western/Action,0 days 01:28:00.000000000,39
41,19,,Blind,250,21,2017.0,Drama/Romance,0 days 01:46:00.000000000,-22
89,99,https://resizing.flixster.com/8UGk2gtbBXXkoPnt2dWDkYNhM-c=/206x305/v2/https://resizing.flixster.com/gqSZNQZwomw-qlBT2EXN8dtoD7k=/ems.ZW1zLXByZC1hc3NldHMvbW92aWVzL2FiZjU2OTA0LWM5YmQtNDZmZC05MTk2LWM0MDc2YzI4NjhmZC53ZWJw,Faces Places,1000,141,2017.0,Documentary,0 days 01:29:00.000000000,10
76,89,https://resizing.flixster.com/syMgg--drd8Z1F_PmtNArfKh1vc=/206x305/v2/https://resizing.flixster.com/o6jIJRJ8JmQ721Z7l6WtQjwULOc=/ems.ZW1zLXByZC1hc3NldHMvbW92aWVzL2UyY2MyY2Y4LWU4YWUtNDI0Mi04ZTNlLWU0OTcwMDMzNTNhNi53ZWJw,A Ciambra,250,57,2017.0,Drama,0 days 01:58:00.000000000,13
38,40,https://resizing.flixster.com/LKfb39geUfXOP9JjvVw17lDJRSE=/206x305/v2/https://resizing.flixster.com/WartbgqgwuuaJGJruF0oFIdECmA=/ems.ZW1zLXByZC1hc3NldHMvbW92aWVzL2MzYTI3MGEzLTBjZWUtNGZkOS1hYmM0LTJiZmQ5NDMwZTgzZC53ZWJw,Chronically Metropolitan,1,10,2016.0,Comedy/Drama,0 days 01:30:00.000000000,2
16,10,https://resizing.flixster.com/he-k_pyL5X9amr-CVts6fs2uwKI=/206x305/v2/https://resizing.flixster.com/Jz8Quf7HSsFJRypnVIZCWj7Gx4A=/ems.ZW1zLXByZC1hc3NldHMvbW92aWVzLzM2ZGIxNjg5LTI4ODAtNDIwOC05YWIzLTViYTFhZjAzZDIyOS53ZWJw,The Gracefield Incident,100,10,2017.0,Sci fi/Horror,0 days 01:29:00.000000000,-6
89,75,,Moss,100,8,2017.0,Romance/Adventure,0 days 01:21:00.000000000,-14
79,97,https://resizing.flixster.com/PuDC3_4VxzhmORob4ge7otBwVPU=/206x305/v2/https://resizing.flixster.com/6gROSgtVpBiemjaGlsKqFE2sTtA=/ems.ZW1zLXByZC1hc3NldHMvbW92aWVzL2I0ZjQ1YWI1LTVlM2EtNDYwZS1iYTUzLTc0OTc0ZWViMjkxYS53ZWJw,Tehran Taboo,100,36,2017.0,Drama/Animation,0 days 01:36:00.000000000,18
71,85,https://resizing.flixster.com/nduEb_03lgemmEiX_lWw6OvENJ4=/206x305/v2/https://resizing.flixster.com/9ntcZUgV0alnBGQdJ2vsca5E0xo=/ems.ZW1zLXByZC1hc3NldHMvbW92aWVzL2I0MGNiOWY3LTM5OGYtNGU1MS1hMzc3LTkyYWEwMjcyZTdiZC53ZWJw,The Square,2500,215,2017.0,Comedy,0 days 02:22:00.000000000,14
80,96,/assets/pizza-pie/images/poster_default.c8c896e70c3.gif,The Florida Project,10000,313,2017.0,Drama,0 days 01:55:00.000000000,16
85,85,https://resizing.flixster.com/8e_7lns-5D-CTas6X2gWTlXl-Ec=/206x305/v2/https://resizing.flixster.com/QCWXhj3pjbljMLo7n5KsssKSDaw=/ems.ZW1zLXByZC1hc3NldHMvbW92aWVzLzEwNWU0NTVjLWQ1YWMtNDdmMS1hODFlLWM3NDYyZjY3YmQyNS53ZWJw,Santoalla,100,13,2016.0,Documentary/Mystery and thriller,0 days 01:23:00.000000000,0
49,70,https://resizing.flixster.com/TUhbqos9eDdLMiyrmflxSUncMNI=/206x305/v2/https://resizing.flixster.com/nEBWQA7TEZesoTlTWyV-lH_Kfd0=/ems.ZW1zLXByZC1hc3NldHMvbW92aWVzL2I1OGNiODNhLTZiYWYtNDAyZS05ZWYxLWQyMGUzNmM4ZDFkZS53ZWJw,Double Lover,250,104,2017.0,Drama/Mystery and thriller,0 days 01:48:00.000000000,21
71,77,https://resizing.flixster.com/wLEnlJ5FL52eyV4LHjl3V1gLabo=/206x305/v2/https://resizing.flixster.com/PZktZbMzfbtShHX1h5mt2OwMslI=/ems.ZW1zLXByZC1hc3NldHMvbW92aWVzLzdmMTkyN2EyLTA3ODItNGE1YS04MWYzLWM1NGQxOTBjNDgxYi53ZWJw,In the Fade,500,150,2017.0,Crime/Drama,0 days 01:45:00.000000000,6
44,88,,Imitation Girl,50,8,2017.0,Sci fi/Drama,0 days 01:24:00.000000000,44
18,0,https://resizing.flixster.com/8aTE0v0YP0FjVRUGWSQrmG4-8Yo=/206x305/v2/https://resizing.flixster.com/iPtfJ6HF01Njj9V8vtWnmEejoTs=/ems.ZW1zLXByZC1hc3NldHMvbW92aWVzLzQxMDU5N2Q2LWZiNjktNDEzNC1hYmFhLTdlY2YxNzI1NTNiMS53ZWJw,Armed Response,100,12,2017.0,Action/Horror,0 days 01:33:00.000000000,-18
40,4,https://resizing.flixster.com/MonJQPMAll4I5q87cJsANyXo7EM=/206x305/v2/https://resizing.flixster.com/bwEE1SZFKvqp9F8M4XaBJ_p64eI=/ems.ZW1zLXByZC1hc3NldHMvbW92aWVzLzY3Y2UzYTIzLWFhNjAtNDI4YS1iMDBkLTQ1YjIwMWVlYzI3Ni53ZWJw,Tyler Perry's Boo 2! A Madea Halloween,5000,23,2017.0,Other/Adventure,0 days 01:41:00.000000000,-36
22,40,,Nails,50,15,2017.0,Horror,0 days 01:25:00.000000000,18
36,52,https://resizing.flixster.com/TQwEj3mskQqCKeBZjD58FQIHk6Q=/206x305/v2/https://resizing.flixster.com/EWx1sShjbg8GjGPs8daOg4T-Br8=/ems.ZW1zLXByZC1hc3NldHMvbW92aWVzLzhhN2RlODQ2LThiYWEtNDFlYS05NTg5LTEyYjFmNjQ2MDk4ZC53ZWJw,England Is Mine,250,65,2017.0,Drama/Music,0 days 01:39:00.000000000,16
77,87,https://resizing.flixster.com/RwFafNfn7L2gi9eQR36SCC4VBBQ=/206x305/v2/https://resizing.flixster.com/FAJUHKMaZS0V9QVzSbgeFZ4KlL0=/ems.ZW1zLXByZC1hc3NldHMvbW92aWVzL2QzYTRhMDFiLTM1NzUtNGQ4ZC05OTA2LTMyNzFlN2Q2ZTk3NC53ZWJw,Professor Marston & the Wonder Women,5000,181,2017.0,Drama/History,0 days 01:48:00.000000000,10
52,54,,Crash Pad,100,13,2017.0,Romance,0 days 01:33:00.000000000,2
57,50,https://resizing.flixster.com/HWK2oRZ1TIRvaqmtWMeypDltKqY=/206x305/v2/https://resizing.flixster.com/oj6Rg_gQmfn9B5FdYDMsofAGBMc=/ems.ZW1zLXByZC1hc3NldHMvbW92aWVzLzQ1NTlkNTVlLTlkMzktNGRjNC1iNGY0LTQ5ZWNjZjI1NzIyYy53ZWJw,Fatal Countdown: Reset,50,8,2017.0,Action/Mystery and thriller,0 days 01:46:00.000000000,-7
68,67,https://resizing.flixster.com/12XX1g1jyW6MSuZxFTXLJm2Bmd4=/206x305/v2/https://resizing.flixster.com/D_ojzDsg5fsTri2FRAER0zyqnw8=/ems.ZW1zLXByZC1hc3NldHMvbW92aWVzLzZhZDc3OWQ2LWJhODctNGY4OC05NTgzLTkxMTMwMmZjYjM1Yy53ZWJw,Manolo: The Boy Who Made Shoes for Lizards,100,33,2017.0,Documentary,0 days 01:29:00.000000000,-1
29,57,https://resizing.flixster.com/do6nGidVvY_XEhWmFRJGRqO01qk=/206x305/v2/https://resizing.flixster.com/iCqw5auZR8TheL8ZxH1zRNYcXWE=/ems.ZW1zLXByZC1hc3NldHMvbW92aWVzLzFmNjBlMWRlLTAyZDYtNDFlOS1hMzAxLTViMzQyMmU0NzVlYi53ZWJw,They Remain,100,28,2017.0,Horror/Mystery and thriller,0 days 01:42:00.000000000,28
59,60,https://resizing.flixster.com/NdV85EtPSuId9iUnK-Jrto4udsg=/206x305/v2/https://resizing.flixster.com/0szz1dI0zG9Swstwr9qvzgms0hE=/ems.ZW1zLXByZC1hc3NldHMvbW92aWVzL2FiMzNkOGI4LTAxNmMtNDc2MC04YTY4LWZiMmVlNTlhYjAwZi53ZWJw,Jungle,2500,53,2017.0,Mystery and thriller/Action,0 days 01:55:00.000000000,1
38,0,,Gun Shy,100,11,2017.0,Comedy/Action,0 days 01:26:00.000000000,-38
77,92,https://resizing.flixster.com/XtX-qDBR7aV3wpEyDlk9_SKMXxY=/206x305/v2/https://resizing.flixster.com/wE7ym7DhqI87KERVqyBFmDzIj4A=/ems.ZW1zLXByZC1hc3NldHMvbW92aWVzLzczY2NjYTBhLWFlZDgtNGU3Ny1hNTM0LWI0NzUyYjM1MGE5Mi53ZWJw,Ali's Wedding,250,25,2017.0,Romance,0 days 01:46:00.000000000,15
86,84,https://resizing.flixster.com/8XHvGCU5JlHBcb2aVsoJ0wNz9YU=/206x305/v2/https://resizing.flixster.com/pxqdUFy-PXhYHxXvJ1d5vqkmsw4=/ems.ZW1zLXByZC1hc3NldHMvbW92aWVzLzViNjRlZTkxLTBjMTktNDlhYi04ZTZhLWI1NjBjNjgwOWExNS53ZWJw,Loving Vincent,5000,160,2017.0,Drama/Animation,0 days 01:35:00.000000000,-2
52,62,,Entanglement,100,37,2017.0,Romance,0 days 01:25:00.000000000,10
68,40,,The Stray,500,10,2017.0,Drama,0 days 01:32:00.000000000,-28
71,77,https://resizing.flixster.com/TRC0MTXP83z_V7OtVqvJgRzAUBo=/206x305/v2/https://resizing.flixster.com/DVqEoYQoV_gLrhFO5lKfSgJd8Qs=/ems.ZW1zLXByZC1hc3NldHMvbW92aWVzLzdhYzgwYmMyLTY4YjEtNDMwMi04MmFlLWRlMjgwYmUxYjU0MC53ZWJw,Last Flag Flying,2500,217,2017.0,Comedy/Drama,0 days 02:04:00.000000000,6
51,44,,Madame,100,36,2017.0,Romance,0 days 01:31:00.000000000,-7
38,81,,Midnighters,100,32,2017.0,Other/Horror,0 days 01:34:00.000000000,43
51,35,https://resizing.flixster.com/qozY1y4mKpacNG1ngQOWTFlPDFM=/206x305/v2/https://resizing.flixster.com/XUWnckLr3alpo-JuPCyqtZ3RwMk=/ems.ZW1zLXByZC1hc3NldHMvbW92aWVzLzZkYzBkM2MzLTJkZDEtNDZkNS04MzQ0LWJhNjg1NjAzZGFlZS53ZWJw,The Female Brain,100,20,2017.0,Romance,0 days 01:40:00.000000000,-16
88,95,https://resizing.flixster.com/VGv1x-F74hVNMq2AFzUQ8NvXAlk=/206x305/v2/https://resizing.flixster.com/ozHfVjfPbgU5m5ZNQV4u6225or0=/ems.ZW1zLXByZC1hc3NldHMvbW92aWVzL2EzZWFlMGEyLWYyZDYtNGY1NC1iODEzLTg0Yjg2NjIzNjgwNi53ZWJw,Becks,100,20,2017.0,Gay and lesbian/Drama,0 days 01:31:00.000000000,7
71,80,https://resizing.flixster.com/1SK7mUpOxHqkwiLG-XJhS0Kjrlg=/206x305/v2/https://resizing.flixster.com/r1FMxFL4squjrxkkRgs0q6YhDoQ=/ems.ZW1zLXByZC1hc3NldHMvbW92aWVzL2Y2MjNjNGEzLTg4MTMtNGM4OS1hZmIxLThiNTg0Mzc4MjUyMi53ZWJw,Sun Dogs,100,5,2017.0,Comedy/Drama,0 days 01:34:00.000000000,9
77,40,https://resizing.flixster.com/_LqGC76J88nG2H-pRPSTM8BTOIM=/206x305/v2/https://resizing.flixster.com/1Vgnci39SpP5JJ5XGPWzGgMFvrQ=/ems.ZW1zLXByZC1hc3NldHMvbW92aWVzLzI4NGJjMzhjLTVlYmMtNDI1Ni1hZTY2LTFkNjhkYzI0OWZiMy53ZWJw,A Question of Faith,1000,5,2017.0,Drama,0 days 01:31:00.000000000,-37
41,18,,Scorched Earth,100,11,2018.0,Action,0 days 01:34:00.000000000,-23
59,100,https://resizing.flixster.com/vR-499N4R4ThIcKWHy9rawE23eM=/206x305/v2/https://flxt.tmsimg.com/assets/p15126311_p_v8_aa.jpg,Catching Feelings,100,7,2017.0,Comedy/Drama,0 days 02:04:00.000000000,41
14,25,,Open Water 3: Cage Dive,100,8,2017.0,Horror/Mystery and thriller,0 days 01:20:00.000000000,11
46,79,https://resizing.flixster.com/lrX2F4nTMc52cdftBtjiKcXyM-k=/206x305/v2/https://flxt.tmsimg.com/assets/p14480295_p_v10_ab.jpg,Cult of Chucky,1000,24,2017.0,Horror,0 days 01:30:00.000000000,33
33,71,,The Ice Cream Truck,100,21,2017.0,Comedy/Horror,0 days 01:36:00.000000000,38
72,61,https://resizing.flixster.com/zFNFe2B9PD7S_5ixQRO5qyVb_gE=/206x305/v2/https://resizing.flixster.com/mTrxbLzFjc9APngiiLB5zRGqNwM=/ems.ZW1zLXByZC1hc3NldHMvbW92aWVzL2RkMGMyYjg1LWNkODQtNGYyZi04NTQzLWI5NWEzZjU0NTAzMC53ZWJw,Dog Years,250,28,2017.0,Comedy/Drama,0 days 01:36:00.000000000,-11
23,44,https://resizing.flixster.com/2yDTnZ0CapMMMqZg5AZ3oe0vgAc=/206x305/v2/https://flxt.tmsimg.com/assets/p14298210_p_v10_ab.jpg,Jackals,100,16,2016.0,Mystery and thriller,0 days 01:25:00.000000000,21
75,69,https://resizing.flixster.com/6OaUsQrhpfgKUeuTGoZgJ_3ituw=/206x305/v2/https://resizing.flixster.com/W5utWMHcmzG1oO-yjh9U5cps93I=/ems.ZW1zLXByZC1hc3NldHMvbW92aWVzL2NlMjY1MmZlLTZlYzEtNGQ1OS1hZmNmLThkNjYxMDA3YmRhYy53ZWJw,Wolf Warrior II,1000,13,2017.0,Action/Adventure,0 days 02:01:00.000000000,-6
71,75,,Unleashed,250,8,2016.0,Fantasy/Romance,0 days 01:36:00.000000000,4
54,22,https://resizing.flixster.com/zfREO8nEb0lgANEKZ4K9mfkyx-g=/206x305/v2/https://resizing.flixster.com/vqQgioliCFmpDmqKoEQB1WCxTeg=/ems.ZW1zLXByZC1hc3NldHMvbW92aWVzLzgwMzA4MzM5LTc1NzYtNDBkMC1hMWFmLTc5OWZkYzM0Y2NiOS53ZWJw,6 Below: Miracle on the Mountain,250,18,2017.0,Drama/Adventure,0 days 01:37:00.000000000,-32
89,86,https://resizing.flixster.com/lqX_rKDn-TyTCf01NWkfWTeoSSs=/206x305/v2/https://resizing.flixster.com/eQb3TooI2i9TBIuNDbE7rssyULY=/ems.ZW1zLXByZC1hc3NldHMvbW92aWVzLzZlYTcyNGUzLTljNDAtNGI0Zi1hZjY4LTk4YTQyMDlmMTMwMS53ZWJw,The Insult,1000,116,2017.0,Drama,0 days 01:53:00.000000000,-3
26,28,https://resizing.flixster.com/CuLVKr_QsSPh_iyoEBInZYsTVBE=/206x305/v2/https://resizing.flixster.com/9iBVHiJ1ZZ3w5zmD50VGFeU6b1c=/ems.ZW1zLXByZC1hc3NldHMvbW92aWVzL2Y1MzYxOGFlLWU1ZDMtNDdjOS05OTE2LTJiZmQzNjEzM2U3My53ZWJw,The Vault,500,29,2017.0,Horror/Mystery and thriller,0 days 01:31:00.000000000,2
53,54,,"Roman J. Israel, Esq.",2500,175,2017.0,Crime/Drama,0 days 01:57:00.000000000,1
67,59,,What Happened to Monday,2500,37,2017.0,Action/Sci fi,0 days 02:03:00.000000000,-8
48,90,,4 Days in France,50,21,2016.0,Romance/Comedy,0 days 02:22:00.000000000,42
24,30,https://resizing.flixster.com/sa0bNQJ2p8Xe7-asSGcBu42Pqq8=/206x305/v2/https://resizing.flixster.com/tZMSNFM89ydAYnYj0AKg75v_tfc=/ems.ZW1zLXByZC1hc3NldHMvbW92aWVzLzdmN2U3ZTA4LTkzYWEtNDNmOC1iODc2LTZmZDQ5ZmQ4NzQ5MS53ZWJw,Leatherface,2500,44,2017.0,Horror,0 days 01:30:00.000000000,6
13,27,,The Wilde Wedding,100,15,2017.0,Romance,0 days 01:36:00.000000000,14
80,31,https://resizing.flixster.com/bV3DuhScYMwwZdGJkwCf5UN8Jow=/206x305/v2/https://resizing.flixster.com/fpo4A7oYn9pcDjBvp1_5f28vyqI=/ems.ZW1zLXByZC1hc3NldHMvbW92aWVzLzRlYzkzYWViLWQ5NmYtNGNkNi04OGM1LWRjMjZkNmI2YzM2Mi53ZWJw,Po,100,13,2016.0,Drama,0 days 01:34:00.000000000,-49
60,100,https://resizing.flixster.com/9QaztgrbCgT5uElzfe4wNNVpPAU=/206x305/v2/https://flxt.tmsimg.com/assets/p14427142_p_v10_aa.jpg,Batman vs. Two-Face,100,8,2017.0,Action/Animation,0 days 01:12:00.000000000,40
79,75,https://resizing.flixster.com/_4YXmB3kh2mbPOahtt6C8aI65OE=/206x305/v2/https://resizing.flixster.com/cZNXShVJgY0ZhllslmcISSDXIz0=/ems.ZW1zLXByZC1hc3NldHMvbW92aWVzL2FhNmZkNzZmLTI5NWUtNGZkNS04MmFkLWYyMTY0MTBiY2UwNC53ZWJw,American Satan,500,8,2017.0,Mystery and thriller/Music,0 days 01:51:00.000000000,-4
75,79,https://resizing.flixster.com/kSdX9vEy1QMeXXFZa859OM76umg=/206x305/v2/https://resizing.flixster.com/OFVL2J2SpxxnD6Os4NOVW07Gvok=/ems.ZW1zLXByZC1hc3NldHMvbW92aWVzLzM0OGE1YTZiLWI5ODYtNGVlOS1hYjk2LTI1YmMxMmMyZGRlZi53ZWJw,The Bachelors,250,19,2017.0,Comedy/Drama,0 days 01:39:00.000000000,4
47,50,https://resizing.flixster.com/B-dSHMU7A0J4CwZa5LoAiieQGTk=/206x305/v2/https://resizing.flixster.com/fKcJAhNCa15v2v5bliSh7Xg9eqM=/ems.ZW1zLXByZC1hc3NldHMvbW92aWVzLzBiNWYwYjcwLWJlYzMtNDdlNy05ZjgyLWEwNjcxYjE1YWIxMS53ZWJw,The Monster Project,100,6,2017.0,Horror/Mystery and thriller,0 days 01:35:00.000000000,3
84,100,https://resizing.flixster.com/iH_rzJw1s4L0SVuUIWfbKoJbpcs=/206x305/v2/https://flxt.tmsimg.com/assets/p13679973_p_v10_aa.jpg,California Typewriter,250,39,2016.0,Documentary,0 days 01:43:00.000000000,16
68,44,https://resizing.flixster.com/Wv9YaproRnGanIDtjdE1Rcmvs5A=/206x305/v2/https://resizing.flixster.com/NxngNSZTfrQnj2wHCd398pEPz_o=/ems.ZW1zLXByZC1hc3NldHMvbW92aWVzLzU3M2RhZDEwLTg4NmUtNGQ1Zi04NjRmLWY5MWVmN2U1ZGU5My53ZWJw,Permanent,250,9,2017.0,Comedy,0 days 01:33:00.000000000,-24
23,14,https://resizing.flixster.com/xApcg9eYSkDEV35tZnqmtt14Mwc=/206x305/v2/https://resizing.flixster.com/1UwfHyWLYmDQkSoaT3by5Nojztg=/ems.ZW1zLXByZC1hc3NldHMvbW92aWVzLzNhYjA0YjM1LWI4MjktNDZhYS1hZmM2LTllZTg5ZjY5MTYwYi53ZWJw,The Adventurers,100,7,2017.0,Action/Adventure,0 days 01:44:00.000000000,-9
93,100,https://resizing.flixster.com/BpkPvDpi1nS1VmNEdooayVtY-wQ=/206x305/v2/https://resizing.flixster.com/GVxOOs9qzpaad6pSyIiit56aNu8=/ems.ZW1zLXByZC1hc3NldHMvbW92aWVzLzBmNTdmZGNlLWJlNzctNDNjMi1iYzllLTIzNmRjOTYwZTQ5OS53ZWJw,Too Funny To Fail,100,18,2017.0,,,7
84,92,,Kickboxer: Retaliation,500,13,2018.0,Action/Drama,0 days 01:50:00.000000000,8
45,62,https://resizing.flixster.com/K_qAv1Lk7yytS5AYbfZUqPyLqB0=/206x305/v2/https://resizing.flixster.com/1guV3EIWgA4kJSOc-TfB-0xbJiU=/ems.ZW1zLXByZC1hc3NldHMvbW92aWVzL2Q1MGQ1YzlkLTAyYTktNDZlNi05MDFhLTYzZGU2YjA1Njg0My53ZWJw,Most Likely to Murder,100,13,2018.0,Comedy,0 days 01:20:00.000000000,17
46,13,https://resizing.flixster.com/NHYPPLdF1DVUQCnae0uPOAw3Qxo=/206x305/v2/https://resizing.flixster.com/gh5lQpoFiw44GO0M-QxYlFhPBB8=/ems.ZW1zLXByZC1hc3NldHMvbW92aWVzL2RmOGUyMDc1LWQ3ZjEtNDEwMS1hYzc1LTQwMWY0MTYwNDBiOC53ZWJw,The Houses October Built 2,100,8,2017.0,Horror/Mystery and thriller,0 days 01:41:00.000000000,-33
28,84,https://resizing.flixster.com/ITn3O7SMtZjxKnNAPZkwxMZvDAQ=/206x305/v2/https://resizing.flixster.com/wkOw3mYRll_IdinjnZTjAzXT8ak=/ems.ZW1zLXByZC1hc3NldHMvbW92aWVzLzVkNDhlZTBiLWIzNmUtNDRhNy04MDczLWZiMWJmNDZhNTBjNi53ZWJw,Mohawk,100,43,2017.0,Drama/History,0 days 01:31:00.000000000,56
71,89,,Mary and The Witch's Flower,1000,90,2017.0,Fantasy/Adventure,0 days 01:43:00.000000000,18
62,33,https://resizing.flixster.com/YUcrzJlFe6y46DwIkzutAT9pLUM=/206x305/v2/https://resizing.flixster.com/EQKsre7m8ZrD-0YD80UhfU-OG_k=/ems.ZW1zLXByZC1hc3NldHMvbW92aWVzL2I0ODEwZGI0LTM3YzItNGJiOC1hODQyLTFiZjM0ZGQ0OGRiNi53ZWJw,Pokémon the Movie: I Choose You!,500,9,2017.0,Fantasy/Adventure,0 days 01:38:00.000000000,-29
29,17,,Clowntergeist,50,6,2016.0,Horror,0 days 01:20:00.000000000,-12
44,60,https://resizing.flixster.com/VWXYt37clVHudWFO_7E--gDyM5E=/206x305/v2/https://flxt.tmsimg.com/assets/p14208467_p_v10_aa.jpg,The Atoning,50,5,2017.0,Horror/Mystery and thriller,0 days 01:29:00.000000000,16
66,88,,Annihilation,10000,318,2018.0,Mystery and thriller/Sci fi,0 days 01:55:00.000000000,22
24,9,https://resizing.flixster.com/KYmsGi3q0u0f14C7br0ViotvIvo=/206x305/v2/https://resizing.flixster.com/eQUXQVgKOBfideMTq1sh8LG75Ek=/ems.ZW1zLXByZC1hc3NldHMvbW92aWVzLzM0ODMwNjI5LTczYmUtNDNlNS1iMTRlLWFhYzYyOTlhODZiNy53ZWJw,Don't Sleep,50,11,2017.0,Horror/Mystery and thriller,0 days 01:35:00.000000000,-15
50,71,,Cut Shoot Kill,1,7,2017.0,Action/Horror,0 days 01:37:00.000000000,21
83,93,https://resizing.flixster.com/yEhkFtBdyY9XGeNXefc_hvcwyW4=/206x305/v2/https://resizing.flixster.com/sleAGdsD28_yeugvwomQ-y7ZOFg=/ems.ZW1zLXByZC1hc3NldHMvbW92aWVzLzVjMTdkOWUxLTFlN2ItNDYzMi04ZjY3LTA5ODIyZmRmNGM5NC53ZWJw,One of Us,250,28,2017.0,,,10
72,91,,Journey's End,1000,102,2017.0,History/War,0 days 01:47:00.000000000,19
11,58,https://resizing.flixster.com/wa03Pm1KYpvN4inVQJimw1YP2JY=/206x305/v2/https://resizing.flixster.com/XXXoeyTThPLyPXHPC9NjJwKM5KA=/ems.ZW1zLXByZC1hc3NldHMvbW92aWVzL2YyMDRhZDk5LTU3YWItNDkxMC05YWM1LTI3YTQ5NzE3ODgyZS53ZWJw,Mrs. Hyde,1,31,2017.0,Comedy/Drama,0 days 01:35:00.000000000,47
46,20,https://resizing.flixster.com/JTGBra6PPceh6dPCOAThWqsHQwY=/206x305/v2/https://flxt.tmsimg.com/assets/p14427203_p_v10_aa.jpg,Where's the Money,100,5,2017.0,Comedy,0 days 01:26:00.000000000,-26
77,93,https://resizing.flixster.com/7HrELyQI275i59ssfaMt9BWns-M=/206x305/v2/https://resizing.flixster.com/vR6pjgQHPi8EzznTyljo_cMSbSk=/ems.ZW1zLXByZC1hc3NldHMvbW92aWVzLzYyYjczMmZhLTYxMDMtNDNjYi1hOTBhLWU2YTYyYTMyNmU0Yi53ZWJw,Thelma,2500,148,2017.0,Horror/Mystery and thriller,0 days 01:56:00.000000000,16
53,67,,Ancien and the Magic Tablet,100,18,2017.0,Fantasy/Anime,0 days 01:50:00.000000000,14
78,95,,The Death of Stalin,5000,247,2017.0,Comedy,0 days 01:47:00.000000000,17
92,63,https://resizing.flixster.com/qQUORJHZEZjMuTMAis9ARupkTAQ=/206x305/v2/https://resizing.flixster.com/bFtCac0POoSExO9j8qeBwRbGCCs=/ems.ZW1zLXByZC1hc3NldHMvbW92aWVzLzljMWQ4MDYxLWEwOWItNGEyMy1hNmQ5LWZlMTZmNzg2Zjk2OS53ZWJw,I Can Only Imagine,2500,32,2018.0,Drama/Music,0 days 01:50:00.000000000,-29
31,17,https://resizing.flixster.com/6C2LeQcglo6c_4uL25OcmCXZ5-M=/206x305/v2/https://resizing.flixster.com/Jz5DxIHuO3XX3BwK07FlnH-co_U=/ems.ZW1zLXByZC1hc3NldHMvbW92aWVzL2QzYTMyYTg2LTk0YTItNDZiOS04ZmU1LTQ1ODdjMzFmNDU1Mi53ZWJw,Jeepers Creepers 3,2500,6,2017.0,Action/Horror,0 days 01:40:00.000000000,-14
35,70,https://resizing.flixster.com/2K8CuIrYtLrHihVp46-xlJMlZA0=/206x305/v2/https://resizing.flixster.com/oCjQ2Ssv_fptPFJTi9BGGJA3wRI=/ems.ZW1zLXByZC1hc3NldHMvbW92aWVzLzBlZjI3ZWVhLWRjNjItNDI1Ni1hMDVlLTRkNzVmZmNjNGUyZi53ZWJw,Cold Moon,100,10,2016.0,Crime/Horror,0 days 01:32:00.000000000,35
34,65,,Still/Born,100,23,2017.0,Horror/Mystery and thriller,0 days 01:27:00.000000000,31
25,32,,Inside,100,19,2016.0,Horror/Mystery and thriller,0 days 01:31:00.000000000,7
74,90,https://resizing.flixster.com/_cwD6UDaDxeT6_M5oKBnVGvxeLA=/206x305/v2/https://resizing.flixster.com/NVJgFAZE2InVTSoozxQKJp-Ahs0=/ems.ZW1zLXByZC1hc3NldHMvbW92aWVzL2U2NTBkNzg4LWU1NzUtNDBkMy05M2UzLTNmNGQ5MTFiZmY5ZC53ZWJw,Brawl in Cell Block 99,5000,93,2017.0,Action/Mystery and thriller,0 days 02:12:00.000000000,16
81,100,,Haunters: The Art of the Scare,100,9,2017.0,Horror/Other,0 days 01:28:00.000000000,19
60,80,https://resizing.flixster.com/NP1NgvcimkaMnZoKWHsl1QgMFfo=/206x305/v2/https://resizing.flixster.com/YYrZRqRgbdb6x-70UcevGCCyP9U=/ems.ZW1zLXByZC1hc3NldHMvbW92aWVzL2Y1YzUyOWUxLWRlN2YtNDk2Yi04NTI1LTY1Y2U1Y2VmNDBjZC53ZWJw,Beside Bowie: The Mick Ronson Story,1,5,2017.0,Documentary/Music,0 days 01:48:00.000000000,20
70,71,,Disney's Descendants 2,500,7,2017.0,Adventure/Kids and family,0 days 01:51:00.000000000,1
71,91,,Gerald's Game,2500,78,2017.0,Horror/Mystery and thriller,0 days 01:43:00.000000000,20
47,92,https://resizing.flixster.com/7lAPP4jVoc8IoNoYpnzQXbQzzbs=/206x305/v2/https://resizing.flixster.com/RwxJ1pYmmCKsTnfOfdOqst7sQ4A=/ems.ZW1zLXByZC1hc3NldHMvbW92aWVzL2E5YzYxYTMzLWM4YmEtNGQ5NS1hY2MyLTM2ODI2OTMwNGI4NC53ZWJw,Little Evil,1000,12,2017.0,Comedy/Horror,0 days 01:34:00.000000000,45
75,95,https://resizing.flixster.com/oKA6lCdSSpWBMUr04mCkIuXyptk=/206x305/v2/https://resizing.flixster.com/GrIGLIwEoEoSZDuqwc89nkG4qAU=/ems.ZW1zLXByZC1hc3NldHMvbW92aWVzLzE0YWU4Y2QzLTY2OTQtNDRhMy05Y2E3LWQ3YTY1ZGVkMDE0Yi53ZWJw,Jerry Before Seinfeld,250,19,2017.0,Comedy/Stand up,0 days 01:01:00.000000000,20
46,67,,Victor Crowley,100,15,2017.0,Comedy/Horror,0 days 01:22:00.000000000,21
80,73,https://resizing.flixster.com/jeNuW8rRsEY4RqS8cCFxBEXXLUk=/206x305/v2/https://resizing.flixster.com/s3a2uhuJlAQcTi-WPAEkgkXhTis=/ems.ZW1zLXByZC1hc3NldHMvbW92aWVzLzIxNzBlZjk4LWRmOGQtNGY5YS1hMTBjLWE2Nzg5ZDQyZTNkNS53ZWJw,Gaga: Five Foot Two,5000,40,2017.0,Documentary,0 days 01:40:00.000000000,-7
63,73,https://resizing.flixster.com/5jr7evmrcHWbfjocQ5tXOldW0uE=/206x305/v2/https://resizing.flixster.com/7qmpifY_tiJZ1vPx975ka9ruglQ=/ems.ZW1zLXByZC1hc3NldHMvbW92aWVzL2I0MTIwZjA5LWUyMGEtNGRhOC04NTNjLTZkZjNlZmFkZjBkMi53ZWJw,Back to Burgundy,100,45,2017.0,Comedy/Drama,0 days 01:53:00.000000000,10
79,100,,Bad Blood: The Movie,50,5,2016.0,Horror,0 days 01:20:00.000000000,21
14,50,https://resizing.flixster.com/TRWIIPmS18C9em_GrR5503xo-eE=/206x305/v2/https://resizing.flixster.com/x9Ac4Wd5Z18h1c5LPVi5D693fK8=/ems.ZW1zLXByZC1hc3NldHMvbW92aWVzLzA1NzFlYTQ0LTUwY2QtNDE0OS1iYmM3LWVmMGI4ZGIxMmYwYy53ZWJw,Blood Money,50,8,2017.0,Action/Mystery and thriller,0 days 01:25:00.000000000,36
68,80,,Marc Maron: Too Real,1,5,2017.0,,,12
60,93,https://resizing.flixster.com/l3eBSD0YPmn_iH1b7cDw3En-H4Y=/206x305/v2/https://resizing.flixster.com/V82-8eZj5ZcJvkKPm11ioDjdKWE=/ems.ZW1zLXByZC1hc3NldHMvbW92aWVzLzczYjQxMTM5LWM2MzctNGY4MS1hODg3LWE5MjdjNDFlNTE3NS53ZWJw,Radius,500,15,2017.0,Sci fi/Mystery and thriller,0 days 01:27:00.000000000,33
40,40,,Wetlands,1,15,2017.0,Crime/Drama,0 days 01:38:00.000000000,0
72,25,https://resizing.flixster.com/CO_EdRqDgPEfgyOhWRG-ehM3jUc=/206x305/v2/https://resizing.flixster.com/7EJqCjKjCSUO6nJ8FAQruVNxFP4=/ems.ZW1zLXByZC1hc3NldHMvbW92aWVzL2Y2NTEwMzgxLWY4MzUtNDRkOC1hYWFiLTA3ZjYwMzQ5MWVkZS53ZWJw,Blood Honey,500,8,2017.0,Mystery and thriller,0 days 01:35:00.000000000,-47
65,80,/assets/pizza-pie/images/poster_default.c8c896e70c3.gif,All the Money in the World,5000,255,2017.0,Crime/Drama,0 days 02:12:00.000000000,15
62,75,,Public Schooled,100,8,2017.0,Comedy,0 days 01:26:00.000000000,13
58,64,,The Tribes of Palos Verdes,250,22,2017.0,Comedy/Drama,0 days 01:45:00.000000000,6
63,83,,Black Cop,50,12,2017.0,Drama,0 days 01:31:00.000000000,20
48,83,https://resizing.flixster.com/uYmrCTkiTYJlfWNIYdMbjTDR6Ko=/206x305/v2/https://resizing.flixster.com/FNNQZ4CA0k9bRD2q6KDVkKwFH1Q=/ems.ZW1zLXByZC1hc3NldHMvbW92aWVzLzc0M2JjOTU1LTBmMDAtNDkzMS05Y2U2LTBiMGViNTgzNzMyYS53ZWJw,The Mimic,1,6,2017.0,Fantasy/Horror,0 days 01:40:00.000000000,35
66,88,https://resizing.flixster.com/WvFvvhMWCbXj87QkCmsQhz4XI3M=/206x305/v2/https://resizing.flixster.com/swYsVGTOL7kGMS8k3664xkA1_F8=/ems.ZW1zLXByZC1hc3NldHMvbW92aWVzLzBkZjcxZTJlLTVmN2QtNGQ1NS1hY2JkLWE5M2RkNjExNzM4Ni53ZWJw,Wheelman,500,25,2017.0,Action/Mystery and thriller,0 days 01:22:00.000000000,22
49,84,https://resizing.flixster.com/ijNx2P4hD0o1kC_XsRmuOrMSeMc=/206x305/v2/https://resizing.flixster.com/Pa4SAZJXxYfFJcw3fyali6GVp_Y=/ems.ZW1zLXByZC1hc3NldHMvbW92aWVzL2FiMGNlZTNiLTdiNjQtNDQzNC04ZWFjLTIyZDc4YjIxYmZmNy53ZWJw,The Final Year,250,105,2017.0,Documentary,0 days 01:29:00.000000000,35
88,90,,"I, Tonya",10000,381,2017.0,Biography/Comedy,0 days 02:01:00.000000000,2
45,17,,Acrimony,1,36,2018.0,Drama/Mystery and thriller,0 days 02:00:00.000000000,-28
37,23,https://resizing.flixster.com/k2vnSJyzTXyosh1I3M3gH0Xz9i0=/206x305/v2/https://resizing.flixster.com/tJbpNdASwWyWB_puK-9Mt_393Do=/ems.ZW1zLXByZC1hc3NldHMvbW92aWVzL2QyMGQwNmNjLTJhZmQtNDMzYS05ZTI1LWFlZjQwOTRhNTA4OS53ZWJw,The 15:17 to Paris,2500,165,2018.0,Drama/Mystery and thriller,0 days 01:34:00.000000000,-14
64,93,,Rift,100,15,2017.0,Horror/Gay and lesbian,0 days 01:51:00.000000000,29
61,75,https://resizing.flixster.com/Bp3ub936iUmheQ5O_AmWPob-CvA=/206x305/v2/https://resizing.flixster.com/7k5hQxsBIctw4vTNgCq1xZUZKik=/ems.ZW1zLXByZC1hc3NldHMvbW92aWVzLzYxZGMyYTIzLTk5ZDMtNDk3OS05ZDc2LWJiNjJmYmU1OWE5MC53ZWJw,11/8/16,50,12,2017.0,Documentary,0 days 01:44:00.000000000,14
60,91,https://resizing.flixster.com/j1WSNmGrLVyOJ1SAWPDCb_SHf-o=/206x305/v2/https://flxt.tmsimg.com/assets/p14642026_p_v8_aa.jpg,Arthur Miller: Writer,50,11,2017.0,Documentary,0 days 01:38:00.000000000,31
84,100,https://resizing.flixster.com/5WYotKOME0OKyyKWvMhnJQ_rUNw=/206x305/v2/https://resizing.flixster.com/y3Mzesv1zNSC9BMYwdhO5yJ2mKo=/ems.ZW1zLXByZC1hc3NldHMvbW92aWVzLzkyOWU2YmI2LWNjYTgtNDk1Mi1iMjljLWUwOWQyNmNjNzIzYy53ZWJw,Planet Earth: One Amazing Day,100,21,2017.0,Documentary,0 days 01:35:00.000000000,16
54,82,,Pyewacket,250,34,2017.0,Horror/Mystery and thriller,0 days 01:30:00.000000000,28
70,70,https://resizing.flixster.com/ZrehlVgoejAQSIP9NtH63-HKqWU=/206x305/v2/https://resizing.flixster.com/U9VxzZBB1WjScK2qp8y5qON8yoY=/ems.ZW1zLXByZC1hc3NldHMvbW92aWVzLzY0MWViZjE1LTU0OWUtNDM1Ni1iZjBjLTVlMDk2NmZhNjY4Zi53ZWJw,Kodachrome,500,50,2017.0,Comedy/Drama,0 days 01:40:00.000000000,0
39,56,https://resizing.flixster.com/HwYdxGcRUjP6o2Yj701L19yfT0s=/206x305/v2/https://resizing.flixster.com/QheXa753t99fsLlc5nBiCXCpGR8=/ems.ZW1zLXByZC1hc3NldHMvbW92aWVzL2IzYjhjNTM0LThhNWUtNGMyZC05NGFkLWQ5NmIzMDU0ZmY2MS53ZWJw,The Lodgers,250,45,2017.0,Mystery and thriller/Horror,0 days 01:33:00.000000000,17
60,73,https://resizing.flixster.com/nIAIeVRf1McErYh_mZ8QMV6bOuc=/206x305/v2/https://resizing.flixster.com/JB6FYubQLd0-nvrGtUKtROH2V4Y=/ems.ZW1zLXByZC1hc3NldHMvbW92aWVzLzgwZTdhMjFhLTkzZjYtNDI0ZC1hMGQxLTE0YzljMmIwYTI4YS53ZWJw,The Ritual,1000,92,2017.0,Horror,0 days 01:34:00.000000000,13
74,78,,I Kill Giants,1000,63,2017.0,Fantasy/Adventure,0 days 01:46:00.000000000,4
86,100,,Heroin(e),1,10,2017.0,Documentary,0 days 00:39:00.000000000,14
47,70,https://resizing.flixster.com/m5DBwMX8WCo21e5K6yXJm96JyhY=/206x305/v2/https://resizing.flixster.com/g4wmLWPaCtaRiwYgZwQynmemNks=/ems.ZW1zLXByZC1hc3NldHMvbW92aWVzLzRlYjUzMmJlLTcyNzctNDg4MC1hZjk5LWFhNmY3YTBhY2EzMC53ZWJw,The Cured,500,66,2017.0,Horror/Mystery and thriller,0 days 01:35:00.000000000,23
59,88,https://resizing.flixster.com/D0deHceCbQUkfXrLKFBxch-UeqA=/206x305/v2/https://resizing.flixster.com/jMHes-lRvOBv0QhR0WmUjTiCu7M=/ems.ZW1zLXByZC1hc3NldHMvbW92aWVzL2Q1ZjBhOWFiLWEyODgtNGYwYS1iMTA3LWNhYzMzNGQyZWE5Zi53ZWJw,The Ravenous,250,32,2017.0,Horror/Mystery and thriller,0 days 01:43:00.000000000,29
60,29,https://resizing.flixster.com/NEXtQHS539Kf9ptfM11LVb3tgFQ=/206x305/v2/https://resizing.flixster.com/wXZTpyXEnb-r6AjsJ43l0aKfUCw=/ems.ZW1zLXByZC1hc3NldHMvbW92aWVzL2Y0MjQ1Y2RjLTM2NWMtNDg1Yy1iMDc2LTcwNDY0NmJlM2IxNi53ZWJw,Trafficked,100,7,2017.0,Drama/Mystery and thriller,0 days 01:44:00.000000000,-31
93,100,https://resizing.flixster.com/U5hGZQVr-B9ddkAzTdtzeAvpBBs=/206x305/v2/https://resizing.flixster.com/51cma08SeUNRN1kkWf8P0KwA1P4=/ems.ZW1zLXByZC1hc3NldHMvbW92aWVzLzUzODNiMjJiLWZmNTYtNDZjYi1hZTMzLTZhNTQ4NTBhYWMwMS53ZWJw,Cuba and the Cameraman,250,7,2017.0,Documentary,0 days 01:53:00.000000000,7
83,100,,Kingdom of Us,100,8,2017.0,Documentary/Drama,0 days 01:49:00.000000000,17
54,62,https://resizing.flixster.com/FquqiQDHcamJMqVZ4Iw0oenFQd4=/206x305/v2/https://resizing.flixster.com/AIqZY6Efv-m-jCJGRHbVgx5mYfM=/ems.ZW1zLXByZC1hc3NldHMvbW92aWVzLzI4Mjc5MGYxLTViNWEtNDkyOC04MjNjLWIwYjI1NTA3ZDA4Mi53ZWJw,Every Day,1000,63,2018.0,Romance/Fantasy,0 days 01:35:00.000000000,8
74,30,/assets/pizza-pie/images/poster_default.c8c896e70c3.gif,Let There Be Light,2500,10,2017.0,Drama,0 days 01:41:00.000000000,-44
29,52,https://resizing.flixster.com/a1ucfO9xo8pQZIxzhOSCxXsMTx0=/206x305/v2/https://resizing.flixster.com/exbtFGUvYkIEA_m0WjmYKG0ZszM=/ems.ZW1zLXByZC1hc3NldHMvbW92aWVzL2U4YWIwYWYyLWU4ZTUtNDc3Yy1hN2VmLTE3OGFiNzA0ODI1My53ZWJw,24 Hours to Live,250,21,2017.0,Action/Mystery and thriller,0 days 01:33:00.000000000,23
48,29,https://resizing.flixster.com/Qv7irmfoYD7MRU1u6x-k2-Xit70=/206x305/v2/https://resizing.flixster.com/TBwSK71Mt2l_Cml9ljOjfTCyzeg=/ems.ZW1zLXByZC1hc3NldHMvbW92aWVzLzM0YjIyY2ZkLThjODgtNDQzMS05MGY5LTBkNmI2Njc1NDNkZC53ZWJw,Almost Friends,100,7,2016.0,Romance,0 days 01:41:00.000000000,-19
73,40,https://resizing.flixster.com/fJiMr0Tp0jbgVcRETEuLycNMUz8=/206x305/v2/https://resizing.flixster.com/hJlJr_fUme6_ElFNbSn8wJpSYDs=/ems.ZW1zLXByZC1hc3NldHMvbW92aWVzLzdiYWNkZDdkLWY1NmMtNDcyZC05YWFkLTE3YzMyY2ZmNjU0Mi53ZWJw,Amanda and Jack Go Glamping,100,5,2017.0,Romance,0 days 01:34:00.000000000,-33
62,25,,Cook Off!,250,8,2017.0,Comedy,0 days 01:38:00.000000000,-37
53,86,https://resizing.flixster.com/kwXUeLt316mMYgtgP9LCsuuDL4g=/206x305/v2/https://resizing.flixster.com/6SJS2YswLt9dXkN_N5Wh0PByx94=/ems.ZW1zLXByZC1hc3NldHMvbW92aWVzL2I4N2RhZjc5LTljZTQtNDVhMi05NTFjLTIyMDQwYTAwYzBkNi53ZWJw,I Remember You,250,7,2017.0,Horror,0 days 01:45:00.000000000,33
89,83,https://resizing.flixster.com/QEHV8Wg84w5TB0e56k8rsfabt6I=/206x305/v2/https://resizing.flixster.com/0zqAHYzCMw1qBo3JdKgHwxXT9L8=/ems.ZW1zLXByZC1hc3NldHMvbW92aWVzLzk0MGFlNzI5LTAwYWMtNGYyZC1iNDU0LWIyZGYwZTVmN2E3NC53ZWJw,The Legend of 420,50,6,2017.0,Documentary,0 days 01:27:00.000000000,-6
30,4,https://resizing.flixster.com/fn3THylFd-C_bM-DAZkMm8Cc2sw=/206x305/v2/https://resizing.flixster.com/mUh5A9fSJJqWzRXi6Hfp9RPcdNY=/ems.ZW1zLXByZC1hc3NldHMvbW92aWVzLzIxODhhMWRhLWEwZDYtNGEyNS04NmQzLTBhMDBlMDBlMWMzNS53ZWJw,Hangman,250,23,2017.0,Crime/Drama,0 days 01:38:00.000000000,-26
40,90,https://resizing.flixster.com/RAi0cecklDWghrcbpz9WyPHZmy0=/206x305/v2/https://resizing.flixster.com/Tnx2ovG8wlfrA9-Sk0iNUABU4es=/ems.ZW1zLXByZC1hc3NldHMvbW92aWVzLzZiMDUwMjY1LTE5NzctNGFhNy1iNTRkLTRhYmJiMWRkNDg5Zi53ZWJw,B&B,50,10,2017.0,Gay and lesbian/Mystery and thriller,0 days 01:27:00.000000000,50
57,91,,1922,1000,44,2017.0,Horror,0 days 01:42:00.000000000,34
81,100,,Just Charlie,50,7,2017.0,Drama,0 days 01:37:00.000000000,19
81,46,https://resizing.flixster.com/6kfiVUGtMODlraawkziWK5RRIb0=/206x305/v2/https://resizing.flixster.com/5BTtfYQpwyTfbQZ1VK8_3gugms4=/ems.ZW1zLXByZC1hc3NldHMvbW92aWVzLzYzNzNjM2E2LWM0YmUtNGMyMC04N2MyLTUyNWY4Y2M2ZmQwOS53ZWJw,"Paul, Apostle of Christ",1000,39,2018.0,Drama,0 days 01:48:00.000000000,-35
23,47,,The Hurricane Heist,500,59,2018.0,Action/Mystery and thriller,0 days 01:43:00.000000000,24
71,100,https://resizing.flixster.com/XOiaTo1j0fs86p15eV9GOo7sY1k=/206x305/v2/https://resizing.flixster.com/Kno3155IjxeHeObHskwIGgeqtUs=/ems.ZW1zLXByZC1hc3NldHMvbW92aWVzL2Q2ZjRiNGYzLTgyZmYtNDgyYS05NWRmLTk2MTdkMDgxMTAwMC53ZWJw,Creep 2,1000,23,2017.0,Horror/Mystery and thriller,0 days 01:18:00.000000000,29
88,91,https://resizing.flixster.com/qEbcQsYjjwFKZskLWjgcO0lbuqU=/206x305/v2/https://resizing.flixster.com/cz7dx-a-F8zoH6eXauuTzfi4C8Q=/ems.ZW1zLXByZC1hc3NldHMvbW92aWVzLzgwOGViMzdmLWUwNzItNDFiZi1hOTZmLTJkNWJkZTMxNjYwOC53ZWJw,"Love, Simon",5000,234,2018.0,Romance/Gay and lesbian,0 days 01:50:00.000000000,3
80,94,,The Newspaperman: The Life and Times of Ben Bradlee,50,17,2017.0,,,14
63,100,https://resizing.flixster.com/ixrZX6Uw73wMrl4fvNplviQOwZM=/206x305/v2/https://resizing.flixster.com/lYUoxlMJzw5hx3_WDSnW_mKTWu8=/ems.ZW1zLXByZC1hc3NldHMvbW92aWVzL2FjOTgzNWNkLWY1ZTMtNDgwMC05YjE3LTRhY2U1MGYyODljYi53ZWJw,Cold November,100,6,2017.0,Drama,0 days 01:32:00.000000000,37
61,79,,Voyeur,250,29,2017.0,Documentary,0 days 01:36:00.000000000,18
66,88,,Cargo,1000,76,2018.0,,,22
63,100,,Patton Oswalt: Annihilation,100,13,2017.0,,,37
38,67,https://resizing.flixster.com/Yo4Ti5i52nqk5LX2a0M0M6f-LRU=/206x305/v2/https://resizing.flixster.com/-vO9diV1_DihYMJ-9W4bOiGRfKc=/ems.ZW1zLXByZC1hc3NldHMvbW92aWVzLzM5ODYzYmRhLWNkMjMtNDdiNy05MGE5LWFmZDU5MzFkZTIwMi53ZWJw,Beyond Skyline,500,21,2017.0,Action/Sci fi,0 days 01:46:00.000000000,29
29,17,,The Stolen,1,6,2016.0,Drama/Western,0 days 01:35:00.000000000,-12
33,41,https://resizing.flixster.com/0EHiB6zOPKIHVplrSoNx6CX2iQA=/206x305/v2/https://resizing.flixster.com/iCnqPXdLyCiuA91E1uLlin_wlLk=/ems.ZW1zLXByZC1hc3NldHMvbW92aWVzL2ExMDFmNGQ5LTE4N2UtNDNlZi1iNjEwLTBhNWE3NmY3MmYwZi53ZWJw,An Ordinary Man,50,22,2017.0,Drama/Mystery and thriller,0 days 01:30:00.000000000,8
80,89,https://resizing.flixster.com/0JW3PoSOtXkNa7qDjn4KfPcDGZs=/206x305/v2/https://resizing.flixster.com/22e1Fgte2AqNKZVNks1Who00Dm4=/ems.ZW1zLXByZC1hc3NldHMvbW92aWVzL2JhMGNhM2I4LTQ2NTAtNDExMy1iMWQ3LTE1ZDJmNjVhN2Q3YS53ZWJw,Joan Didion: The Center Will Not Hold,100,35,2017.0,Documentary,0 days 01:34:00.000000000,9
64,44,,Love Beats Rhymes,50,9,2017.0,Drama/Music,0 days 01:46:00.000000000,-20
35,39,https://resizing.flixster.com/-6mrgmODfzcjw6XLSkFNuHN9VZE=/206x305/v2/https://resizing.flixster.com/mX6i0gWk63jVjINmcQvSCTnluDg=/ems.ZW1zLXByZC1hc3NldHMvbW92aWVzLzljYTVjMmQxLTAwZmMtNDQxZS1hNjU0LWViZGIyOTY1NmI3ZC53ZWJw,The Strangers: Prey at Night,1000,124,2018.0,Horror/Mystery and thriller,0 days 01:25:00.000000000,4
32,13,https://resizing.flixster.com/sMzYzpRnbJ5y4CvfuM0fDKPVRPw=/206x305/v2/https://resizing.flixster.com/hcqxO-G7jquNe6mZ9VEetbKExbU=/ems.ZW1zLXByZC1hc3NldHMvbW92aWVzLzczOWNhYzNhLTcyMTctNDExNC05ZWMzLThiYzg0N2IxMGM4MC53ZWJw,Winchester,2500,130,2018.0,Horror/Mystery and thriller,0 days 01:39:00.000000000,-19
95,100,https://resizing.flixster.com/BQHGRTDD9m9rK1ENBF70SGO3iq4=/206x305/v2/https://resizing.flixster.com/Ic7xZ0mqf0UoIQEcR2q9oZTmQ9M=/ems.ZW1zLXByZC1hc3NldHMvbW92aWVzLzE4Mzk2ODIwLTMwZmYtNGM5Yy04ODJmLTE1NTRmZGVlYTIxNi53ZWJw,Trouble Is My Business,250,6,2017.0,Drama/Crime,0 days 01:56:00.000000000,5
22,10,https://resizing.flixster.com/g5EbMwAJDKWtsigDclSdf_IqnpE=/206x305/v2/https://flxt.tmsimg.com/assets/p14675716_p_v10_ac.jpg,Happy Family,100,21,2017.0,Other/Kids and family,0 days 01:36:00.000000000,-12
64,88,https://resizing.flixster.com/QAgZtVnuIIHTvdHQDUw6MdN9X4c=/206x305/v2/https://resizing.flixster.com/0PUAbJgoIXp4Nc2_FRvpxlxFgyA=/ems.ZW1zLXByZC1hc3NldHMvbW92aWVzL2IxNWYwN2E4LTk5YWEtNGViNC1hNzM4LTNmYTgyZWI4Y2FmMC53ZWJw,Gold Star,1,8,2017.0,Drama,0 days 01:30:00.000000000,24
19,0,,Slumber,100,8,2017.0,Horror/Mystery and thriller,0 days 01:25:00.000000000,-19
31,61,https://resizing.flixster.com/D71HAUvuOiT5qxovXZ4KZl_f8xE=/206x305/v2/https://resizing.flixster.com/sG37c13eGpODphXYHxfdrfvFdYI=/ems.ZW1zLXByZC1hc3NldHMvbW92aWVzL2E5NmQ4MGNiLTIzYTctNDI4NC04NDcwLWVjNWIzODMyY2FkZS53ZWJw,Bullet Head,100,18,2017.0,Crime/Drama,0 days 01:33:00.000000000,30
79,79,,The China Hustle,100,33,2017.0,Documentary,0 days 01:24:00.000000000,0
56,82,https://resizing.flixster.com/aDwVcphuc_LIkh60u1xj-tRbVr0=/206x305/v2/https://resizing.flixster.com/4T1WHW8MFCYXmhFHoQ8iaH38d6M=/ems.ZW1zLXByZC1hc3NldHMvbW92aWVzLzE5ZmZiNGRkLTBiNDctNDA4Yy04N2JkLTc0YWY1MGQ5OGZjNy53ZWJw,Beirut,1000,132,2018.0,Drama/Mystery and thriller,0 days 01:49:00.000000000,26
48,39,https://resizing.flixster.com/honj1sVAOdhc37zNsL6UkJVjitQ=/206x305/v2/https://resizing.flixster.com/cnxAH4ql4w6ZkchNoA_lh66CyBg=/ems.ZW1zLXByZC1hc3NldHMvbW92aWVzLzVjMzA5NWUzLWI5NGMtNGViYi1hNjkzLWMzODA1YzJkNDY4MC53ZWJw,Nostalgia,100,56,2018.0,Drama,0 days 01:54:00.000000000,-9
31,0,,In the Absence of Good Men,50,5,2017.0,Crime/Drama,0 days 01:28:00.000000000,-31
48,25,https://resizing.flixster.com/aPE6GAXIFocPG5M2eLYwCoTXDk0=/206x305/v2/https://resizing.flixster.com/UXmyQGVgZQVjAkT8x07p1guoX2U=/ems.ZW1zLXByZC1hc3NldHMvbW92aWVzLzI0MGQ4NTlhLTFjNTAtNDNkOC1hOTc3LTE5Y2E5YTA4YjRmYi53ZWJw,Tau,500,12,2018.0,Sci fi/Mystery and thriller,0 days 01:37:00.000000000,-23
88,92,https://resizing.flixster.com/e9eGUuS5AbpL66-1lqd5o_y1-dc=/206x305/v2/https://resizing.flixster.com/HQ_tBpHXr-RMF3oo3lix_E_UP7o=/ems.ZW1zLXByZC1hc3NldHMvbW92aWVzLzljNWU3ZGZkLTA1MGUtNGY1NS04Mzc2LWEwNGJmMmQ0YzEwMC53ZWJw,"Jim & Andy: The Great Beyond - Featuring a Very Special, Contractually Obligated Mention of Tony Clifton",500,49,2017.0,Documentary,0 days 01:34:00.000000000,4
65,100,,Saving Capitalism,100,5,2017.0,,,35
33,60,,It Came From the Desert,1,5,2017.0,Action/Horror,0 days 01:29:00.000000000,27
54,60,,Terrifier,500,15,2017.0,Other/Horror,0 days 01:22:00.000000000,6
47,73,,A Christmas Prince,250,11,2017.0,Romance/Other,0 days 01:32:00.000000000,26
67,75,,Batman: Gotham by Gaslight,500,12,2018.0,Animation/Adventure,0 days 01:18:00.000000000,8
90,100,https://resizing.flixster.com/76sZkbsp-X_R6yEEdPGffr02Z5Q=/206x305/v2/https://resizing.flixster.com/su-aJnvdayw6LeuOmHePL4wo5rM=/ems.ZW1zLXByZC1hc3NldHMvbW92aWVzL2NhYTc4ODZkLWM2MDQtNDFlMC05MmY4LWYxODMzYjEwYTIzZC53ZWJw,What Lies Upstream,500,11,2017.0,Documentary,0 days 01:29:00.000000000,10
58,43,https://resizing.flixster.com/ujXgMYGBel5qFRbJRFYIKbNHbZM=/206x305/v2/https://resizing.flixster.com/P8U0g443satdMZ8XfSWcTcNJV2Q=/ems.ZW1zLXByZC1hc3NldHMvbW92aWVzL2ZhMmIxZTMwLTMyYmEtNDBkMS1hMGUwLWJmMGNmMmQ4ZDJkYy53ZWJw,When We First Met,500,23,2018.0,Romance,0 days 01:37:00.000000000,-15
58,80,https://resizing.flixster.com/B51xPtbdXqJg2bu-qyN65U02Vd0=/206x305/v2/https://resizing.flixster.com/w5oPJH3i2Xh9weDJfKNNRJOVvD0=/ems.ZW1zLXByZC1hc3NldHMvbW92aWVzLzNmNDFhZmY5LWFhZWUtNGU0Ni05ZjhjLTlmNTM4N2ZiNDE3MS53ZWJw,Unsane,2500,236,2018.0,Horror/Mystery and thriller,0 days 01:38:00.000000000,22
30,0,https://resizing.flixster.com/_RRJmThEyfwBaLW0W6ZCQpTCCn8=/206x305/v2/https://flxt.tmsimg.com/assets/p14899659_p_v10_aa.jpg,Acts of Violence,250,13,2018.0,Action/Mystery and thriller,0 days 01:26:00.000000000,-30
53,17,https://resizing.flixster.com/WVxcCsLkOYE3MxWufXQZamo2jMc=/206x305/v2/https://resizing.flixster.com/QUhpn2MAWv4Cu-KW8G6RBN-54AM=/ems.ZW1zLXByZC1hc3NldHMvbW92aWVzLzM1MjBiZGIyLTE1NDktNDQ4ZS1hNDA5LWUyY2ExMTdkYjBmOS53ZWJw,The Competition,100,6,2018.0,Romance,0 days 01:43:00.000000000,-36
42,16,https://resizing.flixster.com/sOwmVZmkBCODr77kzmC7kVy5Qgw=/206x305/v2/https://resizing.flixster.com/QFn0LFr7NbrdflekSAeKQcU9F-k=/ems.ZW1zLXByZC1hc3NldHMvbW92aWVzLzQ0MzE4ZTgxLTIwNzctNGFiOC05NDFhLWZjOWJhMjQ1MzFkZi53ZWJw,Dear Dictator,100,25,2017.0,Comedy,0 days 01:30:00.000000000,-26
39,40,https://resizing.flixster.com/Wot3cVkjYRZOmSXPUgXovc1I9uU=/206x305/v2/https://flxt.tmsimg.com/assets/p14868105_p_v8_aa.jpg,El Camino Christmas,100,5,2017.0,Other/Comedy,0 days 01:28:00.000000000,1
48,0,/assets/pizza-pie/images/poster_default.c8c896e70c3.gif,Status Update,250,5,2018.0,Comedy,0 days 01:46:00.000000000,-48
42,47,https://resizing.flixster.com/c3vFLhDzxCapzeNm35YkCC8tslk=/206x305/v2/https://resizing.flixster.com/d5ocvFBHsjAWCeaqZM0moR2Oj1I=/ems.ZW1zLXByZC1hc3NldHMvbW92aWVzL2ExMjhmNGFhLTA4OTQtNGJjOS1iNGI0LTg4MTFjNWZmOGIyNC53ZWJw,Allure,50,32,2017.0,Gay and lesbian/Drama,0 days 01:45:00.000000000,5
51,86,,Judd Apatow: The Return,1,7,2017.0,Comedy/Stand up,0 days 01:09:00.000000000,35
76,100,https://resizing.flixster.com/f47zIscZndcjsW2sdnGHXGLw_Uw=/206x305/v2/https://resizing.flixster.com/0X-yLY0gbUAO_v7NB-9hNhP9xYQ=/ems.ZW1zLXByZC1hc3NldHMvbW92aWVzLzM0NWM4MGYyLTM1ZmYtNDg0Yi1hODQ0LTBkYzUzNDFkMWQyZC53ZWJw,Seeing Allred,100,15,2018.0,Documentary,0 days 01:36:00.000000000,24
34,43,https://resizing.flixster.com/4SH1tVfwb5V5rEImt3TlU9DNjgU=/206x305/v2/https://resizing.flixster.com/4Y3FMRBsOFUVcLHLTWmrY2FciMk=/ems.ZW1zLXByZC1hc3NldHMvbW92aWVzLzMxZWZlODIyLTA5YmYtNGNkYS05YTc1LTZhZmQxZjQ0M2ZjOC53ZWJw,Christmas Inheritance,100,7,2017.0,Romance/Other,0 days 01:44:00.000000000,9
61,42,https://resizing.flixster.com/3SLtBKM7gtW4phMwRp9VtsJctLA=/206x305/v2/https://resizing.flixster.com/LZX08N3mHRQzgzM3kjrop5WTgTQ=/ems.ZW1zLXByZC1hc3NldHMvbW92aWVzLzVjZGFlNGY4LTI5NDEtNDFjNi05NDZkLTJjYWI3MzFlNjNlNi53ZWJw,The Valley,1,12,2017.0,Drama/Mystery and thriller,0 days 01:35:00.000000000,-19
55,70,https://resizing.flixster.com/txFDgU8MdE8cJ-yKQsenVH46U_w=/206x305/v2/https://resizing.flixster.com/UUFTa1zbkIgKo2c16HcEhmFIGDE=/ems.ZW1zLXByZC1hc3NldHMvbW92aWVzLzQxNmE4MTQ1LWQ5ODItNGUzNi05YTFmLTVlY2QzNDk5YTA3NC53ZWJw,Finding Your Feet,500,88,2017.0,Romance/Comedy,0 days 01:51:00.000000000,15
40,22,,Kill Order,1,9,2017.0,Action/Sci fi,0 days 01:17:00.000000000,-18
67,100,,Notes From The Field,1,6,2018.0,,,33
9,13,,Day of the Dead: Bloodline,250,8,2018.0,Horror,0 days 01:30:00.000000000,4
61,82,https://resizing.flixster.com/3YD2mxc_7b62nxRrxfhM82cDrpU=/206x305/v2/https://resizing.flixster.com/BUtsldJPisTa8xmsrbas8EYccgk=/ems.ZW1zLXByZC1hc3NldHMvbW92aWVzLzdmNGEzNTg1LTZkYjQtNGI1OS05NmQyLWZlMzM0MTZmNWQxNy53ZWJw,Batman Ninja,1000,17,2018.0,Action/Anime,0 days 01:25:00.000000000,21
33,30,https://resizing.flixster.com/hRykby258AhuNew2yCFxfem4kJs=/206x305/v2/https://resizing.flixster.com/RX1oRkBnk4MVGx08c6q_BnZXOXo=/ems.ZW1zLXByZC1hc3NldHMvbW92aWVzLzE2ZGJhMzEyLWNlMjgtNDM1MC1hMDNkLTA2M2RkOGNmZjM5ZS53ZWJw,The Midnight Man,100,10,2016.0,Horror/Mystery and thriller,0 days 01:33:00.000000000,-3
63,83,,Accident Man,100,6,2018.0,Action/Mystery and thriller,0 days 01:52:00.000000000,20
12,0,,Deep Blue Sea 2,250,5,2018.0,,,-12
53,47,https://resizing.flixster.com/bXh4aZF_ArQZw8pV4Og4yajxiME=/206x305/v2/https://resizing.flixster.com/TLBbeSMOIRJL0svacM5xZUF4jy0=/ems.ZW1zLXByZC1hc3NldHMvbW92aWVzLzAxZGFkNDQzLWMzYjUtNDdjZC05OTU3LTU3N2U5NzMzNjhlMC53ZWJw,Curvature,100,17,2017.0,Sci fi/Mystery and thriller,0 days 01:30:00.000000000,-6
49,10,https://resizing.flixster.com/PEvGANwDs9_Q3RgsRuUOm8CnCOI=/206x305/v2/https://resizing.flixster.com/J4Uuc08UMgIBzGmgJHHgxv0hF5k=/ems.ZW1zLXByZC1hc3NldHMvbW92aWVzLzdmYjFiOTIxLWM0MzAtNDc0ZS05NTVlLWZjNGMxNDlkNjMzNC53ZWJw,Basmati Blues,250,29,2017.0,Romance/Comedy,0 days 01:46:00.000000000,-39
83,75,https://resizing.flixster.com/V7gBNkzS-V60BbZmJ2vXYxmmM1g=/206x305/v2/https://resizing.flixster.com/ryfINcJ-ZCQaN-K6DlwPFt1d0-c=/ems.ZW1zLXByZC1hc3NldHMvbW92aWVzLzJjMDJlMTdkLTBhMzAtNDM0ZS05YTkzLWRiNGQ5ZDVmMjMyOS53ZWJw,Bomb City,500,12,2017.0,Crime/Drama,0 days 01:35:00.000000000,-8
96,100,https://resizing.flixster.com/0g7dgp1SXfXJZjqtJfpqgFGKQMU=/206x305/v2/https://resizing.flixster.com/deW7jF-PNqLt-5JpcYYqkb3oaEQ=/ems.ZW1zLXByZC1hc3NldHMvbW92aWVzL2Y0MzVkMWVmLThmYWQtNDJlMi05ZTdhLWQzMDlkOTg1OGFhMC53ZWJw,King in the Wilderness,50,11,2018.0,Documentary,0 days 01:51:00.000000000,4
61,93,,Pass Over,1,14,2018.0,Comedy/Drama,0 days 01:14:00.000000000,32
60,68,https://resizing.flixster.com/n-TuueBhTdaBTiBHeO_5327Hc0A=/206x305/v2/https://resizing.flixster.com/-PCkFEWuzho2eDDD7h65P6Ltk-o=/ems.ZW1zLXByZC1hc3NldHMvbW92aWVzLzVlMTk4Njc5LWEyMmYtNDUwYS05MTJmLTNlM2FhOTI5NTk1Mi53ZWJw,Come Sunday,100,34,2018.0,Drama/Biography,0 days 01:46:00.000000000,8
8,14,https://resizing.flixster.com/xfGXO3b-wuMDeZAA6a8F7qVAz3s=/206x305/v2/https://resizing.flixster.com/M5_lJ1eN7a9B922zxsNXh_7FfNs=/ems.ZW1zLXByZC1hc3NldHMvbW92aWVzL2E5OTNkM2U0LTg0YWUtNGQ1Yi1hNTFmLWEwNzgyYjIwYWQ0Yi53ZWJw,The Open House,1000,14,2018.0,Mystery and thriller,0 days 01:34:00.000000000,6
9,21,,Looking Glass,100,24,2018.0,Mystery and thriller,0 days 01:44:00.000000000,12
70,100,https://resizing.flixster.com/jyqwbw5IwQkDQDCTIr_1Hluyu4A=/206x305/v2/https://resizing.flixster.com/BsFns3DNYczXswuAVA5zz9VRr7o=/ems.ZW1zLXByZC1hc3NldHMvbW92aWVzLzVkZTlmODA2LTdhODgtNGIwMC04OTYxLTU2MTU5NTY5YzY4MS53ZWJw,Survivors Guide to Prison,100,14,2018.0,Documentary,0 days 01:42:00.000000000,30
9,25,,Beast of Burden,100,8,2018.0,Action/Mystery and thriller,0 days 01:29:00.000000000,16
26,40,https://resizing.flixster.com/5gYCgMCVD1MdgEmSDJKbEv-hHZc=/206x305/v2/https://flxt.tmsimg.com/assets/p15039555_p_v10_aa.jpg,Hellraiser: Judgment,250,10,2018.0,Horror,0 days 01:21:00.000000000,14
64,29,,Elis,1,7,2016.0,Drama/Music,0 days 01:50:00.000000000,-35
43,78,,The Revival,50,9,2017.0,Gay and lesbian/Drama,0 days 01:25:00.000000000,35
100,100,https://resizing.flixster.com/2Fh-GmAIsBak-dnBvdV4W4Y7xmQ=/206x305/v2/https://resizing.flixster.com/rXWf2ShH8QlH8Hi4y2CyVFIm9WQ=/ems.ZW1zLXByZC1hc3NldHMvbW92aWVzL2VmNmU4OTVkLTUzMDMtNDEwMS1hMmViLTBlNDQyMWYzZDk0NC53ZWJw,Where's Daddy?,1,6,2018.0,,,0
31,13,https://resizing.flixster.com/5qGmsNy5HRdLdVUnKiUdvUy2nNs=/206x305/v2/https://resizing.flixster.com/VgJCdgSttlinjqu6vVIK9iIPM_4=/ems.ZW1zLXByZC1hc3NldHMvbW92aWVzL2E3NGVhNTg0LTAwNjctNDY2MC1hZWUzLWNhNTdhMDI2NzcwZS53ZWJw,Woody Woodpecker,100,8,2017.0,Comedy/Kids and family,0 days 01:34:00.000000000,-18
79,100,https://resizing.flixster.com/A8IHthb_48TVQGXJ2pJc5KmoEuU=/206x305/v2/https://resizing.flixster.com/oI0UCxiDENTX43llqqvtop5VdHU=/ems.ZW1zLXByZC1hc3NldHMvbW92aWVzLzg1MDM1Zjc4LWY0Y2QtNGY0NS05NTUyLTViYzAwMzg5NzY4MC53ZWJw,Tom Segura: Disgraceful,50,5,2018.0,,,21
62,80,,Katt Williams: Great America,1,5,2018.0,,,18
53,100,https://resizing.flixster.com/GYha1awxb0y_2hzgp2-YSPZGllQ=/206x305/v2/https://resizing.flixster.com/iSz8O0HnUO8Bny0R8B9d3FOkre8=/ems.ZW1zLXByZC1hc3NldHMvbW92aWVzLzZiN2Y3YzM1LTU5ZWItNGM0Ni1iNmM4LTMyYzk1MGRiNzRlNC53ZWJw,Todd Glass: Act Happy,1,7,2018.0,,,47
74,77,https://resizing.flixster.com/ALFtJMOmqfwjnxLh0ulTwmDpkMw=/206x305/v2/https://resizing.flixster.com/vLtjOd2ajfDvkOUAqWf2rK6S0pQ=/ems.ZW1zLXByZC1hc3NldHMvbW92aWVzL2I1ZjQxZTA0LWJlMDUtNDljMC1hZWE4LWMzMWVlZDMxZDhiOC53ZWJw,Braven,1000,31,2018.0,Action/Mystery and thriller,0 days 01:34:00.000000000,3
33,13,,Huntsville,100,8,2017.0,Drama/Mystery and thriller,0 days 01:27:00.000000000,-20
71,14,,Living Among Us,100,7,2018.0,Horror,0 days 01:21:00.000000000,-57
37,0,https://resizing.flixster.com/uztMr_I6k0rO_cTB28qgmVRkDUA=/206x305/v2/https://resizing.flixster.com/otcyQNqCnUGdQ71Tkw4zyyoyHV8=/ems.ZW1zLXByZC1hc3NldHMvbW92aWVzL2FkMTNhMzM0LTNkZTMtNGFkYi1iOWRjLTg3ZGU4NjNlNzVjOS53ZWJw,Delirium,50,5,2018.0,Horror/Mystery and thriller,0 days 01:28:00.000000000,-37
99,100,https://resizing.flixster.com/GFWkmGSGbGpnWQ-FU7BCvuWbyqs=/206x305/v2/https://resizing.flixster.com/1MUy5i8T_4puVw2fzKNicoLaSBc=/ems.ZW1zLXByZC1hc3NldHMvbW92aWVzLzM0MGRkZTgwLTQ0NjAtNGI0Zi05Y2VmLWY1YmQxYWE3ZmJhYS53ZWJw,Maktub,250,5,2017.0,Comedy/Drama,0 days 01:40:00.000000000,1
48,33,,The Monkey King 3,100,6,2018.0,Romance/Action,0 days 01:56:00.000000000,-15
80,0,,The Music of Silence,100,17,2017.0,Drama/Music,0 days 02:10:00.000000000,-80
22,25,,The Humanity Bureau,100,8,2017.0,Action/Sci fi,0 days 01:35:00.000000000,3
74,80,https://resizing.flixster.com/VbPltsB4Y2yR5D45hxOIiWd4bcs=/206x305/v2/https://resizing.flixster.com/AP0UOZ9dGY6spPuAIjQeM9kGtbw=/ems.ZW1zLXByZC1hc3NldHMvbW92aWVzLzhmZTllMjZhLWZlOGEtNDQ3NC04ODNhLTliZmUzMjkxNThlOC53ZWJw,White Fang,100,10,2018.0,Adventure/Animation,0 days 01:25:00.000000000,6
45,18,https://resizing.flixster.com/3otQ7p_3_LC3B1rLK966tl6mA1E=/206x305/v2/https://resizing.flixster.com/q-gaNFPJI6G8DZFd0gfX5Ambflg=/ems.ZW1zLXByZC1hc3NldHMvbW92aWVzLzk1ZmU1NmMwLTVlMzItNDRlOS1hOWY4LWE1YjA1MzkzYmMyOC53ZWJw,A Little Something for Your Birthday,50,22,2017.0,Romance,0 days 01:34:00.000000000,-27
67,89,https://resizing.flixster.com/EikWwwXAkq8-dbBPXbVyFc2Z_cE=/206x305/v2/https://resizing.flixster.com/nWfeaHUTlzaoyPm_C9-z5xQ15xU=/ems.ZW1zLXByZC1hc3NldHMvbW92aWVzL2RmZWQ4NjQwLTNhM2QtNDBjZi1hNzE3LThkZWE5Y2U0NDEwYy53ZWJw,Sunday's Illness,100,19,2018.0,Drama,0 days 01:53:00.000000000,22
31,67,https://resizing.flixster.com/hxQE3-QiWrdxXcCIfpgxHFIuxqU=/206x305/v2/https://resizing.flixster.com/hgtJuA0S-GE8WhxQsJ7PFxxSfNs=/ems.ZW1zLXByZC1hc3NldHMvbW92aWVzLzkwMTk3NGNiLTgyYjktNDM1ZS1hNjhkLTczOTBiYjE4YjBlNi53ZWJw,Fred Armisen: Standup For Drummers,50,6,2018.0,,,36
76,95,https://resizing.flixster.com/RDsSDENSJEaT1ARqbziUGK3B-zE=/206x305/v2/https://resizing.flixster.com/8f9Qlg3h-oBO8ptppLEobiDMlA8=/ems.ZW1zLXByZC1hc3NldHMvbW92aWVzLzUyNmJkYTRhLTljNTQtNDJlMy04OWYwLTIzMTcyNjk4NmMwZC53ZWJw,Outside In,250,41,2017.0,Drama,0 days 01:49:00.000000000,19
73,67,,The Lullaby,100,12,2017.0,Horror,0 days 02:05:00.000000000,-6
33,22,https://resizing.flixster.com/1w2vXC0vBYBiaslpjHZiTOwxgCk=/206x305/v2/https://resizing.flixster.com/nCDTzxkfo15gzaTuG8tInJmrI1A=/ems.ZW1zLXByZC1hc3NldHMvbW92aWVzL2VkMGVmMmNkLTIzYmYtNDU4MC04OTY0LTE0ODZjYzk3Nzc1MC53ZWJw,Submergence,250,54,2017.0,Romance/Drama,0 days 01:52:00.000000000,-11
81,85,https://resizing.flixster.com/PbrMFjT2r-vr_wUOySA1zNIV2xY=/206x305/v2/https://resizing.flixster.com/Nq7XCwxABToNqKNJW3ID9Z0SEjM=/ems.ZW1zLXByZC1hc3NldHMvbW92aWVzL2E4ZDdiYjUwLTRmM2YtNDc2My05ZThkLWMyODY3MWViY2Q5Ni53ZWJw,First Match,100,20,2018.0,Drama,0 days 01:42:00.000000000,4
59,32,,Irreplaceable You,100,19,2018.0,Romance/Comedy,0 days 01:36:00.000000000,-27
71,60,,Benji,100,10,2018.0,Drama,0 days 01:27:00.000000000,-11
91,71,https://resizing.flixster.com/DIsZK1ZYkarmMdWJbbB4sISDuOA=/206x305/v2/https://resizing.flixster.com/1lLst2yliQXzvPR9lbOENd0qTKg=/ems.ZW1zLXByZC1hc3NldHMvbW92aWVzLzNlMGVjYmM5LWU5OTEtNGFlZS1iZjQwLWFiNmJmMGY2NzBiZC53ZWJw,Counterfeiters,1,7,2017.0,Drama,0 days 01:13:00.000000000,-20
36,42,,Spinning Man,250,12,2018.0,Mystery and thriller,0 days 01:40:00.000000000,6
27,100,,Traffic Stop,50,8,2017.0,Documentary,0 days 00:30:00.000000000,73
62,50,https://resizing.flixster.com/WTcgGWOR89T3UbUQ0XxYt8jVbsM=/206x305/v2/https://resizing.flixster.com/WWcFHrfAvZXCjMUj9ywH0pK4ZFw=/ems.ZW1zLXByZC1hc3NldHMvbW92aWVzL2RkN2FjNWVhLTdkOGMtNGMzMy1hMGY5LTYxNDI2MmQxYmFhMy53ZWJw,Demon House,250,12,2018.0,Documentary/Horror,0 days 01:51:00.000000000,-12
20,7,https://resizing.flixster.com/vIf90F0zecpwCDCRcTfIHpsV8yk=/206x305/v2/https://resizing.flixster.com/ojETzCfijsf_t24a1WVecR3Vw78=/ems.ZW1zLXByZC1hc3NldHMvbW92aWVzLzljYWNmY2E3LWI0NGUtNDI1Ny04ODM5LTcyNTNmNDg1YjExZi53ZWJw,7 Guardians of the Tomb,100,15,2018.0,Action/Fantasy,0 days 01:30:00.000000000,-13
29,40,https://resizing.flixster.com/T9EN9yCyiyd4i1246ZNkPn9Zc3g=/206x305/v2/https://flxt.tmsimg.com/assets/p15299576_p_v10_aa.jpg,Tremors: A Cold Day in Hell,100,5,2018.0,Sci fi/Horror,0 days 01:38:00.000000000,11
38,100,https://resizing.flixster.com/4EPYODf0HFqUXUtRviM-iOAl0Vg=/206x305/v2/https://resizing.flixster.com/-wj1szOMuxVnw5e_z1hMtFPQcg4=/ems.ZW1zLXByZC1hc3NldHMvbW92aWVzL2Q0N2Y2OTgxLWNmMmItNGIxNi05NWY4LTg4ZmU5NTc3Y2FkYS53ZWJw,Chris Rock: Tamborine,250,23,2018.0,Comedy/Stand up,0 days 01:04:00.000000000,62
21,67,,10x10,100,9,2018.0,Mystery and thriller,0 days 01:28:00.000000000,46
60,57,https://resizing.flixster.com/DVTCwBOeHJ3nrN-8RE4VlKXDxEY=/206x305/v2/https://resizing.flixster.com/5yHdcPona8q6yTuXp_opfG4CO6Q=/ems.ZW1zLXByZC1hc3NldHMvbW92aWVzL2Q3ZjA4NWI0LTViZGQtNGQ1Yi1hZjUzLWU2ZDYxZTc0YWNiNC53ZWJw,Juggernaut,1,7,2017.0,Crime/Drama,0 days 01:45:00.000000000,-3
30,23,https://resizing.flixster.com/8OHECqJh87-Rm0ZkLDm5zLcq2XI=/206x305/v2/https://resizing.flixster.com/EAzmg53l4UFXiLU9GMQw0Wz-4hQ=/ems.ZW1zLXByZC1hc3NldHMvbW92aWVzL2Y5MGFlOTQ4LTkwYmEtNGEwMi04NWQ2LTg3MDcxMGUxOWIwNS53ZWJw,Supercon,1,13,2018.0,Comedy/Action,0 days 01:40:00.000000000,-7
57,20,https://resizing.flixster.com/Sjbr2Dtb1lr2H8jAeh5qJ5cL9Vs=/206x305/v2/https://resizing.flixster.com/dIv37wWHMaujiUFmYBaQDg5zkEU=/ems.ZW1zLXByZC1hc3NldHMvbW92aWVzLzJlMWMxOWJjLTgyN2UtNDAyOS1iZTkxLThhYzlkNjU4ZTVkMS53ZWJw,The Escape of Prisoner 614,50,10,2018.0,Western/Comedy,0 days 01:35:00.000000000,-37
35,47,https://resizing.flixster.com/jMAzqAYz_TYFBI2idXtHCzDNuP0=/206x305/v2/https://resizing.flixster.com/L0UORlm3beuur3rtV8wpomghkSo=/ems.ZW1zLXByZC1hc3NldHMvbW92aWVzLzgwNjc0ODllLThlYzgtNGZkNy04NWExLTE5OTg4NTA3MDdjNS53ZWJw,In Darkness,250,32,2018.0,Mystery and thriller,0 days 01:50:00.000000000,12
67,17,https://resizing.flixster.com/oHd0FnOkgYcRCLpxp-rDzL4bkxU=/206x305/v2/https://resizing.flixster.com/kZLISBpvPpv-zWkE3gyD3IJLJkI=/ems.ZW1zLXByZC1hc3NldHMvbW92aWVzLzBmNjk2NzdiLWM5OWUtNDVkYS1hYTg1LWEyMGRiNWYzNzA4MS53ZWJw,The Outsider,500,24,2018.0,Crime/Drama,0 days 02:00:00.000000000,-50
67,86,https://resizing.flixster.com/mzavM0x4PdzCfw3oknZ51zob7Bw=/206x305/v2/https://resizing.flixster.com/ARvK6SrkAMbOCqUHEgrs4xuivSE=/ems.ZW1zLXByZC1hc3NldHMvbW92aWVzLzA4NzliMTg2LTA4ZDMtNGU2OC1iMWFkLTZkNjcyOTVmZmY0Ni53ZWJw,Class Rank,100,14,2017.0,Comedy,0 days 01:48:00.000000000,19
72,88,https://resizing.flixster.com/kEl8_-kYnovue6cX1boCrECDJHo=/206x305/v2/https://flxt.tmsimg.com/assets/p15101072_p_v10_aa.jpg,Suicide Squad: Hell to Pay,250,8,2018.0,Animation/Action,0 days 01:31:00.000000000,16
50,62,https://resizing.flixster.com/sgzC_1kFVZMuguZ4b_EIfKlnCW0=/206x305/v2/https://resizing.flixster.com/h1PzMpYtNoioSjLFPP7qdwCSuwo=/ems.ZW1zLXByZC1hc3NldHMvbW92aWVzLzdhN2E5Mjg4LTdjZGQtNGM2ZC05NThkLWVjNDZlZGIxNmQzOC53ZWJw,Take Your Pills,100,13,2018.0,Documentary,0 days 01:27:00.000000000,12
42,30,https://resizing.flixster.com/u3qCHEszFiGxs93dDOZ_ke1mzZI=/206x305/v2/https://resizing.flixster.com/JP7W4XFfpBapr6lzUMtoHP32D_w=/ems.ZW1zLXByZC1hc3NldHMvbW92aWVzL2YwODE4ODVmLTA1OTktNDExOS04NDY5LTMwNWI2MTVhZTk2MS53ZWJw,The Legacy of a Whitetail Deer Hunter,100,23,2018.0,Comedy/Drama,0 days 01:23:00.000000000,-12
58,72,,The Rachel Divide,50,25,2018.0,Documentary,0 days 01:30:00.000000000,14
38,29,,Paradox,1,7,2018.0,Western/Drama,0 days 01:13:00.000000000,-9
55,86,,6 Balloons,250,29,2018.0,Drama,0 days 01:15:00.000000000,31
72,73,https://resizing.flixster.com/vDvPYg82Q7XEz5-PIIfOCy1-4I4=/206x305/v2/https://resizing.flixster.com/y7j5J8QzXCatWu-jeIXzw-R7crU=/ems.ZW1zLXByZC1hc3NldHMvbW92aWVzLzgxNTQwNDRmLTQ3OTItNGQxYS1iMmYzLWZkYmI1Y2UzODc5ZC53ZWJw,Prodigy,250,22,2017.0,Sci fi/Mystery and thriller,0 days 01:20:00.000000000,1
40,100,,Steven Tyler: Out on a Limb,1,5,2018.0,Documentary/Music,0 days 01:33:00.000000000,60
37,21,https://resizing.flixster.com/SkRZmDam26r_v-vULjfTZFciMlw=/206x305/v2/https://resizing.flixster.com/6UybkypGwuzxA-SunPhcvlcrDCY=/ems.ZW1zLXByZC1hc3NldHMvbW92aWVzLzM2NDE0YWYxLThiODYtNDgxZi1hODJmLWIyMjg5OTg4M2FiMS53ZWJw,Terminal,500,67,2018.0,Crime/Drama,0 days 01:36:00.000000000,-16
70,80,https://resizing.flixster.com/6vE2kZscf61eSmWiF1ZwKh4lf-I=/206x305/v2/https://resizing.flixster.com/75C0h_xGd3R-4oFHnLRzKRp_x7s=/ems.ZW1zLXByZC1hc3NldHMvbW92aWVzLzNmNWQ2Y2Y1LWE0NTktNDc0Ny05NmM3LTI2YzNlZjMwZTZjMy53ZWJw,Alex Strangelove,500,25,2018.0,Comedy/Gay and lesbian,0 days 01:39:00.000000000,10
78,100,,Mercury 13,100,24,2018.0,Documentary,0 days 01:19:00.000000000,22
33,13,https://resizing.flixster.com/55k0t1sQV9xdkeoao8xtmrmJXYU=/206x305/v2/https://resizing.flixster.com/WCovESXIONuGvRXN4Dbf34JrBrw=/ems.ZW1zLXByZC1hc3NldHMvbW92aWVzLzZmN2VjMWY3LWMxNTEtNDNjZi1iYTM0LWM2OGYwODQyYjVlZS53ZWJw,Carter & June,100,8,2017.0,Action/Comedy,0 days 01:27:00.000000000,-20
50,83,https://resizing.flixster.com/qnJE5SkakEEzi__i0fKXECp0Cas=/206x305/v2/https://resizing.flixster.com/rTAfRR3JT4VoKeBSjiZ6TSqV4_8=/ems.ZW1zLXByZC1hc3NldHMvbW92aWVzL2VjNTIwY2MzLTBhOWUtNDMyYi04ZjAzLWFkYmU0MzlkYmQ1MC53ZWJw,Happy Anniversary,100,6,2018.0,Comedy,0 days 01:18:00.000000000,33
69,60,,Amateur,100,5,2018.0,Drama,0 days 01:36:00.000000000,-9
13,8,https://resizing.flixster.com/LH0IUiZHZqvOveB6mjDjDqRwsQw=/206x305/v2/https://resizing.flixster.com/ebvnz1ddlfk8MnZjIl20woFBYYk=/ems.ZW1zLXByZC1hc3NldHMvbW92aWVzLzczODNlMTZlLTE3OTktNDg4Ni1iNmQxLThmMWJjMzZhOGQxYS53ZWJw,Escape Plan 2: Hades,500,26,2018.0,Action/Mystery and thriller,0 days 01:34:00.000000000,-5
57,80,,Coming to My Senses,1,5,2017.0,Documentary/Adventure,0 days 01:25:00.000000000,23
42,57,https://resizing.flixster.com/ZrtnydHRObX4SR8tzGKIrbX3BsE=/206x305/v2/https://resizing.flixster.com/KiQyD0zybhwXo5ggftQZWo4Ue3c=/ems.ZW1zLXByZC1hc3NldHMvbW92aWVzLzkwMjU5ZjVkLWU4YTgtNGU4NC1iNzU2LTJjMzg2N2VkYWI0MS53ZWJw,Duck Butter,100,37,2018.0,Comedy/Drama,0 days 01:33:00.000000000,15
20,60,https://resizing.flixster.com/SzBifiLK8uJLCyv52FdW0Hha1G0=/206x305/v2/https://flxt.tmsimg.com/assets/p14276516_p_v10_aa.jpg,20 Weeks,1,5,2017.0,Romance/Drama,0 days 01:29:00.000000000,40
35,50,,4/20 Massacre,1,8,2018.0,Action/Horror,0 days 01:24:00.000000000,15
72,80,,I Am Not an Easy Man,100,5,2018.0,Comedy,0 days 01:38:00.000000000,8
20,35,https://resizing.flixster.com/hjZ2TuwNcdzgTpGXqY5Radk8uX4=/206x305/v2/https://resizing.flixster.com/b9Ed-rDhgwJev8oG_Tk22X-RkoI=/ems.ZW1zLXByZC1hc3NldHMvbW92aWVzLzAxNWYzZjFiLWEyOGYtNDliNy1hYTBiLWZkN2RiYjMwZTgwOC53ZWJw,Feral,100,17,2017.0,Horror/Mystery and thriller,0 days 01:32:00.000000000,15
94,71,,Do You Trust This Computer?,1,14,2018.0,Documentary,0 days 01:30:00.000000000,-23
65,29,https://resizing.flixster.com/D_P_X3C84glViYWvXE6b87RC_No=/206x305/v2/https://resizing.flixster.com/vYIYygO61NrBWefBShISLq0RYzA=/ems.ZW1zLXByZC1hc3NldHMvbW92aWVzL2RkYzJkYmI4LTk1ZGItNDhhMC05MTY2LTdjMTM1YWEzN2M0YS53ZWJw,The Last Witness,50,7,2018.0,Drama/Mystery and thriller,0 days 01:33:00.000000000,-36
82,100,https://resizing.flixster.com/UQFx5E7r9ITgDUqaQJX73eMqG0k=/206x305/v2/https://resizing.flixster.com/whsqMoR6FsEk-9jFul8FvuNC_AI=/ems.ZW1zLXByZC1hc3NldHMvbW92aWVzLzIxZDc5OTk3LWNiNzQtNDhmYy05MjU0LTU2MWNlZDcxNmM0YS53ZWJw,End Game,50,7,2018.0,Documentary,0 days 00:40:00.000000000,18
62,88,https://resizing.flixster.com/OAX9UgBUaXWksQerSfMe38zzLI4=/206x305/v2/https://resizing.flixster.com/gBXFwoA0JZn1fmx-yKiX8lXVFbA=/ems.ZW1zLXByZC1hc3NldHMvbW92aWVzL2I4ZDUyZjAyLWVmMDMtNDZhOC1iN2EzLTBjYzQ0ZjBkMjRmOC53ZWJw,Zoo,100,17,2017.0,War/Drama,0 days 01:37:00.000000000,26
65,71,,Candy Jar,100,7,2018.0,Comedy,0 days 01:32:00.000000000,6
33,20,https://resizing.flixster.com/y4LBFEz8lIs0tdKck_F7CJ3g3Is=/206x305/v2/https://resizing.flixster.com/NZqniyaPq5Cx1gATpcsT1o0jS2M=/ems.ZW1zLXByZC1hc3NldHMvbW92aWVzL2E5NmUxOTFhLTZkZWMtNGYzNC1hNGMyLTVkZWYxZmRiMmE5OS53ZWJw,Hover,1,5,2018.0,Sci fi,0 days 01:50:00.000000000,-13
44,83,,The Debt Collector,100,6,2018.0,Action/Sports and fitness,0 days 01:36:00.000000000,39
58,80,,Psychokinesis,250,10,2018.0,Action/Adventure,0 days 01:41:00.000000000,22
39,67,https://resizing.flixster.com/2KGpJajQ4XCtS-1I6-IATHzfFuo=/206x305/v2/https://resizing.flixster.com/Z_I5DIKijgDAwSJ9CTqOi6F9Ah8=/ems.ZW1zLXByZC1hc3NldHMvbW92aWVzL2VmNGYyODA1LTBhYTYtNGY1MC1hM2U0LTZjYTg3MTkwODI0MC53ZWJw,Ibiza,500,24,2018.0,Romance/Adventure,0 days 01:34:00.000000000,28
91,100,,Us and Them,100,6,2018.0,Drama,0 days 02:00:00.000000000,9
56,15,https://resizing.flixster.com/YRXQjPkuWrtBs6756L6QHF9yy5Y=/206x305/v2/https://resizing.flixster.com/QxgpoMqB6oihhVrlWxSXZro3P4Q=/ems.ZW1zLXByZC1hc3NldHMvbW92aWVzLzg2ZDk2Yjk1LWQ0MWQtNGUzMi1iYmQzLTA1MWIwNzgwZDZhZi53ZWJw,The Kissing Booth,2500,13,2018.0,Romance,0 days 01:45:00.000000000,-41
90,100,https://resizing.flixster.com/hlts-SydxTwfzokpPfslciOthWg=/206x305/v2/https://resizing.flixster.com/LYnkrVmXZyxS5JMf8ooSlIZ-CJw=/ems.ZW1zLXByZC1hc3NldHMvbW92aWVzLzU4ZmMyZTNiLTE5YmUtNDQwZi04YTZiLWNjOTc5MTk1OWZmZC53ZWJw,John Mulaney: Kid Gorgeous at Radio City,100,20,2018.0,Comedy/Stand up,0 days 01:04:00.000000000,10
48,100,,Hari Kondabolu: Warn Your Relatives,1,7,2018.0,,,52
69,100,,Ali Wong: Hard Knock Wife,100,21,2018.0,,,31
39,71,https://resizing.flixster.com/8bZBjT-3I1t28tjy03JgONuxvuc=/206x305/v2/https://flxt.tmsimg.com/assets/p15125114_p_v13_ba.jpg,The Jurassic Games,100,7,2018.0,Sci fi/Mystery and thriller,0 days 01:26:00.000000000,32
67,92,,Set It Up,1000,60,2018.0,Romance,0 days 01:45:00.000000000,25
71,100,https://resizing.flixster.com/wv9FmLvx8aROjAmmFDBQYI6S8Uk=/206x305/v2/https://resizing.flixster.com/O381vhoFK4ZPFBVfSH_taGqt3z4=/ems.ZW1zLXByZC1hc3NldHMvbW92aWVzL2Y3NjdhZTgzLWYyMTItNDVkMi04MDE3LTAyZGZkYjAyMTZiYi53ZWJw,Steve Martin and Martin Short: An Evening You Will Forget for the Rest of Your Life,100,10,2018.0,,,29
38,20,https://resizing.flixster.com/v6QZOcemeRP6Kqb2GItjypqOea8=/206x305/v2/https://resizing.flixster.com/5KirdEQEfwNL2z9zCImyQVFdqSQ=/ems.ZW1zLXByZC1hc3NldHMvbW92aWVzLzg3NGIxOTU4LWU4YjYtNDdmOS1hMDA3LWM3ODQ3NTU1ZDI3NS53ZWJw,Hooked,1,5,2017.0,Drama,0 days 01:31:00.000000000,-18
63,100,https://resizing.flixster.com/VxcHiTTP9lVDXx3Rf8geL_GG4fI=/206x305/v2/https://resizing.flixster.com/HAT3MmZxi3yRlwAi_aa0UoNq8Ks=/ems.ZW1zLXByZC1hc3NldHMvbW92aWVzLzAzNWIzNzViLWI1YmItNDc2Zi1hMTYzLTE0OGY4YmQzMzlmOC53ZWJw,Lust Stories,250,10,2018.0,Drama,0 days 02:00:00.000000000,37
80,100,,Recovery Boys,100,11,2018.0,Documentary,0 days 01:29:00.000000000,20
26,100,https://resizing.flixster.com/gON51DT-ezBWx49J9EwXDZcHKEQ=/206x305/v2/https://resizing.flixster.com/883QC98MYgv5Xg7Gd2KVrm9Fi4Y=/ems.ZW1zLXByZC1hc3NldHMvbW92aWVzLzk1MDA0YjIxLWFlNjktNGI4ZC1iMmY2LWI3NTU3NzJiNGExZi53ZWJw,Hannah Gadsby: Nanette,1000,49,2018.0,Comedy/Stand up,0 days 01:09:00.000000000,74
25,20,https://resizing.flixster.com/Js6_7V1AKz2un3GdDhY7ReGCRaQ=/206x305/v2/https://resizing.flixster.com/8xnWdQVrjnHedtJv0kw5jFcrwd8=/ems.ZW1zLXByZC1hc3NldHMvbW92aWVzL2RhZjUyZDYyLTlhZWUtNDE1Zi05ZDgzLTNiMDA3N2FiYWYyMC53ZWJw,"To Each, Her Own",1,5,2018.0,Romance/Gay and lesbian,0 days 01:35:00.000000000,-5
75,95,,Calibre,500,20,2018.0,Mystery and thriller,0 days 01:41:00.000000000,20
29,82,https://resizing.flixster.com/35fZPfUNy8XXZdcoyFseujeiRH4=/206x305/v2/https://resizing.flixster.com/PvaKKP8TGg-8SIuQouLbM40u9C0=/ems.ZW1zLXByZC1hc3NldHMvbW92aWVzLzgwNmQzMDhkLTYyOWItNDEyMy05NmZmLTkyZWI4NzhjOTFkYS53ZWJw,W. Kamau Bell: Private School Negro,1,11,2018.0,,,53
38,57,https://resizing.flixster.com/YFFIvMi0TKcXiYNsTUD5H3Yis10=/206x305/v2/https://flxt.tmsimg.com/assets/p37759_p_v10_ac.jpg,Willard,2500,23,1971.0,Horror,0 days 01:35:00.000000000,19
55,57,,Tough Guys,2500,14,1986.0,Comedy,0 days 01:43:00.000000000,2
67,74,https://resizing.flixster.com/xKbcEqzd0OyE8puv1laOIxHKNjo=/206x305/v2/https://resizing.flixster.com/7bfvKLE-SSKcLUDhNvFulAnSsX4=/ems.ZW1zLXByZC1hc3NldHMvbW92aWVzLzg2ZDRlMTU5LWYwN2ItNGU3Mi04YTMxLWJlYmI1ODNhZDY5MC53ZWJw,Phantasm,10000,46,1979.0,Horror,0 days 01:27:00.000000000,7
50,68,,What Alice Found,500,38,2003.0,Drama,0 days 01:36:00.000000000,18
65,93,,Daughters of the Dust,1000,76,1991.0,Drama,0 days 01:54:00.000000000,28
92,86,https://resizing.flixster.com/uIRifttB-4KvZL75hpxedsMIGCU=/206x305/v2/https://flxt.tmsimg.com/assets/p71028_p_v10_aa.jpg,Hombre mirando al sudeste,1000,7,1986.0,Drama,0 days 01:44:00.000000000,-6
85,100,,Only Yesterday,100,56,1991.0,Drama/Anime,0 days 01:58:00.000000000,15
73,91,,Cat People,5000,66,1942.0,Horror,0 days 01:13:00.000000000,18
92,94,/assets/pizza-pie/images/poster_default.c8c896e70c3.gif,The Story of the Last Chrysanthemums,500,16,1939.0,Drama,0 days 02:28:00.000000000,2
36,31,https://resizing.flixster.com/9gJJfWWxeruQDnlbrHs0ScX30y4=/206x305/v2/https://resizing.flixster.com/_zCo_nRAL7H726Cid0oKTNWzoO4=/ems.ZW1zLXByZC1hc3NldHMvbW92aWVzL2EyZjc5YzY1LTY3YTAtNGI0MC04ZTFlLWFhMWE3ZjBkNTkzNi53ZWJw,Dad's Army,2500,35,2016.0,Comedy,0 days 01:40:00.000000000,-5
80,40,https://resizing.flixster.com/ZQmvphjXyyxg0QIpMj95vL8PHrc=/206x305/v2/https://flxt.tmsimg.com/assets/p8016980_p_v10_aa.jpg,The Trouble With Terkel,5000,5,2010.0,Comedy/Animation,0 days 01:28:00.000000000,-40
85,98,https://resizing.flixster.com/LYabn4veNdDL6rPAQyleQLn4CJY=/206x305/v2/https://flxt.tmsimg.com/assets/p8049_p_v8_ac.jpg,Chimes at Midnight,1000,50,1965.0,Drama/History,0 days 01:55:00.000000000,13
74,69,https://resizing.flixster.com/q0b0SN6VzAavJyEdNX3Do6raztU=/206x305/v2/https://flxt.tmsimg.com/assets/p37338_p_v8_aa.jpg,The Savage Innocents,500,13,1959.0,Adventure,0 days 01:50:00.000000000,-5
43,50,/assets/pizza-pie/images/poster_default.c8c896e70c3.gif,Something Wild,250,8,1961.0,Drama,0 days 01:52:00.000000000,7
73,100,,Multiple Maniacs,1000,21,1970.0,Comedy/Drama,0 days 01:30:00.000000000,27
69,46,,Luna,500,13,1979.0,Drama,0 days 02:24:00.000000000,-23
38,67,,Ben,500,9,1972.0,Mystery and thriller,0 days 01:33:00.000000000,29
65,88,https://resizing.flixster.com/Fgl7LmQIszBhR1uZE27b--zR3PQ=/206x305/v2/https://resizing.flixster.com/LIA7FG0Rq6pTbSeEqFLWAdJV9oA=/ems.ZW1zLXByZC1hc3NldHMvbW92aWVzLzA4MTBiMTU0LWU2MGEtNGJhNi1iZmZhLTIzNzQ5NGQ3MjFkZi53ZWJw,Ocean Waves,1000,17,1993.0,Anime/Adventure,0 days 01:12:00.000000000,23
46,33,,Little Fauss and Big Halsy,250,6,1970.0,Drama,0 days 01:39:00.000000000,-13
42,83,,The Battle of the Sexes,100,6,1959.0,Comedy,0 days 01:28:00.000000000,41
38,50,https://resizing.flixster.com/tDvHlTw-uuL3Lm0RKehUtKHClqo=/206x305/v2/https://flxt.tmsimg.com/assets/p167153_p_v8_aa.jpg,Burning Annie,50,8,2004.0,Comedy/Drama,0 days 01:35:00.000000000,12
23,8,https://resizing.flixster.com/1A6QOFjziDoH2TKS3CUznZDm4C8=/206x305/v2/https://resizing.flixster.com/LzHZJxEZrJA3cItA0KZOkbGWwi8=/ems.ZW1zLXByZC1hc3NldHMvbW92aWVzLzFmOWRlN2NmLTk1NmQtNDRjOS1iNTBhLTE2NTMyMTk1MzdkMC53ZWJw,Rings,10000,114,2017.0,Horror/Mystery and thriller,0 days 01:37:00.000000000,-15
9,22,,"Tell Me That You Love Me, Junie Moon",100,9,1970.0,Comedy/Drama,0 days 01:52:00.000000000,13
56,29,https://resizing.flixster.com/fjhUMqJX4ahgznRWwl4yN1XSf8k=/206x305/v2/https://flxt.tmsimg.com/assets/p3457_p_v8_aa.jpg,Five Miles to Midnight,100,7,1963.0,Drama,0 days 01:50:00.000000000,-27
73,75,https://resizing.flixster.com/72FhGmevjIsFxbIxIErFj6brZQ4=/206x305/v2/https://flxt.tmsimg.com/assets/p5994_p_v8_aa.jpg,Deadline U.S.A.,100,8,1952.0,Drama,0 days 01:27:00.000000000,2
37,60,,The Killer Is Loose,100,5,1956.0,Mystery and thriller,0 days 01:13:00.000000000,23
37,44,,xXx: Return of Xander Cage,25000,149,2017.0,Mystery and thriller/Action,0 days 01:42:00.000000000,7
49,74,https://resizing.flixster.com/P_6xaNLgCJZHDwjRFDp4kZGjSQI=/206x305/v2/https://resizing.flixster.com/H40xA3SvhqksJ0q7axK-dDZ2sOo=/ems.ZW1zLXByZC1hc3NldHMvbW92aWVzL2EzOTMwZWE4LTA4MWMtNDYzZC05MTk1LWI4NTRjMjRlMjUxZS53ZWJw,Ghostbusters,100000,389,2016.0,Comedy/Fantasy,0 days 01:57:00.000000000,25
75,86,,Eleni,100,7,1985.0,Drama,0 days 01:57:00.000000000,11
50,63,https://resizing.flixster.com/Sh1CXTGKAvIBKJ7w24wecMPnxgg=/206x305/v2/https://flxt.tmsimg.com/assets/p4726_p_v10_aa.jpg,Wild in the Streets,50,19,1968.0,Comedy,0 days 01:37:00.000000000,13
76,28,,Warcraft,25000,233,2016.0,Action/Fantasy,0 days 02:03:00.000000000,-48
30,23,https://resizing.flixster.com/CAfyvHdoF9-AQCjF4j9dzUJchrA=/206x305/v2/https://resizing.flixster.com/rmBL9NP-3dfRtn457tFSHCbbAI8=/ems.ZW1zLXByZC1hc3NldHMvbW92aWVzL2ZiODJkNGJjLWEyY2MtNGU2ZC1hZGM5LThjZmQyODJiMWMwMi53ZWJw,American Pastoral,2500,123,2016.0,Drama,0 days 01:48:00.000000000,-7
59,90,https://resizing.flixster.com/2io7BcyFhGf1JytMpEfyZyO821U=/206x305/v2/https://resizing.flixster.com/kpFTRpOet-L8TqzOVANGVd5Nc_k=/ems.ZW1zLXByZC1hc3NldHMvbW92aWVzL2Q1NjhkZjY0LTc5NGItNDYzYi04MmFlLWFlOWRhOTc5NWJkZC53ZWJw,Blood on the Mountain,100,10,2016.0,Documentary,0 days 01:33:00.000000000,31
73,70,,Reign of Assassins,1000,10,2010.0,Action/Sports and fitness,0 days 02:00:00.000000000,-3
36,57,,The Lost Bladesman,500,7,2011.0,Action/Drama,0 days 01:47:00.000000000,21
49,91,https://resizing.flixster.com/Pxq7rFBMDW1soPNlhoc2Dw71rUY=/206x305/v2/https://flxt.tmsimg.com/assets/p8796494_p_v7_aa.jpg,Fake It So Real,100,11,2011.0,Documentary,0 days 01:34:00.000000000,42
40,87,/assets/pizza-pie/images/poster_default.c8c896e70c3.gif,Almayer's Folly,100,15,2011.0,Drama,0 days 02:07:00.000000000,47
16,65,https://resizing.flixster.com/FXljGtg2VkMi_uAcXTyTL6ILTfM=/206x305/v2/https://flxt.tmsimg.com/assets/p8955515_p_v10_ab.jpg,Resistance,250,17,2011.0,Drama/Mystery and thriller,0 days 01:32:00.000000000,49
47,61,https://resizing.flixster.com/3NtLLrXPMSXj632Yz408q8LSIe8=/206x305/v2/https://flxt.tmsimg.com/assets/p9211332_p_v10_aa.jpg,Policeman,100,18,2011.0,Drama,0 days 01:45:00.000000000,14
35,34,https://resizing.flixster.com/xHAROfY2-qGdIxWqAyQRiWXgk9Q=/206x305/v2/https://flxt.tmsimg.com/assets/p9288765_p_v10_ac.jpg,A Fantastic Fear of Everything,2500,32,2012.0,Comedy,0 days 01:39:00.000000000,-1
54,40,https://resizing.flixster.com/Q8-vPzGO_JA4alRA59KZLTOEUFk=/206x305/v2/https://resizing.flixster.com/Tcd4j4MgmO05h5d1bymCyCyq8vE=/ems.ZW1zLXByZC1hc3NldHMvbW92aWVzLzQ1ZjlhZmI5LWI0MjQtNDI4NC1hZjMzLWI5MjQxZTRhZGIyZC53ZWJw,Smurfs: The Lost Village,25000,97,2017.0,Comedy/Kids and family,0 days 01:31:00.000000000,-14
43,18,https://resizing.flixster.com/rPI6eO4MET8q1_415XHiIPhDxtc=/206x305/v2/https://resizing.flixster.com/5Su0k28CRHDYP-PSdqdMLVpDf4I=/ems.ZW1zLXByZC1hc3NldHMvbW92aWVzLzE1NDI4NDljLTFjMDUtNDM2NC1hODk4LTAwYWQ1YTczNDgwZS53ZWJw,Assassin's Creed,50000,224,2016.0,Action/Adventure,0 days 01:56:00.000000000,-25
43,25,,Solace,5000,51,2015.0,Mystery and thriller,0 days 01:41:00.000000000,-18
88,100,,Three Sisters,1,6,2013.0,,,12
71,92,,Ray Harryhausen: Special Effects Titan,250,12,2011.0,Documentary,0 days 01:30:00.000000000,21
67,75,https://resizing.flixster.com/vC-gSJsyeevo31XPR2JLrkPrvoM=/206x305/v2/https://resizing.flixster.com/S_XHV6vWK4BVZCOzvG8gKZdYS3E=/ems.ZW1zLXByZC1hc3NldHMvbW92aWVzLzQ0YTI0NTc5LTQwYjMtNDQ0OC1hMDJlLThhYWRjZWFkMTExZC53ZWJw,Trolls,25000,163,2016.0,Comedy/Kids and family,0 days 01:28:00.000000000,8
78,87,https://resizing.flixster.com/AKnotwZpA6YBXzmEKuMMdAP9j8s=/206x305/v2/https://resizing.flixster.com/_9TafmKoulrsV-TGcIqiZzHqC58=/ems.ZW1zLXByZC1hc3NldHMvbW92aWVzLzUwMzUyZGMxLTViMjAtNDM5MS04YjhmLTRlNzU1YWNlMzViZS53ZWJw,Kung Fu Panda 3,50000,179,2016.0,Animation/Comedy,0 days 01:35:00.000000000,9
65,20,,Indigo Children,100,5,2012.0,Drama,0 days 01:16:00.000000000,-45
35,34,https://resizing.flixster.com/GMEgxXPQCGKnsYpKqZR2Z6VSq2k=/206x305/v2/https://resizing.flixster.com/t3PsAzGm0eZdgNRB-JLmCpqPWTI=/ems.ZW1zLXByZC1hc3NldHMvbW92aWVzLzA0ZjBmODBmLTY3ZGEtNGIxMC04ZTI1LTFjYmZjYjY4M2FiZC53ZWJw,Masterminds,25000,99,2016.0,Comedy/Action,0 days 01:35:00.000000000,-1
62,72,https://resizing.flixster.com/s0rUgpBVdOEEBfkArOVmTzjxxSk=/206x305/v2/https://resizing.flixster.com/XnlA_HbNO0vQ8nr-RkJAoHQc164=/ems.ZW1zLXByZC1hc3NldHMvbW92aWVzLzg1NjE3YmNlLTYxYjktNDU2Mi04YjNjLWI3MzcyMjU3ZmY3NC53ZWJw,The Secret Life of Pets,50000,235,2016.0,Animation/Comedy,0 days 01:31:00.000000000,10
48,37,https://resizing.flixster.com/Ea58FpdxUpAEm9-Tcse08e69arA=/206x305/v2/https://resizing.flixster.com/uTPraZCbTvY5iwpLHVOot9fcYeA=/ems.ZW1zLXByZC1hc3NldHMvbW92aWVzL2YxNTRiZmI0LWY0YzItNDBkNi04YmM1LWI3MDIzNjZhZTVjMS53ZWJw,Resident Evil: The Final Chapter,50000,101,2016.0,Action/Horror,0 days 01:42:00.000000000,-11
84,86,,Bayou Maharajah: The Tragic Genius of James Booker,50,7,2013.0,Documentary/Gay and lesbian,0 days 01:30:00.000000000,2
55,100,,Brothers Hypnotic,50,7,2013.0,Documentary,0 days 01:20:00.000000000,45
84,94,,Finding Dory,100000,332,2016.0,Animation/Comedy,0 days 01:43:00.000000000,10
29,38,https://resizing.flixster.com/ybl3tVTcoxx7dCF1eak9UjJ3AwM=/206x305/v2/https://flxt.tmsimg.com/assets/p10394771_p_v10_aa.jpg,Tricked,100,16,2013.0,Documentary,0 days 01:20:00.000000000,9
59,45,,Walking With the Enemy,1000,38,2013.0,Drama/History,0 days 02:06:00.000000000,-14
46,43,https://resizing.flixster.com/Qi7HhAHa5cbx-Bx498MRvaLAjRY=/206x305/v2/https://resizing.flixster.com/GTV_HTfIT79o-Vl_wa2PpEGOpHw=/ems.ZW1zLXByZC1hc3NldHMvbW92aWVzLzRmNmI3ZmMxLTY4MGMtNDRlYy1iNWM5LWJlNjFkY2UxYTVlMS53ZWJw,The Angry Birds Movie,25000,161,2016.0,Adventure/Kids and family,0 days 01:33:00.000000000,-3
66,58,,The Dressmaker,5000,141,2015.0,Comedy/Drama,0 days 01:53:00.000000000,-8
63,30,https://resizing.flixster.com/RHU2iCXZ0uMJOLc6Lwidy5U-Pxo=/206x305/v2/https://resizing.flixster.com/l4wwgnMoWxrxqgA_pTggFpgNDb0=/ems.ZW1zLXByZC1hc3NldHMvbW92aWVzL2MyNzZiZjdmLWU0ZDYtNDA0OC1iZjUzLTdkMGVkZWEyOTEyNi53ZWJw,Passengers,50000,286,2016.0,Romance/Mystery and thriller,0 days 01:51:00.000000000,-33
32,0,https://resizing.flixster.com/N3UQ5RXBa3hca6QdYW0zb3drubI=/206x305/v2/https://resizing.flixster.com/JzY4lYAkzmVMOzp5ZjJQ7FRvyfM=/ems.ZW1zLXByZC1hc3NldHMvbW92aWVzLzViNmVkYzllLTFhZmYtNDM1My05ODNhLThlODJlMGRhNDIwOC53ZWJw,Term Life,1000,7,2016.0,Mystery and thriller/Action,0 days 01:34:00.000000000,-32
54,70,https://resizing.flixster.com/Pkkd_q8nPcr4K1zurgsF3Ey5hkk=/206x305/v2/https://resizing.flixster.com/FHhfGnTN6QHBgJRQ70AswJw4cDw=/ems.ZW1zLXByZC1hc3NldHMvbW92aWVzLzBkYjU0OTAzLTRmMDMtNDg5OC05NjM2LWQ4YmI3ZWQxNDFkNy53ZWJw,A Hologram for the King,10000,150,2016.0,Comedy/Drama,0 days 01:37:00.000000000,16
37,43,,Girlfriend's Day,100,7,2017.0,Comedy,0 days 01:10:00.000000000,6
30,30,,Independence Day: Resurgence,50000,227,2016.0,Action/Sci fi,0 days 02:00:00.000000000,0
33,33,,A Long Way From Home,1,9,2013.0,Drama,0 days 01:25:00.000000000,0
60,64,https://resizing.flixster.com/2uBuGGFjnuKU-WhyPRI0Neyud7w=/206x305/v2/https://resizing.flixster.com/WdXjAj2N97A_y9yLfR46bl1110Y=/ems.ZW1zLXByZC1hc3NldHMvbW92aWVzLzQwZjA0ZjI5LWJiYzctNGYxMy05MzJmLWZkY2MyYjZmNmMyZC53ZWJw,Miss Peregrine's Home for Peculiar Children,25000,253,2016.0,Drama/Fantasy,0 days 02:01:00.000000000,4
36,23,https://resizing.flixster.com/8BoWxa6i1rV2OIo5_utvQelRW0U=/206x305/v2/https://resizing.flixster.com/0hpksFUukNRvnr5tjvAe4trOpZc=/ems.ZW1zLXByZC1hc3NldHMvbW92aWVzL2RlZWU5NDFhLWFmN2UtNDgyOS04OThiLWZhYTE3NjcwOTRiNy53ZWJw,Inferno,25000,252,2016.0,Action/Adventure,0 days 01:56:00.000000000,-13
50,32,,Monster Trucks,5000,98,2016.0,Action/Fantasy,0 days 01:45:00.000000000,-18
80,86,https://resizing.flixster.com/v-0W5KoaHbJ_mOOtHT0W01gzBpo=/206x305/v2/https://resizing.flixster.com/JAfS4SFEv2YU9R5vQzYCFfi63wY=/ems.ZW1zLXByZC1hc3NldHMvbW92aWVzLzE2NzlmMjI1LWU2MmItNDRmNC05MzRhLWFlOWMxNTRlZWQ4ZC53ZWJw,Star Trek Beyond,50000,311,2016.0,Fantasy/Action,0 days 02:02:00.000000000,6
53,41,,Beauty and the Beast,2500,27,2014.0,Romance/Fantasy,0 days 01:52:00.000000000,-12
53,33,,Now You See Me 2,50000,195,2016.0,Comedy/Adventure,0 days 02:09:00.000000000,-20
37,44,,Clown,2500,25,2014.0,Horror,0 days 01:40:00.000000000,7
53,25,https://resizing.flixster.com/IKNcEGGl8PJgvWb-N6bFfsJKRo8=/206x305/v2/https://resizing.flixster.com/6J4nWnbj5wI49zKilVNbUKBtdeU=/ems.ZW1zLXByZC1hc3NldHMvbW92aWVzLzNhYzIxZGE5LWRmMTgtNDg1My1hNzIzLWEzY2EyZDI3MTE4YS53ZWJw,Ben-Hur,10000,191,2016.0,History/Adventure,0 days 02:05:00.000000000,-28
63,29,https://resizing.flixster.com/ez9rVR-NGPp3hpHtp0UPT1X3we8=/206x305/v2/https://resizing.flixster.com/496d-Jgi0o8rVQkAWVe0IGKr9_w=/ems.ZW1zLXByZC1hc3NldHMvbW92aWVzLzM2NGE2MDdmLTU2YmYtNDU4ZC1iZGQzLTY4MWE0ZTgyODkyMy53ZWJw,Batman v Superman: Dawn of Justice,100000,430,2016.0,Fantasy/Action,0 days 02:33:00.000000000,-34
61,61,,The Light Between Oceans,10000,235,2016.0,Romance/Drama,0 days 02:13:00.000000000,0
31,10,,Search Party,1000,20,2014.0,Comedy/Adventure,0 days 01:33:00.000000000,-21
79,74,https://resizing.flixster.com/Ngdb9LFyJagL-yIxHaqcFm7dBOg=/206x305/v2/https://resizing.flixster.com/tsNpgLW1eOqcB378bWoSjuyy8js=/ems.ZW1zLXByZC1hc3NldHMvbW92aWVzL2I5YjEzMWNmLTcyMmMtNDBlMi05ZTA5LWM0MGExYzBkYzM1Ni53ZWJw,Fantastic Beasts and Where to Find Them,50000,341,2016.0,Fantasy/Adventure,0 days 02:07:00.000000000,-5
50,82,,Sausage Party,50000,235,2016.0,Animation/Comedy,0 days 01:29:00.000000000,32
42,35,,Live by Night,10000,239,2016.0,Crime/Drama,0 days 02:09:00.000000000,-7
17,11,,Cell,2500,54,2016.0,Horror/Mystery and thriller,0 days 01:38:00.000000000,-6
86,94,https://resizing.flixster.com/OlsjJFkVU04ua30VpcdQA9kg7BM=/206x305/v2/https://resizing.flixster.com/kmF2v0EIRYHtOb_sACpGl0gegFM=/ems.ZW1zLXByZC1hc3NldHMvbW92aWVzLzQ2ODNjZGEyLTg0NDMtNDcxYS1iZGYwLTI2NWMzNmZjNTJkOC53ZWJw,The Jungle Book,50000,325,2016.0,Fantasy/Action,0 days 01:45:00.000000000,8
48,29,https://resizing.flixster.com/KEqgLExvelKFKu5kJ5wq_ODvQLM=/206x305/v2/https://resizing.flixster.com/KeIhWdF3ZV574LUAE0hGPVowyy4=/ems.ZW1zLXByZC1hc3NldHMvbW92aWVzLzAyNDQ2Y2E3LTgxNmEtNGIxZC1iMGIwLWQ5NDMxNGZlMmNkMy53ZWJw,Alice Through the Looking Glass,25000,258,2016.0,Fantasy/Adventure,0 days 01:53:00.000000000,-19
65,47,https://resizing.flixster.com/-cqbD8f3ThSwB3CurIgw-Jk6bzI=/206x305/v2/https://resizing.flixster.com/H-unMoOtNnYZrqMBoVEzterjAtg=/ems.ZW1zLXByZC1hc3NldHMvbW92aWVzLzY3ZDc1OWFmLTQ2NzQtNGM5OS1iMjdiLWUyYjc0ODAxM2NiNS53ZWJw,X-Men: Apocalypse,100000,343,2016.0,Sci fi/Action,0 days 02:23:00.000000000,-18
83,92,,Imperial Dreams,500,12,2014.0,Drama,0 days 01:27:00.000000000,9
39,18,https://resizing.flixster.com/ICH1j3WhtyBiHuTanvCvdmWSlpQ=/206x305/v2/https://flxt.tmsimg.com/assets/p12009493_p_v10_aw.jpg,Ice Age: Collision Course,25000,119,2016.0,Animation/Comedy,0 days 01:34:00.000000000,-21
58,36,https://resizing.flixster.com/40tmqKaFaSkopFxnF_VXsiHyUaw=/206x305/v2/https://resizing.flixster.com/WL1N42Rg9tVkoIF5FC3tA1vQufk=/ems.ZW1zLXByZC1hc3NldHMvbW92aWVzLzdlYTA2ZDdmLTQyNTUtNDk3Yi1hYzBjLTY4ZTBjMjRjZWUxYS53ZWJw,The Legend of Tarzan,50000,256,2016.0,Action/Drama,0 days 01:50:00.000000000,-22
42,38,https://resizing.flixster.com/z3Z4KaHhk1EPp73sIC-atJo6aaM=/206x305/v2/https://resizing.flixster.com/D9n6AvTWvjvuWYbmFrNx4H6yAv8=/ems.ZW1zLXByZC1hc3NldHMvbW92aWVzLzJiNWM5NTg0LWU5ZTktNGFjZi1iMTFhLTMxNTk5NjVhYzAxOC53ZWJw,Jack Reacher: Never Go Back,25000,240,2016.0,Action/Mystery and thriller,0 days 01:53:00.000000000,-4
50,67,,Schneider vs. Bax,100,9,2015.0,Comedy/Mystery and thriller,0 days 01:36:00.000000000,17
54,67,,Whiskey Tango Foxtrot,10000,211,2016.0,Comedy/Drama,0 days 01:51:00.000000000,13
81,80,https://resizing.flixster.com/JuQ9Ygf_sxntsAgxTSEaHgbx6Dg=/206x305/v2/https://resizing.flixster.com/PTF7mLgl4ODLOWM48EM1R0tVmBA=/ems.ZW1zLXByZC1hc3NldHMvbW92aWVzLzZmOGI0NDk3LTA4NDYtNGYzNi04ZGZlLWRkMzczM2ExMWZjOC53ZWJw,The Conjuring 2,50000,252,2016.0,Horror/Mystery and thriller,0 days 02:13:00.000000000,-1
31,18,,Absolutely Anything,2500,44,2015.0,Comedy/Sci fi,0 days 01:25:00.000000000,-13
81,86,https://resizing.flixster.com/0nl2p5rUa26GBOjJQn6c8epGlXU=/206x305/v2/https://resizing.flixster.com/ojRcSUXRW2y4H06kSM_R28dqkmA=/ems.ZW1zLXByZC1hc3NldHMvbW92aWVzLzk4MDFkNTBjLTQwYTgtNGE1Ni04MTY4LTMzNzViMzNiYmMxYi53ZWJw,A Monster Calls,25000,266,2016.0,Fantasy/Adventure,0 days 01:48:00.000000000,5
89,90,https://resizing.flixster.com/1vJbfjmK1CCABLLIS9tU3nEL0bo=/206x305/v2/https://resizing.flixster.com/WuTR5KccDVIly7EOv6TuaJ2Jidg=/ems.ZW1zLXByZC1hc3NldHMvbW92aWVzLzllZThmOGM5LTVjZmUtNDQ5Yy04ZjdjLTcyOWEzZWI0N2FlZC53ZWJw,Captain America: Civil War,100000,419,2016.0,Fantasy/Adventure,0 days 02:26:00.000000000,1
49,88,,Fort Tilden,500,34,2014.0,Comedy,0 days 01:36:00.000000000,39
90,93,,Logan,50000,418,2017.0,Fantasy/Adventure,0 days 02:17:00.000000000,3
76,93,https://resizing.flixster.com/Yx7UHLlZwF5d19W2Vi5nauAdvwU=/206x305/v2/https://flxt.tmsimg.com/assets/p10225007_p_v10_ac.jpg,Boy and the World,1000,58,2013.0,Kids and family/Animation,0 days 01:20:00.000000000,17
27,57,,Phantasm: Ravager,500,14,2016.0,Horror,0 days 01:27:00.000000000,30
38,40,,Misconception,50,5,2014.0,Documentary,0 days 01:33:00.000000000,2
50,50,https://resizing.flixster.com/hqQcnZdQPWeuFVvLdvFVgFd4KHg=/206x305/v2/https://resizing.flixster.com/uKmvnjkd3PQzZ8-jptppR32tpJo=/ems.ZW1zLXByZC1hc3NldHMvbW92aWVzLzA0OWY3NDc3LTk3ZjYtNGFmYy1hZmI4LTJlODYzMzQ1MzgxNy53ZWJw,The Frontier,50,6,2015.0,Crime/Drama,0 days 01:28:00.000000000,0
15,22,https://resizing.flixster.com/5gHB2Vz8Z7kCqkAV7KFo-A-HzZ0=/206x305/v2/https://resizing.flixster.com/5kQIciNv2DHgzdhGXZfVM5gVPVw=/ems.ZW1zLXByZC1hc3NldHMvbW92aWVzLzRkNjkyZjRkLTNjNGUtNDVhMS1iZmVkLTU5NTU4ZGZhMTcxMC53ZWJw,Chernaya roza,50,9,2014.0,Action/Mystery and thriller,0 days 01:23:00.000000000,7
41,11,https://resizing.flixster.com/R3u6rbNZvegxyyRdrOH_cwcFSxs=/206x305/v2/https://resizing.flixster.com/c5bbB9lth-HZJj0RVQxFs8FWtX8=/ems.ZW1zLXByZC1hc3NldHMvbW92aWVzLzE2YjBkN2Q5LTM5MGQtNDM3MC1iNGZmLTYxYTY1ZDNlZmUwYi53ZWJw,The Divergent Series: Allegiant,25000,196,2016.0,Action/Sci fi,0 days 02:01:00.000000000,-30
31,40,,The Hollow Point,250,15,2016.0,Crime/Drama,0 days 01:37:00.000000000,9
27,38,,Skiptrace,2500,32,2016.0,Action/Comedy,0 days 01:47:00.000000000,11
83,100,,Odd Brodsky,1,6,2013.0,Comedy,0 days 01:33:00.000000000,17
35,24,https://resizing.flixster.com/7sBEfXzr6XUsbaWE6Fotz6-VFPA=/206x305/v2/https://resizing.flixster.com/Xk7SWIvs9B5o6zbx-uqIxn7y-6c=/ems.ZW1zLXByZC1hc3NldHMvbW92aWVzL2RjNzNiNTVmLWU0ZDMtNGE5Ni1hYjJmLTMwMzVhMDk0OWE5ZC53ZWJw,Collide,2500,41,2016.0,Action/Mystery and thriller,0 days 01:34:00.000000000,-11
50,66,,Monster Hunt,500,29,2015.0,Kids and family/Fantasy,0 days 01:56:00.000000000,16
42,21,https://resizing.flixster.com/kz5jEJIlQ5MJgADPExkMcrMC5Q4=/206x305/v2/https://resizing.flixster.com/TgkL7J87Gj3BDCejm6EiNQvkpVI=/ems.ZW1zLXByZC1hc3NldHMvbW92aWVzLzEzY2JhYzIzLWNkMzYtNGU5NC1hNTE5LTQwN2I2MmFmYzcwYi53ZWJw,Ratchet & Clank,5000,81,2016.0,Comedy/Sci fi,0 days 01:34:00.000000000,-21
56,85,,Violet,100,20,2014.0,Drama,0 days 01:22:00.000000000,29
57,74,,The BFG,25000,301,2016.0,Fantasy/Kids and family,0 days 01:55:00.000000000,17
78,60,https://resizing.flixster.com/_ZD_0iK1Ui8lJHIrMturejlhIiI=/206x305/v2/https://resizing.flixster.com/ZeqGRPVBqn-5v0UxeVL8jjCkzOY=/ems.ZW1zLXByZC1hc3NldHMvbW92aWVzLzU3ZTkxYWI4LTVjODgtNDJhMS1hNjJiLTkyYzk0YWU1ZWJjNC53ZWJw,Hillsong: Let Hope Rise,2500,10,2016.0,Documentary/Music,0 days 01:43:00.000000000,-18
77,97,https://resizing.flixster.com/H9tpJlcqu0dn07Fux006NRj09k8=/206x305/v2/https://resizing.flixster.com/VoeEYv0jzv7yUYdFsmyXrs7rEEw=/ems.ZW1zLXByZC1hc3NldHMvbW92aWVzLzVlOGJlNWUzLWMyY2QtNDU5MS04M2IwLTAwNzg2MTUzNTVhZi53ZWJw,The Dark Horse,5000,64,2014.0,Drama/Biography,0 days 02:04:00.000000000,20
79,91,,The Nice Guys,50000,317,2016.0,Action/Mystery and thriller,0 days 01:56:00.000000000,12
48,0,,Max Steel,5000,21,2016.0,Fantasy/Action,0 days 01:32:00.000000000,-48
73,54,https://resizing.flixster.com/Ob0D89DHz-8_ExP2pA1tvd4NfNA=/206x305/v2/https://resizing.flixster.com/m4JujEgEr32ckhEF1cRRYHNObQ4=/ems.ZW1zLXByZC1hc3NldHMvbW92aWVzLzc0YjY1NDliLWNhNTMtNDQwYS04OThmLWM5NmFiMzI4YjBmNy53ZWJw,Me Before You,25000,179,2016.0,Romance/Drama,0 days 01:50:00.000000000,-19
33,11,https://resizing.flixster.com/7IKWvSUs5vZ09LSGoxD4Nhw7tbs=/206x305/v2/https://flxt.tmsimg.com/assets/p12693588_p_v13_aw.jpg,I Am Wrath,1000,9,2016.0,Drama/Action,0 days 01:32:00.000000000,-22
85,89,,Doctor Strange,100000,377,2016.0,Fantasy/Action,0 days 01:55:00.000000000,4
80,80,https://resizing.flixster.com/bCZbEtAzNfd4gKOjBHFmk3Ue_Ao=/206x305/v2/https://flxt.tmsimg.com/assets/p10989488_p_v8_aa.jpg,Little White Lie,100,5,2014.0,Documentary/Drama,0 days 01:05:00.000000000,0
45,19,https://resizing.flixster.com/hiCbGB3h_fcDZcKQJGtPfkhHMEA=/206x305/v2/https://resizing.flixster.com/6Ldo-xjRhHi6ZC55wfvWVCasc_E=/ems.ZW1zLXByZC1hc3NldHMvbW92aWVzL2Y0NTQ0ZWIwLTMwZDItNDM1Zi1iMjJhLTNiZjAwMTY4YWE1OS53ZWJw,The Huntsman: Winter's War,25000,218,2016.0,Action/Fantasy,0 days 01:54:00.000000000,-26
47,30,https://resizing.flixster.com/NUoKVma6uj6TZniAm_ezPIOhbLg=/206x305/v2/https://resizing.flixster.com/Au0INvSoU5RtZXF-pjj03wzI6K8=/ems.ZW1zLXByZC1hc3NldHMvbW92aWVzLzI0YmRkZDBmLTRhNWQtNGQzNC04ZmVmLTAzMTdmNjAzOTZkNi53ZWJw,Criminal,10000,138,2016.0,Action/Mystery and thriller,0 days 01:53:00.000000000,-17
66,77,,Haemoo,100,13,2014.0,Drama,0 days 01:51:00.000000000,11
65,50,https://resizing.flixster.com/mRbMMlgfxrl1YGiy6VcCx34y-x4=/206x305/v2/https://resizing.flixster.com/wUkSCuAuISr7wuVcgqqNPoGhggQ=/ems.ZW1zLXByZC1hc3NldHMvbW92aWVzL2RlOWFkNGFhLTMzM2UtNDQzOC05NDExLTNiZjQzY2M1MzE2NS53ZWJw,Saban's Power Rangers,25000,177,2017.0,Fantasy/Action,0 days 02:04:00.000000000,-15
46,38,https://resizing.flixster.com/UfA9HLQx5HRpwu4ncdc3oq_wMnM=/206x305/v2/https://resizing.flixster.com/uMppyl_a2W37Ic9ME3PX_dWMotY=/ems.ZW1zLXByZC1hc3NldHMvbW92aWVzLzkzNmZhNDg1LTQ4ZGQtNGVlYi04MzcyLTZiMWJlNGI2MjQ0MC53ZWJw,Teenage Mutant Ninja Turtles: Out of the Shadows,50000,172,2016.0,Action/Adventure,0 days 01:47:00.000000000,-8
35,23,https://resizing.flixster.com/VGIRItDir78p9FVxsU_kKjgJdeQ=/206x305/v2/https://resizing.flixster.com/pwEaqu_OjkpEfa2OYLAkip4TSTQ=/ems.ZW1zLXByZC1hc3NldHMvbW92aWVzL2I3ODQ3NzI0LTRiMjYtNDVmZS04NmFkLTllODliNTlhYjQ0NC53ZWJw,Yoga Hosers,2500,60,2016.0,Comedy/Horror,0 days 01:28:00.000000000,-12
37,39,https://resizing.flixster.com/lRhqyFcWmH66gOvse868V-J9y4c=/206x305/v2/https://resizing.flixster.com/muE346-64qo6XPKNOuRcqm5aHiM=/ems.ZW1zLXByZC1hc3NldHMvbW92aWVzL2QwMjIyMTk4LWNhNDQtNGNmMi1iZDJlLWZiZjM5ZTFmZWU1OS53ZWJw,The 9th Life of Louis Drax,1000,67,2016.0,Mystery and thriller,0 days 01:48:00.000000000,2
48,50,,The Beat Beneath My Feet,100,8,2014.0,Comedy/Drama,0 days 01:32:00.000000000,2
69,84,,The President,500,25,2014.0,Comedy/Drama,0 days 01:58:00.000000000,15
67,85,https://resizing.flixster.com/UvgAP88rrUsbRm0cxlggeu8Jids=/206x305/v2/https://flxt.tmsimg.com/assets/p11093347_p_v8_aa.jpg,Hockney,250,47,2014.0,Documentary,0 days 01:52:00.000000000,18
17,0,https://resizing.flixster.com/Hfp7-nOfGiqjNn6kr0UX8-Q1tjc=/206x305/v2/https://resizing.flixster.com/HK8biL52BTsoHLua4o13UqRbK50=/ems.ZW1zLXByZC1hc3NldHMvbW92aWVzL2VmN2NjMmFjLTY2MmMtNGVhNS1iYjIzLTZhNWUwMjY3ZDU4Ni53ZWJw,The Disappointments Room,2500,26,2016.0,Horror/Mystery and thriller,0 days 01:32:00.000000000,-17
67,100,https://resizing.flixster.com/O6XMqiYoSNjrTciqmy_X83B6JFc=/206x305/v2/https://flxt.tmsimg.com/assets/p12350294_p_v10_aa.jpg,A Midsummer Night's Dream,100,7,2014.0,Comedy/Fantasy,0 days 02:24:00.000000000,33
66,77,,"My Love, Don't Cross That River",250,26,2014.0,Documentary,0 days 01:26:00.000000000,11
42,36,https://resizing.flixster.com/Mj8-aAN-boI5ux0Vb6mOJhhyRnA=/206x305/v2/https://flxt.tmsimg.com/assets/p12607594_p_v10_at.jpg,Equals,2500,84,2015.0,Romance/Sci fi,0 days 01:41:00.000000000,-6
68,87,https://resizing.flixster.com/xPemfxgugsmIjVn9Z2R8nLM1v58=/206x305/v2/https://resizing.flixster.com/k6e6yDliTxlyMfgoBqymhwqSqpM=/ems.ZW1zLXByZC1hc3NldHMvbW92aWVzL2I1MWZhYjhkLWFkZjAtNGZlYy1iZGEyLWEwOTc3NzkwOWMxNy53ZWJw,Everybody Wants Some!!,10000,243,2016.0,Comedy,0 days 01:56:00.000000000,19
88,30,,Love Thy Nature,100,10,2014.0,Documentary,0 days 01:16:00.000000000,-58
80,90,,The LEGO Batman Movie,25000,314,2017.0,Comedy/Kids and family,0 days 01:46:00.000000000,10
55,54,,Jason Bourne,50000,324,2016.0,Action/Mystery and thriller,0 days 02:03:00.000000000,-1
82,83,https://resizing.flixster.com/gh54I8Xt-5k6i78ZBk8u4mE-PYs=/206x305/v2/https://resizing.flixster.com/AMuZB1k7yJqf1jq7kS8RbSMpYRw=/ems.ZW1zLXByZC1hc3NldHMvbW92aWVzLzQ4Y2NmYzJhLWE4ODctNDQ5NS05NjMzLWIxMDU4ZjJkZGViNy53ZWJw,Deepwater Horizon,25000,265,2016.0,Drama/Mystery and thriller,0 days 01:47:00.000000000,1
71,72,https://resizing.flixster.com/L4yl92rRv_2iixKQjx5_lSOw13g=/206x305/v2/https://resizing.flixster.com/KIEIE-zxON4CcDWwHBJz2yPF7-I=/ems.ZW1zLXByZC1hc3NldHMvbW92aWVzLzJmMDRmYmE2LTUzMTAtNDNkZi1iZThmLTY1MGFkZTIxMmUyMi53ZWJw,The Infiltrator,10000,179,2016.0,Crime/Drama,0 days 02:07:00.000000000,1
59,26,,Suicide Squad,100000,384,2016.0,Action/Fantasy,0 days 02:03:00.000000000,-33
89,95,,Moana,50000,282,2016.0,Comedy/Kids and family,0 days 01:53:00.000000000,6
60,95,https://resizing.flixster.com/dv46l2wzQatG4dUAynO_NzXGzmQ=/206x305/v2/https://flxt.tmsimg.com/assets/p11086580_p_v8_ab.jpg,The Creeping Garden,250,20,2014.0,Documentary,0 days 01:21:00.000000000,35
40,31,https://resizing.flixster.com/0-ny-A7BQsj2z7OA3DK_M9JmhsA=/206x305/v2/https://resizing.flixster.com/qWQLvl3zmsw_IMwGAa1fo6joXdE=/ems.ZW1zLXByZC1hc3NldHMvbW92aWVzL2IzM2QzNGJmLWY4ZGQtNDY5OC05NGFjLWEwNjViNjNkNzZmZC53ZWJw,Mechanic: Resurrection,25000,59,2016.0,Adventure/Mystery and thriller,0 days 01:39:00.000000000,-9
62,71,,Central Intelligence,50000,188,2016.0,Comedy/Action,0 days 01:47:00.000000000,9
78,88,https://resizing.flixster.com/p6rarYySyS45qeSE0jQInAhwb3A=/206x305/v2/https://resizing.flixster.com/tk9oHi1zkKsMPekdMVJgjz39Lws=/ems.ZW1zLXByZC1hc3NldHMvbW92aWVzLzc2YjEzNWIxLTk5NjItNDM5ZC1iZjBlLWIxZmVjMzZkZDVkOC53ZWJw,Don't Breathe,25000,237,2016.0,Horror/Mystery and thriller,0 days 01:28:00.000000000,10
42,17,https://resizing.flixster.com/FjGqMtgsl9XCEL9-shKhUIWqKcY=/206x305/v2/https://flxt.tmsimg.com/assets/p11814623_p_v10_aa.jpg,Listening,250,12,2014.0,Sci fi/Mystery and thriller,0 days 01:40:00.000000000,-25
72,64,,The Magnificent Seven,25000,313,2016.0,Western/Action,0 days 02:08:00.000000000,-8
76,89,https://resizing.flixster.com/O91J3Y_tpXPueJUEXTr8rY5p3z4=/206x305/v2/https://flxt.tmsimg.com/assets/p11424980_p_v8_aa.jpg,How to Dance in Ohio,50,9,2015.0,Documentary,0 days 01:28:00.000000000,13
84,78,https://resizing.flixster.com/pk-xqkBLBZ892KU-hAuswxNdnpU=/206x305/v2/https://flxt.tmsimg.com/assets/p11368881_p_v10_aa.jpg,Dying to Know: Ram Dass & Timothy Leary,100,9,2014.0,Documentary/Drama,0 days 01:39:00.000000000,-6
45,36,https://resizing.flixster.com/zjoWngWKjbLy7PGHTQLA1fmf4DM=/206x305/v2/https://resizing.flixster.com/_53OVKHBawa8rxJ9NEdVfFTXYKg=/ems.ZW1zLXByZC1hc3NldHMvbW92aWVzLzI4OWU0ODkxLTczNDYtNDlkZS04ZDZmLWRmNmYxZWFiZTYyMy53ZWJw,The Bronze,2500,99,2015.0,Comedy,0 days 01:40:00.000000000,-9
86,97,https://resizing.flixster.com/8RdCeAGQHHfEeANiIuHNcqeciyE=/206x305/v2/https://resizing.flixster.com/NHLQkvygQNB8IG8Oxm1KkWC21Zs=/ems.ZW1zLXByZC1hc3NldHMvbW92aWVzLzIyYjhmZWVlLWQ3Y2ItNDliMC05MTkxLTQwYzQ3ZTRmZDZiZi53ZWJw,Kubo and the Two Strings,25000,221,2016.0,Kids and family/Animation,0 days 01:42:00.000000000,11
51,38,,Mike and Dave Need Wedding Dates,25000,172,2016.0,Comedy,0 days 01:38:00.000000000,-13
38,21,https://resizing.flixster.com/JljVNi6fuVjmSyGtlsn-0BX9tTE=/206x305/v2/https://flxt.tmsimg.com/assets/p12235748_p_v10_ab.jpg,The Boss,25000,196,2016.0,Comedy,0 days 01:39:00.000000000,-17
48,56,,The Purge: Election Year,25000,163,2016.0,Action/Horror,0 days 01:49:00.000000000,8
36,36,,Sugar Mountain,100,11,2016.0,Drama/Mystery and thriller,0 days 01:46:00.000000000,0
70,61,https://resizing.flixster.com/s1Ch6RdG83JB2XirpxJhquwFA3A=/206x305/v2/https://resizing.flixster.com/DvSjs6muVFJ2OgfRFehzCEXzsxQ=/ems.ZW1zLXByZC1hc3NldHMvbW92aWVzLzM3ZTdjNjU2LTRjYWQtNDE2Ni1iZTM3LTMwY2VjN2Q4M2Q3MC53ZWJw,Snowden,25000,259,2016.0,Drama/Mystery and thriller,0 days 02:14:00.000000000,-9
60,86,,Adventures in Babysitting,50,7,2016.0,Kids and family/Adventure,0 days 01:30:00.000000000,26
72,88,https://resizing.flixster.com/Ll3wHap0E7ECOd7ZId1OYc6DoMY=/206x305/v2/https://resizing.flixster.com/YxnlEllJlsQckBD-Gf_L9sOobf0=/ems.ZW1zLXByZC1hc3NldHMvbW92aWVzLzZhMzZmMmQ0LTY4MzYtNGNhNC1iYjdlLWIwMzFhYTJkZjBkYi53ZWJw,Pete's Dragon,25000,244,2016.0,Fantasy/Kids and family,0 days 01:43:00.000000000,16
45,76,https://resizing.flixster.com/AX2IcXZdnCydmcgyEna0yu0XaSw=/206x305/v2/https://flxt.tmsimg.com/assets/p11454947_p_v13_ae.jpg,Last Days in the Desert,2500,71,2015.0,Drama,0 days 01:39:00.000000000,31
67,96,,The Russian Woodpecker,500,25,2015.0,Documentary/War,0 days 01:21:00.000000000,29
85,90,,"What Happened, Miss Simone?",1000,48,2015.0,Documentary/Music,0 days 01:41:00.000000000,5
80,90,https://resizing.flixster.com/hcgnZJK7sv4EPNJqJfSsQbbb1nw=/206x305/v2/https://resizing.flixster.com/1ey5WYlqoGB6YO6ezew8sNhn2NY=/ems.ZW1zLXByZC1hc3NldHMvbW92aWVzL2YxMmQ4NmUzLTM4NDEtNGU3Mi04Yjg0LTMxOTE5NDU2YWZlZS53ZWJw,City of Gold,2500,62,2015.0,Documentary/Biography,0 days 01:29:00.000000000,10
37,64,,I Am Michael,2500,36,2015.0,Gay and lesbian/Drama,0 days 01:42:00.000000000,27
66,91,https://resizing.flixster.com/tytSixv3622XCKP8wIhDzr6MQFM=/206x305/v2/https://resizing.flixster.com/X7nz14a8S-mVCxqP4-xHGRdW_2U=/ems.ZW1zLXByZC1hc3NldHMvbW92aWVzL2NlNWJlZDJlLTkwYWYtNDc0Mi04YmVkLTI2YjM4NjA4N2YwMy53ZWJw,Songs My Brothers Taught Me,250,23,2015.0,Drama,0 days 01:41:00.000000000,25
42,72,,Take Me to the River,250,36,2015.0,Gay and lesbian/Drama,0 days 01:24:00.000000000,30
72,79,https://resizing.flixster.com/Adq8woQs7hT1gSZXZKn2ph56zq0=/206x305/v2/https://flxt.tmsimg.com/assets/p11602228_p_v10_aa.jpg,Deep Web,500,14,2015.0,Documentary,0 days 01:30:00.000000000,7
80,71,,Beauty and the Beast,50000,378,2017.0,Fantasy/Romance,0 days 02:09:00.000000000,-9
44,64,,Neighbors 2: Sorority Rising,50000,207,2016.0,Comedy,0 days 01:32:00.000000000,20
74,64,https://resizing.flixster.com/7fm3g6P5AC4nt5HpUiGBxYjpUEs=/206x305/v2/https://resizing.flixster.com/TAQ49tt_OzM9V98tpVGTkbi8Ey8=/ems.ZW1zLXByZC1hc3NldHMvbW92aWVzLzQ2MGNjNzU0LTBkYmItNGVhOS04NTdlLTY1NGE3NTRhYzBmMi53ZWJw,The Siege of Jadotville,1000,11,2016.0,Drama/Mystery and thriller,0 days 01:48:00.000000000,-10
69,60,https://resizing.flixster.com/--IC008B4qq3z1cbvK8JTn5Ypis=/206x305/v2/https://resizing.flixster.com/FAhjIEpyxhf6BneORjMdfTdtt0I=/ems.ZW1zLXByZC1hc3NldHMvbW92aWVzLzdjMjM4ZWEwLWNjNTAtNGExMy1hZjdiLThjMWNiM2EwMjNjNS53ZWJw,Lazer Team,2500,35,2015.0,Action/Sci fi,0 days 01:42:00.000000000,-9
64,47,https://resizing.flixster.com/bM7Ei-DFmWTB3mi6oOL86sfUv24=/206x305/v2/https://resizing.flixster.com/RtNdc58oRTSb7SXzcVWBpGTtEnQ=/ems.ZW1zLXByZC1hc3NldHMvbW92aWVzLzRkMGNkOTk4LTVlZDEtNDYzNC1hYjFjLWJkODE4ZWNjOGExMC53ZWJw,Free State of Jones,10000,188,2016.0,War/Drama,0 days 02:19:00.000000000,-17
45,56,,The Outskirts,2500,9,2017.0,Comedy,0 days 01:35:00.000000000,11
82,81,https://resizing.flixster.com/Tu39h0zgqLr0Cy-MQRmKzMy_XF4=/206x305/v2/https://resizing.flixster.com/TI2lCOEV6Urzm4IuoPUusTIsBhI=/ems.ZW1zLXByZC1hc3NldHMvbW92aWVzL2RiYjE5MGJjLTA2ZDAtNGYwMy05MDg0LTM0NDM4MjdlZmU5NC53ZWJw,The Founder,25000,242,2016.0,Drama/History,0 days 01:55:00.000000000,-1
22,7,https://resizing.flixster.com/CBDeV0eDa1ZAXXVqthAbtSQlCXM=/206x305/v2/https://resizing.flixster.com/6hHrhsuB8-rNEX0IuuHfy1Ev2F8=/ems.ZW1zLXByZC1hc3NldHMvbW92aWVzLzhkYTEwYmMxLTAwMmQtNDAxYi1hOTk5LTE4YjhlZjcyNWQyZS53ZWJw,Shut In,5000,45,2016.0,Mystery and thriller,0 days 01:31:00.000000000,-15
86,84,,Rogue One: A Star Wars Story,100000,452,2016.0,Fantasy/Action,0 days 02:14:00.000000000,-2
37,19,,Keeping Up With the Joneses,10000,124,2016.0,Comedy/Action,0 days 01:40:00.000000000,-18
59,47,https://resizing.flixster.com/KjlKxNIiRoK0Sfvr-01PWLwtg4s=/206x305/v2/https://resizing.flixster.com/EPDnYu7yspbHtItggAJ3KV810kE=/ems.ZW1zLXByZC1hc3NldHMvbW92aWVzL2YyOTAwYTI1LWIxNTctNDJhMS04OTY5LTZlNDI5MzYzMmEwZS53ZWJw,The Hollars,2500,92,2016.0,Comedy/Drama,0 days 01:28:00.000000000,-12
38,50,,Summer Camp,100,10,2015.0,Horror/Mystery and thriller,0 days 01:24:00.000000000,12
80,70,,Marinoni: The Fire in the Frame,1,10,2015.0,Documentary,0 days 01:30:00.000000000,-10
69,69,,Bleed for This,5000,144,2016.0,Drama/Biography,0 days 01:56:00.000000000,0
62,10,https://resizing.flixster.com/odg6hI98YFTKM4vgLIK2xWhw1iA=/206x305/v2/https://resizing.flixster.com/OmmthjxF-KGJ30NWHR-gyx2gmH0=/ems.ZW1zLXByZC1hc3NldHMvbW92aWVzLzBkZWY5ZWRlLTM5NTctNGU1Yi1hYzNiLWVhMzRmNTE1MjdkYy53ZWJw,God's Not Dead 2,10000,40,2016.0,Drama,0 days 02:01:00.000000000,-52
60,84,,My Mother,2500,91,2015.0,Comedy/Drama,0 days 01:46:00.000000000,24
51,59,https://resizing.flixster.com/yWH9cjag0rR50BsRNwWe-b_GW_k=/206x305/v2/https://resizing.flixster.com/leXInGS1lU18ChVDgVht5nl3HPI=/ems.ZW1zLXByZC1hc3NldHMvbW92aWVzL2M0Y2M3NDdiLWYxNmEtNDQxNC1iMGI3LTk0NjI4NjU3ZDRkYi53ZWJw,The Neon Demon,5000,258,2016.0,Horror/Mystery and thriller,0 days 01:57:00.000000000,8
45,12,,When the Bough Breaks,5000,25,2016.0,Drama,0 days 01:42:00.000000000,-33
32,60,,Roseanne for President!,50,10,2015.0,Documentary,0 days 01:37:00.000000000,28
42,88,,Sun Choke,500,25,2015.0,Mystery and thriller,0 days 01:23:00.000000000,46
42,50,,Circle,1000,6,2015.0,Horror/Sci fi,0 days 01:27:00.000000000,8
79,90,https://resizing.flixster.com/nGXACXRgywk2LvzHV5EiGpE1GB4=/206x305/v2/https://resizing.flixster.com/NwyequZNFmBZhuDf8y_mLkCGYnQ=/ems.ZW1zLXByZC1hc3NldHMvbW92aWVzLzE3M2E2NzliLWE2ZjYtNGZmYy04YzNjLTA4NmVhYzM0NjFlOS53ZWJw,Fastball,500,20,2015.0,Documentary,0 days 01:27:00.000000000,11
41,44,https://resizing.flixster.com/kbSJZ4PnbFPLcGsoBMYGv6vG4OI=/206x305/v2/https://flxt.tmsimg.com/assets/p12837431_p_v10_ab.jpg,Billy Lynn's Long Halftime Walk,5000,160,2016.0,Comedy/Drama,0 days 01:48:00.000000000,3
62,65,,Storks,10000,139,2016.0,Animation/Comedy,0 days 01:23:00.000000000,3
51,74,https://resizing.flixster.com/mITwJoItajKd2TIDu-RvKEgK7XM=/206x305/v2/https://resizing.flixster.com/f1slzs5aV_d2qYgiIFzDmikbXG0=/ems.ZW1zLXByZC1hc3NldHMvbW92aWVzLzYyZWZlYWQ5LTQ0NmMtNDhmOS1hYzljLTY5OTc4YTk1NTJkYS53ZWJw,Danny Says,100,31,2015.0,Documentary/Music,0 days 01:44:00.000000000,23
48,11,https://resizing.flixster.com/3e7c_07BN8BhFeUFRKXbH5znea0=/206x305/v2/https://resizing.flixster.com/efRLw-WUQQ04NqmFGmqY6OQLhD8=/ems.ZW1zLXByZC1hc3NldHMvbW92aWVzL2FjNDEyY2UyLTU5OWItNGY5OS1iMGE2LWM5Y2RmYzhhZTUxZi53ZWJw,Fifty Shades Darker,25000,207,2017.0,Romance/Drama,0 days 01:58:00.000000000,-37
82,100,,For the Love of Spock,1000,31,2016.0,Documentary,0 days 01:40:00.000000000,18
81,90,https://resizing.flixster.com/54gurF8JO_kCFtVNbxnIPNSEoOI=/206x305/v2/https://resizing.flixster.com/m9MHyVQI_ABWHGAQPoftYy0fyQI=/ems.ZW1zLXByZC1hc3NldHMvbW92aWVzLzllMzcxZTYzLTE2NmUtNGY4Zi1iYjI5LTBiNTBlMDRkYWE0NS53ZWJw,La La Land,50000,463,2016.0,Romance/Comedy,0 days 02:08:00.000000000,9
58,100,,Breaking a Monster,250,24,2015.0,Documentary/Music,0 days 01:33:00.000000000,42
57,82,,Ouija: Origin of Evil,10000,123,2016.0,Horror/Mystery and thriller,0 days 01:39:00.000000000,25
17,7,,No Stranger Than Love,100,14,2015.0,Romance/Fantasy,0 days 01:29:00.000000000,-10
52,73,https://resizing.flixster.com/17KmRS4JW8OJe-i6hyhFRzDPRu0=/206x305/v2/https://resizing.flixster.com/qrXGpmMkzZNvtz4KshhP_N2Yx9M=/ems.ZW1zLXByZC1hc3NldHMvbW92aWVzLzAxMTgxNGE4LTZjNWQtNDQ5YS05MmE4LTA1MWU1MmVmZWU4MC53ZWJw,Back Home,2500,128,2015.0,Drama,0 days 01:49:00.000000000,21
42,17,https://resizing.flixster.com/hQ3q_N4yKvTKYWZVxw3L_4haAtA=/206x305/v2/https://flxt.tmsimg.com/assets/p13040330_p_v10_ah.jpg,The Sea of Trees,1000,52,2015.0,Drama,0 days 01:50:00.000000000,-25
40,65,https://resizing.flixster.com/EzOxvj5j_FQ7sz-dDbSx-jE-pEY=/206x305/v2/https://resizing.flixster.com/zKf_Zoi74dcXiOU-8p_9OICnBQQ=/ems.ZW1zLXByZC1hc3NldHMvbW92aWVzLzMyZTI2YTExLWU4MDYtNGU0NS1hMzIzLWUzNjIxMWFiNjJkOS53ZWJw,SiREN,500,20,2016.0,Horror/Mystery and thriller,0 days 01:22:00.000000000,25
83,92,,Speed Sisters,250,24,2015.0,Documentary/Drama,0 days 01:20:00.000000000,9
66,90,https://resizing.flixster.com/Vh0y1F_zTH1H90NTSXXHHXtjZw8=/206x305/v2/https://flxt.tmsimg.com/assets/p12003500_p_v8_ab.jpg,Barbershop: The Next Cut,10000,93,2016.0,Comedy,0 days 01:52:00.000000000,24
75,65,,The Great Gilly Hopkins,1,17,2016.0,Comedy/Drama,0 days 01:37:00.000000000,-10
58,76,https://resizing.flixster.com/OF_VQKYQs5G3WBbXWrmWtQhtYbA=/206x305/v2/https://resizing.flixster.com/7QhMIUhI98Zoz_KyE1o01Ge_CyE=/ems.ZW1zLXByZC1hc3NldHMvbW92aWVzLzNjYzUwYWJjLTZiMGMtNDcxYy1iMmM5LThjN2JiNzNmZjM5ZC53ZWJw,Kevin Hart: What Now?,10000,59,2016.0,Comedy/Documentary,0 days 01:36:00.000000000,18
57,31,,Welcome to Happiness,100,16,2015.0,Fantasy/Comedy,0 days 01:48:00.000000000,-26
62,100,,808,50,6,2015.0,Documentary,0 days 01:47:00.000000000,38
41,42,https://resizing.flixster.com/2Mql_E1ZiB0nqPIarDLP2DGLYaE=/206x305/v2/https://resizing.flixster.com/Sywo2FR0i7t3s8A9NccyZSuwYf0=/ems.ZW1zLXByZC1hc3NldHMvbW92aWVzL2I2ZWM4MzZiLTBkZDYtNGNkMC05M2FlLTU4MjA3YTdiYzFlNC53ZWJw,A Cure for Wellness,10000,210,2016.0,Horror/Mystery and thriller,0 days 02:20:00.000000000,1
41,14,,Nine Lives,10000,72,2016.0,Comedy/Fantasy,0 days 01:29:00.000000000,-27
77,97,https://resizing.flixster.com/CdhqGzwhAjiNsO8AWuHJi1MBLWA=/206x305/v2/https://resizing.flixster.com/Q796kp5FDEonYD7NM4nJRn4KuQc=/ems.ZW1zLXByZC1hc3NldHMvbW92aWVzLzQ0NTFlODk1LTk3NzktNDZkNi1hYzdlLTMzOTQ5OGM4MjBhYy53ZWJw,April and the Extraordinary World,2500,58,2015.0,Animation/Sci fi,0 days 01:45:00.000000000,20
75,90,https://resizing.flixster.com/DsDNDqCjfY7Ae1U30LpzdviAafc=/206x305/v2/https://resizing.flixster.com/izrNcUyp_6PNGd9nFAH9oxt08bU=/ems.ZW1zLXByZC1hc3NldHMvbW92aWVzL2YzNjFkMjMwLTc5ZWYtNGRhOC1hNTAwLWRjNGJlNDA2OWM0My53ZWJw,Green Room,10000,241,2015.0,Horror/Mystery and thriller,0 days 01:34:00.000000000,15
50,72,,A Tale of Love and Darkness,1000,67,2015.0,Drama/History,0 days 01:38:00.000000000,22
81,45,,Miracles From Heaven,10000,93,2016.0,Drama,0 days 01:49:00.000000000,-36
30,17,https://resizing.flixster.com/SwZTyufmNrtdpAqvMbjU0_6f3jc=/206x305/v2/https://resizing.flixster.com/LkrYAgGp7McfxMlL8MYIDhB2Tss=/ems.ZW1zLXByZC1hc3NldHMvbW92aWVzL2I4M2FiZDY5LWFjOGMtNDFiZi1hNGI5LTAyZjY5ZDlmNmU2Mi53ZWJw,USS Indianapolis: Men of Courage,1000,12,2016.0,War/Action,0 days 02:15:00.000000000,-13
28,34,,By the Sea,5000,158,2015.0,Romance/Drama,0 days 02:02:00.000000000,6
50,73,,Uncle Kent 2,1,11,2015.0,Comedy/Drama,0 days 01:13:00.000000000,23
76,51,,The Accountant,25000,284,2016.0,Drama/Action,0 days 02:08:00.000000000,-25
69,61,,War Dogs,25000,234,2016.0,Comedy/Drama,0 days 01:54:00.000000000,-8
82,87,https://resizing.flixster.com/Y-ExLtRzXr3yScCY6Cnk_NFgWuY=/206x305/v2/https://resizing.flixster.com/bZzCZjrfnUSTA5k2jLrGupk-Ka8=/ems.ZW1zLXByZC1hc3NldHMvbW92aWVzLzM3MGE4OTUxLTJlMzYtNGViZC04ZTFhLTk0ZmQ3YTIzMjFhNC53ZWJw,Dheepan,2500,126,2015.0,Drama,0 days 01:50:00.000000000,5
68,82,,The Brand New Testament,2500,77,2015.0,Comedy/Fantasy,0 days 01:53:00.000000000,14
55,78,,Keanu,10000,179,2016.0,Comedy/Action,0 days 01:40:00.000000000,23
71,92,https://resizing.flixster.com/jP-1SZurURKWFXbhMhCTTOBLC48=/206x305/v2/https://resizing.flixster.com/WnlNJAnbFVn15Nzo9bqek-DpxOk=/ems.ZW1zLXByZC1hc3NldHMvbW92aWVzLzRjYWM0M2U5LWRmMmQtNDgxNi04ZWJiLTg4ODczM2U0MTFkMC53ZWJw,Southside With You,5000,160,2016.0,Romance/Drama,0 days 01:21:00.000000000,21
91,84,https://resizing.flixster.com/K6KagINKY4Dgd7LnkNvSrwMhzTQ=/206x305/v2/https://resizing.flixster.com/ZY8sF8hExSna0D4ytmSu2Vah9SY=/ems.ZW1zLXByZC1hc3NldHMvbW92aWVzLzM3MGVkZTFlLTZmNWMtNDgwYS04NjFlLTg3OWE3OWU5MDk2YS53ZWJw,Hacksaw Ridge,50000,281,2016.0,History/Biography,0 days 02:19:00.000000000,-7
84,85,https://resizing.flixster.com/gMfqDjWylo1snPiRBc6IRQlhWfU=/206x305/v2/https://resizing.flixster.com/GrzxUIlf6EjYWd_yuSk7o7lfty4=/ems.ZW1zLXByZC1hc3NldHMvbW92aWVzL2U5NmU3MWFmLTk1M2MtNDliZC05M2MwLWY1MzBjMzQ4YzgyYi53ZWJw,Sully,25000,346,2016.0,Drama/Biography,0 days 01:36:00.000000000,1
80,73,,Good Ol' Boy,250,11,2015.0,Comedy/Drama,0 days 01:42:00.000000000,-7
34,48,https://resizing.flixster.com/0za1l0ReUSh9wHI5ByFl_29xXZE=/206x305/v2/https://resizing.flixster.com/uW7JgEWH-hNOY1FcTYPklnm8hL8=/ems.ZW1zLXByZC1hc3NldHMvbW92aWVzL2Q4YmQ3MjBmLTQyMWUtNGNlMS04OGI0LTc1MGUyMjBjYTE2MS53ZWJw,War Machine,5000,93,2017.0,Comedy/War,0 days 02:02:00.000000000,14
76,96,https://resizing.flixster.com/QUdS7oY7MgcbPb2B-QGh_4C43Nw=/206x305/v2/https://flxt.tmsimg.com/assets/p11856476_p_v10_ab.jpg,Hitchcock/Truffaut,5000,118,2015.0,Documentary,0 days 01:20:00.000000000,20
65,79,https://resizing.flixster.com/kQeH9sVK3QKW99V-u_5-Yi7LrOs=/206x305/v2/https://resizing.flixster.com/S3h_javIgDCxmLhRLT-HhxBaZKg=/ems.ZW1zLXByZC1hc3NldHMvbW92aWVzLzA0Y2UxOTFhLWJiNjMtNDM4Yy1iYWJlLWViMjYxNmE1OWYxMS53ZWJw,Popstar: Never Stop Never Stopping,10000,171,2016.0,Comedy/Music,0 days 01:26:00.000000000,14
57,77,,Chronic,500,60,2015.0,Drama,0 days 01:33:00.000000000,20
84,92,https://resizing.flixster.com/ilsPMqaoTa7wQK49XEBSNPOuR0M=/206x305/v2/https://resizing.flixster.com/Ja4KEp3sB9Wqbg2kOStbJT5rCqo=/ems.ZW1zLXByZC1hc3NldHMvbW92aWVzL2I4ZjIwMmEyLTQyMDItNDdmNi1hNDE4LTE5MjI5MWFjNzNlYS53ZWJw,Requiem for the American Dream,2500,25,2015.0,Biography,0 days 01:13:00.000000000,8
82,100,https://resizing.flixster.com/2wTZKy8iMpL1h3WYsGA-boH2OwI=/206x305/v2/https://resizing.flixster.com/N3Dpi1FuF_bBzc117sRGTUAkA50=/ems.ZW1zLXByZC1hc3NldHMvbW92aWVzL2VmYTc5ZGNmLTc5YWQtNDFhZS1hMWNjLTMxYTg3YTJkNDFjZS53ZWJw,Uncertain,250,22,2015.0,Documentary/Drama,0 days 01:22:00.000000000,18
34,13,https://resizing.flixster.com/jyGSGi6oY0faY-KQdAP341guxsE=/206x305/v2/https://resizing.flixster.com/LRmUQgBUQsEgVFk9h-2XYccf4kM=/ems.ZW1zLXByZC1hc3NldHMvbW92aWVzL2E2YWZiY2I2LTQ4NDctNDIyNS1hZDVkLWI4YjdlMWVkOGEzMy53ZWJw,Spark: A Space Tail,500,23,2016.0,Comedy/Sci fi,0 days 01:30:00.000000000,-21
73,83,https://resizing.flixster.com/8WDDVEwasaGwRbGk5_5VBjyv3Qk=/206x305/v2/https://resizing.flixster.com/YoAKOEk5uZqRVVwdWZPA3vsIB04=/ems.ZW1zLXByZC1hc3NldHMvbW92aWVzL2NiZmNlMWM2LTcyOWEtNGQ0My04NDZhLTI0MjhhYmNmNWM3ZS53ZWJw,Confirmation,250,48,2016.0,Drama,0 days 01:50:00.000000000,10
41,74,,Wiener-Dog,2500,116,2016.0,Comedy,0 days 01:27:00.000000000,33
53,92,,The Seventh Fire,250,26,2015.0,Documentary/Drama,0 days 01:18:00.000000000,39
36,18,https://resizing.flixster.com/bTmsFs_qLdSSDhUAXVGfjHTAGnY=/206x305/v2/https://flxt.tmsimg.com/assets/p11929007_p_v10_ab.jpg,I Saw the Light,2500,157,2015.0,Drama/History,0 days 02:03:00.000000000,-18
81,98,,Sherpa,1000,41,2015.0,Documentary,0 days 01:36:00.000000000,17
48,57,,Beautiful Something,50,7,2015.0,Romance/Gay and lesbian,0 days 01:32:00.000000000,9
54,53,https://resizing.flixster.com/ucbsFNS1r53DQrb2R6U5rsfG1mA=/206x305/v2/https://resizing.flixster.com/bTrX1D3sEcmnKnHrQc50uOORe_g=/ems.ZW1zLXByZC1hc3NldHMvbW92aWVzLzg5MjhhOTI0LTdhYTQtNDJiMy1hNzg3LThlNTdhMjQxMmNmYi53ZWJw,Demolition,5000,206,2015.0,Comedy/Drama,0 days 01:41:00.000000000,-1
83,94,https://resizing.flixster.com/dhsZ6UYkE9lUiKqarQ5pH0w-Rfc=/206x305/v2/https://resizing.flixster.com/OCMloLXb6tFN1iiio86nNOuX-b0=/ems.ZW1zLXByZC1hc3NldHMvbW92aWVzL2VkNzRmZDY4LWZhNWMtNDJmOC05ZjNjLTRkMTZjNmQzOTQ3Mi53ZWJw,Little Sister,2500,123,2015.0,Drama,0 days 02:06:00.000000000,11
65,87,,The Lobster,25000,263,2015.0,Romance/Sci fi,0 days 01:58:00.000000000,22
50,90,,My Golden Days,1000,77,2015.0,Drama,0 days 02:03:00.000000000,40
81,81,,Holding the Man,500,26,2015.0,Romance/Gay and lesbian,0 days 02:07:00.000000000,0
40,94,,600 Miles,250,31,2015.0,Drama/Mystery and thriller,0 days 01:25:00.000000000,54
44,8,https://resizing.flixster.com/ZAhpaQZ1J8eQfwNZOwbZabNSMpM=/206x305/v2/https://resizing.flixster.com/_v3-jjSqLOOJCCZJn_XwV0MmElk=/ems.ZW1zLXByZC1hc3NldHMvbW92aWVzLzU1M2Q3ZDc5LTk3ZjAtNGYwMS1iNWM0LTI2ODNlODQ1ODVlMC53ZWJw,Mother's Day,10000,159,2016.0,Romance/Comedy,0 days 01:58:00.000000000,-36
81,67,https://resizing.flixster.com/sApyDcKC8zAn7noHct2iP0wEPfE=/206x305/v2/https://resizing.flixster.com/0caH9sF_fElKo7S_ri9ePuDsmGw=/ems.ZW1zLXByZC1hc3NldHMvbW92aWVzL2NmNzExYjNhLTdlMTYtNDJhMy1hM2VmLWQ3OGNiZGYzY2Q3OC53ZWJw,Admiral,100,6,2015.0,Biography/History,0 days 02:02:00.000000000,-14
61,100,,They Will Have to Kill Us First,100,19,2015.0,Documentary,0 days 01:45:00.000000000,39
77,21,https://resizing.flixster.com/CClYk4pbSzxqlWV0LqVZE5FOhXM=/206x305/v2/https://resizing.flixster.com/uBMmeIZAabJQ5SPJ1QMH1mrnB4c=/ems.ZW1zLXByZC1hc3NldHMvbW92aWVzLzVhZDljODNlLTU1ZTAtNGQ5Mi1iZDNjLTBmZGU5ZTg4ZDNmNi53ZWJw,The Shack,10000,72,2017.0,Drama,0 days 02:12:00.000000000,-56
44,32,,About Ray,2500,44,2015.0,Comedy/Drama,0 days 01:34:00.000000000,-12
59,78,,The Shallows,25000,219,2016.0,Adventure/Mystery and thriller,0 days 01:27:00.000000000,19
56,71,https://resizing.flixster.com/YX5tgn4K5AyFafw-dvuglBA7deQ=/206x305/v2/https://flxt.tmsimg.com/NowShowing/162035/162035_aa.jpg,Café Society,10000,256,2016.0,Romance,0 days 01:36:00.000000000,15
51,58,https://resizing.flixster.com/FxopZe_37xJgpaIujJr3mTDyWdo=/206x305/v2/https://resizing.flixster.com/uHM2KDljHyb_c8yPoeI_MgeBf4A=/ems.ZW1zLXByZC1hc3NldHMvbW92aWVzL2Q2NTkwNDc4LWVjNmQtNDU0YS1iZWNiLTA2MjgzNjA2YjhkMS53ZWJw,Money Monster,10000,281,2016.0,Drama/Mystery and thriller,0 days 01:38:00.000000000,7
36,86,,A Sinner in Mecca,100,14,2015.0,Documentary/Gay and lesbian,0 days 01:19:00.000000000,50
36,48,,Mascots,500,48,2016.0,Comedy,0 days 01:35:00.000000000,12
62,87,,Oddball,500,23,2015.0,Kids and family/Adventure,0 days 01:36:00.000000000,25
25,33,https://resizing.flixster.com/cIjdkvRGQAufCBnaRMrcBG8kwmY=/206x305/v2/https://flxt.tmsimg.com/assets/p12711998_p_v10_aa.jpg,StalkHer,1,6,2015.0,Romance/Comedy,0 days 01:30:00.000000000,8
36,50,https://resizing.flixster.com/Y72z8d1iZ4uBZK7QNx1jZ7jUGiQ=/206x305/v2/https://flxt.tmsimg.com/assets/p12016433_p_v10_aa.jpg,Attack on Titan: End of the World,1000,8,2015.0,Action/Fantasy,0 days 01:30:00.000000000,14
50,89,https://resizing.flixster.com/MWQcUB1LZ-zCdhoJJ-tBt2inXcI=/206x305/v2/https://resizing.flixster.com/FWQUY_w3owezMJ57VLhZkylNblA=/ems.ZW1zLXByZC1hc3NldHMvbW92aWVzL2I5ODJmYTM0LTg5NGUtNGY3ZS1iZGQ1LTlhYTY3ZDc5MjEyNS53ZWJw,Antarctica: Ice and Sky,250,28,2015.0,Documentary,0 days 01:29:00.000000000,39
59,71,https://resizing.flixster.com/pYV5FvKhB2sMZBNmsBAJZ6Rf-Qk=/206x305/v2/https://resizing.flixster.com/pgJfsalsSp4Ub-QkMI7tr23Z5B0=/ems.ZW1zLXByZC1hc3NldHMvbW92aWVzL2U1OGJjYzExLTViODMtNGY0ZC1iNGYyLTZlOWYxN2JiZjJhZC53ZWJw,The Commune,500,94,2016.0,Drama,0 days 01:52:00.000000000,12
46,58,https://resizing.flixster.com/QzFH1UQh8bX5n3O53vSeVv3WVEE=/206x305/v2/https://flxt.tmsimg.com/assets/p12397099_p_v10_aa.jpg,David Brent: Life on the Road,2500,77,2016.0,Comedy/Musical,0 days 01:36:00.000000000,12
28,23,,The Adderall Diaries,500,35,2015.0,Drama,0 days 01:27:00.000000000,-5
44,71,https://resizing.flixster.com/LJc0QhAX_3Ct6SCA_-noRt7C6I8=/206x305/v2/https://resizing.flixster.com/HBHVCQSUo-weWU4OpBSEgNWByjw=/ems.ZW1zLXByZC1hc3NldHMvbW92aWVzL2Y5ZjYwNjdmLTMxZjQtNDUzZC1hOTJiLTNiMzg4NjAyYjEyMi53ZWJw,Reset,100,17,2015.0,Documentary,0 days 01:50:00.000000000,27
47,44,https://resizing.flixster.com/_JQe7rdr1yrPFzdt7UdU3yCpkwQ=/206x305/v2/https://resizing.flixster.com/9VWUrwiNAY39PhpMI1FpufG0znw=/ems.ZW1zLXByZC1hc3NldHMvbW92aWVzLzIwMWYxNDQ3LTU5NWItNDhlYS1hOTkxLTdjMDg0NDQ4MTM0NS53ZWJw,The Debt,100,9,2015.0,Mystery and thriller,0 days 01:39:00.000000000,-3
64,96,https://resizing.flixster.com/vxORxbFIwnF3azlTo1vhmHRd7s8=/206x305/v2/https://flxt.tmsimg.com/assets/p12123501_p_v10_aa.jpg,Heart of a Dog,2500,90,2015.0,Documentary,0 days 01:15:00.000000000,32
68,86,,Parched,250,22,2015.0,Drama,0 days 01:56:00.000000000,18
55,70,,Len and Company,100,10,2015.0,Comedy/Drama,0 days 01:42:00.000000000,15
53,90,https://resizing.flixster.com/N6LDYIiYaqz_uaR1Ckk3ln87538=/206x305/v2/https://flxt.tmsimg.com/assets/p13117994_p_v10_ab.jpg,Downriver,50,10,2015.0,Gay and lesbian/Drama,0 days 01:39:00.000000000,37
50,73,https://resizing.flixster.com/BE2RvKYU17E-JZZe6BPAFXT0pGM=/206x305/v2/https://resizing.flixster.com/bVT0KKpiHEplOEYtmQ1zOR3Jf0M=/ems.ZW1zLXByZC1hc3NldHMvbW92aWVzL2JjMDNjNDZmLTcyYTItNGE1ZS1iNTllLWI3OTQ3YmEzNjkxOS53ZWJw,The Blackcoat's Daughter,2500,70,2015.0,Horror/Mystery and thriller,0 days 01:33:00.000000000,23
45,42,,Gold,5000,186,2016.0,Drama/Adventure,0 days 02:00:00.000000000,-3
58,89,,A Bigger Splash,5000,182,2015.0,Drama/Mystery and thriller,0 days 02:05:00.000000000,31
60,90,,My Great Night,100,21,2015.0,Comedy,0 days 01:38:00.000000000,30
37,44,,Song to Song,5000,131,2017.0,Romance/Drama,0 days 02:09:00.000000000,7
44,73,,Blinky Bill the Movie,100,11,2015.0,Animation/Comedy,0 days 01:33:00.000000000,29
59,28,,Fathers and Daughters,1000,50,2015.0,Drama,0 days 01:56:00.000000000,-31
51,72,https://resizing.flixster.com/qI9T_or7Fq_90K3P2OpyeXmQOz8=/206x305/v2/https://resizing.flixster.com/r3c0IRruYeaJctYbuhEhEVpKplg=/ems.ZW1zLXByZC1hc3NldHMvbW92aWVzL2RjYjlmZmMxLThlOWEtNGUxZi05MDViLWU5OGY0YWE0MTRkMi53ZWJw,Disorder,1000,79,2015.0,Drama/Mystery and thriller,0 days 01:41:00.000000000,21
82,95,,Eye in the Sky,25000,219,2015.0,Drama/Mystery and thriller,0 days 01:42:00.000000000,13
71,63,,The Man Who Knew Infinity,10000,130,2015.0,Drama/History,0 days 01:54:00.000000000,-8
45,31,,Septembers of Shiraz,250,13,2015.0,Drama/Mystery and thriller,0 days 01:50:00.000000000,-14
73,88,,Born to Be Blue,5000,118,2015.0,Drama/History,0 days 01:37:00.000000000,15
47,83,https://resizing.flixster.com/aWAIPe8zZl3BapZu1wRdeoDxV9A=/206x305/v2/https://resizing.flixster.com/OEKccHhxjFJVHWhJRDB4lqa7kQ4=/ems.ZW1zLXByZC1hc3NldHMvbW92aWVzL2NlNWFkOTFjLWM3ZWItNDdmMi04MGU2LTRlNGUxMmI5ZWIwZS53ZWJw,The Family Fang,2500,82,2015.0,Comedy/Drama,0 days 01:46:00.000000000,36
21,18,,The Girl in the Photographs,250,22,2015.0,Horror/Mystery and thriller,0 days 01:35:00.000000000,-3
54,52,,Hardcore Henry,10000,147,2015.0,Action/Sci fi,0 days 01:35:00.000000000,-2
43,76,,Into the Forest,5000,51,2015.0,Drama/Mystery and thriller,0 days 01:41:00.000000000,33
44,83,https://resizing.flixster.com/TlQSQ16fESovm3qVLM-vkf2fiIM=/206x305/v2/https://resizing.flixster.com/dmwgYg_c8AHea26xHfja-5EfG8c=/ems.ZW1zLXByZC1hc3NldHMvbW92aWVzL2Q0Njk1YmYyLTI5M2QtNGVjMC1iYmU0LWMwMTZjODY3ZjI4Yy53ZWJw,Evolution,2500,63,2015.0,Mystery and thriller/Horror,0 days 01:21:00.000000000,39
68,88,,Neon Bull,250,50,2015.0,Drama,0 days 01:43:00.000000000,20
50,81,https://resizing.flixster.com/i9te5hDbjdpWHJAxdjkPcQYy7-E=/206x305/v2/https://resizing.flixster.com/C7LOQ_68-RKBg-CS5kYK34uqSAQ=/ems.ZW1zLXByZC1hc3NldHMvbW92aWVzLzNkZjQ3NTRlLTM4NDAtNDc2YS04YmExLWRlYmQyNmJmMWQ1NC53ZWJw,Sunset Song,2500,115,2015.0,Drama/History,0 days 02:15:00.000000000,31
38,74,,11 Minutes,100,19,2015.0,Mystery and thriller,0 days 01:21:00.000000000,36
52,83,https://resizing.flixster.com/EZEzE3sXSkWnQai6bJSJsli-r_E=/206x305/v2/https://resizing.flixster.com/w-3QWKpvYvgqVwyClTDuMCAiGz8=/ems.ZW1zLXByZC1hc3NldHMvbW92aWVzL2NhN2Q3OTJhLWViYzctNGVmYi04NTgxLTM3ZDk1YzgwMjQwOS53ZWJw,Born to Dance,50,6,2015.0,Drama/Music,0 days 01:36:00.000000000,31
60,63,,A Month of Sundays,50,19,2015.0,Comedy/Drama,0 days 01:49:00.000000000,3
47,50,,No Men Beyond This Point,100,8,2015.0,Comedy/Sci fi,0 days 01:20:00.000000000,3
47,76,https://resizing.flixster.com/AhDbyf8ZgAm0NWdDHhmwnJWCgw0=/206x305/v2/https://resizing.flixster.com/1s9RhEnKx4SjgxwSla6k9YnvSlI=/ems.ZW1zLXByZC1hc3NldHMvbW92aWVzLzkxMjNiMzZhLTNiM2EtNDVhOC1hOGVhLTJkMWRiZmM4MDMyMi53ZWJw,The Ones Below,2500,49,2015.0,Mystery and thriller,0 days 01:27:00.000000000,29
44,33,,The Steps,50,6,2015.0,Comedy,0 days 01:38:00.000000000,-11
65,91,,Presenting Princess Shaw,250,46,2015.0,Documentary,0 days 01:20:00.000000000,26
76,58,,Urban Hymn,50,26,2015.0,Drama/Music,0 days 01:54:00.000000000,-18
53,85,,River,250,13,2015.0,Mystery and thriller,0 days 01:35:00.000000000,32
36,60,https://resizing.flixster.com/-C2Zs1OXFC7HpyYKIEUky5AW8ys=/206x305/v2/https://resizing.flixster.com/6t_nlGjwXHqXNEOs_wx6sjD-3q0=/ems.ZW1zLXByZC1hc3NldHMvbW92aWVzL2M0NGU5ZjI3LTE3YTEtNDc4Ni05MWFiLTM3N2RmODFlM2Q2ZC53ZWJw,High-Rise,10000,221,2015.0,Horror/Comedy,0 days 01:59:00.000000000,24
74,97,,Ixcanul,1000,39,2015.0,Drama,0 days 01:33:00.000000000,23
34,62,https://resizing.flixster.com/-gymo4bt0J6a7dhM42d8UkMAUTE=/206x305/v2/https://resizing.flixster.com/B6UsCRDJkglJkvABMLfBYeDKLAY=/ems.ZW1zLXByZC1hc3NldHMvbW92aWVzL2JlMTE4ZjdlLWY5MjctNDdiYy1iZWQ4LThjYjk4OTBmNzc2NS53ZWJw,The Mind's Eye,250,26,2015.0,Sci fi/Action,0 days 01:27:00.000000000,28
29,88,,Night of the Living Deb,100,8,2015.0,Comedy,0 days 01:25:00.000000000,59
19,35,,Hunted,50,20,2015.0,Mystery and thriller/Action,0 days 01:44:00.000000000,16
57,77,https://resizing.flixster.com/ZwkKqaIZWV6Gb7jLrK3IS0yLaQE=/206x305/v2/https://resizing.flixster.com/A8iDH91jbXrUlq6rUTHsGCOrl4Q=/ems.ZW1zLXByZC1hc3NldHMvbW92aWVzLzBkOTA1YmJkLTdjNjgtNGNkNC05NmQyLWQ2ODg4MTVkYzVjOS53ZWJw,Elvis & Nixon,5000,154,2016.0,Comedy,0 days 01:26:00.000000000,20
47,67,https://resizing.flixster.com/1Ry6GIB5uHCMYL9OSAenXlheBY0=/206x305/v2/https://resizing.flixster.com/RxaGgZIZ4k80ns6b03t_gxyScLE=/ems.ZW1zLXByZC1hc3NldHMvbW92aWVzLzZkZDQ5N2RmLWRmYmYtNDcxZC1hZjYwLTNlNjMzZDMwM2M2Mi53ZWJw,The Automatic Hate,100,12,2015.0,Comedy/Drama,0 days 01:38:00.000000000,20
88,92,https://resizing.flixster.com/zAn4BiXTFBs0EMmwvYbqGuIR9ho=/206x305/v2/https://flxt.tmsimg.com/assets/p12150047_p_v10_aq.jpg,Land of Mine,2500,107,2015.0,History/War,0 days 01:40:00.000000000,4
70,100,,Golden Kingdom,250,7,2015.0,Drama,0 days 01:44:00.000000000,30
51,39,https://resizing.flixster.com/ouDSv6gTRj3oU7A6qICoZR3LjqQ=/206x305/v2/https://resizing.flixster.com/dJKV38Mi6MoA8y8ghZujPUgtbnQ=/ems.ZW1zLXByZC1hc3NldHMvbW92aWVzL2I5MTY2NjA5LTU5NGUtNGE2Ny1iOTI2LTI3YTYzYzQyYmRmYS53ZWJw,Why Him?,10000,156,2016.0,Other/Comedy,0 days 01:51:00.000000000,-12
61,78,,Band of Robbers,1000,27,2015.0,Comedy,0 days 01:35:00.000000000,17
48,44,,The Girl on the Train,25000,308,2016.0,Mystery and thriller,0 days 01:52:00.000000000,-4
54,89,https://resizing.flixster.com/rQAsW2KfObtKFNKnMG2j8dg-MYc=/206x305/v2/https://resizing.flixster.com/pJxMqaMfC-BCg5JBcvQ8FI4glcU=/ems.ZW1zLXByZC1hc3NldHMvbW92aWVzLzA2YmFkZGQyLWY1NjQtNDBkOC1iOGFiLWFiOTkxOGM4ZWVmOS53ZWJw,The Childhood of a Leader,1000,66,2015.0,Drama/Mystery and thriller,0 days 01:55:00.000000000,35
28,50,https://resizing.flixster.com/RmyC3a40V_JMogikGHmOhHiQhWo=/206x305/v2/https://flxt.tmsimg.com/assets/p12037369_p_v8_aa.jpg,Viral,500,14,2016.0,Horror/Mystery and thriller,0 days 01:29:00.000000000,22
58,16,https://resizing.flixster.com/2QxvPmyCCKaLDa5_4E5WjWgMD34=/206x305/v2/https://resizing.flixster.com/654otPwoACbAH0YbYvVlUCMnWZQ=/ems.ZW1zLXByZC1hc3NldHMvbW92aWVzL2FkZGU0NWJlLTE0OGEtNGM4NC05MTUyLWMyZDk3NWRkZTBlNC53ZWJw,Man Down,2500,55,2015.0,Drama/Mystery and thriller,0 days 01:30:00.000000000,-42
18,58,,Bite,250,19,2015.0,Horror,0 days 01:28:00.000000000,40
9,80,,The Demolisher,1,5,2015.0,Action/Horror,0 days 01:25:00.000000000,71
49,95,,The Similars,250,20,2015.0,Horror/Sci fi,0 days 01:29:00.000000000,46
74,67,,The Bounce Back,1000,6,2016.0,Romance,0 days 01:44:00.000000000,-7
72,81,https://resizing.flixster.com/VF6k26zuq-rBy08uEd5jXaxk1x0=/206x305/v2/https://flxt.tmsimg.com/assets/p12433541_p_v10_al.jpg,Closet Monster,1000,32,2015.0,Gay and lesbian/Drama,0 days 01:30:00.000000000,9
85,82,https://resizing.flixster.com/-9FRYLCfGkg0Ew6-Fc6DSPpr4cs=/206x305/v2/https://resizing.flixster.com/DtzlZsbPyHlb5zHKzISUkYuCXPo=/ems.ZW1zLXByZC1hc3NldHMvbW92aWVzLzcyMmVlOGNlLTJiZjItNDJiOC1hN2U4LTc0MWU4ZjYxMTZmYy53ZWJw,Captain Fantastic,10000,227,2016.0,Comedy/Drama,0 days 01:59:00.000000000,-3
45,47,,Sand Castle,500,17,2017.0,Drama/War,0 days 01:53:00.000000000,2
53,0,https://resizing.flixster.com/izwSnv-ybN6DfEVOTIuGD7SOPao=/206x305/v2/https://flxt.tmsimg.com/assets/p12243771_p_v10_ab.jpg,Christmas Eve,500,10,2015.0,Other/Drama,0 days 01:36:00.000000000,-53
57,74,https://resizing.flixster.com/t9Szd3vSM8puRHmvLkgFeDcc7uI=/206x305/v2/https://resizing.flixster.com/8zxhKKwkXn9Pj2AHggLyKQib7VA=/ems.ZW1zLXByZC1hc3NldHMvbW92aWVzL2E0YzU0MjQ3LTI0NmYtNDI4NC1hMDgxLTU2ZTQ0MWZjZmY5Yi53ZWJw,Miles Ahead,5000,179,2016.0,Drama/Music,0 days 01:36:00.000000000,17
61,75,,Lights Out,25000,178,2016.0,Horror/Mystery and thriller,0 days 01:17:00.000000000,14
38,58,https://resizing.flixster.com/PR-SAdiI3hDcO09va1459pubzhk=/206x305/v2/https://resizing.flixster.com/MG0zIq9dlEcxTYWY9yekZbKAEXs=/ems.ZW1zLXByZC1hc3NldHMvbW92aWVzLzRhNTM1YzdjLWEyNmYtNGFmZS1hYTgxLTc3ODcyZWVjNmY3Yy53ZWJw,Bleak Street,1,24,2015.0,Drama,0 days 01:40:00.000000000,20
79,77,https://resizing.flixster.com/ZHQCuzuIQhOyuccLUPZYWtA-lVg=/206x305/v2/https://resizing.flixster.com/9596MSlE4LXLTIriLDgbpnVdJIE=/ems.ZW1zLXByZC1hc3NldHMvbW92aWVzLzliM2RmZWJhLWQwZGQtNGViYi1hNzg2LTZhMTcyMTM5YTU4NC53ZWJw,Split,50000,308,2016.0,Horror/Mystery and thriller,0 days 01:57:00.000000000,-2
65,78,,Bridget Jones's Baby,10000,211,2016.0,Romance,0 days 02:02:00.000000000,13
63,69,,Lucha Mexico,100,13,2015.0,Documentary,0 days 01:45:00.000000000,6
25,27,,The Rocky Horror Picture Show: Let's Do the Time Warp Again,500,41,2016.0,,,2
46,63,,Desierto - Border Sniper,2500,92,2015.0,Action/Drama,0 days 01:30:00.000000000,17
94,80,,"Look at Us Now, Mother!",100,10,2015.0,Documentary/Comedy,0 days 01:26:00.000000000,-14
83,87,https://resizing.flixster.com/1Mym194IDPBFmaPd4SsyW81LcH8=/206x305/v2/https://resizing.flixster.com/61J2vY88X80yehMmNITj4UnrqRo=/ems.ZW1zLXByZC1hc3NldHMvbW92aWVzLzA1NzY5YjVhLTZjOTMtNGFlOC1hNTQ5LTJlZjA2MDk4NzMyZi53ZWJw,All the Way,2500,46,2016.0,Drama/Biography,0 days 02:12:00.000000000,4
46,87,https://resizing.flixster.com/rI4_wnvX5xV8mSbygwBquCKrnRo=/206x305/v2/https://resizing.flixster.com/J-_10F3FnIoLsKfigkbHqR6uLTc=/ems.ZW1zLXByZC1hc3NldHMvbW92aWVzL2U4MWRiYWU5LTNjM2MtNGQzZS05NzVhLTVhMzRhNjM2YzUyNC53ZWJw,Francofonia,1000,75,2015.0,Documentary/Drama,0 days 01:27:00.000000000,41
43,68,,"Rabin, the Last Day",100,19,2015.0,Drama,0 days 02:33:00.000000000,25
47,59,,Klown Forever,100,17,2015.0,Comedy,0 days 01:39:00.000000000,12
52,86,https://resizing.flixster.com/6Bop3sFv96qFU5yVfA_1xzaFuuU=/206x305/v2/https://resizing.flixster.com/1C9fK_V0gztHsDrVdfKAB-yCXzg=/ems.ZW1zLXByZC1hc3NldHMvbW92aWVzL2NiMDk1ZWM5LThmOTEtNDY0YS05ZGVkLTkwNWQ3NGIxMjZlZi53ZWJw,Maggie's Plan,5000,183,2015.0,Romance,0 days 01:38:00.000000000,34
77,92,,Tanna,500,39,2015.0,Romance/Drama,0 days 01:44:00.000000000,15
65,97,,Mavis!,100,32,2015.0,Music/Biography,0 days 01:20:00.000000000,32
31,22,,Ithaca,250,18,2015.0,Drama,0 days 01:36:00.000000000,-9
85,67,https://resizing.flixster.com/ZZPUOl8ExcVYRaySw-1VahRYaOc=/206x305/v2/https://resizing.flixster.com/m7k6LYhwB1upjDQvZUMmWtDoDeQ=/ems.ZW1zLXByZC1hc3NldHMvbW92aWVzLzFiNjk1YjJjLTFmNmQtNGYzOS04ZmEzLWQwN2JiN2Q1MDc3NS53ZWJw,Greater,2500,15,2016.0,Drama/Biography,0 days 02:10:00.000000000,-18
71,45,,Uncle Nick,250,11,2015.0,Comedy,0 days 01:33:00.000000000,-26
25,42,,Aftermath,2500,55,2017.0,Drama/Mystery and thriller,0 days 01:32:00.000000000,17
29,27,,Five Nights in Maine,100,30,2015.0,Drama,0 days 01:24:00.000000000,-2
34,32,https://resizing.flixster.com/xQLkOwnc7auiUPiwgFZU2VV4N50=/206x305/v2/https://resizing.flixster.com/6yarmcxKiDwros9jBCAsn6DNprc=/ems.ZW1zLXByZC1hc3NldHMvbW92aWVzLzI0NDFhNzA2LWE0MDctNGJlYy05Zjk2LTMxN2U0ZGVjMjQ4MS53ZWJw,The Whole Truth,500,31,2016.0,Crime/Drama,0 days 01:33:00.000000000,-2
71,83,,Denial,5000,166,2016.0,Drama,0 days 01:50:00.000000000,12
81,86,https://resizing.flixster.com/ZkbZ33QqgdtOM7sKqA6FwQV8xjA=/206x305/v2/https://resizing.flixster.com/6YGUWEGpSI5ZvB60YdL3DOvc6Q4=/ems.ZW1zLXByZC1hc3NldHMvbW92aWVzLzdjYWY1MmIzLWViMjQtNDA5My1iOTkwLTliZGE0MmYwNmU1MS53ZWJw,Okja,10000,237,2017.0,Drama/Sci fi,0 days 01:58:00.000000000,5
60,100,https://resizing.flixster.com/QRu2gtPpbf8iUolhvtqSvfx6ATw=/206x305/v2/https://resizing.flixster.com/egQevwbcoNmmZZpsHbWnvWTKVZI=/ems.ZW1zLXByZC1hc3NldHMvbW92aWVzLzQ5YzAzMjY2LWEyMjItNGUwNC05MmRiLWUyOGJjNDZiZWEyNi53ZWJw,The Dresser,250,14,2015.0,Drama,0 days 01:45:00.000000000,40
33,24,https://resizing.flixster.com/8Y3Rwh3yNf0kjaHcJhn7XpNbx50=/206x305/v2/https://resizing.flixster.com/fLSKno2ghjdAnPwoUF5kovcsPww=/ems.ZW1zLXByZC1hc3NldHMvbW92aWVzLzc0M2VjNmU4LWU1NTgtNDkxYS04NjhiLTU1MGMxMmZmZWUzOC53ZWJw,Bad Santa 2,10000,135,2016.0,Other/Comedy,0 days 01:32:00.000000000,-9
58,63,,Middle School: The Worst Years of My Life,5000,43,2016.0,Comedy/Kids and family,0 days 01:32:00.000000000,5
72,72,https://resizing.flixster.com/o-xeF4wGycpqvdAe1wLh60OAoSw=/206x305/v2/https://resizing.flixster.com/pEGQkrkn5qwFU-MIjM65s8yspBA=/ems.ZW1zLXByZC1hc3NldHMvbW92aWVzL2Y0NGZmNGRmLTNkNTItNGVmNi1hMzk3LTcxZmU5NTBhYjBlZC53ZWJw,Sing,25000,186,2016.0,Comedy/Kids and family,0 days 01:48:00.000000000,0
37,25,,Sleepless,5000,61,2017.0,Action/Mystery and thriller,0 days 01:35:00.000000000,-12
68,90,,Mountains May Depart,500,84,2015.0,Drama,0 days 02:12:00.000000000,22
49,29,https://resizing.flixster.com/Xxt-v3RA1fIQEdhUhmeu0KzUHkk=/206x305/v2/https://resizing.flixster.com/-KLSpiIEtaZZPQfjMp5SXqhnBcs=/ems.ZW1zLXByZC1hc3NldHMvbW92aWVzLzc5ZTI2NmYzLTUyODctNDkxOC04OTczLTNkYjNlNmI0Njg0ZS53ZWJw,Outlaws and Angels,250,28,2016.0,Western/Drama,0 days 02:00:00.000000000,-20
50,72,,Our Kind of Traitor,5000,142,2016.0,Mystery and thriller,0 days 01:48:00.000000000,22
74,83,,Julieta,2500,200,2016.0,Drama,0 days 01:36:00.000000000,9
72,17,,Meet the Blacks,5000,12,2016.0,Comedy,0 days 01:33:00.000000000,-55
73,35,,A Dog's Purpose,10000,147,2017.0,Fantasy/Comedy,0 days 02:00:00.000000000,-38
56,85,,The Meddler,5000,143,2015.0,Comedy/Drama,0 days 01:40:00.000000000,29
35,47,https://resizing.flixster.com/KdJuCC2lHQo2cpuNpX_4LhmsnoI=/206x305/v2/https://resizing.flixster.com/zzfRcmhtB0YCRaK2MW6iavk0vZ8=/ems.ZW1zLXByZC1hc3NldHMvbW92aWVzLzY3OTk0NGIyLWQxNTctNDBlNi05ODFiLTVhNTVmNzEzYzYyNi53ZWJw,31,2500,45,2016.0,Other/Horror,0 days 01:42:00.000000000,12
41,45,https://resizing.flixster.com/vrhYLjvV7Tc1ZlToVTF5MHPGayY=/206x305/v2/https://resizing.flixster.com/ljXNCt1I1d2teAr0KPaoqqIjfe0=/ems.ZW1zLXByZC1hc3NldHMvbW92aWVzLzNjOTJlNTBmLWFlZmEtNDBmMy1hNjA5LTdkZjRkNzM0ZDQxMi53ZWJw,The Blackout Experiments,50,11,2016.0,Documentary,0 days 01:21:00.000000000,4
33,70,,Antibirth,250,33,2016.0,Horror/Mystery and thriller,0 days 01:34:00.000000000,37
29,61,https://resizing.flixster.com/i4UxdZBzquckX17TdrctlFJiKWo=/206x305/v2/https://resizing.flixster.com/Ntrd9uudFrj65v2rWDdoWbnxKdE=/ems.ZW1zLXByZC1hc3NldHMvbW92aWVzLzJjOTg4MjcxLWE5NzAtNDBlMC1hYTllLWJhOTRhMWNjMjQ4MC53ZWJw,Carnage Park,250,23,2016.0,Action/Horror,0 days 01:20:00.000000000,32
69,38,,Milton's Secret,100,13,2016.0,Drama,0 days 01:28:00.000000000,-31
54,16,,The Space Between Us,10000,137,2017.0,Romance/Adventure,0 days 02:00:00.000000000,-38
33,79,,The Apostate,50,19,2015.0,Comedy,0 days 01:20:00.000000000,46
30,47,,Wilson,2500,131,2017.0,Comedy,0 days 01:34:00.000000000,17
51,38,https://resizing.flixster.com/-SY2YHFyLtJyTbfADkSIB3u8uzc=/206x305/v2/https://resizing.flixster.com/ZnoLg7HTwll4obOjliNPMfnW1_k=/ems.ZW1zLXByZC1hc3NldHMvbW92aWVzLzQ5ZmQ0MTZiLWVhZDQtNGM5MC04NjM4LWI3ZWFhZTFlNDRiOS53ZWJw,Compadres,1000,16,2016.0,Action/Comedy,0 days 01:42:00.000000000,-13
92,95,https://resizing.flixster.com/-a4AGrPNbcGxK-5Z3i_FMwtp5WQ=/206x305/v2/https://resizing.flixster.com/Exx7HQQQGrHPSXuoqm-z3zvEdzU=/ems.ZW1zLXByZC1hc3NldHMvbW92aWVzL2U5MjNjMWM4LWM0MDktNDgxNi04ZDU4LTEyZjQxY2VmNjQwOC53ZWJw,Sing Street,10000,210,2016.0,Romance/Comedy,0 days 01:46:00.000000000,3
71,73,https://resizing.flixster.com/uNyCGs1JExBTXvyOLLDpBaxAVfk=/206x305/v2/https://resizing.flixster.com/gMrk35eFTg9TWTOXYXs-82pWj3A=/ems.ZW1zLXByZC1hc3NldHMvbW92aWVzLzI5NTU4ZGYyLTAxNjgtNGRiNy1iZGUxLTVkMDk0ODAzNmJhYy53ZWJw,The Birth of a Nation,10000,268,2016.0,Drama/History,0 days 01:54:00.000000000,2
22,19,https://resizing.flixster.com/yZ5tiAW7ud7SGSck-10XDy3OzCA=/206x305/v2/https://resizing.flixster.com/vKxIJNQOztFV1peehHZ7IFRLjOM=/ems.ZW1zLXByZC1hc3NldHMvbW92aWVzLzBhZTYxMGRiLTgyZWYtNGI0MS05YWQzLWRkYTJiZmVjMjFmNi53ZWJw,The Bye Bye Man,5000,90,2017.0,Horror/Mystery and thriller,0 days 01:36:00.000000000,-3
46,53,https://resizing.flixster.com/A6W_NO9ZCinkXrqp8w4skMETTlg=/206x305/v2/https://resizing.flixster.com/CqsK3LpB74rqbN8VSE6W3cT0oPQ=/ems.ZW1zLXByZC1hc3NldHMvbW92aWVzLzE5MmZjODBlLTY2OTYtNGYzZi1iYTBhLTg2MDFlMDc5NmVhNi53ZWJw,Genius,2500,110,2016.0,,,7
62,94,,Colliding Dreams,100,17,2015.0,Documentary,0 days 02:15:00.000000000,32
86,93,https://resizing.flixster.com/ZJIJrqmq6-nASkh8WiXx_tfd0Ik=/206x305/v2/https://resizing.flixster.com/TX5awm7jgyVlBJySyfsWODBU87k=/ems.ZW1zLXByZC1hc3NldHMvbW92aWVzLzUwZTk4Nzg1LTdjZWUtNGY1My05Y2NkLTIyYmQ2YmM2ODljZi53ZWJw,The Eagle Huntress,5000,128,2016.0,Documentary,0 days 01:27:00.000000000,7
67,86,,Norman Lear: Just Another Version of You,250,43,2016.0,Documentary,0 days 01:31:00.000000000,19
68,93,https://resizing.flixster.com/8Z4Hpn4dQxAqByMlWEHwikgxMo8=/206x305/v2/https://resizing.flixster.com/SY5L0ze-qKBdWs5gTEFJztUCAfY=/ems.ZW1zLXByZC1hc3NldHMvbW92aWVzLzg4MzNjZDZmLTAwYjgtNGM1MC1iNjc3LTg0MzQ4MGVjZjc5ZC53ZWJw,"Lo and Behold, Reveries of the Connected World",5000,141,2016.0,Documentary,0 days 01:38:00.000000000,25
60,64,,Sophie and the Rising Sun,100,11,2016.0,Romance/Drama,0 days 01:56:00.000000000,4
24,51,,Complete Unknown,500,76,2016.0,Drama/Mystery and thriller,0 days 01:31:00.000000000,27
81,94,,"Life, Animated",2500,117,2016.0,Documentary,0 days 01:31:00.000000000,13
73,81,https://resizing.flixster.com/hEdnCZk7o9fS4y6GYzNly1CAsIg=/206x305/v2/https://resizing.flixster.com/UaKmK3wGoGrnjEEZ46SYPQPjRyw=/ems.ZW1zLXByZC1hc3NldHMvbW92aWVzL2IwODA0ZGI2LTMzNzMtNDE0Ny05NDE3LThkYmM1MWY0NGZhYy53ZWJw,Audrie & Daisy,500,16,2016.0,Documentary,0 days 01:30:00.000000000,8
69,85,https://resizing.flixster.com/4i-ubulZMoVs4MSbClLhk-6s6FA=/206x305/v2/https://resizing.flixster.com/zC5lSHx3xCM9I88lgUIQAq3aj-U=/ems.ZW1zLXByZC1hc3NldHMvbW92aWVzL2NjMDI2YmMyLTBlNTEtNDk1Ni05MTJiLWM1NmU1ZjMzZjIyMC53ZWJw,Tallulah,2500,54,2016.0,Drama,0 days 01:51:00.000000000,16
72,72,https://resizing.flixster.com/aYPGSMTtz8sfpAPnrV2e6gW22ys=/206x305/v2/https://resizing.flixster.com/xXOMHLsOAN8riPEExr6k9oSTexE=/ems.ZW1zLXByZC1hc3NldHMvbW92aWVzLzNhNTBhMmI3LTAwNjUtNDA3OS1hN2RlLTEyMjczODU3NWQxNi53ZWJw,Swiss Army Man,10000,209,2016.0,Comedy/Fantasy,0 days 01:35:00.000000000,0
49,78,https://resizing.flixster.com/0-_7nPf4c5-jv3UrdrYoXpByNK0=/206x305/v2/https://resizing.flixster.com/0bGjb0HKD2P4aevNzNk9RtEQdMc=/ems.ZW1zLXByZC1hc3NldHMvbW92aWVzLzA4NmIwNmUxLTM3NTktNDJmZS1iYmJlLTQ1YjNjMGRiYzdlNi53ZWJw,The Intervention,1000,51,2016.0,Comedy/Drama,0 days 01:30:00.000000000,29
54,50,,The Free World,100,20,2016.0,Romance/Drama,0 days 01:40:00.000000000,-4
64,85,https://resizing.flixster.com/eON03MaKE4psj6cgrEiUyFWy6rI=/206x305/v2/https://resizing.flixster.com/fmVDwVv7p6SrwjVGZWtk7CAOvis=/ems.ZW1zLXByZC1hc3NldHMvbW92aWVzLzliOTkwNzA3LWJiOGItNDViZC1iZmVmLWFiODAyZTVkNTk5MS53ZWJw,Imperium,5000,73,2016.0,Crime/Drama,0 days 01:48:00.000000000,21
59,94,,Richard Linklater: Dream Is Destiny,250,31,2016.0,Documentary,0 days 01:30:00.000000000,35
78,96,,Manchester by the Sea,50000,350,2016.0,Drama,0 days 02:17:00.000000000,18
74,81,https://resizing.flixster.com/cBc2biwpPLM1b5_nAxh0TpIVrUY=/206x305/v2/https://resizing.flixster.com/HKJ7ofaGRG6llSpGKUtn4dTbDNQ=/ems.ZW1zLXByZC1hc3NldHMvbW92aWVzL2E0ZTZmOTlmLWNhMWYtNDI4Mi1iOTAyLTAwYmZkMTk5NWY4OC53ZWJw,Indignation,5000,135,2016.0,Drama,0 days 01:50:00.000000000,7
42,69,,Frank & Lola,1000,42,2016.0,Romance/Drama,0 days 01:28:00.000000000,27
68,99,https://resizing.flixster.com/WPda2V1RhUmznew2nhfdt3wTet8=/206x305/v2/https://flxt.tmsimg.com/NowShowing/160266/160266_aa.jpg,Cameraperson,500,106,2016.0,Documentary,0 days 01:42:00.000000000,31
83,97,https://resizing.flixster.com/sjFUc4REO1tA1Ypdb5uJ4UcrJJM=/206x305/v2/https://resizing.flixster.com/bc3O86_VFTOijmRGg093FQAmWC8=/ems.ZW1zLXByZC1hc3NldHMvbW92aWVzL2MxZGQ4MDBhLWVmZGEtNDBiZi1iOWQxLTViNTQwMmIwYzI3Ny53ZWJw,Weiner,5000,176,2016.0,Documentary,0 days 01:36:00.000000000,14
68,94,,Newtown,250,36,2016.0,Documentary/Drama,0 days 01:25:00.000000000,26
90,96,https://resizing.flixster.com/cmuhIoPCEM-YpBaMsTXf4bevato=/206x305/v2/https://resizing.flixster.com/8Wd-qZZxpooUOU-Elt-OisxGsFA=/ems.ZW1zLXByZC1hc3NldHMvbW92aWVzL2U1YzI0ZDJkLTU2NzgtNGUxMy1iM2UxLThkMTNmN2I5OGJiMi53ZWJw,Gleason,2500,69,2016.0,Documentary,0 days 01:51:00.000000000,6
62,77,https://resizing.flixster.com/Y-OLKURChdvQZ77L_8Hv5aM6t0s=/206x305/v2/https://flxt.tmsimg.com/assets/p12951356_p_v10_ab.jpg,Author: The JT LeRoy Story,250,91,2016.0,Documentary,0 days 01:50:00.000000000,15
54,81,https://resizing.flixster.com/V6ywEbVkk-oHukZRLmB32oNGoaU=/206x305/v2/https://resizing.flixster.com/avXd8JsywmuDjvG3bUNVp9OuzUw=/ems.ZW1zLXByZC1hc3NldHMvbW92aWVzL2Y0NGM3NzZjLWFjMWMtNGVlNi1iYzg2LTVhNzcwOTVkNjM5Zi53ZWJw,Joshy,500,26,2016.0,Comedy/Drama,0 days 01:33:00.000000000,27
45,79,https://resizing.flixster.com/KxdU2H_f_5yN4_RiuSqF-m8eDmc=/206x305/v2/https://resizing.flixster.com/owAe0NDQpV1qEfFvATyuHALxWy4=/ems.ZW1zLXByZC1hc3NldHMvbW92aWVzLzA2Y2VlYTExLTFhNDYtNDRiNy05MGU4LWEwZjcyNTI3OTVmYy53ZWJw,Goat,2500,77,2016.0,Drama,0 days 01:36:00.000000000,34
52,81,https://resizing.flixster.com/0K_8y8BTjXKXAu6NuTfoeCkcNxM=/206x305/v2/https://resizing.flixster.com/EtIyEy1AG-_2gWFuXy2AZRiVTps=/ems.ZW1zLXByZC1hc3NldHMvbW92aWVzLzY5NWJlMjI4LWVmM2YtNGI0Mi1hNmI5LWFiOWNkMjRlZTk4Ni53ZWJw,Equity,2500,100,2016.0,Drama/Mystery and thriller,0 days 01:40:00.000000000,29
63,97,,Little Men,5000,143,2016.0,Drama,0 days 01:25:00.000000000,34
61,70,https://resizing.flixster.com/ID6VQZULvRoCe_qcAyuzXJsc8Gw=/206x305/v2/https://resizing.flixster.com/XysV-r2wnu-__fW-gBWkD8EMQvE=/ems.ZW1zLXByZC1hc3NldHMvbW92aWVzL2U0N2Y0N2FmLWVlMjMtNGM0Ny05ZThjLTgzMzk4MTExMmEyMi53ZWJw,The Land,500,20,2016.0,Crime/Drama,0 days 01:41:00.000000000,9
71,88,https://resizing.flixster.com/jpnE4PQd3QlZg4Qw3UnjEaEW1Qg=/206x305/v2/https://resizing.flixster.com/NzyF4YE3Ej0lpx47Uu6lNCbNOB0=/ems.ZW1zLXByZC1hc3NldHMvbW92aWVzLzI2YzQ5OGVmLTZmZDYtNDU1YS1iMWY5LTBhZTQ2Njc1ZTk2ZS53ZWJw,Christine,5000,126,2016.0,Drama/Biography,0 days 01:59:00.000000000,17
60,87,,Jackie,25000,354,2016.0,Drama/History,0 days 01:39:00.000000000,27
46,20,https://resizing.flixster.com/W-gBRijxLJV-w-L8xTeIKMs5sXs=/206x305/v2/https://flxt.tmsimg.com/assets/p12613356_p_v10_aa.jpg,Who's Driving Doug,50,5,2016.0,Drama,0 days 01:39:00.000000000,-26
83,94,,The Edge of Seventeen,25000,215,2016.0,Comedy/Drama,0 days 01:45:00.000000000,11
63,58,https://resizing.flixster.com/95LnPP2XGqdctSLRxqzP8JQiv-4=/206x305/v2/https://resizing.flixster.com/R4_Rc9BA-l90WlREf8pZECLgh_U=/ems.ZW1zLXByZC1hc3NldHMvbW92aWVzL2MxMDdmZTdkLTNkMGEtNGMyNy05NDY0LTEwMDM3ZjdlNzI1Mi53ZWJw,Bad Moms,25000,171,2016.0,Comedy,0 days 01:41:00.000000000,-5
72,96,https://resizing.flixster.com/UI6237YtzkTj65oclKJWvo4SjYg=/206x305/v2/https://resizing.flixster.com/p79fgn_5Xm5Gs5An2aF5FIr4WKc=/ems.ZW1zLXByZC1hc3NldHMvbW92aWVzL2MxYzRjZDgyLWNjNWMtNGE2My1iMjgxLWY3ZjQ3NjlhM2I3Yy53ZWJw,Paterson,10000,262,2016.0,Comedy/Drama,0 days 01:58:00.000000000,24
53,69,,Operation Avalanche,1000,62,2016.0,Drama/Mystery and thriller,0 days 01:34:00.000000000,16
53,19,https://resizing.flixster.com/ral8vXv3UyXNcHFq1o075a1mHiQ=/206x305/v2/https://resizing.flixster.com/Zbl6oWCvwidKQzd2HnToODzc15k=/ems.ZW1zLXByZC1hc3NldHMvbW92aWVzLzgzN2JlNzUwLTc3MmQtNDI3Mi1iNTUxLTMzNThmYjliMTBiOC53ZWJw,Tyler Perry's Boo! A Madea Halloween,10000,43,2016.0,Other/Adventure,0 days 01:43:00.000000000,-34
45,18,https://resizing.flixster.com/q64aZYDmq9D6zE4H-jjfQFobqwI=/206x305/v2/https://flxt.tmsimg.com/assets/p13023821_p_v10_ba.jpg,CHIPS,10000,111,2017.0,Comedy/Action,0 days 01:41:00.000000000,-27
51,100,https://resizing.flixster.com/u9P4uUza-2NMTbNQqlr-atYgZlU=/206x305/v2/https://resizing.flixster.com/dxSWXtN55TaJLzEkvZK0jX-Sx-M=/ems.ZW1zLXByZC1hc3NldHMvbW92aWVzL2ZmZmE5OWQ4LTY5OTYtNGUwMC1iNDAzLWIxOTM5OTdmM2JmYy53ZWJw,The Monkey King 2,500,5,2016.0,Action/Fantasy,0 days 01:59:00.000000000,49
60,0,https://resizing.flixster.com/1gUeIqpUICBH-p4Ef54Owpm7Ah0=/206x305/v2/https://resizing.flixster.com/lttIxeksG89pFQswgyFdJtUlSZ8=/ems.ZW1zLXByZC1hc3NldHMvbW92aWVzLzYyM2I2NzZmLWVlOWUtNDViNS05M2EyLWJiOWRkOTlmNGZiOC53ZWJw,Backgammon,1,6,2015.0,Mystery and thriller,0 days 01:29:00.000000000,-60
44,22,,The Perfect Match,2500,18,2016.0,Romance,0 days 01:36:00.000000000,-22
41,58,https://resizing.flixster.com/CkwguVJX9aioVX8GcnQt_PMa_EY=/206x305/v2/https://resizing.flixster.com/Ympc05q2EqPhJrLc_cmxaOCe7m4=/ems.ZW1zLXByZC1hc3NldHMvbW92aWVzL2VmMDI1Y2NhLThhMjUtNGUwNS04ZGY0LTFlODM5NGIyZjJiZC53ZWJw,Absolutely Fabulous: The Movie,5000,154,2016.0,Comedy,0 days 01:26:00.000000000,17
91,97,https://resizing.flixster.com/gwRFY0dagCnFVtBRBK-W6x60mr0=/206x305/v2/https://resizing.flixster.com/kGMGmEsMmeP2n_erPI-n7XuB6P0=/ems.ZW1zLXByZC1hc3NldHMvbW92aWVzLzg3YjBiY2Q5LTYwM2MtNGIzMC04ODg3LTNiMzllZTc5MzdjYy53ZWJw,Hunt for the Wilderpeople,10000,203,2016.0,Comedy/Adventure,0 days 01:41:00.000000000,6
44,9,https://resizing.flixster.com/NkdWCDiyqiXxYMxbcWUTxZ_jQLc=/206x305/v2/https://resizing.flixster.com/e3xKNsJY5s_QTfLBpC9O3hbs4cs=/ems.ZW1zLXByZC1hc3NldHMvbW92aWVzLzY2ODIyMGU5LWZjYjctNDI5Ni04YTkyLWE4NDgzNWQzNjE5ZS53ZWJw,Despite the Falling Snow,100,22,2016.0,Romance/Mystery and thriller,0 days 01:33:00.000000000,-35
76,77,https://resizing.flixster.com/2o8368PmyN_3s_fjqzWaeIvST7Y=/206x305/v2/https://flxt.tmsimg.com/assets/p13259807_p_v10_ac.jpg,A Street Cat Named Bob,2500,65,2016.0,Drama/Biography,0 days 01:43:00.000000000,1
19,3,,The Darkness,5000,33,2016.0,Horror/Mystery and thriller,0 days 01:33:00.000000000,-16
63,79,https://resizing.flixster.com/mrOZjl4euDETLYVUw_x6-EIHbeg=/206x305/v2/https://flxt.tmsimg.com/assets/p13012003_p_v10_aa.jpg,American Honey,5000,214,2016.0,Comedy/Drama,0 days 02:42:00.000000000,16
73,99,,Under the Shadow,2500,91,2016.0,Horror/Mystery and thriller,0 days 01:24:00.000000000,26
54,96,,The Fits,1000,109,2015.0,Drama,0 days 01:12:00.000000000,42
57,78,https://resizing.flixster.com/vb68K-C34aC_lc_Nkh07rH8rAeU=/206x305/v2/https://resizing.flixster.com/onA6FsO6ZUXYKdfIW1sX4ghA3gg=/ems.ZW1zLXByZC1hc3NldHMvbW92aWVzLzFhNWUxYmI4LWI1OWUtNDVmNS1iM2FkLTU3MjRkMDhmMjJkZS53ZWJw,The Eyes of My Mother,2500,100,2016.0,Horror/Drama,0 days 01:16:00.000000000,21
60,95,https://resizing.flixster.com/lcFqlmFfNe31OIynzU6KZmGeFQQ=/206x305/v2/https://resizing.flixster.com/oJR5qDXBc5wjeor2l4mkjTygvJU=/ems.ZW1zLXByZC1hc3NldHMvbW92aWVzL2Y4ZmM2MTk3LThlODAtNDlmMS04OTc5LWEyOTM3ZDVmNzJlZC53ZWJw,The Mermaid,2500,38,2016.0,Comedy/Fantasy,0 days 01:33:00.000000000,35
60,96,https://resizing.flixster.com/IGOOrRtmQzCs4TYOAFBr0Nlxt78=/206x305/v2/https://resizing.flixster.com/Djfo3ybypPD4GDcRzYLgPwMzIIw=/ems.ZW1zLXByZC1hc3NldHMvbW92aWVzLzE0MTdkZjc0LTk4NDgtNDU3ZS05MTMwLTg3YzY1ZjkyNzY3NC53ZWJw,Love & Friendship,10000,213,2016.0,Comedy,0 days 01:33:00.000000000,36
73,87,https://resizing.flixster.com/g5_n3d-V8H4oUoXzuNKyLjc8dlc=/206x305/v2/https://resizing.flixster.com/2KJUoWIC3_78XYF5XopL883d4zE=/ems.ZW1zLXByZC1hc3NldHMvbW92aWVzLzFlMWYzMDFkLTEwNTItNDMzNC1hMWQ1LTk4NzFkYjliYWZhYi53ZWJw,Kicks,1000,39,2016.0,Comedy/Drama,0 days 01:24:00.000000000,14
45,75,https://resizing.flixster.com/0Yli8Sd-AWs1Zo0BDxKNLfANfuc=/206x305/v2/https://resizing.flixster.com/iU39jIILczvu_3-rTBv5utETQ_E=/ems.ZW1zLXByZC1hc3NldHMvbW92aWVzL2Y3NDRiMmI1LWM4ZmEtNDBjYS05NjQxLTQ2MjJmNGZjZWU0YS53ZWJw,Brahman Naman,100,8,2016.0,Comedy,0 days 01:35:00.000000000,30
73,92,,Eat That Question: Frank Zappa in His Own Words,1000,75,2016.0,Documentary/Music,0 days 01:30:00.000000000,19
69,94,,Under the Sun,500,32,2015.0,Documentary,0 days 01:46:00.000000000,25
40,25,https://resizing.flixster.com/b3S5tC9QR5grNICvkAHCOa-fIQg=/206x305/v2/https://resizing.flixster.com/G4huqN2jzlkaok4At_OALbgC_iE=/ems.ZW1zLXByZC1hc3NldHMvbW92aWVzLzFkN2M5ZWVlLTI2MTUtNGRjOC04ZGUwLTk1NDY4MTY2YjhlYi53ZWJw,Fist Fight,10000,133,2017.0,Comedy,0 days 01:31:00.000000000,-15
53,79,https://resizing.flixster.com/hFDfaGEoX_-y4mEIBeg0G1M1FfM=/206x305/v2/https://resizing.flixster.com/OKptLSKpuOqdvqBGUj6jlCc1Dyg=/ems.ZW1zLXByZC1hc3NldHMvbW92aWVzLzg0ZWFkMmNkLWE0YjQtNGYxMi1iZWQ0LWM5Yzk1OTAzZDU5Mi53ZWJw,The Lovers and the Despot,250,76,2016.0,Documentary,0 days 01:35:00.000000000,26
73,13,,"No manches, Frida",2500,8,2016.0,Comedy,0 days 01:40:00.000000000,-60
64,14,https://resizing.flixster.com/ELP2a2TW1sPFmpsBvgVV0hPmvPw=/206x305/v2/https://resizing.flixster.com/NStJx5Y0JPCS5fyAfInnJH7eG1k=/ems.ZW1zLXByZC1hc3NldHMvbW92aWVzL2UxZmMxM2I0LTdkNzMtNDcxNy04NzgxLTE5YWVjOTNlZDVlYi53ZWJw,Collateral Beauty,10000,184,2016.0,Drama/Fantasy,0 days 01:37:00.000000000,-50
55,92,,Ma,1,13,2015.0,Drama,0 days 01:21:00.000000000,37
33,42,https://resizing.flixster.com/QD0FhnU3p8RP_Jp6Gg9DG0C_5z8=/206x305/v2/https://resizing.flixster.com/T-Sa36fYmVtD2L5cZ8E1X-Dl8PE=/ems.ZW1zLXByZC1hc3NldHMvbW92aWVzL2FlM2YxNWE0LWZmMDUtNGJkZS05OTA3LTFkZmY1ZjFkMzRjMi53ZWJw,Awakening the Zodiac,250,12,2017.0,Mystery and thriller,0 days 01:40:00.000000000,9
63,75,,High Strung,500,8,2016.0,Romance/Drama,0 days 01:37:00.000000000,12
37,61,https://resizing.flixster.com/YMBVxOPXAs7B-uWTZQaj-LZa8YM=/206x305/v2/https://resizing.flixster.com/faAOgaxZrafcdq6jSD9KxTzO0zM=/ems.ZW1zLXByZC1hc3NldHMvbW92aWVzLzQxYzNmYzlkLTQzODMtNGIzMi1hYzI5LTIyMDUzN2RjMGVjMS53ZWJw,Dirty Cops - War on Everyone,2500,98,2016.0,Comedy,0 days 01:38:00.000000000,24
24,17,https://resizing.flixster.com/vNwtoeTfQpNFuHfAB5VDc3wGBAI=/206x305/v2/https://flxt.tmsimg.com/assets/p12741049_p_v10_ac.jpg,Incarnate,2500,35,2016.0,Horror/Mystery and thriller,0 days 01:26:00.000000000,-7
71,99,,Things to Come,5000,146,2016.0,Drama,0 days 01:41:00.000000000,28
52,60,,Shepherds and Butchers,50,10,2016.0,Drama,0 days 01:46:00.000000000,8
51,57,https://resizing.flixster.com/pEyPAif0-X0n2tEuRQmNaQugCbE=/206x305/v2/https://resizing.flixster.com/ktErdhxUJZsxKbI1pPcnuecjAU4=/ems.ZW1zLXByZC1hc3NldHMvbW92aWVzL2NiMjgyYjdlLTRmZjAtNDlhYS04OGU3LTdhZjA5NTljNjg5Ny53ZWJw,Alone in Berlin,500,54,2016.0,Drama/History,0 days 01:43:00.000000000,6
75,92,,Zero Days,2500,71,2016.0,Documentary,0 days 01:56:00.000000000,17
72,76,,Miss Sloane,5000,193,2016.0,Drama/Mystery and thriller,0 days 02:12:00.000000000,4
66,95,https://resizing.flixster.com/-H4nsDU_noyO3Hisf7TbBdwkA9k=/206x305/v2/https://resizing.flixster.com/iZEqFFlUcATv3-J2nRCgY5Nu10c=/ems.ZW1zLXByZC1hc3NldHMvbW92aWVzLzFhMzNiOTZjLTUzNzctNGUxMC1hMjBkLWRlZTk1MDU1MjI5ZS53ZWJw,Fire at Sea,1000,94,2016.0,Documentary,0 days 01:48:00.000000000,29
85,89,,John Wick: Chapter 2,50000,276,2017.0,Action/Mystery and thriller,0 days 02:02:00.000000000,4
66,67,,Nerve,10000,141,2016.0,Action/Mystery and thriller,0 days 01:36:00.000000000,1
28,17,,The Wild Life,2500,59,2016.0,Animation/Comedy,0 days 01:30:00.000000000,-11
68,87,https://resizing.flixster.com/cfhjGvMSOewpYNynJsOKb1ycPZ0=/206x305/v2/https://resizing.flixster.com/AIAJd_71ZbDfyC026XWPKmIJYCg=/ems.ZW1zLXByZC1hc3NldHMvbW92aWVzLzhkYTcyMDE0LTYwNDMtNDFiNi1iMTZhLTcwNThhOWY5YmQxZi53ZWJw,Florence Foster Jenkins,10000,229,2016.0,Comedy/Drama,0 days 01:50:00.000000000,19
45,75,,Kill Command,1000,12,2016.0,Action/Sci fi,0 days 01:39:00.000000000,30
69,76,https://resizing.flixster.com/4QgYauHU1wtxBtoxW2jZViNLOmc=/206x305/v2/https://resizing.flixster.com/jalGff1ne-NqjRS0XhzZBsDjbo4=/ems.ZW1zLXByZC1hc3NldHMvbW92aWVzLzQ0ODYyYTY2LWVhZjQtNGI5My04ZjVhLTk2Mzk5OTZhYWZhMC53ZWJw,The First Monday in May,1000,59,2016.0,Documentary,0 days 01:31:00.000000000,7
40,41,https://resizing.flixster.com/LIwhKaXMaid38mDeVmMoE5nzYzQ=/206x305/v2/https://resizing.flixster.com/orRps2NX8noUas08NIYb_QrJjBQ=/ems.ZW1zLXByZC1hc3NldHMvbW92aWVzL2JhMDVhYjdhLWExMjktNDlkMC1iZmJhLThkM2IwNDRlYWI0Zi53ZWJw,Office Christmas Party,10000,185,2016.0,Other/Comedy,0 days 01:45:00.000000000,1
52,45,https://resizing.flixster.com/nTOgSRxz4tFKzBSz4Dm6GRYuK_U=/206x305/v2/https://resizing.flixster.com/LygvrIw6xj8lYM8ORbl786_wGHY=/ems.ZW1zLXByZC1hc3NldHMvbW92aWVzLzFiODI4YzlmLTk3Y2EtNGE3Zi1iZWU4LThmZGFjMGU2ZDkyMS53ZWJw,Hands of Stone,5000,109,2016.0,Drama/History,0 days 01:45:00.000000000,-7
55,44,https://resizing.flixster.com/jsB99F8GL7Cj8mWNB2nXvNu2Ld0=/206x305/v2/https://resizing.flixster.com/X-w-_o6LyDoHRGG9zozpZF8iI-s=/ems.ZW1zLXByZC1hc3NldHMvbW92aWVzLzU2MmZkNWUwLWZkM2MtNDRhMy1hMDQxLWI3NjY5OTJlNGE4OS53ZWJw,Quitters,50,9,2015.0,Comedy/Drama,0 days 01:30:00.000000000,-11
86,81,,Patriots Day,25000,237,2016.0,Crime/Drama,0 days 02:10:00.000000000,-5
36,77,,Slumlord,500,13,2015.0,Horror/Mystery and thriller,0 days 01:27:00.000000000,41
63,77,,And Punching the Clown,250,13,2016.0,Comedy,0 days 01:35:00.000000000,14
16,19,,Dirty Dancing,250,21,2017.0,Romance/Drama,0 days 02:18:00.000000000,3
44,45,,The Discovery,1000,62,2017.0,Romance/Sci fi,0 days 01:50:00.000000000,1
91,84,https://resizing.flixster.com/hf2O00o68KO3iQJC_lEE-okSviY=/206x305/v2/https://resizing.flixster.com/fJLJQ31I0aFkvmoEbg_M8lROdnk=/ems.ZW1zLXByZC1hc3NldHMvbW92aWVzLzUxMDhlMDA4LWZiMWUtNGE2Mi1hYmVmLWNlMzgzYWEwNjM5Yi53ZWJw,Lion,25000,266,2016.0,Drama/Biography,0 days 02:01:00.000000000,-7
32,33,,Bling,50,6,2016.0,Animation/Romance,0 days 01:21:00.000000000,1
29,63,https://resizing.flixster.com/QDvQeRsIVmmXPk5vmZyA0IOtRV4=/206x305/v2/https://resizing.flixster.com/oknIyFWco6W5H_xBr8ckCH-4sqc=/ems.ZW1zLXByZC1hc3NldHMvbW92aWVzLzAwMDI1NGI1LTRkNWUtNGZjOC05ODM3LWQ2YjA3ZjRlZDdlMi53ZWJw,The Trust,2500,46,2016.0,Crime/Drama,0 days 01:33:00.000000000,34
87,91,https://resizing.flixster.com/hWtkkI3NOt1ZLVDMZOU1oS6QK2c=/206x305/v2/https://resizing.flixster.com/VKcoMxAEhRvbDz43rBxCZnJg5e8=/ems.ZW1zLXByZC1hc3NldHMvbW92aWVzLzgyODI3NmEyLWIyNTktNDlmYy05NDQwLTY0ZmY2ZDBjZWFkMi53ZWJw,A Man Called Ove,5000,118,2015.0,Comedy/Drama,0 days 01:56:00.000000000,4
56,91,,Transpecos,250,23,2016.0,Mystery and thriller,0 days 01:26:00.000000000,35
58,96,,Hunter Gatherer,250,24,2016.0,Drama,0 days 01:28:00.000000000,38
29,63,https://resizing.flixster.com/KYUYkVdOIYAk38GYDSPnzfcaMEY=/206x305/v2/https://resizing.flixster.com/V4oQz6HGok9snxYn5oCBLSkS-8k=/ems.ZW1zLXByZC1hc3NldHMvbW92aWVzLzIwMmM3NGVlLTE0OTktNDkzMy1iNGZjLTg4ZGUxNzU5NzMzMy53ZWJw,Claire in Motion,100,19,2016.0,Drama/Mystery and thriller,0 days 01:23:00.000000000,34
54,67,/assets/pizza-pie/images/poster_default.c8c896e70c3.gif,Life,25000,256,2017.0,Horror/Sci fi,0 days 01:43:00.000000000,13
51,77,,In a Valley of Violence,2500,69,2016.0,Western,0 days 01:44:00.000000000,26
69,98,https://resizing.flixster.com/F8EpPVNEhnk6NrshLQK8zarlAAc=/206x305/v2/https://resizing.flixster.com/WqTcC_BxGRJVeX_oCRt8CObvWa8=/ems.ZW1zLXByZC1hc3NldHMvbW92aWVzLzllM2I4NzA5LWI2ZjUtNGEyNC1iZTYzLWQ4MjUwYTdmMGY5OC53ZWJw,Don't Think Twice,10000,136,2016.0,Comedy/Drama,0 days 01:28:00.000000000,29
57,92,,Slash,500,25,2016.0,Comedy/Drama,0 days 01:40:00.000000000,35
24,52,https://resizing.flixster.com/C24ZIlvNIH2rHzOH4LHjngSW1K8=/206x305/v2/https://resizing.flixster.com/twOak-RMEZsHAJ4yjhuFYucThvM=/ems.ZW1zLXByZC1hc3NldHMvbW92aWVzLzM3NDJiZGRhLThkNDctNDUyMy1iNzA3LTk0MGI2MjQzYjc5MC53ZWJw,Holidays,500,29,2016.0,Horror,0 days 01:44:00.000000000,28
56,81,,My Blind Brother,1000,36,2016.0,Romance,0 days 01:23:00.000000000,25
61,93,,I Am Not a Serial Killer,2500,57,2016.0,Mystery and thriller,0 days 01:44:00.000000000,32
48,67,https://resizing.flixster.com/0SFq_Ur0t6C0_Zgd2sNquaSQMhs=/206x305/v2/https://resizing.flixster.com/F0RsU_KDvaCTR9ZVN38pFhNr9OM=/ems.ZW1zLXByZC1hc3NldHMvbW92aWVzLzc2ZDBiOGQ4LTVkZTAtNDE5OS04NTRjLTBjZTZjNzAxMTM5Zi53ZWJw,My Father Die,100,15,2016.0,Action/Mystery and thriller,0 days 01:30:00.000000000,19
56,94,,Little Sister,500,35,2016.0,Comedy/Drama,0 days 01:31:00.000000000,38
63,100,https://resizing.flixster.com/hheJXpTfeEn1lZ0-oKVcj-vi8qo=/206x305/v2/https://resizing.flixster.com/zfJ9fn570k1JO6j6LMASe_zyMcY=/ems.ZW1zLXByZC1hc3NldHMvbW92aWVzL2RlMWQwZGRkLWY1NzUtNDM5Ni04YTUwLTY4NjUzZjZmODc3Zi53ZWJw,Chicken People,250,20,2016.0,Documentary/Comedy,0 days 01:23:00.000000000,37
46,33,https://resizing.flixster.com/IgLsdbTohMI9ouVbkLeQr-kgFLA=/206x305/v2/https://resizing.flixster.com/qvXlIIe_N1ts0Ba_ajzDlfr1Mh0=/ems.ZW1zLXByZC1hc3NldHMvbW92aWVzLzVhNzI2ZjEzLTNmMjItNGUyMi04NDUwLTQwMjVjNGE3Zjc1NS53ZWJw,The Waiting,500,15,2016.0,Drama/Mystery and thriller,0 days 01:37:00.000000000,-13
76,88,https://resizing.flixster.com/CyPTDWwEdcxJmsdya67z6UYueFE=/206x305/v2/https://resizing.flixster.com/QSCmn2sBLYSkXMTMRwCSqABAKD4=/ems.ZW1zLXByZC1hc3NldHMvbW92aWVzLzQ3YzJjNTYyLTRlODUtNGQwMi04ZTJiLTVlYTkwZjc3YjFlZC53ZWJw,Loving,10000,292,2016.0,Drama/History,0 days 02:03:00.000000000,12
53,11,,Papa: Hemingway in Cuba,1000,45,2015.0,Drama/History,0 days 01:49:00.000000000,-42
17,3,,Arsenal,250,30,2017.0,Action/Mystery and thriller,0 days 01:32:00.000000000,-14
85,82,,We Are X,250,28,2016.0,Documentary/Music,0 days 01:33:00.000000000,-3
89,99,,Tower,2500,99,2016.0,Documentary,0 days 01:38:00.000000000,10
41,75,,American Fable,500,16,2016.0,Drama/Mystery and thriller,0 days 01:36:00.000000000,34
48,41,,Kickboxer: Vengeance,1000,34,2016.0,Action/Sports and fitness,0 days 01:30:00.000000000,-7
78,92,,From Nowhere,100,13,2016.0,Drama,0 days 01:29:00.000000000,14
55,78,,We the People: The Market Basket Effect,100,9,2016.0,Documentary,0 days 01:16:00.000000000,23
48,67,,Rainbow Time,50,15,2016.0,Comedy/Drama,0 days 01:31:00.000000000,19
67,86,https://resizing.flixster.com/igc8Wq0L3bD23Coe8b-8EndWpyc=/206x305/v2/https://resizing.flixster.com/eTqQ88VZy7KggyuX4k0QSC3vfOA=/ems.ZW1zLXByZC1hc3NldHMvbW92aWVzL2RmYTcxYjMwLTQzNmMtNDQ1ZC1hZGQ1LTY0Y2NmNjgwMDVjZC53ZWJw,The Girl With All the Gifts,5000,127,2016.0,Horror/Mystery and thriller,0 days 01:51:00.000000000,19
57,87,https://resizing.flixster.com/xSyKd6HhTvDYsTxPgl63k-WAeZU=/206x305/v2/https://resizing.flixster.com/I1guc4gLfB9MYVr_t1QgdG2IZFc=/ems.ZW1zLXByZC1hc3NldHMvbW92aWVzLzRhOGVmODZiLTdmMWMtNDA5YS05OTRjLTFjMTgwN2M2OWZkNC53ZWJw,The Lost City of Z,10000,245,2016.0,Drama/Adventure,0 days 02:21:00.000000000,30
84,38,,Vaxxed: From Cover-Up to Catastrophe,1000,13,2016.0,Documentary,0 days 01:31:00.000000000,-46
48,9,,Sundown,100,11,2016.0,Romance/Adventure,0 days 01:43:00.000000000,-39
60,95,https://resizing.flixster.com/4-ze-H5jVz84jxfkPE1G-q97_WE=/206x305/v2/https://resizing.flixster.com/4JP0zP0BQiDVlCVtf2YxNiAONXY=/ems.ZW1zLXByZC1hc3NldHMvbW92aWVzLzBkY2Q0MzZiLTc3NzEtNGU0OS04OGRlLTk3MTk4ODc3ZTk3YS53ZWJw,The Love Witch,1000,111,2016.0,Comedy/Horror,0 days 02:00:00.000000000,35
59,67,,Mad Tiger,50,12,2015.0,Documentary/Drama,0 days 01:22:00.000000000,8
22,20,,The Late Bloomer,250,10,2016.0,Romance,0 days 01:30:00.000000000,-2
42,35,,The Great Wall,10000,236,2016.0,Adventure/Action,0 days 01:44:00.000000000,-7
88,97,,Burden,1,36,2016.0,Documentary,0 days 01:28:00.000000000,9
35,50,,Between Us,100,8,2016.0,Romance/Comedy,0 days 01:33:00.000000000,15
51,90,,Always Shine,500,51,2016.0,Drama/Mystery and thriller,0 days 01:27:00.000000000,39
47,40,,All We Had,100,25,2016.0,Drama,0 days 01:45:00.000000000,-7
39,50,,"Fear, Inc.",100,12,2016.0,Comedy/Horror,0 days 01:31:00.000000000,11
77,70,,Bad Rap,1,10,2016.0,Documentary,0 days 01:22:00.000000000,-7
46,85,,Harry Benson: Shoot First,100,27,2016.0,Documentary,0 days 01:27:00.000000000,39
38,57,,Free to Run,50,7,2016.0,Documentary,0 days 01:30:00.000000000,19
47,95,,Tikkun,100,20,2015.0,Drama,0 days 02:00:00.000000000,48
30,25,,Jack Goes Home,100,12,2016.0,Horror/Mystery and thriller,0 days 01:40:00.000000000,-5
49,21,https://resizing.flixster.com/EdSWBOmo8YFmWw_uK5RXR-IxOGI=/206x305/v2/https://resizing.flixster.com/BiG92qJvReBEFn11ogZV76iyCzE=/ems.ZW1zLXByZC1hc3NldHMvbW92aWVzLzk3ZThiOTFlLTkyMzItNDhmZS1iMWY4LTZiNmMzYTc5NzFhMi53ZWJw,Underworld: Blood Wars,10000,96,2016.0,Horror/Action,0 days 01:32:00.000000000,-28
93,93,https://resizing.flixster.com/Fo0zzPGmrK2F5T2LVTG0B3OWiOc=/206x305/v2/https://resizing.flixster.com/ollL2QfxZCa3P5ROOMIvo_bIVNA=/ems.ZW1zLXByZC1hc3NldHMvbW92aWVzLzhjZGE3MTgzLTRlMTktNDQyZS04ODQzLWVhNDE5MWM5MmI0ZS53ZWJw,Hidden Figures,50000,318,2016.0,History/Drama,0 days 02:07:00.000000000,0
36,57,,Love at First Child,1,7,2015.0,Comedy,0 days 01:31:00.000000000,21
74,100,,The Anthropologist,250,6,2015.0,Documentary,0 days 01:21:00.000000000,26
10,40,https://resizing.flixster.com/mk4K0fn1IFRmlp6Wbfx04VKSvrM=/206x305/v2/https://flxt.tmsimg.com/assets/p12791171_p_v10_aa.jpg,Most Likely to Die,100,5,2015.0,Horror,0 days 01:20:00.000000000,30
38,50,,Johnny Frank Garrett's Last Word,50,6,2016.0,Horror,0 days 01:35:00.000000000,12
24,14,https://resizing.flixster.com/kgxQqFK9BoXf-W9vHh-wwxdvY50=/206x305/v2/https://resizing.flixster.com/eyaMrBImXB_yks1xtLlzRbqsPJ0=/ems.ZW1zLXByZC1hc3NldHMvbW92aWVzL2MzZjU2MTRhLTcyZjAtNGRjNS1iNTM5LTM1YWYxNTNhMTcyNC53ZWJw,Sharknado: The 4th Awakens,500,14,2016.0,Comedy/Sci fi,0 days 01:30:00.000000000,-10
46,65,https://resizing.flixster.com/EqMyNLuclIF8-yPxMjajfPY9SvA=/206x305/v2/https://resizing.flixster.com/9OCkpRq3uKrp3Sy3sO6_Ge8IcZ8=/ems.ZW1zLXByZC1hc3NldHMvbW92aWVzLzU2NDU3OTJkLWRjM2QtNDE4Mi04ODI3LTYzMTU5ZDczNjg2NC53ZWJw,Finding Altamira,100,17,2016.0,Drama/History,0 days 01:33:00.000000000,19
50,45,https://resizing.flixster.com/uqu2yjymqs53St6Qz80ew_HyeVg=/206x305/v2/https://resizing.flixster.com/XeCuxj1az94ZkYO8qT_S2FAv-hE=/ems.ZW1zLXByZC1hc3NldHMvbW92aWVzLzA2MmUwZTJkLTQ2ZDItNDg2Mi1iOWNkLWE0YWFjNzFmM2U3YS53ZWJw,Youth in Oregon,100,20,2016.0,Comedy/Drama,0 days 01:39:00.000000000,-5
80,24,,Mr. Church,2500,33,2016.0,Drama,0 days 01:44:00.000000000,-56
32,49,,King Cobra,1000,35,2016.0,Crime/Gay and lesbian,0 days 01:32:00.000000000,17
31,51,https://resizing.flixster.com/Gxgc_zHUo7Cy7-yQwstZ8GiR844=/206x305/v2/https://flxt.tmsimg.com/assets/p13825571_p_v10_ac.jpg,The Ticket,250,35,2016.0,Drama,0 days 01:38:00.000000000,20
15,43,https://resizing.flixster.com/HLDqANMUVKi6XqSax5MrU_XSJ1s=/206x305/v2/https://resizing.flixster.com/J_Y6v5z4u72-WyJVbiCoUPk0uSM=/ems.ZW1zLXByZC1hc3NldHMvbW92aWVzL2IzNzE2YzIyLTVjOTAtNDc5Ny1hZDEyLWE0Y2M5YTkwZGYyMi53ZWJw,My Bakery in Brooklyn,100,7,2016.0,Comedy/Drama,0 days 01:40:00.000000000,28
66,44,https://resizing.flixster.com/b3KLKR6NJZIHSdFRmAFqg2a87Kk=/206x305/v2/https://resizing.flixster.com/6dRcPlEAJJuvtTHPCKRSsdI4j14=/ems.ZW1zLXByZC1hc3NldHMvbW92aWVzL2VjNWJiZjhlLTMyMTItNGNlZC1iNzMzLTdmMGI5OTM5MTYwNS53ZWJw,Vincent N Roxxy,250,18,2016.0,Crime/Drama,0 days 01:50:00.000000000,-22
27,21,,Nerdland,100,14,2016.0,Comedy/Animation,0 days 01:23:00.000000000,-6
80,79,,The American Side,500,19,2014.0,Drama/Mystery and thriller,0 days 01:30:00.000000000,-1
21,62,,"Mother, May I Sleep With Danger?",50,13,2016.0,Gay and lesbian/Mystery and thriller,0 days 01:30:00.000000000,41
63,89,,Blood Father,5000,97,2016.0,Action/Mystery and thriller,0 days 01:28:00.000000000,26
64,49,https://resizing.flixster.com/TLrfYL6cwzkDrsmXTb3LH_sMgI0=/206x305/v2/https://resizing.flixster.com/5vj7uEUSovznx89MDbZuiO5Q25g=/ems.ZW1zLXByZC1hc3NldHMvbW92aWVzL2ZhNzlkMWM3LWUzNTctNGM1OC1hNjY5LTYyMzg1ZTc2YjI0MS53ZWJw,Almost Christmas,5000,69,2016.0,Other/Drama,0 days 01:52:00.000000000,-15
57,93,,AWOL,250,15,2016.0,Romance/Gay and lesbian,0 days 01:25:00.000000000,36
75,95,https://resizing.flixster.com/kY1E1q93r53W85s5nVTNAwvq8Qg=/206x305/v2/https://resizing.flixster.com/iVQOVpqo7Xlc0bK4hJfEoyohZ9U=/ems.ZW1zLXByZC1hc3NldHMvbW92aWVzL2IzOWQ5Y2NkLTc5NjYtNDVjZi1hNzIyLWJjNmJmMjI0YmYyMC53ZWJw,Being 17,500,41,2016.0,Gay and lesbian/Drama,0 days 01:54:00.000000000,20
64,61,,Allied,25000,254,2016.0,Drama/War,0 days 01:59:00.000000000,-3
27,36,,Lavender,250,22,2016.0,Mystery and thriller,0 days 01:33:00.000000000,9
65,70,https://resizing.flixster.com/uzkL4v4EW4DJINom6UQJ12cVAQk=/206x305/v2/https://resizing.flixster.com/Ahh3BMKqLiIzZGhMEdYK794nK1s=/ems.ZW1zLXByZC1hc3NldHMvbW92aWVzLzBlN2ZhY2RhLWYxMTQtNDVmNi1hNjMyLTM3MjdkMGQ2MDJiZi53ZWJw,Coming Through the Rye,250,23,2015.0,Drama,0 days 01:37:00.000000000,5
14,35,,A Kind of Murder,500,17,2016.0,Crime/Drama,0 days 01:38:00.000000000,21
12,20,https://resizing.flixster.com/Y2axgifdTIWtdyjSA2vodsiohzQ=/206x305/v2/https://resizing.flixster.com/CriWO270YPiHK0e_YvNiQ8AolCs=/ems.ZW1zLXByZC1hc3NldHMvbW92aWVzL2E0NTYxMzg2LTk3ZWEtNGYwMC1hNmI5LWM4YTQyMTUxMWE4Mi53ZWJw,The Last Heist,100,10,2016.0,Action/Mystery and thriller,0 days 01:24:00.000000000,8
92,0,,Is That a Gun in Your Pocket?,250,11,2016.0,Comedy,0 days 01:37:00.000000000,-92
75,92,,Fences,25000,268,2016.0,Drama,0 days 02:13:00.000000000,17
43,0,,The True Memoirs of an International Assassin,500,9,2016.0,Action/Comedy,0 days 01:38:00.000000000,-43
31,11,,Ghost Team,100,9,2016.0,Comedy/Horror,0 days 01:23:00.000000000,-20
70,95,https://resizing.flixster.com/1EfcBvckbQVe_xXXBKGLCaVVmoE=/206x305/v2/https://flxt.tmsimg.com/NowShowing/166832/166832_aa.jpg,Gimme Danger,1000,110,2016.0,Documentary/Music,0 days 01:48:00.000000000,25
15,43,https://resizing.flixster.com/Zn-yucMI1RKy7tfXc73F3T3CmtI=/206x305/v2/https://resizing.flixster.com/4_5wPHterHz9AzEiuojyKJSiYF8=/ems.ZW1zLXByZC1hc3NldHMvbW92aWVzL2RlNmVhNGVhLTkxOWQtNGY1Zi1iZDg4LTVlNWYxMDhjNWRkNC53ZWJw,Approaching the Unknown,1000,21,2016.0,Sci fi/Mystery and thriller,0 days 01:30:00.000000000,28
40,25,https://resizing.flixster.com/KGnPfpxa-Fp9v6UUvFne-J-fySY=/206x305/v2/https://resizing.flixster.com/c3jVL_DcpSmY4NPg_J77-fc612c=/ems.ZW1zLXByZC1hc3NldHMvbW92aWVzLzZkY2RlNWFiLTM0MGYtNDRhMC04MjUxLTBkMTk0YTJiZGUxYi53ZWJw,Table 19,5000,118,2017.0,Comedy/Drama,0 days 01:27:00.000000000,-15
85,29,https://resizing.flixster.com/UmnFWI-by9yQbsVoQUFdeUrU9Wg=/206x305/v2/https://resizing.flixster.com/9rRUaav2sUBktm1qbAE8xU0zJic=/ems.ZW1zLXByZC1hc3NldHMvbW92aWVzLzMwYjU2YmIzLWFmMjItNDg2YS1hMmY5LTQxYTRiNDdlY2FjZC53ZWJw,Passage to Mars,250,7,2016.0,Documentary,0 days 01:34:00.000000000,-56
52,20,https://resizing.flixster.com/Ft_10F83NCJl_1_XDkkdgPZzqR4=/206x305/v2/https://resizing.flixster.com/2lnMOo7zdabrnrw5JkN9oscn8bg=/ems.ZW1zLXByZC1hc3NldHMvbW92aWVzLzEwMjE0MjRkLWRjM2QtNDliNi05YjljLWJmNWMzZGIxOTdlMC53ZWJw,The Dog Lover,100,10,2016.0,Drama,0 days 01:42:00.000000000,-32
68,14,https://resizing.flixster.com/iGJ0vfOFbbCax5_Scfp2Q6rXA1s=/206x305/v2/https://resizing.flixster.com/ugoZGpjg-GnncVUEV2y9E_DIT98=/ems.ZW1zLXByZC1hc3NldHMvbW92aWVzL2Y2MDFhOGYyLTA2MTUtNGRlMi04OWFiLWVhYzU5NTEzMTE3OS53ZWJw,Vigilante Diaries,100,7,2016.0,Action/Mystery and thriller,0 days 01:24:00.000000000,-54
82,20,https://resizing.flixster.com/f3p8hWv8Hd1ZHWG-V4Tw_318xyA=/206x305/v2/https://resizing.flixster.com/2BN6jPlAiXp58-n1JpWKsD39V54=/ems.ZW1zLXByZC1hc3NldHMvbW92aWVzLzA3Zjk4YTEyLTQ0NWUtNDY5Zi05OWQ0LWU1NGZjOTI0Mjg3NC53ZWJw,I'm Not Ashamed,2500,10,2016.0,Drama/Biography,0 days 01:52:00.000000000,-62
23,24,https://resizing.flixster.com/eL5mTpu5n5P6TcIRBjYGuMKAkPk=/206x305/v2/https://resizing.flixster.com/4DmwHxHTSeMh7jRh7QAiQzkeDic=/ems.ZW1zLXByZC1hc3NldHMvbW92aWVzLzE1M2VlZDY3LTFhZWYtNGU5Mi05YTMzLTFjNTNmMGM0ZGQ1ZC53ZWJw,Marauders,1000,21,2016.0,Crime/Drama,0 days 01:47:00.000000000,1
100,88,,Left on Purpose,50,8,2015.0,Documentary/Drama,0 days 01:35:00.000000000,-12
16,15,https://resizing.flixster.com/rm-cszmScaU7tcHREpxAF9NBhZc=/206x305/v2/https://flxt.tmsimg.com/assets/p13068812_p_v8_aa.jpg,Let's Be Evil,100,13,2016.0,Sci fi/Mystery and thriller,0 days 01:23:00.000000000,-1
55,80,https://resizing.flixster.com/ZASDx051GauquJuqSzWQiCeM-r0=/206x305/v2/https://resizing.flixster.com/JjLLmrk2BpYgqRG5_QcMT6DMP6Q=/ems.ZW1zLXByZC1hc3NldHMvbW92aWVzLzBiYmNiODM0LThjZGMtNDI2Yy04ZDhhLTUyMDU4Y2UyZDkyZi53ZWJw,Out of Print,100,5,2014.0,Documentary,0 days 01:26:00.000000000,25
51,39,https://resizing.flixster.com/135YfxOLpv56jruE5H4ff7O_w3I=/206x305/v2/https://flxt.tmsimg.com/assets/p13026012_p_v10_ae.jpg,Batman: The Killing Joke,10000,41,2016.0,Animation/Action,0 days 01:16:00.000000000,-12
88,97,,Hell or High Water,25000,281,2016.0,Drama/Crime,0 days 01:37:00.000000000,9
25,0,https://resizing.flixster.com/LVDQ-siju4xkwg6kmiQ4TRPbyFQ=/206x305/v2/https://resizing.flixster.com/iXYK6bBHXRgevQ9A8WoOpIUjekw=/ems.ZW1zLXByZC1hc3NldHMvbW92aWVzLzk5NGZlZTRiLTRhODAtNGYwMC1iMTVjLTM0ZTBhMjM4Y2E3Yi53ZWJw,Amateur Night,250,6,2016.0,Comedy,0 days 01:33:00.000000000,-25
82,99,,The Wailing,5000,82,2016.0,Horror/Mystery and thriller,0 days 02:36:00.000000000,17
97,100,https://resizing.flixster.com/NZLNwVZjhdE1gg0svUnKNcSxGqE=/206x305/v2/https://resizing.flixster.com/FwiGA5b2PK7GuFHoMY43bzwFrkE=/ems.ZW1zLXByZC1hc3NldHMvbW92aWVzL2Q2YzhmYWY2LTUyZDYtNDNkMC1hOTUyLTQ1OWFmODA3NjVjNy53ZWJw,O.J.: Made in America,1000,53,2016.0,,,3
76,98,,Long Way North,1000,54,2015.0,Animation/Drama,0 days 01:21:00.000000000,22
31,40,,Traded,100,5,2016.0,Western/Drama,0 days 01:38:00.000000000,9
31,37,,Blair Witch,10000,222,2016.0,Horror/Mystery and thriller,0 days 01:29:00.000000000,6
13,0,,Andròn -- The Black Labyrinth,100,6,2015.0,Action/Sci fi,0 days 01:40:00.000000000,-13
73,93,,Toni Erdmann,5000,239,2016.0,Comedy/Drama,0 days 02:42:00.000000000,20
28,20,,Billionaire Ransom,100,5,2016.0,Mystery and thriller,0 days 01:47:00.000000000,-8
91,95,,The Handmaiden,10000,219,2016.0,Romance/Drama,0 days 02:24:00.000000000,4
89,94,,Train to Busan,10000,117,2016.0,Action/Horror,0 days 01:58:00.000000000,5
86,100,,Bright Lights: Starring Carrie Fisher and Debbie Reynolds,500,57,2016.0,Documentary,0 days 01:35:00.000000000,14
89,99,https://resizing.flixster.com/lXUjzlAvsX2vG5jejB0kzhj5w0k=/206x305/v2/https://resizing.flixster.com/Y4jVEKisE1x6Qw6OSVh9dI-UKJ0=/ems.ZW1zLXByZC1hc3NldHMvbW92aWVzLzE4YjVhNTRjLWY1MWYtNDUzZS04Nzk2LTg2ZjE4NzQ3YWJmZS53ZWJw,My Life as a Zucchini,5000,137,2016.0,Comedy/Drama,0 days 01:06:00.000000000,10
56,78,,Mean Dreams,500,46,2016.0,Mystery and thriller,0 days 01:45:00.000000000,22
80,4,https://resizing.flixster.com/kHP7lThT0V24wkShr9N4w4M60Gs=/206x305/v2/https://resizing.flixster.com/74vDVCjwvWO1vqiudQJLAotlQYg=/ems.ZW1zLXByZC1hc3NldHMvbW92aWVzL2Q2ZjQzOTAxLTU2ZTUtNDBjNC1iNThkLTNkNTBlNTZiMDJlNy53ZWJw,Hillary's America: The Secret History of the Democratic Party,10000,28,2016.0,Documentary,0 days 01:47:00.000000000,-76
19,50,https://resizing.flixster.com/AwPBeLiAh4ONdbWbUe6ELn_oZMk=/206x305/v2/https://resizing.flixster.com/yb7F0M-6fvfhlCLfJXIxbWxQBnA=/ems.ZW1zLXByZC1hc3NldHMvbW92aWVzL2ZkYTZkOGVjLTRkNDAtNGRiNi1iNzkwLWY3ZTY4OThkYjBhNi53ZWJw,Dog Eat Dog,500,70,2016.0,Crime/Comedy,0 days 01:33:00.000000000,31
81,93,https://resizing.flixster.com/RIONDOh-97Pu2SPu3svikkOa_-A=/206x305/v2/https://resizing.flixster.com/y8fCEOg1ocb70dAYFGy6bC0rxko=/ems.ZW1zLXByZC1hc3NldHMvbW92aWVzLzVkNzQxNDQ1LWE5Y2EtNDFjMC04NmU2LWY2ZWMwZmUwM2QxNS53ZWJw,The Red Turtle,5000,166,2016.0,Animation/Adventure,0 days 01:20:00.000000000,12
74,84,https://resizing.flixster.com/Ae3xkBowF6WQ8f7BlFvjbGgEwoo=/206x305/v2/https://resizing.flixster.com/X2LZiA5Y5xPOLgmCNbFAmONBmwo=/ems.ZW1zLXByZC1hc3NldHMvbW92aWVzL2FjZTFhNTVhLTJjNDQtNDk3MC04MTM4LTNlMGZjNDEwZGNhNC53ZWJw,Divines,500,19,2016.0,Drama,0 days 01:45:00.000000000,10
53,41,,Come What May,50,22,2015.0,War/Drama,0 days 01:54:00.000000000,-12
33,55,,Rules Don't Apply,2500,180,2016.0,Romance/Comedy,0 days 02:01:00.000000000,22
73,91,,Elle,10000,242,2016.0,Drama/Mystery and thriller,0 days 02:11:00.000000000,18
57,75,https://resizing.flixster.com/ZGM_BQO_efV14W7ylO4NC2g4Tcc=/206x305/v2/https://resizing.flixster.com/Wa3BzcRfT_3hkOB3G4VCqJNgD7s=/ems.ZW1zLXByZC1hc3NldHMvbW92aWVzLzMwNDNmYTUyLWJiYTctNGNhMi04MWIxLTZlNGYxNmE3YmU5OS53ZWJw,Buddymoon,250,8,2016.0,Comedy,0 days 01:20:00.000000000,18
78,81,https://resizing.flixster.com/92aT-JWaqz_MBWTES_RN37EtVaI=/206x305/v2/https://resizing.flixster.com/jEzevAd2cWZv2OCp-wbX5YNoCo4=/ems.ZW1zLXByZC1hc3NldHMvbW92aWVzLzA3ODdjOWE2LTIyMzAtNDNkOS05ZTBhLWU5NDQwYjVlNzE4Ny53ZWJw,T2 Trainspotting,10000,250,2017.0,Comedy/Drama,0 days 01:57:00.000000000,3
39,78,,Garn,100,9,2016.0,Documentary,0 days 01:16:00.000000000,39
84,96,,The Salesman,5000,196,2016.0,Mystery and thriller/Drama,0 days 02:05:00.000000000,12
48,71,,The Seasons in Quincy: Four Portraits of John Berger,50,24,2016.0,Documentary/Biography,0 days 01:30:00.000000000,23
33,50,,Edge of Winter,250,22,2016.0,Drama/Mystery and thriller,0 days 01:29:00.000000000,17
25,23,,Intruder,100,13,2016.0,Horror/Mystery and thriller,0 days 01:35:00.000000000,-2
30,37,,Morgan,5000,153,2016.0,Horror/Sci fi,0 days 01:28:00.000000000,7
42,67,,Lazy Eye,100,12,2016.0,Romance/Gay and lesbian,0 days 01:30:00.000000000,25
54,100,,We Go On,100,10,2016.0,Horror/Drama,0 days 01:30:00.000000000,46
71,66,https://resizing.flixster.com/J_7ywn7XuA1UqGJuQAGMV6SoUus=/206x305/v2/https://resizing.flixster.com/rHIrD8sZsK2_NdkBNeB93KfHw4Y=/ems.ZW1zLXByZC1hc3NldHMvbW92aWVzLzFiMTA3ZmQzLTY2YjktNDhhMy04YmQ5LTUxZTM5ZDg2NzU2MC53ZWJw,Anthropoid,5000,107,2016.0,War/Drama,0 days 02:00:00.000000000,-5
50,83,,Front Cover,250,12,2015.0,Romance/Comedy,0 days 01:27:00.000000000,33
73,74,https://resizing.flixster.com/7SSZSiS2eerV1DFW0STXriwa4yw=/206x305/v2/https://resizing.flixster.com/rjyIfQFHRXry_BfpFCxGwaxL8J4=/ems.ZW1zLXByZC1hc3NldHMvbW92aWVzL2VjZTgzMDg1LTBkMWItNDUyNC1iYWExLTRiMGY5OGNiODRjOS53ZWJw,Nocturnal Animals,25000,300,2016.0,Crime/Drama,0 days 01:56:00.000000000,1
30,82,https://resizing.flixster.com/SofHcGxWBKD1xkK_vdVk_Fo0ADg=/206x305/v2/https://resizing.flixster.com/PbzEkSkg4dKie51wBTQlbDkSPQQ=/ems.ZW1zLXByZC1hc3NldHMvbW92aWVzL2EwYzM1ZWUwLWVkZWItNGE4Mi1hNTRmLTE0ZjY1ZGZkZDExNS53ZWJw,Dying Laughing,250,22,2016.0,Documentary/Comedy,0 days 01:29:00.000000000,52
30,33,https://resizing.flixster.com/Z8DDlDIitdpQS2gv8GzsxnyXOMk=/206x305/v2/https://resizing.flixster.com/zV80ppi70k7nCVvm50ow0L0SEfA=/ems.ZW1zLXByZC1hc3NldHMvbW92aWVzL2E5ZTg1YjE5LWZmYTItNGEwNC05NWM1LTg4ZDFhYmUyMTA0Yy53ZWJw,Officer Downe,100,12,2016.0,Action/Fantasy,0 days 01:31:00.000000000,3
76,55,https://resizing.flixster.com/bYZwGUimwNX3gBOM-i0AP95juT4=/206x305/v2/https://resizing.flixster.com/PZ3l-qpOxx04fIlJVMBhItKDa2k=/ems.ZW1zLXByZC1hc3NldHMvbW92aWVzL2RlNjkwZGIwLWQ5NDQtNDZmMC04MTI5LWFlZDQyZmIwYTVkNi53ZWJw,Can We Take a Joke?,100,20,2015.0,Documentary,0 days 01:15:00.000000000,-21
66,40,https://resizing.flixster.com/eSqs_FzgnHhrWOoBpaAiJu2I_nU=/206x305/v2/https://resizing.flixster.com/EMRWBC_a2f3GPG6V7iiQfPG7r4A=/ems.ZW1zLXByZC1hc3NldHMvbW92aWVzL2U0YWI4MTY0LWNjMGUtNGM1OS05Y2MxLTVjMDJhZGEzYzNlZi53ZWJw,The Hollow,100,5,2016.0,Crime/Drama,0 days 02:08:00.000000000,-26
75,25,https://resizing.flixster.com/OY-Iv0s20WTExC-FMALJnjLH0ic=/206x305/v2/https://resizing.flixster.com/mKpQtEC8nPfdUoMpzJGTl4lpdiE=/ems.ZW1zLXByZC1hc3NldHMvbW92aWVzLzczMzJhNmZmLWM0YWYtNGRmMy1hZTU3LTI5MTg3M2VkYzAyOS53ZWJw,Undrafted,250,8,2016.0,Comedy,0 days 01:40:00.000000000,-50
40,0,,Spaceman,100,8,2016.0,Drama,0 days 01:30:00.000000000,-40
29,83,https://resizing.flixster.com/xexEOqbx4XrmqJa2-JO5kFLGT70=/206x305/v2/https://resizing.flixster.com/ail4R0Ru4PzL-KwZ3C5wr0gP7PU=/ems.ZW1zLXByZC1hc3NldHMvbW92aWVzL2Y5OTc4YTlkLTlmMmMtNGI3OS1hNmY3LTMxYjVlYzhkZDJkMy53ZWJw,Beyond the Gates,500,23,2016.0,Horror/Mystery and thriller,0 days 01:24:00.000000000,54
51,40,https://resizing.flixster.com/gsFFaK9InuqnTr6_IiHtT3CYR1A=/206x305/v2/https://flxt.tmsimg.com/assets/p13114058_p_v13_ap.jpg,Operation Chromite,500,20,2016.0,History/War,0 days 01:55:00.000000000,-11
68,12,https://resizing.flixster.com/Rq7zJ-xzvWTsAfgipd1yNeNyBUM=/206x305/v2/https://resizing.flixster.com/GWaNMBW6LV6eEmGoW3EmWmX6woM=/ems.ZW1zLXByZC1hc3NldHMvbW92aWVzLzVhMWY2N2MyLTc2MDktNGYyZi1iYzhmLWY2MThmZDE4MTI1OS53ZWJw,Kingsglaive: Final Fantasy XV,2500,17,2016.0,Animation/Action,0 days 01:50:00.000000000,-56
43,89,,Three,250,28,2016.0,Action/Mystery and thriller,0 days 01:27:00.000000000,46
56,60,https://resizing.flixster.com/CB8vpi-qhEt8mZiDVGLrHXLJrb8=/206x305/v2/https://resizing.flixster.com/w4GKeKe2ZTosXKok5uJ6qZpeW2Q=/ems.ZW1zLXByZC1hc3NldHMvbW92aWVzLzZkOTEzYmYxLWNhYTItNGRlOS05ZjY5LWFkZDNjN2I4N2FkYi53ZWJw,Cold War 2,500,10,2016.0,Crime/Action,0 days 01:54:00.000000000,4
52,78,,Ants on a Shrimp,50,9,2016.0,Documentary,0 days 01:28:00.000000000,26
28,38,,Abattoir,250,21,2016.0,Horror/Mystery and thriller,0 days 01:38:00.000000000,10
67,86,https://resizing.flixster.com/7xdkHFeQds7YlcDYRXSdFf-t3lw=/206x305/v2/https://resizing.flixster.com/VTBzLHeS2W2Re_ogwnl-4vC9L0c=/ems.ZW1zLXByZC1hc3NldHMvbW92aWVzLzA4ODAyMDhhLWU1ODUtNDAzNi1hZDhlLWZkZDMxNjk5Y2QxOS53ZWJw,Citizen Soldier Birds Eye View,250,7,2016.0,Documentary/War,0 days 01:35:00.000000000,19
82,94,https://resizing.flixster.com/OvdPc2UmVxUlKqimb9jA-wrFb1s=/206x305/v2/https://resizing.flixster.com/cR4Yoq8QlGb966w0Ru4eMaGaLw4=/ems.ZW1zLXByZC1hc3NldHMvbW92aWVzLzBlNjgwNTY3LTgzZGUtNDBkYi05MmRjLTVjZTY2ZmM5YWIxMi53ZWJw,Arrival,50000,429,2016.0,Sci fi/Mystery and thriller,0 days 01:56:00.000000000,12
77,40,,Priceless,2500,5,2016.0,Drama/Mystery and thriller,0 days 01:38:00.000000000,-37
93,20,https://resizing.flixster.com/Zc1rofMtaATICW8qAHhtJMRLTmc=/206x305/v2/https://flxt.tmsimg.com/assets/p13035119_p_v8_ab.jpg,The Brooklyn Banker,50,5,2016.0,Crime/Drama,0 days 01:39:00.000000000,-73
83,14,,Autumn Lights,100,7,2016.0,Drama/Mystery and thriller,0 days 01:38:00.000000000,-69
42,65,,Detour,250,31,2016.0,Mystery and thriller,0 days 01:37:00.000000000,23
89,96,,The Beatles: Eight Days a Week -- The Touring Years,5000,103,2016.0,Documentary/Music,0 days 01:46:00.000000000,7
48,83,https://resizing.flixster.com/ZWk-m4xd4VlsA8EiwTK1fJ33sbg=/206x305/v2/https://resizing.flixster.com/LmaBYfx8ZXP3H4KIs4a6AAnbilU=/ems.ZW1zLXByZC1hc3NldHMvbW92aWVzLzQ2ZmNmOTlkLWNkMjUtNDBjZi04YWQ4LTA1ZDJmOWI3MjkyYy53ZWJw,Dr. Feelgood: Dealer or Healer?,100,6,2016.0,Documentary,0 days 01:21:00.000000000,35
44,100,,Mom and Me,50,8,2015.0,Documentary,0 days 01:17:00.000000000,56
47,13,,Spin Out,1,8,2016.0,Romance,0 days 01:32:00.000000000,-34
52,71,https://resizing.flixster.com/SCpJLvpB4uB2aW994pMEHff2MO0=/206x305/v2/https://resizing.flixster.com/LCOZJMr6wr5BUtRwi0Gfd-tgRZA=/ems.ZW1zLXByZC1hc3NldHMvbW92aWVzLzJiZjVjMmU2LWVhYjItNDdiNy05MTY4LWM1ZjY0ZmNkZWRkYS53ZWJw,XOXO,500,7,2016.0,Comedy,0 days 01:32:00.000000000,19
74,88,,20th Century Women,10000,226,2016.0,Drama/Comedy,0 days 01:58:00.000000000,14
49,20,https://resizing.flixster.com/-UAkyFXLeG2-2SMchvlkJO2ffxM=/206x305/v2/https://resizing.flixster.com/RACETEdWzoAJUoDOxABPVArn4ns=/ems.ZW1zLXByZC1hc3NldHMvbW92aWVzLzExMGMzZWZmLWRhOTctNGI3MC1iNTVmLTMyZTJiYjhjOTRlOC53ZWJw,Ace the Case,50,5,2016.0,Comedy/Mystery and thriller,0 days 01:34:00.000000000,-29
63,29,https://resizing.flixster.com/gYHLuMRbExEiJ1yL24fu3vKsx80=/206x305/v2/https://flxt.tmsimg.com/assets/p13114737_p_v10_ab.jpg,New Life,100,7,2016.0,Romance/Drama,0 days 01:28:00.000000000,-34
79,98,,Moonlight,25000,389,2016.0,Gay and lesbian/Drama,0 days 01:51:00.000000000,19
39,86,,Gernika,100,7,2016.0,Romance/War,0 days 01:50:00.000000000,47
54,38,,Cardboard Boxer,100,8,2016.0,Drama,0 days 01:28:00.000000000,-16
60,100,https://resizing.flixster.com/WTjQ1zN7Q78ITqG8sDKeeJz1JMk=/206x305/v2/https://resizing.flixster.com/4233YXb5Vl_xOLXK7m7O8Knk8cA=/ems.ZW1zLXByZC1hc3NldHMvbW92aWVzL2FiNTMyYTU4LTkxYmItNDBiZC1hNGU2LTNhNmQzNjA2YWVkMi53ZWJw,Operator,250,6,2016.0,Comedy/Drama,0 days 01:27:00.000000000,40
46,38,https://resizing.flixster.com/hAlGNI5rt4j9pweczilEiz01y3o=/206x305/v2/https://resizing.flixster.com/AypOXcYbP8Sjdj_oZ-gLNZS79LU=/ems.ZW1zLXByZC1hc3NldHMvbW92aWVzL2ZkMjhlYTBlLTllN2MtNDMxMy1hNmNhLTU4NjEwMmVjZjU5Ny53ZWJw,Ovation,1,8,2015.0,Comedy,0 days 01:42:00.000000000,-8
76,84,https://resizing.flixster.com/NeybHFG9rD7IG5cEKc3Kfb5F98k=/206x305/v2/https://resizing.flixster.com/pmtwzy1KfB5ZYpwmjpWLHJf9wTE=/ems.ZW1zLXByZC1hc3NldHMvbW92aWVzL2FkMDlmZTI2LTllY2ItNDgwYi1hYTdlLTdkZTFlZDc5M2RhNi53ZWJw,A United Kingdom,5000,164,2016.0,Romance/Drama,0 days 01:51:00.000000000,8
38,91,,Shelley,250,11,2016.0,Horror/Mystery and thriller,0 days 01:32:00.000000000,53
74,94,https://resizing.flixster.com/ie_DacSPbMd6V6wjvbJDTAx4_Gs=/206x305/v2/https://resizing.flixster.com/ldtKtBv_O0ri0mVqd6i2Un49qfY=/ems.ZW1zLXByZC1hc3NldHMvbW92aWVzLzhhMWNhMTI5LTc0YjMtNDdkOS04ZWRmLTYzZTIzY2Y5YjdmNC53ZWJw,Floyd Norman: An Animated Life,250,16,2016.0,Documentary,0 days 01:28:00.000000000,20
43,33,https://resizing.flixster.com/GCr1d3soyguRfC4T2fEDtNsagoQ=/206x305/v2/https://resizing.flixster.com/GsmTWvfqiUh5f27Ix5UUfYWJzoM=/ems.ZW1zLXByZC1hc3NldHMvbW92aWVzLzAwMTdkZThiLTRkOWMtNGI1Yy05YWUzLTU5NjZlNjczYjY0Mi53ZWJw,Kampai! For the Love of Sake,50,9,2015.0,Documentary,0 days 01:35:00.000000000,-10
39,27,,Sandy Wexler,500,22,2017.0,Comedy,0 days 02:10:00.000000000,-12
49,100,,"Olympic Pride, American Prejudice",50,8,2015.0,Documentary,0 days 01:30:00.000000000,51
41,33,https://resizing.flixster.com/BBQjBAQUfPkE85ckez_ZWl1_dUc=/206x305/v2/https://resizing.flixster.com/4jieQwuZwuSSlYDX-h5g95xR92E=/ems.ZW1zLXByZC1hc3NldHMvbW92aWVzL2U0OGMwYjQxLTEzODUtNGVmNC1iNmUwLTI2ODYzZjI2MGI4Mi53ZWJw,Good Kids,250,6,2016.0,Comedy,0 days 01:30:00.000000000,-8
90,97,https://resizing.flixster.com/fCLt_s2b9RQ1FUvjCwJKFd3R5tw=/206x305/v2/https://resizing.flixster.com/CSpVTilYGaoUMk8F0A8Oi5QyCc8=/ems.ZW1zLXByZC1hc3NldHMvbW92aWVzLzUyYTJiMjg5LTg5NzctNGNjMC04OWViLWE0MTVmYTdhYTVkOS53ZWJw,13TH,2500,104,2016.0,Documentary,0 days 01:40:00.000000000,7
35,14,,Correspondence,50,7,2016.0,Romance/Drama,0 days 01:56:00.000000000,-21
84,50,,The Resurrection of Gavin Stone,1000,12,2017.0,Comedy/Drama,0 days 01:32:00.000000000,-34
57,64,,Before I Fall,5000,123,2017.0,Drama/Mystery and thriller,0 days 01:40:00.000000000,7
29,57,https://resizing.flixster.com/wGCzu4m3FnRZC09U8_IxGxnLtrU=/206x305/v2/https://resizing.flixster.com/OcnIxnoZhthrFKTTFxIVN4kBNaY=/ems.ZW1zLXByZC1hc3NldHMvbW92aWVzLzEzOTkyMjk2LWI4YTUtNDYwZC1iNGMzLTY4MWJlOWFmZjAwNC53ZWJw,Brother Nature,100,7,2016.0,Comedy,0 days 01:37:00.000000000,28
68,53,https://resizing.flixster.com/P3fIebb3bVkjIkM5k4Xr1xkE9aQ=/206x305/v2/https://resizing.flixster.com/WU6WnoTEORajpD79ksMcAYNGq7Y=/ems.ZW1zLXByZC1hc3NldHMvbW92aWVzLzNhZGU4YzBhLWVhMzEtNDNhZC1iYTcwLTgyYzIzMjIwN2FhMi53ZWJw,London Town,250,17,2016.0,Drama,0 days 01:32:00.000000000,-15
10,60,,Worry Dolls,50,5,2016.0,Horror/Mystery and thriller,0 days 01:26:00.000000000,50
47,47,https://resizing.flixster.com/nC6lhEiKKPmVWAqMAOM6DZuGwyw=/206x305/v2/https://resizing.flixster.com/iZZ9X2O4E4y0l0e8Z_-H2QUrvCg=/ems.ZW1zLXByZC1hc3NldHMvbW92aWVzL2Q0N2Y0MTI1LWVjZWItNGM4MS04ZWQ0LTMyMzNjN2MwMzk5Yy53ZWJw,Rock Dog,2500,57,2016.0,Comedy/Kids and family,0 days 01:30:00.000000000,0
57,86,https://resizing.flixster.com/VzCqA3HVdmf-fhfmESCBFIB0BJM=/206x305/v2/https://resizing.flixster.com/yTV3kY1bsuGSfFlOSq8YXGpmbYw=/ems.ZW1zLXByZC1hc3NldHMvbW92aWVzLzY4ZTBiM2U5LWE2YzMtNDZkMC05NmY1LTgyNzVkMDAzNTE0Zi53ZWJw,Be My Cat: A Film for Anne,50,7,2015.0,Crime/Horror,0 days 01:27:00.000000000,29
35,0,,Life on the Line,250,15,2015.0,Action/Drama,0 days 01:38:00.000000000,-35
85,88,,Dancer,250,33,2016.0,Documentary,0 days 01:25:00.000000000,3
35,67,,The Neighbor,100,6,2016.0,Mystery and thriller,0 days 01:24:00.000000000,32
25,9,,I.T.,500,43,2016.0,Mystery and thriller,0 days 01:35:00.000000000,-16
76,64,,The Zookeeper's Wife,10000,180,2017.0,Drama/History,0 days 02:05:00.000000000,-12
29,0,,My Dead Boyfriend,50,11,2016.0,Romance,0 days 01:30:00.000000000,-29
77,91,,Blue Jay,1000,32,2016.0,Drama,0 days 01:25:00.000000000,14
71,82,,Amanda Knox,1000,49,2016.0,Crime/Documentary,0 days 01:32:00.000000000,11
73,92,https://resizing.flixster.com/3ueD29pOg2SqhXmRLnk2RlONP3I=/206x305/v2/https://resizing.flixster.com/rohaPtn2_64M9YcsKF5Q5IZ-ND4=/ems.ZW1zLXByZC1hc3NldHMvbW92aWVzLzFkNGFmYTQwLWQ0NjMtNDY0Zi1hZTIwLWIzY2JkODNhNzU0Yy53ZWJw,Into the Inferno,1000,49,2016.0,Documentary,0 days 01:44:00.000000000,19
74,77,,The Ivory Game,250,22,2016.0,Documentary,0 days 01:52:00.000000000,3
83,100,,The White Helmets,500,6,2016.0,Documentary,0 days 00:40:00.000000000,17
28,74,,We Are the Flesh,250,47,2016.0,Fantasy/Horror,0 days 01:19:00.000000000,46
46,43,https://resizing.flixster.com/rm8zPB_6hGjqtBsClMHFyAu4A_g=/206x305/v2/https://resizing.flixster.com/_F_KtIvhK9FP8acOWi3p4nhQ3WM=/ems.ZW1zLXByZC1hc3NldHMvbW92aWVzLzIyYzJhNmZhLTRkYmEtNDQwMy1hODQ1LTIwMDc4OTA1OTdjZi53ZWJw,ARQ,500,7,2016.0,Sci fi,0 days 01:28:00.000000000,-3
71,97,https://resizing.flixster.com/WF7JMDm0ih8919UAbJpG-vFtsBk=/206x305/v2/https://resizing.flixster.com/oyR_qklYImcF2kyMrqp1jmfv9yo=/ems.ZW1zLXByZC1hc3NldHMvbW92aWVzL2VkZDU5YWNkLTRmYjktNGZhYi05MmExLTgwYmVjNmFhYWMzMS53ZWJw,Seasons,1000,29,2015.0,Documentary,0 days 01:37:00.000000000,26
30,9,,ClownTown,100,11,2016.0,Horror/Mystery and thriller,0 days 01:26:00.000000000,-21
46,47,https://resizing.flixster.com/ycusES7Ox_aGqFoqhis-zcbrfxQ=/206x305/v2/https://resizing.flixster.com/9hTlZoA7VkvJIksTTht2NKAaCKY=/ems.ZW1zLXByZC1hc3NldHMvbW92aWVzL2JiZDIwYzVmLWY4YWMtNGEyYS1hODE3LTE3ZjM1NTM2ZWY1ZC53ZWJw,Ordinary World,250,17,2016.0,Drama/Comedy,0 days 01:26:00.000000000,1
67,94,,Batman: Return of the Caped Crusaders,250,18,2016.0,Animation/Action,0 days 01:18:00.000000000,27
72,100,https://resizing.flixster.com/Ps6dJ3DRzHMCsMBz4z1-VOClRv4=/206x305/v2/https://resizing.flixster.com/eVyLXh0DMrBMPmyuhaovsQ0I-Hw=/ems.ZW1zLXByZC1hc3NldHMvbW92aWVzLzhjN2VlZGI5LWU2YWEtNGI2Yy1hNmE0LWIzYmFjMjQ4YjBjNS53ZWJw,Disturbing the Peace,100,13,2016.0,Documentary,0 days 01:23:00.000000000,28
69,78,https://resizing.flixster.com/6_WZCR6w0KRes3UPZvHpE2DzRoc=/206x305/v2/https://flxt.tmsimg.com/assets/p13661364_p_v10_aa.jpg,Justice League Dark,1000,9,2017.0,Sci fi/Animation,0 days 01:16:00.000000000,9
51,75,https://resizing.flixster.com/9DyoM3dyi2RaxtUQWWS-yUVnQEQ=/206x305/v2/https://resizing.flixster.com/xCT_ZIKBcuJv-IGi7kBXOsj5cQM=/ems.ZW1zLXByZC1hc3NldHMvbW92aWVzLzQzOTA3NjJlLTcyMzAtNDRiYS1hMDBlLWYzMGQ3YTBkYzljMS53ZWJw,The Sense of an Ending,1000,120,2017.0,Drama,0 days 01:48:00.000000000,24
57,40,,Moments of Clarity,1,5,2015.0,Comedy/Adventure,0 days 01:37:00.000000000,-17
25,25,,The Legend of the Chupacabras,1,8,2016.0,Animation/Comedy,0 days 01:21:00.000000000,0
69,88,https://resizing.flixster.com/jhclKZxpC1wpgoK8ZL7eAfifZfU=/206x305/v2/https://resizing.flixster.com/MRWNnMG5GLLJyGsrb4_sAQ3mwYc=/ems.ZW1zLXByZC1hc3NldHMvbW92aWVzLzQ4NGEzMGYzLWU1NzAtNDIwYS05Zjk4LTcyNTZjM2FlMGFlZi53ZWJw,Hounds of Love,1000,98,2016.0,Crime/Drama,0 days 01:48:00.000000000,19
38,30,,In Dubious Battle,250,23,2016.0,Drama/History,0 days 01:54:00.000000000,-8
40,80,https://resizing.flixster.com/64DoYl_VJ2ug0cWR5BC8lftcccs=/206x305/v2/https://resizing.flixster.com/cIeAtasqgglzRfW9_QhVEoO3e8Q=/ems.ZW1zLXByZC1hc3NldHMvbW92aWVzL2IyMTFiMzNmLTMzNDYtNDEyYi04ZTljLWNlNTRlNTc1YTRjMS53ZWJw,The Monster,2500,50,2016.0,Fantasy/Horror,0 days 01:31:00.000000000,40
53,43,https://resizing.flixster.com/GyzFi8ji8o9xYSBw4npCvrNydkQ=/206x305/v2/https://resizing.flixster.com/3m3piZsWWxsSjrS5XctoK0JJxj0=/ems.ZW1zLXByZC1hc3NldHMvbW92aWVzLzg5ZWY3OTYyLWZhYzItNGYyZi04YzAyLWQyZWVkMzBiNzU1Yi53ZWJw,Brimstone,1000,77,2016.0,Western/Mystery and thriller,0 days 02:28:00.000000000,-10
56,88,https://resizing.flixster.com/74W5XW2AtBRvOynbMBqiziv88Kw=/206x305/v2/https://resizing.flixster.com/eLpv0l29HCwOhT1jsqeM8-7EM9o=/ems.ZW1zLXByZC1hc3NldHMvbW92aWVzLzcxZjI4ZWZjLTAyNWUtNDNkNC1iNDdiLTdkZDMyNTAzYjY1My53ZWJw,Norman: The Moderate Rise and Tragic Fall of a New York Fixer,2500,126,2016.0,Comedy/Drama,0 days 01:58:00.000000000,32
22,58,https://resizing.flixster.com/lq0SO6xHpmaSRQY-v10Qh27xfLQ=/206x305/v2/https://resizing.flixster.com/ceLH6JKp1OLuEDjLvnJ4iyoippw=/ems.ZW1zLXByZC1hc3NldHMvbW92aWVzLzExOGVkMDRhLWJlMzktNDlhZS1hN2UwLWM4ZDhmYjEwZjY4ZS53ZWJw,The Windmill Massacre,250,12,2016.0,Horror/Mystery and thriller,0 days 01:25:00.000000000,36
45,17,,Mine,1000,30,2016.0,Mystery and thriller/War,0 days 01:47:00.000000000,-28
73,62,,Carrie Pilby,1000,26,2016.0,Comedy/Drama,0 days 01:38:00.000000000,-11
77,75,,Before the Flood,2500,32,2016.0,Documentary,0 days 01:33:00.000000000,-2
68,95,,Tramps,500,22,2016.0,Romance,0 days 01:22:00.000000000,27
25,56,,Trespass Against Us,1000,71,2016.0,Crime/Drama,0 days 01:40:00.000000000,31
57,94,,The Levelling,250,34,2016.0,Drama,0 days 01:23:00.000000000,37
51,80,,Barry,500,46,2016.0,Drama/Biography,0 days 01:44:00.000000000,29
43,73,https://resizing.flixster.com/OcKJOCD-slxglcOHnd4U0dblwGs=/206x305/v2/https://resizing.flixster.com/EvLuZbfI-c_rkRqqvrh_vDiRwjI=/ems.ZW1zLXByZC1hc3NldHMvbW92aWVzL2IwOGE4ZjljLWUyMTctNGU1ZS04MTU3LTFkOTVlYzJkYmEyNC53ZWJw,Catfight,1000,60,2016.0,Comedy,0 days 01:36:00.000000000,30
40,54,,The Belko Experiment,5000,106,2016.0,Action/Horror,0 days 01:30:00.000000000,14
21,34,https://resizing.flixster.com/nqgB-NqR-t3yuX_Hd3x0j6hwheE=/206x305/v2/https://resizing.flixster.com/J_9TILOma7J8qwJjxMbRzvw4Gek=/ems.ZW1zLXByZC1hc3NldHMvbW92aWVzLzYwYTNjOTcwLWZiODctNDBiOC05NzYzLWZhZWQ1ZjlhMDI0ZC53ZWJw,The Assignment,500,61,2016.0,Action/Mystery and thriller,0 days 01:36:00.000000000,13
61,80,https://resizing.flixster.com/PuHcbDFitPHVsBuHqUL9pXlg5ng=/206x305/v2/https://resizing.flixster.com/vcn7dfPKUYXl4mBze_-x7pKuXdU=/ems.ZW1zLXByZC1hc3NldHMvbW92aWVzLzgyYTJhZWIyLTNkMDQtNDI2ZS04ZDU1LTUxOTRjNjg0MzUzOC53ZWJw,Operation Mekong,500,10,2016.0,Action/Adventure,0 days 02:04:00.000000000,19
79,100,/assets/pizza-pie/images/poster_default.c8c896e70c3.gif,Justin Timberlake + The Tennessee Kids,1,14,2016.0,,,21
65,43,,The Duelist,100,14,2016.0,Drama/Mystery and thriller,0 days 01:49:00.000000000,-22
24,58,https://resizing.flixster.com/pjji0_EoZ_Pq3qHSo_Giz0YCRPo=/206x305/v2/https://resizing.flixster.com/027j33LFKzQklClYYZ7N2qnkSgE=/ems.ZW1zLXByZC1hc3NldHMvbW92aWVzLzUzMzkwZDU2LWQzNjMtNGFmZC1hODU2LTU2YWFmZjA1ZTYwZi53ZWJw,I Am the Pretty Thing That Lives in the House,1000,19,2016.0,Horror,0 days 01:27:00.000000000,34
47,36,,Flock of Dudes,100,11,2016.0,Comedy,0 days 01:30:00.000000000,-11
34,9,,The Unspoken,100,11,2015.0,Horror/Mystery and thriller,0 days 01:31:00.000000000,-25
57,73,,Headshot,1000,49,2016.0,Action/Sports and fitness,0 days 01:58:00.000000000,16
70,87,,The Autopsy of Jane Doe,10000,106,2016.0,Horror/Mystery and thriller,0 days 01:26:00.000000000,17
32,56,,Pet,1000,18,2016.0,Mystery and thriller,0 days 01:30:00.000000000,24
18,0,,Contract to Kill,100,5,2016.0,Action/Mystery and thriller,0 days 01:30:00.000000000,-18
58,71,,David Cross: Making America Great Again,1,7,2016.0,,,13
83,99,,I Am Not Your Negro,10000,207,2016.0,Documentary,0 days 01:35:00.000000000,16
41,60,,It Had to Be You,100,5,2015.0,Romance,0 days 01:25:00.000000000,19
76,83,,Mifune: The Last Samurai,500,36,2015.0,Documentary,0 days 01:20:00.000000000,7
47,78,,The Void,5000,74,2016.0,Horror,0 days 01:30:00.000000000,31
16,18,https://resizing.flixster.com/Yk3QrYIaLMH8R17IjKH18H0OepU=/206x305/v2/https://resizing.flixster.com/Glu9pmDb5xPy9zZtetOhHdhRs8g=/ems.ZW1zLXByZC1hc3NldHMvbW92aWVzL2QwZTJhMmQ5LTg0ZmMtNDQwNC04OTVkLTBlZjljOGZmZDUwNy53ZWJw,Rupture,500,34,2016.0,Sci fi/Mystery and thriller,0 days 01:42:00.000000000,2
31,25,,Don't Hang Up,500,16,2016.0,Horror/Mystery and thriller,0 days 01:23:00.000000000,-6
34,38,,Voice From the Stone,500,26,2017.0,Horror/Mystery and thriller,0 days 01:34:00.000000000,4
27,71,https://resizing.flixster.com/SnHigzqU66HyV7KzOyN1CayU-jQ=/206x305/v2/https://resizing.flixster.com/vBdg1Os2JWEVNwDAnywrQUd_Lyk=/ems.ZW1zLXByZC1hc3NldHMvbW92aWVzLzc1NzY3MTA4LTkzN2YtNDVhYy1hNjY4LWY4YjUxNmQ1NGVlYy53ZWJw,"No Pay, Nudity",100,7,2016.0,Comedy/Drama,0 days 01:32:00.000000000,44
9,20,,The Possession Experiment,1,5,2016.0,Horror/Mystery and thriller,0 days 01:24:00.000000000,11
45,94,,SHOT! The Psycho-Spiritual Mantra of Rock,100,17,2016.0,Documentary/Music,0 days 01:35:00.000000000,49
38,55,,Attack of the Lederhosen Zombies,100,11,2016.0,Comedy/Horror,0 days 01:18:00.000000000,17
25,25,,Army of One,500,12,2016.0,Comedy,0 days 01:33:00.000000000,0
92,29,,The Red Pill,1000,7,2016.0,Documentary,0 days 01:57:00.000000000,-63
69,83,https://resizing.flixster.com/TVnj4CQ6UJQdgWo7E8mgkfaQ8Cw=/206x305/v2/https://resizing.flixster.com/D8GkGHB-mVgHvYaVw7qBHlCADhg=/ems.ZW1zLXByZC1hc3NldHMvbW92aWVzL2FmN2FiMTMxLWIxYTgtNDBlMy1hNjMxLWY0NzAwMzBhNThhYi53ZWJw,Silence,25000,283,2016.0,Drama/History,0 days 02:41:00.000000000,14
57,67,,Sword Master,250,12,2016.0,Action/Sports and fitness,0 days 01:45:00.000000000,10
36,14,,All Nighter,250,14,2017.0,Comedy,0 days 01:26:00.000000000,-22
56,90,,The Dark Tapes,250,10,2017.0,Sci fi/Horror,0 days 01:38:00.000000000,34
50,20,,The Adventure Club,1,5,2016.0,Adventure,0 days 01:30:00.000000000,-30
86,98,,Get Out,50000,392,2017.0,Horror/Mystery and thriller,0 days 01:44:00.000000000,12
28,24,,The Comedian,1000,114,2016.0,Comedy/Drama,0 days 02:00:00.000000000,-4
86,100,,The 24 Hour War,250,6,2016.0,Documentary/Drama,0 days 01:38:00.000000000,14
57,90,,Creepy,250,52,2016.0,Mystery and thriller,0 days 02:10:00.000000000,33
17,20,,Dead Awake,100,10,2016.0,Horror/Mystery and thriller,0 days 01:39:00.000000000,3
33,88,https://resizing.flixster.com/jss1q_kKZ9lQ4g3-FQyLOe-mpy8=/206x305/v2/https://flxt.tmsimg.com/assets/p12777256_p_v10_aa.jpg,Roger Corman's Death Race 2050,250,8,2017.0,Action/Sci fi,0 days 01:33:00.000000000,55
64,100,,Fare,1,6,2016.0,Drama/Mystery and thriller,0 days 01:15:00.000000000,36
58,100,https://resizing.flixster.com/uB_-k9q1qxH_DVitxpT7AbwRb3U=/206x305/v2/https://resizing.flixster.com/ING-26XKwin1xjplp34ZwEWgpDk=/ems.ZW1zLXByZC1hc3NldHMvbW92aWVzLzUyMWZhYTQ3LWUzOGMtNDIxZi05ZmVjLTYyNzNmNzU5ZDJjNi53ZWJw,Orange Sunshine,250,7,2016.0,Documentary,0 days 01:45:00.000000000,42
33,62,,Come and Find Me,500,13,2016.0,Mystery and thriller,0 days 01:52:00.000000000,29
69,80,,The Grace of Jake,100,5,2015.0,Comedy/Drama,0 days 01:32:00.000000000,11
12,42,,Drifter,50,12,2016.0,Horror/Mystery and thriller,0 days 01:26:00.000000000,30
50,88,/assets/pizza-pie/images/poster_default.c8c896e70c3.gif,Bwoy,1,8,2016.0,Gay and lesbian/Drama,0 days 01:25:00.000000000,38
18,0,https://resizing.flixster.com/rqBo-diGq_IDqCfQlgGFpeuyuWk=/206x305/v2/https://resizing.flixster.com/48w_PFpf6s4yz4BU34N_exYqkIw=/ems.ZW1zLXByZC1hc3NldHMvbW92aWVzL2ZlMTE3NzU5LTJjMGMtNGMxOS05ZmJmLWIzZWI4YzFiNGE2OS53ZWJw,Kill Ratio,1,5,2016.0,Action,0 days 01:27:00.000000000,-18
76,100,https://resizing.flixster.com/Ng4tNapRe6slSnfEgpsD8xUo9dQ=/206x305/v2/https://resizing.flixster.com/wRm_qeoIGU90rFqcEM7D0fazWYI=/ems.ZW1zLXByZC1hc3NldHMvbW92aWVzLzNiNzU2ZjFiLTdiZjYtNDZkYi1hOWExLTM1NjcwNjY4YjBhMS53ZWJw,Beyond Borders: Esteros,100,8,2016.0,Gay and lesbian/Drama,0 days 01:23:00.000000000,24
67,15,,Bitter Harvest,1000,61,2017.0,War/Drama,0 days 01:43:00.000000000,-52
71,90,,Their Finest,5000,170,2016.0,Romance/Drama,0 days 01:57:00.000000000,19
62,85,,I Am Bolt,250,13,2016.0,Documentary,0 days 01:47:00.000000000,23
87,100,,Mommy Dead and Dearest,250,13,2017.0,Documentary,0 days 01:22:00.000000000,13
82,100,https://resizing.flixster.com/Bq298uo1en3KH9yoxHaUZKNf4F4=/206x305/v2/https://resizing.flixster.com/3kC8SOXByi7TcxK1Qh4hkNE9M5M=/ems.ZW1zLXByZC1hc3NldHMvbW92aWVzL2Y1OGYyNjdiLWZjOWQtNDhjYS05NjRmLWFhM2M5OTBkOTVmZC53ZWJw,Everlasting,100,11,2016.0,Crime/Romance,0 days 01:25:00.000000000,18
51,9,,Run the Tide,100,11,2016.0,Drama,0 days 01:40:00.000000000,-42
64,40,https://resizing.flixster.com/iUJUUVAfjJVOZD4PF4i_d-_iyKs=/206x305/v2/https://resizing.flixster.com/rDI_DEG9E8jYAQmndlYwaNgv5ts=/ems.ZW1zLXByZC1hc3NldHMvbW92aWVzLzczMGFmNGIxLTM0OWQtNGQ0MS04MWU0LTY5OTA0ZWM0YzczMC53ZWJw,The Last Word,1000,95,2017.0,Comedy/Drama,0 days 01:48:00.000000000,-24
83,90,,Marathon: The Patriots Day Bombing,50,10,2016.0,,,7
63,8,https://resizing.flixster.com/uxXVQfs8amxoxiYhVd-7HCAJPlM=/206x305/v2/https://resizing.flixster.com/jCs7On4vXjSv_P3fmRwAaghmHgQ=/ems.ZW1zLXByZC1hc3NldHMvbW92aWVzLzg4YzliNTcwLTAyY2ItNGExNy05ZjhiLWIxZDg4ZmUyOTA2My53ZWJw,The Book of Love,500,12,2016.0,Comedy/Drama,0 days 01:44:00.000000000,-55
41,60,,Burn Country,100,15,2016.0,Drama/Mystery and thriller,0 days 01:43:00.000000000,19
86,75,https://resizing.flixster.com/yITTQxxo-2Ceh_QtHg7sNp5EcQs=/206x305/v2/https://resizing.flixster.com/s3RYlTvwEDekoFU6g_x57dzJeNY=/ems.ZW1zLXByZC1hc3NldHMvbW92aWVzLzY1N2U2ZWJlLWUyYjUtNGJmNy1hYTAzLTk2YTgwZTZlYTIxZC53ZWJw,Father Never Bothered,500,8,2016.0,Comedy,0 days 01:34:00.000000000,-11
35,41,,A Hundred Streets,1000,39,2016.0,Drama,0 days 01:33:00.000000000,6
46,38,https://resizing.flixster.com/LV3G3W2NB-s5ngyCwQtnxJBym6s=/206x305/v2/https://resizing.flixster.com/GZWainJ_-bp02Yabz5ehiqp_KBk=/ems.ZW1zLXByZC1hc3NldHMvbW92aWVzL2VjOTAyNDc5LTk3ZGQtNDlkMS1hOWI4LWIzZTYwN2FmOTgyNS53ZWJw,Railroad Tigers,250,34,2016.0,Comedy/Action,0 days 02:04:00.000000000,-8
92,100,https://resizing.flixster.com/Y9UwfSnKrwHmoCwDRUl4fHML-P8=/206x305/v2/https://resizing.flixster.com/cBdEA_FDRA7KSfBTjgIuewgH4eE=/ems.ZW1zLXByZC1hc3NldHMvbW92aWVzL2FmYjM2OTFiLWZkZjktNDBhOC04ZmQwLTIxMWUxYTA0YTk4Zi53ZWJw,The C Word,100,6,2016.0,Documentary,0 days 01:29:00.000000000,8
17,11,,Eloise,250,9,2017.0,Horror/Mystery and thriller,0 days 01:29:00.000000000,-6
68,33,,Believe,500,6,2016.0,Other/Drama,0 days 01:59:00.000000000,-35
70,57,,Akron,50,7,2015.0,Romance/Gay and lesbian,0 days 01:28:00.000000000,-13
70,100,https://resizing.flixster.com/PAXhFMMPyUiRZl93FJ3x7c-xMUQ=/206x305/v2/https://resizing.flixster.com/J--C5SBGteBsZF4az73X3uu2FtM=/ems.ZW1zLXByZC1hc3NldHMvbW92aWVzLzAwN2ZmYzcyLTJjZTEtNDM4NC1iNmZlLWQ2ZmMwMmZlY2E3Zi53ZWJw,Michael Che Matters,1,5,2016.0,,,30
61,33,https://resizing.flixster.com/2DuQhBqy79zv3qUH59pm0SAnmFA=/206x305/v2/https://resizing.flixster.com/TQjCZQgW0Av0oNKHUR8FeeFUJds=/ems.ZW1zLXByZC1hc3NldHMvbW92aWVzL2YwNWE0YzI4LWJjMDAtNGZhZi05Mzk5LTlmMTFiOGY0YTI1ZC53ZWJw,1 Night,100,6,2016.0,Romance/Comedy,0 days 01:20:00.000000000,-28
45,29,,Bethany,50,7,2017.0,Horror,0 days 01:30:00.000000000,-16
70,89,,Everybody Loves Somebody,2500,19,2017.0,Romance,0 days 01:41:00.000000000,19
70,17,,The Crash,250,12,2017.0,Crime/Drama,0 days 01:24:00.000000000,-53
25,50,,The Warrior's Gate,250,8,2016.0,Action/Fantasy,0 days 01:48:00.000000000,25
20,71,,XX,2500,62,2017.0,Horror,0 days 01:21:00.000000000,51
15,75,https://resizing.flixster.com/aeBBI-u1l4s3pJXa6IWlPjMWMeQ=/206x305/v2/https://resizing.flixster.com/MpZ8_3N2Fkgj4ZNrgnVL9doLUtM=/ems.ZW1zLXByZC1hc3NldHMvbW92aWVzL2U2MmIzYzVhLWMzZWItNDY4ZC1hNjY4LTQxOTU4YzQwNjg2YS53ZWJw,Stray Bullets,50,8,2016.0,Crime/Drama,0 days 01:23:00.000000000,60
39,69,https://resizing.flixster.com/HAvpKnIaZrmS97vbAlCLxWJfSgY=/206x305/v2/https://resizing.flixster.com/-RSlIadRXS5gbL_sra8ALvtPlPU=/ems.ZW1zLXByZC1hc3NldHMvbW92aWVzL2I4MGMyMzVjLTE1ZmUtNGUzMi1iNTQ3LTNmMTE4MDQ5YWYxZi53ZWJw,iBoy,500,13,2017.0,Action/Sci fi,0 days 01:31:00.000000000,30
90,100,https://resizing.flixster.com/ZcRuwo6FEq-moDCAelBLgwrFAGo=/206x305/v2/https://resizing.flixster.com/t3MHuDUgRLVgd7mmbX7ij-V88MA=/ems.ZW1zLXByZC1hc3NldHMvbW92aWVzLzA3ZjE2M2UzLWI5OWUtNGY4Zi04ZmEwLWU5MDc3NGNjMjEwNy53ZWJw,Long Strange Trip,1000,32,2017.0,Documentary/Music,0 days 03:58:00.000000000,10
49,81,,Casting JonBenét,250,54,2017.0,Documentary,0 days 01:20:00.000000000,32
76,89,,I Don't Feel at Home in This World Anymore,2500,65,2017.0,Crime/Drama,0 days 01:36:00.000000000,13
66,100,,Legion of Brothers,250,7,2017.0,Documentary,0 days 01:19:00.000000000,34
96,30,,VooDoo,500,10,2017.0,Horror,0 days 01:24:00.000000000,-66
48,55,https://resizing.flixster.com/k3HeN5DZMnVgADUzTKuWlVVIDXo=/206x305/v2/https://resizing.flixster.com/I4VvTltMryo1hm5biqXkg17SzTI=/ems.ZW1zLXByZC1hc3NldHMvbW92aWVzL2Q1ZjAxYTNmLWI5NDgtNDJlMC04NTc0LTdhM2YyYmM2OTNlYS53ZWJw,Speech & Debate,100,11,2017.0,Comedy,0 days 01:55:00.000000000,7
24,43,https://resizing.flixster.com/0BLaLtBOd-jHgwMF2wF7fY78jx0=/206x305/v2/https://resizing.flixster.com/vyWptXJ2oL1_NOEdBm37F6SrFkk=/ems.ZW1zLXByZC1hc3NldHMvbW92aWVzLzJmN2VjNWYzLWI1MzgtNGJhNi05NjU5LTdiYTBlYzc2NzcyNi53ZWJw,Bokeh,500,21,2017.0,Sci fi/Mystery and thriller,0 days 01:32:00.000000000,19
59,88,https://resizing.flixster.com/1iItOuRWEZW4i2Rn5csWIjD8FYY=/206x305/v2/https://resizing.flixster.com/q_jKSOl_nvyCiS7YEyLiYfoDL8E=/ems.ZW1zLXByZC1hc3NldHMvbW92aWVzLzM3NTYzZGMwLThiMGQtNDU2ZC05ZThlLWI0MTVmZjRkZGU2MC53ZWJw,Burning Sands,250,26,2017.0,Drama,0 days 01:36:00.000000000,29
53,75,https://resizing.flixster.com/_9K3PEWU0WmsIMxkOGpicTixx3o=/206x305/v2/https://resizing.flixster.com/EfYna7cY57OFuGSdo9EXBuhe0e4=/ems.ZW1zLXByZC1hc3NldHMvbW92aWVzLzgzYmY4M2NhLTdmNWEtNGU3MS1hMTZjLWVhNzIwMDdlOTQ0Ny53ZWJw,Berlin Syndrome,2500,88,2017.0,Mystery and thriller,0 days 01:56:00.000000000,22
49,58,,Journey to the West: The Demons Strike Back,500,12,2017.0,Action/Fantasy,0 days 01:49:00.000000000,9
40,0,,Sex Doll,100,5,2016.0,Mystery and thriller,0 days 01:44:00.000000000,-40
62,100,https://resizing.flixster.com/vLUcEDZh0wXV9--mSPtMBtSNwJk=/206x305/v2/https://resizing.flixster.com/OWxMDt92eZO184ZHEtk53BvE_Vk=/ems.ZW1zLXByZC1hc3NldHMvbW92aWVzLzQxMDA2NzI1LTQ4MzQtNGJhNi05M2E1LThmNGJhM2ZkNGJjNi53ZWJw,"Michael Bolton's Big, Sexy Valentine's Day Special",50,5,2017.0,,,38
72,83,,Teen Titans: The Judas Contract,500,6,2017.0,Action/Animation,0 days 01:16:00.000000000,11
39,36,,The Most Hated Woman in America,250,22,2017.0,Drama/Biography,0 days 01:31:00.000000000,-3
55,85,,Win It All,500,40,2017.0,Comedy,0 days 01:30:00.000000000,30
90,100,,Eagles of Death Metal: Nos Amis (Our Friends),100,7,2017.0,Documentary/Music,0 days 01:23:00.000000000,10
39,93,https://resizing.flixster.com/Sbk5CeSmYjEmipztjHQUcUlsfn8=/206x305/v2/https://flxt.tmsimg.com/assets/p13286731_p_v10_aa.jpg,Don't Kill It,250,15,2016.0,Fantasy/Action,0 days 01:33:00.000000000,54
14,0,,The Institute,100,5,2017.0,Mystery and thriller,0 days 01:30:00.000000000,-14
39,71,,Dig Two Graves,500,28,2014.0,Horror/Mystery and thriller,0 days 01:25:00.000000000,32
74,61,,This Beautiful Fantastic,500,23,2016.0,Comedy/Drama,0 days 01:32:00.000000000,-13
83,100,,Neal Brennan: 3 Mics,1,7,2017.0,,,17
75,95,https://resizing.flixster.com/bkUcI8hfKVbPgJvPKirZBGY8giY=/206x305/v2/https://resizing.flixster.com/Ojl_pCkkjyveL2z9AvZrm0QQKQA=/ems.ZW1zLXByZC1hc3NldHMvbW92aWVzL2Y3NTc5NGIyLTdlOWItNDJmMi1iM2FhLTRjY2VhOWM0YmQwMC53ZWJw,Louis C.K.: 2017,250,20,2017.0,,,20
72,83,,Tracy Morgan: Staying Alive,1,6,2017.0,,,11
38,22,https://resizing.flixster.com/3mcjkEHn0rMvXGilxgn6X4vZHMo=/206x305/v2/https://flxt.tmsimg.com/NowShowing/173644/173644_aa.jpg,2:22,500,9,2017.0,Mystery and thriller,0 days 01:39:00.000000000,-16
78,100,https://resizing.flixster.com/6nauqG1W_CwG_C4fwmAAYTAAx_0=/206x305/v2/https://resizing.flixster.com/8dTYZbZwfAlNjCTTL1h7HTOUXBw=/ems.ZW1zLXByZC1hc3NldHMvbW92aWVzLzU1MDc3ODkwLTc5NGItNDVhNC05NDE5LTViMzRkY2UxNmQ4NC53ZWJw,Mike Birbiglia: Thank God for Jokes,50,8,2017.0,Comedy/Stand up,0 days 01:10:00.000000000,22
82,88,,Get Me Roger Stone,500,33,2017.0,Documentary/Biography,0 days 01:40:00.000000000,6
31,59,https://resizing.flixster.com/_cJqD7RDCaEzJHNQS91npn6reAQ=/206x305/v2/https://resizing.flixster.com/Z9mODIuR4j3Rcf6YPE7BRoeCswQ=/ems.ZW1zLXByZC1hc3NldHMvbW92aWVzL2MxNGM1MTU1LWNiZDctNDcxOC05ZjJkLThhMWViMTlhYmY1OC53ZWJw,Small Crimes,250,17,2017.0,Crime/Drama,0 days 01:35:00.000000000,28
81,20,https://resizing.flixster.com/gc8JTMAkP6_dvUtQ03xfkrdogYM=/206x305/v2/https://resizing.flixster.com/CstLlzInIgHS33Oye0jpQwRTC5w=/ems.ZW1zLXByZC1hc3NldHMvbW92aWVzLzFmMDBiOGM0LWRjNjgtNDg3OS1iNTViLWNhMzE4OTkwNDkxOC53ZWJw,Danger Close,50,5,2017.0,Action,0 days 01:27:00.000000000,-61
4,50,https://resizing.flixster.com/yHrZzqaWRIDPzG0HGAs7utXFLxs=/206x305/v2/https://resizing.flixster.com/yBzhjjPS6NI8bFZnZrnfjzTML8I=/ems.ZW1zLXByZC1hc3NldHMvbW92aWVzLzRkMDE5ZTg2LTRmNGQtNDY4Mi1hMDI4LThhOGUzNGM3ZjY2Ny53ZWJw,Amy Schumer: The Leather Special,500,8,2017.0,,,46
26,27,,Drone,250,11,2017.0,Action/Mystery and thriller,0 days 01:31:00.000000000,1
84,86,,I Am Heath Ledger,500,29,2017.0,Documentary,0 days 01:30:00.000000000,2
95,0,,96 Souls,100,6,2016.0,Sci fi/Drama,0 days 01:52:00.000000000,-95
92,60,,Hearing Is Believing,1,5,2016.0,Documentary/Music,0 days 01:44:00.000000000,-32
56,100,,Rodney King,50,9,2017.0,,,44
44,44,,"Can't Stop, Won't Stop: A Bad Boy Story",50,9,2017.0,Documentary/Music,0 days 01:20:00.000000000,0
30,17,https://resizing.flixster.com/HQ3QefYIb3OA2edKSaSrbYWe1oA=/206x305/v2/https://flxt.tmsimg.com/assets/p13838740_p_v10_ab.jpg,Be Afraid,100,12,2017.0,Sci fi/Mystery and thriller,0 days 01:39:00.000000000,-13
58,60,,Shimmer Lake,500,10,2017.0,Crime/Comedy,0 days 01:27:00.000000000,2
86,78,https://resizing.flixster.com/c0WSYJJFW4x_r5cbBjDt83s5D1g=/206x305/v2/https://resizing.flixster.com/_uLOmgxermb7h-kbPpiPER4OED0=/ems.ZW1zLXByZC1hc3NldHMvbW92aWVzLzBlMTc4Y2RlLTYwZDQtNDhhZC1iYTkwLWQ3NzMwOGRkYmE1NC53ZWJw,Hasan Minhaj: Homecoming King,100,9,2017.0,Comedy/Stand up,0 days 01:12:00.000000000,-8
50,100,,Sarah Silverman: A Speck of Dust,50,10,2017.0,,,50
82,88,,"Oh, Hello On Broadway",100,8,2017.0,Comedy,0 days 01:42:00.000000000,6
44,91,,"Nobody Speak: Hulk Hogan, Gawker and Trials of a Free Press",250,34,2017.0,Documentary,0 days 01:36:00.000000000,47
81,91,,Human Flow,1000,118,2017.0,Documentary,0 days 02:20:00.000000000,10
80,100,https://resizing.flixster.com/kTaza1EYpPbCUzRi9LrSVI_Sr0I=/206x305/v2/https://resizing.flixster.com/c5SsyP3-AHPcsNknF2t5xSJhFAw=/ems.ZW1zLXByZC1hc3NldHMvbW92aWVzLzM2MzkyZGY3LWZiOTUtNDhhOC1hMzhjLTM5YTVlMTAzYzFiMi53ZWJw,Maria Bamford: Old Baby,1,14,2017.0,,,20
87,61,,Rosencrantz and Guildenstern Are Dead,10000,31,1990.0,Comedy/Drama,0 days 01:58:00.000000000,-26
84,100,,The Decline of Western Civilization,2500,38,1981.0,Documentary,0 days 01:40:00.000000000,16
22,24,,The Runner,1000,38,2015.0,Drama,0 days 01:30:00.000000000,2
31,40,/assets/pizza-pie/images/poster_default.c8c896e70c3.gif,The Horror of H.P. Lovecraft (LovecraCked! The Movie),1000,5,2006.0,,,9
72,67,,Carry on Screaming,2500,6,1966.0,Comedy,0 days 01:37:00.000000000,-5
89,100,,Titicut Follies,1000,11,1967.0,Documentary,0 days 01:30:00.000000000,11
74,93,https://resizing.flixster.com/05D4EBKogIq6d0ARmLNoMcnnSvQ=/206x305/v2/https://flxt.tmsimg.com/assets/p5805_p_v10_aa.jpg,A Child Is Waiting,1000,14,1963.0,Drama,0 days 01:42:00.000000000,19
77,90,https://resizing.flixster.com/cdp_krSxKLtoq79xeN12LGjUQTk=/206x305/v2/https://flxt.tmsimg.com/assets/p10878_p_v10_ab.jpg,The Decline of Western Civilization Part II: The Metal Years,2500,10,1988.0,Documentary,0 days 01:33:00.000000000,13
85,100,,The Island,500,7,1960.0,Drama,0 days 01:36:00.000000000,15
85,96,,"Out 1, Noli Me Tangere",250,24,1971.0,,,11
90,100,,Speedy,500,6,1928.0,Comedy,0 days 01:27:00.000000000,10
62,100,,Dr. Terror's House of Horrors,1000,5,1965.0,Horror,0 days 01:38:00.000000000,38
94,100,,A Brighter Summer Day,1000,20,1991.0,Drama,0 days 04:00:00.000000000,6
56,40,,Wild Thing,250,5,1987.0,Action,0 days 01:32:00.000000000,-16
70,57,https://resizing.flixster.com/hWzEVeE2RG__qAOfFCuVw6VfhNA=/206x305/v2/https://flxt.tmsimg.com/assets/p6627_p_v10_aa.jpg,The Challenge,250,7,1982.0,Crime/Drama,0 days 01:52:00.000000000,-13
77,100,https://resizing.flixster.com/7jv4BxI9u01Ml3Rjxc_1zrJ2MCo=/206x305/v2/https://resizing.flixster.com/_KgIOt5Ygcag8hFVa68GkGazHvI=/ems.ZW1zLXByZC1hc3NldHMvbW92aWVzLzA4YTg3N2I1LTJhMmItNGM5MC05OWNhLTE2MDhkNDEzZWQzZC53ZWJw,Rebels of the Neon God,500,34,1993.0,Drama,0 days 01:46:00.000000000,23
49,40,,Madhouse,500,5,1974.0,Horror,0 days 01:29:00.000000000,-9
80,67,,The Tall Blond Man With One Black Shoe,500,6,1972.0,Comedy/Mystery and thriller,0 days 01:30:00.000000000,-13
86,82,https://resizing.flixster.com/3AkjJ2HrvonKg_rIkYqD6e-3tRk=/206x305/v2/https://resizing.flixster.com/ORJjIqDWZCl2V4KT1jfLNUPD0oo=/ems.ZW1zLXByZC1hc3NldHMvbW92aWVzLzkyOTFlZTI0LWVlYjAtNGU5Ni1iZWY1LWQ3YjI5NWNmN2UzMS53ZWJw,Ant-Man,100000,331,2015.0,Action/Fantasy,0 days 01:57:00.000000000,-4
19,8,,The Lovers,1000,13,2014.0,Romance/Action,0 days 01:45:00.000000000,-11
68,93,,I'll See You in My Dreams,10000,92,2015.0,Romance/Drama,0 days 01:25:00.000000000,25
63,60,https://resizing.flixster.com/plUgqDQf1XRLIkxNs2loTYYk7RE=/206x305/v2/https://flxt.tmsimg.com/assets/p9514_p_v8_aa.jpg,My American Cousin,100,5,1985.0,Comedy/Drama,0 days 01:35:00.000000000,-3
44,85,,"Hail, Caesar!",25000,360,2016.0,Comedy,0 days 01:46:00.000000000,41
36,4,,Shanghai,2500,24,2010.0,Mystery and thriller/Drama,0 days 01:45:00.000000000,-32
22,30,,Poltergeist,25000,135,2015.0,Horror/Mystery and thriller,0 days 01:33:00.000000000,8
84,99,/assets/pizza-pie/images/poster_default.c8c896e70c3.gif,Darbareye Elly,5000,70,2009.0,Drama/Mystery and thriller,0 days 01:59:00.000000000,15
62,78,,Goosebumps,50000,164,2015.0,Comedy/Fantasy,0 days 01:43:00.000000000,16
86,89,,The Golden Dream,1000,36,2013.0,Drama,0 days 01:42:00.000000000,3
69,33,,Pelé,1000,30,2016.0,Drama/History,0 days 01:47:00.000000000,-36
43,67,,Rich Kids,50,6,1979.0,Comedy/Drama,0 days 01:41:00.000000000,24
73,100,,Sun Ra: A Joyful Noise,1,5,1981.0,Documentary/Music,0 days 01:00:00.000000000,27
33,100,,Stations of the Elevated,100,8,1981.0,Documentary,0 days 00:46:00.000000000,67
86,97,https://resizing.flixster.com/QjeBkzpqqCHcl9sk0kz_1a1Hu-M=/206x305/v2/https://flxt.tmsimg.com/NowShowing/140378/140378_ab.jpg,Mad Max: Fury Road,100000,427,2015.0,Action/Adventure,0 days 02:00:00.000000000,11
45,46,,Pride and Prejudice and Zombies,25000,195,2016.0,Action/Horror,0 days 01:48:00.000000000,1
42,88,,The American Dreamer,1,8,1971.0,Documentary,0 days 01:21:00.000000000,46
43,25,https://resizing.flixster.com/j63oVdMWDKxO8N5t6v9WVUEQSNw=/206x305/v2/https://flxt.tmsimg.com/assets/p11534144_p_v10_ab.jpg,Broken Horses,250,20,2015.0,Crime/Action,0 days 01:41:00.000000000,-18
48,75,https://resizing.flixster.com/7GWI6wWK19qjhanxx_-FxZDyM40=/206x305/v2/https://flxt.tmsimg.com/assets/p8465890_p_v8_aa.jpg,SoulBoy,250,8,2010.0,Romance/Comedy,0 days 01:22:00.000000000,27
20,15,,Pound of Flesh,250,13,2015.0,Action/Mystery and thriller,0 days 01:44:00.000000000,-5
61,67,,Showrunners: The Art of Running a TV Show,250,6,2014.0,Documentary,0 days 01:30:00.000000000,6
40,71,https://resizing.flixster.com/U7Pv7VfACStHt7Zy2A1LhW1AR1o=/206x305/v2/https://flxt.tmsimg.com/assets/p8656244_p_v10_aa.jpg,The Forgotten Space,100,7,2010.0,Documentary,0 days 01:56:00.000000000,31
64,72,,Addiction Incorporated,500,25,2011.0,Documentary,0 days 01:40:00.000000000,8
29,11,,Point Break,10000,110,2015.0,,,-18
52,60,https://resizing.flixster.com/Q1dSQMGRCAcqNmmh0S8Fzd1upxo=/206x305/v2/https://flxt.tmsimg.com/assets/p11823409_p_v10_ae.jpg,Sisters,25000,178,2015.0,Comedy,0 days 01:58:00.000000000,8
75,60,https://resizing.flixster.com/CoAjXXSxwRmbR6J062Sia0xZZGo=/206x305/v2/https://flxt.tmsimg.com/assets/p11447189_p_v10_an.jpg,Southpaw,25000,239,2015.0,Drama,0 days 02:03:00.000000000,-15
73,68,https://resizing.flixster.com/SNJU7WTfUeRGoD05-e99RdopcQo=/206x305/v2/https://flxt.tmsimg.com/assets/p10592915_p_v10_ad.jpg,The Man From U.N.C.L.E.,25000,291,2015.0,Action/Adventure,0 days 01:56:00.000000000,-5
37,47,,Knight of Cups,5000,182,2015.0,Drama,0 days 01:58:00.000000000,10
56,78,https://resizing.flixster.com/3fX5r_IwIZ6nfmmE-meAK89Feio=/206x305/v2/https://flxt.tmsimg.com/assets/p8696334_p_v10_aa.jpg,The Color Wheel,250,27,2011.0,Romance/Comedy,0 days 01:23:00.000000000,22
46,17,,Pixels,50000,203,2015.0,Comedy/Sci fi,0 days 01:46:00.000000000,-29
65,75,https://resizing.flixster.com/v_GW1SYVgjqD_PdmrXejmEAmAA4=/206x305/v2/https://flxt.tmsimg.com/assets/p9124096_p_v10_ab.jpg,Zarafa,500,20,2012.0,Drama/Kids and family,0 days 01:18:00.000000000,10
82,92,,"Electric Boogaloo: The Wild, Untold Story of Cannon Films",500,48,2014.0,Documentary,0 days 01:46:00.000000000,10
54,68,https://resizing.flixster.com/xdH0RkyXgJ6C7ld9HLqqs-0f3Dw=/206x305/v2/https://flxt.tmsimg.com/assets/p8985332_p_v13_ab.jpg,Greedy Lying Bastards,500,37,2012.0,Documentary,0 days 01:30:00.000000000,14
60,100,https://resizing.flixster.com/eDWgrIZWGtth6gRjgWEuq0ec_wU=/206x305/v2/https://flxt.tmsimg.com/assets/p9938336_p_v8_aa.jpg,Life Tracker,100,6,2012.0,Sci fi,0 days 01:42:00.000000000,40
78,83,,Cinderella,50000,250,2015.0,Fantasy/Romance,0 days 01:45:00.000000000,5
55,100,,The Girls in the Band,100,10,2011.0,Documentary/Music,0 days 01:21:00.000000000,45
91,89,,Straight Outta Compton,10000,247,2015.0,Drama/Music,0 days 02:27:00.000000000,-2
65,76,,The Good Dinosaur,50000,218,2015.0,Animation/Comedy,0 days 01:32:00.000000000,11
89,98,,Inside Out,100000,375,2015.0,Fantasy/Comedy,0 days 01:35:00.000000000,9
49,50,,Tomorrowland,50000,298,2015.0,Mystery and thriller/Sci fi,0 days 02:09:00.000000000,1
58,67,,Jobriath A.D.,50,15,2011.0,Documentary,0 days 01:42:00.000000000,9
37,43,https://resizing.flixster.com/lpQjhb9GL3EiTfKapM8sj3Fr2ic=/206x305/v2/https://resizing.flixster.com/C9xmUwz2Y7UGmWmzqD11YKnG5z0=/ems.ZW1zLXByZC1hc3NldHMvbW92aWVzLzIxZjI5ZmU1LWEyMzYtNGU5Ni1iOGIwLTI0NWRiMjdkMjA0Yi53ZWJw,Jane Got a Gun,10000,80,2016.0,Western/Action,0 days 01:38:00.000000000,6
69,89,https://resizing.flixster.com/zQ-_twzyUNg0RXIByKbQ0Y7vEXk=/206x305/v2/https://resizing.flixster.com/_7ELKM68WfQa3fpLJDyp9fsRaw0=/ems.ZW1zLXByZC1hc3NldHMvbW92aWVzLzcwZTVjNGZmLTNiMzgtNGIwMC05NTUwLWFkZjkyYzk1NDJiMS53ZWJw,The Invitation,10000,105,2015.0,Drama/Mystery and thriller,0 days 01:39:00.000000000,20
77,40,,2 Rabbits,100,5,2012.0,Action,0 days 01:48:00.000000000,-37
45,27,,Vacation,25000,175,2015.0,Comedy/Adventure,0 days 01:39:00.000000000,-18
66,69,https://resizing.flixster.com/6t3StpAk0u_-PrdIXA2EEFXAUZg=/206x305/v2/https://flxt.tmsimg.com/assets/p10989172_p_v10_ah.jpg,"The Hunger Games: Mockingjay, Part 2",100000,290,2015.0,Action/Sci fi,0 days 02:16:00.000000000,3
83,75,,Avengers: Age of Ultron,250000,371,2015.0,Sci fi/Action,0 days 02:21:00.000000000,-8
66,71,https://resizing.flixster.com/oxKeQKw1XBoKwOjk_bD7d2E1ThQ=/206x305/v2/https://flxt.tmsimg.com/assets/p11231001_p_v10_aq.jpg,Pawn Sacrifice,10000,119,2014.0,Drama/History,0 days 01:54:00.000000000,5
49,55,,Minions,100000,222,2015.0,Comedy/Animation,0 days 01:31:00.000000000,6
64,51,https://resizing.flixster.com/iHtRLvMZzc7Glr9epavUeOzpOGc=/206x305/v2/https://flxt.tmsimg.com/NowShowing/137581/137581_aa.jpg,Home,50000,138,2015.0,Kids and family/Adventure,0 days 01:34:00.000000000,-13
46,77,https://resizing.flixster.com/T8rnhTDUUskfCG7EVRYSNUUTfMc=/206x305/v2/https://flxt.tmsimg.com/assets/p10568983_p_v10_aa.jpg,Queen and Country,500,91,2014.0,Romance/Drama,0 days 01:55:00.000000000,31
61,17,https://resizing.flixster.com/kf551o6H-lTWPuzsH15OIajsMrM=/206x305/v2/https://resizing.flixster.com/HipK81aml8Yp5NBCo2XSYHqnr7A=/ems.ZW1zLXByZC1hc3NldHMvbW92aWVzL2EwMDliZjdhLWU1NzEtNDViNi05OTFjLWRiNmI1N2U0MmVlYy53ZWJw,Careful What You Wish For,2500,24,2015.0,Mystery and thriller,0 days 01:31:00.000000000,-44
76,87,,The Peanuts Movie,50000,197,2015.0,Animation/Comedy,0 days 01:29:00.000000000,11
83,95,https://resizing.flixster.com/hL5115JDS9qRJYyZsxGXMTS4pj4=/206x305/v2/https://flxt.tmsimg.com/assets/p10656868_p_v10_ab.jpg,East Side Sushi,500,20,2014.0,Comedy/Drama,0 days 01:30:00.000000000,12
42,43,https://resizing.flixster.com/NRR_oG9xoZLTfku52pW9VeYczRw=/206x305/v2/https://flxt.tmsimg.com/assets/p9636395_p_v13_ac.jpg,Spike Island,500,28,2012.0,Drama,0 days 01:36:00.000000000,1
64,39,https://resizing.flixster.com/cjLII__lXAhfsjktHQXY6lBhj_c=/206x305/v2/https://flxt.tmsimg.com/assets/p10760207_p_v8_ac.jpg,Can't Stand Losing You: Surviving the Police,100,18,2012.0,Documentary/Drama,0 days 01:19:00.000000000,-25
73,77,,Danny Collins,10000,133,2015.0,Comedy/Drama,0 days 01:46:00.000000000,4
32,27,https://resizing.flixster.com/3QQc3qj2DCmDduiCoWtpArISgTQ=/206x305/v2/https://flxt.tmsimg.com/assets/p10566741_p_v8_aa.jpg,Marfa Girl,100,15,2012.0,Drama,0 days 01:45:00.000000000,-5
63,55,,Hotel Transylvania 2,50000,110,2015.0,Fantasy/Comedy,0 days 01:29:00.000000000,-8
86,93,,Star Wars: The Force Awakens,100000,440,2015.0,Fantasy/Action,0 days 02:16:00.000000000,7
55,73,https://resizing.flixster.com/m1Yhsj-xSJvyzfYNw_xP3xbErm8=/206x305/v2/https://flxt.tmsimg.com/assets/p11806131_p_v10_ab.jpg,Crimson Peak,25000,280,2015.0,Romance/Horror,0 days 01:59:00.000000000,18
18,9,https://resizing.flixster.com/RdpnPino09kj8OhNm0loHahwyY4=/206x305/v2/https://flxt.tmsimg.com/assets/p10854519_p_v13_ba.jpg,Fantastic Four,100000,260,2015.0,Fantasy/Action,0 days 01:40:00.000000000,-9
10,17,,The Human Centipede III (Final Sequence),2500,46,2015.0,Horror,0 days 01:43:00.000000000,7
78,70,https://resizing.flixster.com/gXVcFTwpcGHjyuAKRc-Wxgkup0w=/206x305/v2/https://resizing.flixster.com/c1CfXPVK5YmNmTyk0BtnhHMBuu4=/ems.ZW1zLXByZC1hc3NldHMvbW92aWVzL2M5OGQ2ZTg0LWZmNzAtNDM0NS04YWJkLWJmNWYzMGVhZTdmNC53ZWJw,Jurassic World,100000,352,2015.0,Mystery and thriller/Action,0 days 02:04:00.000000000,-8
48,56,,Blumenthal,50,9,2013.0,Comedy,0 days 01:36:00.000000000,8
31,16,,The Gunman,10000,181,2015.0,Action/Mystery and thriller,0 days 01:55:00.000000000,-15
29,38,,The Green Inferno,10000,98,2013.0,Horror/Adventure,0 days 01:40:00.000000000,9
71,31,,The Longest Ride,25000,124,2015.0,Romance/Drama,0 days 02:08:00.000000000,-40
35,27,,Victor Frankenstein,25000,143,2015.0,Horror/Drama,0 days 01:50:00.000000000,-8
61,79,,Before You Know It,100,14,2013.0,Documentary/Drama,0 days 01:52:00.000000000,18
41,27,,Child 44,10000,83,2015.0,Mystery and thriller,0 days 02:17:00.000000000,-14
54,33,https://resizing.flixster.com/alNJMDBVXjP6q68R0khP8fYqU-Q=/206x305/v2/https://flxt.tmsimg.com/assets/p9911201_p_v8_ab.jpg,Lost for Words,100,6,2013.0,Romance/Drama,0 days 01:47:00.000000000,-21
55,88,,Stand Clear of the Closing Doors,500,34,2013.0,Drama,0 days 01:34:00.000000000,33
82,82,,Furious 7,100000,276,2015.0,Adventure/Mystery and thriller,0 days 02:17:00.000000000,0
84,83,https://resizing.flixster.com/pVgK-KBQRTIK1cFd21jdKb5xTjE=/206x305/v2/https://flxt.tmsimg.com/assets/p9913116_p_v10_aa.jpg,Gore Vidal: The United States of Amnesia,500,30,2013.0,Documentary,0 days 01:29:00.000000000,-1
22,7,,Norm of the North,5000,70,2016.0,Animation/Comedy,0 days 01:30:00.000000000,-15
58,28,,The Divergent Series: Insurgent,50000,206,2015.0,Action/Sci fi,0 days 01:58:00.000000000,-30
62,59,,Heli,500,44,2013.0,Drama,0 days 01:45:00.000000000,-3
39,76,https://resizing.flixster.com/KPSA8zoT3c8kYn4-VGGoOFyTcjI=/206x305/v2/https://flxt.tmsimg.com/assets/p10231032_p_v10_aa.jpg,Stop the Pounding Heart,100,17,2013.0,Drama,0 days 01:41:00.000000000,37
28,20,https://resizing.flixster.com/t2HMiRtk73EDezaW7nSBZuZDj9w=/206x305/v2/https://flxt.tmsimg.com/assets/p11490980_p_v10_aq.jpg,Aloha,25000,166,2015.0,Romance/Comedy,0 days 01:45:00.000000000,-8
64,65,https://resizing.flixster.com/o9zW9itJgGWqPr4aNM_W-_tQ0mw=/206x305/v2/https://flxt.tmsimg.com/assets/p11299808_p_v13_ar.jpg,Pitch Perfect 2,50000,218,2015.0,Comedy/Musical,0 days 01:55:00.000000000,1
34,78,,Big Game,5000,89,2014.0,Action/Adventure,0 days 01:30:00.000000000,44
71,73,,What We Did on Our Holiday,5000,52,2014.0,Comedy,0 days 01:35:00.000000000,2
71,77,https://resizing.flixster.com/T_g7nH79p-4CeodJXr3pj7prJ8E=/206x305/v2/https://flxt.tmsimg.com/assets/p11319576_p_v8_ab.jpg,The Connection,1000,74,2014.0,Crime/Action,0 days 02:15:00.000000000,6
87,94,https://resizing.flixster.com/KAgCE828nvAzTz3foZ-64Mw_uzs=/206x305/v2/https://flxt.tmsimg.com/NowShowing/141793/141793_aa.jpg,Mission: Impossible Rogue Nation,50000,325,2015.0,Mystery and thriller/Action,0 days 02:11:00.000000000,7
46,19,,Self/less,10000,143,2015.0,Action/Sci fi,0 days 01:56:00.000000000,-27
81,99,,Shaun the Sheep Movie,10000,170,2015.0,Animation/Comedy,0 days 01:25:00.000000000,18
24,14,,Return to Sender,2500,35,2015.0,Drama/Mystery and thriller,0 days 01:35:00.000000000,-10
44,64,,Life,1000,61,2015.0,Drama/History,0 days 01:52:00.000000000,20
66,63,https://resizing.flixster.com/k3UYlSU_ShdlEQ6jstWTj-FHuNU=/206x305/v2/https://resizing.flixster.com/92w4qPCfeYrBRCF-An9equjsSjQ=/ems.ZW1zLXByZC1hc3NldHMvbW92aWVzL2QyYTQ5OTViLWYxOGQtNDUyNy1iYjYyLTIzNWI4M2E2OTA0MS53ZWJw,The Finest Hours,10000,199,2016.0,History/Action,0 days 01:56:00.000000000,-3
62,36,,Hunting Elephants,100,14,2013.0,Comedy,0 days 01:47:00.000000000,-26
35,7,,Hot Pursuit,25000,176,2015.0,Comedy/Action,0 days 01:27:00.000000000,-28
59,48,,The 33,10000,154,2015.0,Drama,0 days 02:05:00.000000000,-11
88,78,,If You Build It,250,27,2013.0,Documentary,0 days 01:22:00.000000000,-10
32,60,,Maggie,10000,135,2015.0,Horror/Mystery and thriller,0 days 01:34:00.000000000,28
85,89,,Love & Mercy,10000,216,2014.0,Drama/Biography,0 days 02:00:00.000000000,4
39,29,,Tio Papi,100,7,2013.0,Comedy/Drama,0 days 01:26:00.000000000,-10
53,27,,Terminator Genisys,50000,274,2015.0,Sci fi/Action,0 days 02:06:00.000000000,-26
56,32,,Chappie,25000,228,2015.0,Action/Sci fi,0 days 02:00:00.000000000,-24
61,63,,Spectre,100000,362,2015.0,Mystery and thriller/Action,0 days 02:28:00.000000000,2
71,83,,9 Full Moons,100,6,2013.0,Romance/Drama,0 days 01:43:00.000000000,12
46,73,,Welcome to Me,10000,109,2014.0,Comedy/Drama,0 days 01:26:00.000000000,27
43,29,,Jellyfish Eyes,100,14,2013.0,Fantasy/Adventure,0 days 01:43:00.000000000,-14
66,49,https://resizing.flixster.com/ERLpHY7pCmvbPqI_QScONdtPXHw=/206x305/v2/https://flxt.tmsimg.com/assets/p12118997_p_v10_ad.jpg,The Young Messiah,5000,39,2016.0,Drama/History,0 days 01:51:00.000000000,-17
78,95,https://resizing.flixster.com/zgyyJb-FFzb2wBHiaBwoFxHnyaQ=/206x305/v2/https://flxt.tmsimg.com/assets/p11421676_p_v10_aj.jpg,Spy,50000,259,2015.0,Comedy/Action,0 days 01:55:00.000000000,17
81,89,,Jerusalem,1000,9,2013.0,Documentary,0 days 00:42:00.000000000,8
29,22,,The Seventh Dwarf,100,9,2014.0,Comedy/Kids and family,0 days 01:28:00.000000000,-7
54,86,,The Turning,2500,28,2013.0,Drama,0 days 03:00:00.000000000,32
67,70,,The Keeper of Lost Causes,1000,27,2013.0,Crime/Drama,0 days 01:37:00.000000000,3
92,98,https://resizing.flixster.com/7wYAhoui16w8hl1nsLZzGcH7bS0=/206x305/v2/https://flxt.tmsimg.com/NowShowing/159213/159213_ac.jpg,Zootopia,100000,293,2016.0,Animation/Comedy,0 days 01:48:00.000000000,6
67,83,https://resizing.flixster.com/44zKP_s9q2PSEju-Q_FZVNc67yk=/206x305/v2/https://resizing.flixster.com/Pd0oqk8PdOJRQSMGTlwS6Xm6cLE=/ems.ZW1zLXByZC1hc3NldHMvbW92aWVzL2E3NTFlYmI3LTgzMzQtNGFmMy04ZGE5LTY3Y2EzNmJjODA5MS53ZWJw,Midnight Special,10000,235,2016.0,Sci fi/Mystery and thriller,0 days 01:51:00.000000000,16
33,23,,Dark Places,5000,82,2015.0,Mystery and thriller,0 days 01:43:00.000000000,-10
50,44,,Ted 2,50000,209,2015.0,Comedy/Fantasy,0 days 01:55:00.000000000,-6
62,32,https://resizing.flixster.com/dglfKLP-N5N5hoVICDRLSAVlmXw=/206x305/v2/https://flxt.tmsimg.com/assets/p10741793_p_v10_ac.jpg,Desert Dancer,1000,44,2015.0,Drama,0 days 01:44:00.000000000,-30
56,59,https://resizing.flixster.com/LE5aMtLIOzM6MEYIDCVSQsfhOjU=/206x305/v2/https://flxt.tmsimg.com/assets/p10569015_p_v10_ae.jpg,Run All Night,10000,186,2015.0,Crime/Action,0 days 01:54:00.000000000,3
53,42,https://resizing.flixster.com/XzYowmNrMjaQSixBB0aAkfiYxv8=/206x305/v2/https://flxt.tmsimg.com/assets/p11003170_p_v10_aj.jpg,In the Heart of the Sea,25000,238,2015.0,Action/Drama,0 days 01:56:00.000000000,-11
34,0,/assets/pizza-pie/images/poster_default.c8c896e70c3.gif,Hell & Back,1000,5,2015.0,,,-34
81,78,,1982,250,9,2013.0,Drama,0 days 01:30:00.000000000,-3
68,60,,Fat,100,5,2013.0,Drama,0 days 01:25:00.000000000,-8
28,7,https://resizing.flixster.com/GgL6R5V4UhNN4DogoBtOyaZoR98=/206x305/v2/https://flxt.tmsimg.com/assets/p11261533_p_v10_ae.jpg,Rock the Kasbah,10000,124,2015.0,Comedy,0 days 01:46:00.000000000,-21
90,100,,The Square,5000,69,2013.0,Documentary,0 days 01:44:00.000000000,10
84,84,https://resizing.flixster.com/XIswpB576K1vPydvNfVvKdODapo=/206x305/v2/https://flxt.tmsimg.com/assets/p10193894_p_v10_ac.jpg,A Wolf at the Door,500,25,2013.0,Crime/Drama,0 days 01:40:00.000000000,0
86,100,https://resizing.flixster.com/QGpXBiZX1d0LSqMmU0NlwooKEO4=/206x305/v2/https://flxt.tmsimg.com/assets/p10316121_p_v10_aa.jpg,Matt Shepard Is a Friend of Mine,500,30,2012.0,Documentary/Gay and lesbian,0 days 01:29:00.000000000,14
32,36,,Misery Loves Comedy,250,25,2015.0,Documentary/Comedy,0 days 01:34:00.000000000,4
76,83,https://resizing.flixster.com/-E3zDVwaezpE26WKhKO0Fo8R7JA=/206x305/v2/https://flxt.tmsimg.com/assets/p10193912_p_v8_ab.jpg,Our Man in Tehran,100,18,2013.0,Documentary,0 days 01:25:00.000000000,7
57,63,,Sleeping With Other People,5000,133,2015.0,Romance,0 days 01:40:00.000000000,6
83,96,,Particle Fever,10000,49,2013.0,Documentary,0 days 01:37:00.000000000,13
69,68,,The 100-Year-Old Man Who Climbed Out the Window and Disappeared,2500,80,2013.0,Comedy/Adventure,0 days 01:54:00.000000000,-1
45,28,https://resizing.flixster.com/_uYE7ZXPJqF4iOQTKHqYmEimI_k=/206x305/v2/https://flxt.tmsimg.com/assets/p11003109_p_v13_aq.jpg,Get Hard,50000,186,2015.0,Comedy,0 days 01:39:00.000000000,-17
56,50,https://resizing.flixster.com/TCT9wfvEqYMRVD-HjoKhh773C1w=/206x305/v2/https://flxt.tmsimg.com/assets/p10627319_p_v7_ab.jpg,The Red Robin,100,8,2013.0,Drama/Mystery and thriller,0 days 01:46:00.000000000,-6
66,88,https://resizing.flixster.com/Kh9dFFFy-JwM996SCTTPCK0HQF8=/206x305/v2/https://resizing.flixster.com/7QANRuySnf0owah3Vt_5oHWCsJ4=/ems.ZW1zLXByZC1hc3NldHMvbW92aWVzL2E1N2NkMTIxLTRkYzItNGE5ZC1hOGRjLWVlZTA3NmQ4NGVkYi53ZWJw,Australia's Lost Gold: The Legend of Lasseter,250,8,2012.0,Documentary,0 days 01:44:00.000000000,22
51,15,,Alvin and the Chipmunks: The Road Chip,25000,68,2015.0,Kids and family/Adventure,0 days 01:26:00.000000000,-36
34,40,,Blackwood,100,15,2014.0,Adventure/Mystery and thriller,0 days 01:30:00.000000000,6
75,84,https://resizing.flixster.com/1jpjjBUgvCXyWoy1IQ2DOPgVuUA=/206x305/v2/https://flxt.tmsimg.com/assets/p11299041_p_v13_ak.jpg,Far From the Madding Crowd,10000,193,2015.0,Romance/Drama,0 days 01:58:00.000000000,9
51,28,,London Has Fallen,25000,197,2016.0,Action/Mystery and thriller,0 days 01:39:00.000000000,-23
26,10,,Unfinished Business,10000,103,2015.0,Comedy,0 days 01:30:00.000000000,-16
61,80,,The New Girlfriend,1000,84,2014.0,Comedy/Drama,0 days 01:47:00.000000000,19
35,73,https://resizing.flixster.com/FKrhWVmIKE7XpC_KcfzzB7BGKQA=/206x305/v2/https://flxt.tmsimg.com/assets/p11684207_p_v10_aa.jpg,The Falling,2500,37,2014.0,Drama/Mystery and thriller,0 days 01:42:00.000000000,38
73,59,https://resizing.flixster.com/bTxruxAmBh34MicTrpqhj6_zgRg=/206x305/v2/https://flxt.tmsimg.com/NowShowing/148432/148432_aa.jpg,The Intern,25000,198,2015.0,Comedy/Drama,0 days 02:01:00.000000000,-14
57,33,,Entourage,25000,213,2015.0,Comedy,0 days 01:44:00.000000000,-24
87,97,https://resizing.flixster.com/Lwr2HqA1ow_O9Dj9_TcL-kKMOsA=/206x305/v2/https://flxt.tmsimg.com/assets/p11436766_p_v10_ae.jpg,Brooklyn,25000,275,2015.0,Romance/Drama,0 days 01:52:00.000000000,10
55,46,https://resizing.flixster.com/zjYUB8VO9gFBRdK4FU5oVR8qK7I=/206x305/v2/https://flxt.tmsimg.com/assets/p10375909_p_v10_ab.jpg,Closer to the Moon,100,13,2013.0,Drama,0 days 01:50:00.000000000,-9
21,15,https://resizing.flixster.com/_MDrbeaaUKD-gh1irG7GMMRENOU=/206x305/v2/https://resizing.flixster.com/Dk6zPgBB9DLYx7VQJVNagdFRaJw=/ems.ZW1zLXByZC1hc3NldHMvbW92aWVzLzE0YmQ1ZjM0LTI4ZmMtNGQ3ZS1hYzM2LWMwYmU4NmVmYWFkYi53ZWJw,Regression,5000,41,2015.0,Crime/Drama,0 days 01:46:00.000000000,-6
40,66,,The Town That Dreaded Sundown,2500,29,2014.0,Horror/Mystery and thriller,0 days 01:25:00.000000000,26
57,90,,The Nightingale,100,10,2013.0,Comedy/Drama,0 days 01:40:00.000000000,33
38,80,,Black Mountain Side,100,5,2013.0,Horror/Mystery and thriller,0 days 01:39:00.000000000,42
40,27,,Pan,50000,200,2015.0,Fantasy/Action,0 days 01:51:00.000000000,-13
49,30,https://resizing.flixster.com/uF_yLqfXRcRqZg1M_9_a_jxW7fg=/206x305/v2/https://resizing.flixster.com/yvuhUQcGTA7qWOPVf7E5Lq8yVNY=/ems.ZW1zLXByZC1hc3NldHMvbW92aWVzL2E1YzZhODk1LTFkMzItNDQxZi1iYzA5LTQ4MDBlMjRlMDE1ZS53ZWJw,Daddy's Home,25000,122,2015.0,Comedy,0 days 01:36:00.000000000,-19
63,97,https://resizing.flixster.com/2_SW8oncqPkU5CufZSWFtGIaOGk=/206x305/v2/https://flxt.tmsimg.com/assets/p10631797_p_v10_aa.jpg,We Come as Friends,250,32,2014.0,Documentary,0 days 01:50:00.000000000,34
80,97,,No No: A Dockumentary,500,32,2014.0,Documentary,0 days 01:40:00.000000000,17
62,88,,"Kumiko, the Treasure Hunter",5000,133,2014.0,Drama/Adventure,0 days 01:44:00.000000000,26
37,15,https://resizing.flixster.com/trfuG4j9byUhfNPUKKjkpBmo15k=/206x305/v2/https://resizing.flixster.com/3oWklZ4T_tWEioxauj8XMJao3CM=/ems.ZW1zLXByZC1hc3NldHMvbW92aWVzLzI2YTVkMGUxLTY0YTQtNGE1Zi05ZmEyLWIwNDBlNzM2MTAyMS53ZWJw,Gods of Egypt,25000,194,2016.0,Action/Fantasy,0 days 02:01:00.000000000,-22
23,16,https://resizing.flixster.com/abawP77lpyKw3oa2dtJVAxycQpM=/206x305/v2/https://flxt.tmsimg.com/assets/p11132251_p_v10_ai.jpg,The Lazarus Effect,10000,109,2015.0,Horror/Mystery and thriller,0 days 01:23:00.000000000,-7
71,82,,Infinitely Polar Bear,10000,120,2014.0,Comedy/Drama,0 days 01:27:00.000000000,11
37,45,,Cooties,5000,42,2014.0,Comedy/Horror,0 days 01:36:00.000000000,8
65,90,https://resizing.flixster.com/NM8Hd5oM228o2YNdsFwJPT_daUA=/206x305/v2/https://flxt.tmsimg.com/assets/p10929597_p_v10_ac.jpg,52 Tuesdays,500,39,2013.0,Gay and lesbian/Drama,0 days 01:49:00.000000000,25
76,97,,Two Days One Night,10000,183,2014.0,Drama,0 days 01:35:00.000000000,21
33,25,https://resizing.flixster.com/ia5s7ivvLAfkZTGpOAF54hm717A=/206x305/v2/https://flxt.tmsimg.com/assets/p10920934_p_v10_aq.jpg,Police Story 2013,500,8,2013.0,Crime/Action,0 days 01:50:00.000000000,-8
78,24,,Little Boy,5000,54,2015.0,War/Drama,0 days 01:46:00.000000000,-54
33,5,https://resizing.flixster.com/YfO8yc622JHKxB4Kr-NCnLR_Xnc=/206x305/v2/https://flxt.tmsimg.com/assets/p11265592_p_v10_aa.jpg,Paul Blart: Mall Cop 2,25000,62,2015.0,Comedy,0 days 01:34:00.000000000,-28
66,84,,Trainwreck,50000,288,2015.0,Romance,0 days 02:05:00.000000000,18
52,89,https://resizing.flixster.com/XSdLPYZrDzTZSEPjXOK8DiafwXs=/206x305/v2/https://flxt.tmsimg.com/assets/p11246699_p_v10_aa.jpg,Lambert & Stamp,500,74,2014.0,Documentary,0 days 01:57:00.000000000,37
86,96,,What We Do in the Shadows,25000,187,2014.0,Comedy/Horror,0 days 01:26:00.000000000,10
76,74,https://resizing.flixster.com/wmT7MbU06GHG5IJoJmxNwUWbZPU=/206x305/v2/https://flxt.tmsimg.com/NowShowing/152024/152024_ab.jpg,The Hateful Eight,50000,336,2015.0,Western,0 days 02:48:00.000000000,-2
67,54,https://resizing.flixster.com/aU-UDu65rVHsCTUraHF-Is-BaFE=/206x305/v2/https://flxt.tmsimg.com/assets/p11002256_p_v13_ap.jpg,The Age of Adaline,25000,169,2015.0,Fantasy/Romance,0 days 01:53:00.000000000,-13
53,79,https://resizing.flixster.com/IZrrseJFfhSBc1GAlTsZG1_lrQc=/206x305/v2/https://flxt.tmsimg.com/assets/p10910426_p_v10_aa.jpg,Get Santa,1000,29,2014.0,Other/Kids and family,0 days 01:42:00.000000000,26
54,62,,Samba,1000,68,2014.0,Comedy/Drama,0 days 01:59:00.000000000,8
40,60,,Saint Laurent,1000,86,2014.0,Gay and lesbian/Drama,0 days 02:31:00.000000000,20
68,72,https://resizing.flixster.com/azrSr4qo65JypxI8wasXeeMV1iU=/206x305/v2/https://flxt.tmsimg.com/assets/p11132479_p_v10_ao.jpg,Everest,25000,231,2015.0,Mystery and thriller/Drama,0 days 02:01:00.000000000,4
43,67,,Batched,5000,69,2014.0,Drama,0 days 01:47:00.000000000,24
64,75,,Steve McQueen: The Man & Le Mans,250,32,2015.0,Documentary,0 days 01:42:00.000000000,11
93,100,/assets/pizza-pie/images/poster_default.c8c896e70c3.gif,Night Will Fall,500,23,2014.0,War/Drama,0 days 01:15:00.000000000,7
36,20,,Get Married If You Can,50,5,2014.0,Comedy,0 days 01:47:00.000000000,-16
81,96,https://resizing.flixster.com/UjH7nm99uLHCPg7k8jWncPmWk88=/206x305/v2/https://flxt.tmsimg.com/assets/p10912522_p_v10_aq.jpg,'71,10000,139,2014.0,Action/Mystery and thriller,0 days 01:39:00.000000000,15
81,94,https://resizing.flixster.com/OE-xj_XQ-iX1-kzHlFXhzwa_gJg=/206x305/v2/https://flxt.tmsimg.com/assets/p11048186_p_v10_ax.jpg,Diplomacy,2500,50,2014.0,Drama/History,0 days 01:28:00.000000000,13
52,49,https://resizing.flixster.com/w-v7gCy4VMN_P0GNuR_eDyZIngw=/206x305/v2/https://flxt.tmsimg.com/assets/p10975274_p_v10_af.jpg,San Andreas,50000,248,2015.0,Mystery and thriller/Action,0 days 01:54:00.000000000,-3
56,40,https://resizing.flixster.com/IGDTv6oWKx2woR6zEq0LLgB3Lsg=/206x305/v2/https://flxt.tmsimg.com/assets/p10513081_p_v10_aa.jpg,Blackbird,500,10,2014.0,Gay and lesbian/Drama,0 days 01:42:00.000000000,-16
77,62,,Race,10000,158,2016.0,Drama/History,0 days 02:14:00.000000000,-15
25,17,https://resizing.flixster.com/Q9VYFyYH4iiD1YfykCnmVmDassw=/206x305/v2/https://flxt.tmsimg.com/assets/p11417001_p_v10_aa.jpg,Aloft,1000,65,2014.0,Drama,0 days 01:56:00.000000000,-8
24,50,,Manglehorn,1000,86,2014.0,Drama,0 days 01:37:00.000000000,26
48,71,https://resizing.flixster.com/JuvAVdg7iTm0A_CRvzuJ5A8Fu6I=/206x305/v2/https://flxt.tmsimg.com/assets/p11265907_p_v10_ac.jpg,In the Courtyard,100,7,2014.0,Comedy/Drama,0 days 01:37:00.000000000,23
41,54,https://resizing.flixster.com/afOHXD5KpplW3QO0QmgWBQc51nQ=/206x305/v2/https://flxt.tmsimg.com/assets/p11659557_p_v10_ak.jpg,Triple 9,10000,184,2016.0,Crime/Action,0 days 01:55:00.000000000,13
48,95,,The Heart Machine,500,21,2014.0,Drama/Mystery and thriller,0 days 01:25:00.000000000,47
44,94,https://resizing.flixster.com/hw1czR2PNZ4k-2wS44134nc3kgk=/206x305/v2/https://flxt.tmsimg.com/assets/p10912145_p_v10_aa.jpg,The Last Impresario,100,16,2013.0,Biography,0 days 01:25:00.000000000,50
89,88,,Tangerines,2500,66,2013.0,Drama/War,0 days 01:23:00.000000000,-1
51,57,,Insidious: Chapter 3,25000,129,2015.0,Horror/Mystery and thriller,0 days 01:37:00.000000000,6
67,97,https://resizing.flixster.com/qLZY-Fcag5u0ZHjymZSvOJr8W6w=/206x305/v2/https://resizing.flixster.com/Z6SKOGqTsqpMlHyZn9ttIN7j0wM=/ems.ZW1zLXByZC1hc3NldHMvbW92aWVzLzdkNjE1YmU3LWMyZmQtNDllNy04NTI1LTQxZTMzOGVlYmFjMC53ZWJw,45 Years,10000,209,2015.0,Drama,0 days 01:33:00.000000000,30
65,100,,The Only Real Game,100,7,2013.0,Documentary,0 days 01:22:00.000000000,35
77,83,,The Walk,25000,275,2015.0,Drama/Adventure,0 days 02:04:00.000000000,6
47,47,https://resizing.flixster.com/MHZfZWDVxw8Ar2LSxWh4SGSX-bs=/206x305/v2/https://resizing.flixster.com/BB8n0S_FC_PgvBVQmxtd_fBwoJ8=/ems.ZW1zLXByZC1hc3NldHMvbW92aWVzLzU4NzY1MDNhLWMwM2UtNGEyYi04MmU0LWQ3YzU4ZTk0ODJlNS53ZWJw,How to Be Single,25000,159,2016.0,Romance,0 days 01:50:00.000000000,0
74,92,,Stations of the Cross,2500,26,2014.0,Drama,0 days 01:47:00.000000000,18
59,96,https://resizing.flixster.com/MiZ9ZfvxAgjH_ydTGjn_eczlaI4=/206x305/v2/https://flxt.tmsimg.com/assets/p11261110_p_v10_ab.jpg,"Black Coal, Thin Ice",250,26,2014.0,Crime/Drama,0 days 01:46:00.000000000,37
69,92,,Born to Fly: Elizabeth Streb vs. Gravity,100,12,2014.0,Documentary/Action,0 days 01:22:00.000000000,23
79,73,,Harmontown,500,26,2014.0,Documentary,0 days 01:41:00.000000000,-6
50,67,,Seeds of Time,100,6,2013.0,Documentary,0 days 01:17:00.000000000,17
52,71,https://resizing.flixster.com/pjMZp3K2YuPHO42eCpQToR6GlSI=/206x305/v2/https://flxt.tmsimg.com/assets/p10744832_p_v10_ac.jpg,Break Point,1000,21,2014.0,Comedy,0 days 01:30:00.000000000,19
43,63,https://resizing.flixster.com/94M_9ewIrxU_X3xxxiTeKmcRTYo=/206x305/v2/https://flxt.tmsimg.com/assets/p11177542_p_v10_aa.jpg,Drug Lord: The Legend of Shorty,50,8,2014.0,Documentary,0 days 01:30:00.000000000,20
85,100,,Patrick's Day,50,5,2014.0,Drama,0 days 01:42:00.000000000,15
58,72,,Soul Boys of the Western World,100,18,2014.0,Documentary/Music,0 days 01:50:00.000000000,14
42,31,https://resizing.flixster.com/uY3DRYlgaygCXJwAlLJwwXVNbqM=/206x305/v2/https://flxt.tmsimg.com/assets/p10837718_p_v10_ab.jpg,Walking on Sunshine,1000,26,2014.0,Romance/Musical,0 days 01:37:00.000000000,-11
68,72,,Suffragette,10000,217,2015.0,Drama/History,0 days 01:46:00.000000000,4
80,92,,Güeros,1000,53,2014.0,Comedy,0 days 01:48:00.000000000,12
32,32,https://resizing.flixster.com/znMIxBJJBIdRjxUb7I-69nXfwcM=/206x305/v2/https://flxt.tmsimg.com/assets/p11613923_p_v8_bb.jpg,Every Secret Thing,2500,38,2014.0,Crime/Drama,0 days 01:33:00.000000000,0
33,23,https://resizing.flixster.com/i0ttXlJhs9_Z0GDpgzi11FUU-0U=/206x305/v2/https://resizing.flixster.com/_VU5Yhx8VEo12j9PZb3Wv03980o=/ems.ZW1zLXByZC1hc3NldHMvbW92aWVzL2RlODJhMmY4LTQyNzEtNDkwZC05NmFjLTU1Y2NlNjhiMzRiZC53ZWJw,Kill Your Friends,1000,61,2015.0,Comedy/Mystery and thriller,0 days 01:43:00.000000000,-10
48,14,,Ride Along 2,25000,121,2016.0,Comedy/Action,0 days 01:41:00.000000000,-34
60,79,https://resizing.flixster.com/wI2hPz76UDLBL0qGijLiPJoq2Nk=/206x305/v2/https://flxt.tmsimg.com/assets/p11119688_p_v10_aa.jpg,24 Days,100,19,2014.0,Drama,0 days 01:50:00.000000000,19
61,76,,112 Weddings,100,17,2014.0,Documentary,0 days 01:35:00.000000000,15
65,89,,Creep,10000,27,2014.0,Comedy/Horror,0 days 01:20:00.000000000,24
70,86,https://resizing.flixster.com/Ts9y62oyuY8I2XW-TC-QcOCv13Q=/206x305/v2/https://flxt.tmsimg.com/assets/p11700470_p_v10_aa.jpg,Animals,500,28,2014.0,Drama,0 days 01:26:00.000000000,16
73,58,,Second Opinion: Laetrile at Sloan-Kettering,100,12,2014.0,Documentary,0 days 01:16:00.000000000,-15
68,91,https://resizing.flixster.com/EMA2yb7UI7WzFoGMPrINIdW9U6M=/206x305/v2/https://flxt.tmsimg.com/assets/p10933423_p_v10_aa.jpg,Faults,2500,35,2014.0,Drama/Mystery and thriller,0 days 01:29:00.000000000,23
88,88,,The Big Short,50000,330,2015.0,Comedy/Drama,0 days 02:10:00.000000000,0
87,71,https://resizing.flixster.com/ZeDVFyGQbHhIRqIPQkRKnEzvmnw=/206x305/v2/https://flxt.tmsimg.com/assets/p11166544_p_v10_aa.jpg,Gone Doggy Gone,100,7,2014.0,Comedy/Drama,0 days 01:29:00.000000000,-16
76,84,,Dior and I,2500,73,2014.0,Documentary,0 days 01:30:00.000000000,8
71,70,,5 to 7,1000,56,2014.0,Romance,0 days 01:38:00.000000000,-1
26,36,,Ardor,100,33,2014.0,Mystery and thriller/Drama,0 days 01:40:00.000000000,10
43,74,https://resizing.flixster.com/5ycQTFG2O73-b6EAL4MNPrbG578=/206x305/v2/https://flxt.tmsimg.com/assets/p10742239_p_v8_ab.jpg,Alex of Venice,1000,31,2014.0,Drama,0 days 01:26:00.000000000,31
30,52,https://resizing.flixster.com/A59oOitlfeUsTnk5FCcIUdIS7Ok=/206x305/v2/https://flxt.tmsimg.com/assets/p10734331_p_v10_am.jpg,Boulevard,2500,73,2014.0,Gay and lesbian/Drama,0 days 01:28:00.000000000,22
69,100,https://resizing.flixster.com/1xvp6GRlYJJDe9QqBY0xirK8DNQ=/206x305/v2/https://flxt.tmsimg.com/assets/p11659279_p_v10_aa.jpg,Famous Nathan,100,7,2014.0,Documentary,0 days 01:36:00.000000000,31
51,75,,Five Star,250,20,2014.0,Drama,0 days 01:22:00.000000000,24
44,86,https://resizing.flixster.com/OfYrGt6QHLr9kjhUmsAERAzZCIY=/206x305/v2/https://flxt.tmsimg.com/assets/p11277984_p_v10_aa.jpg,Glass Chin,250,21,2014.0,Drama/Mystery and thriller,0 days 01:28:00.000000000,42
31,62,https://resizing.flixster.com/pDU4N0Ngd2drc_ut143FldnxP48=/206x305/v2/https://flxt.tmsimg.com/assets/p10669189_p_v10_aa.jpg,Goodbye to All That,250,21,2014.0,Comedy/Drama,0 days 01:27:00.000000000,31
77,88,,Zero Motivation,1000,50,2014.0,Comedy/Drama,0 days 01:40:00.000000000,11
79,67,,The Rise and Rise of Bitcoin,250,9,2014.0,Documentary,0 days 01:30:00.000000000,-12
66,91,/assets/pizza-pie/images/poster_default.c8c896e70c3.gif,The Kidnapping of Michel Houellebecq,250,23,2014.0,Comedy/Drama,0 days 01:33:00.000000000,25
67,76,,Match,1000,38,2014.0,Comedy/Drama,0 days 01:32:00.000000000,9
76,30,https://resizing.flixster.com/m6iDPKhgc4grf9zc-a40mUk_vE4=/206x305/v2/https://flxt.tmsimg.com/assets/p11779009_p_v8_ab.jpg,Soaked in Bleach,1000,10,2015.0,Crime/Documentary,0 days 01:40:00.000000000,-46
70,66,,Trash,2500,44,2014.0,Mystery and thriller/Comedy,0 days 01:53:00.000000000,-4
76,93,,Monkey Kingdom,10000,56,2015.0,Documentary,0 days 01:22:00.000000000,17
45,43,,American Ultra,10000,178,2015.0,Action/Comedy,0 days 01:36:00.000000000,-2
55,65,,Magic Mike XXL,25000,237,2015.0,Comedy/Drama,0 days 01:55:00.000000000,10
24,0,,The Anomaly,1000,17,2014.0,Action/Sci fi,0 days 01:37:00.000000000,-24
84,78,,The Revenant,100000,400,2015.0,Western/Drama,0 days 02:36:00.000000000,-6
65,90,,Clouds of Sils Maria,10000,176,2014.0,Drama,0 days 02:03:00.000000000,25
64,80,,Macbeth,2500,198,2015.0,Drama,0 days 01:53:00.000000000,16
79,84,,I Am Big Bird: The Caroll Spinney Story,2500,74,2014.0,Documentary/Drama,0 days 01:30:00.000000000,5
87,90,https://resizing.flixster.com/5xe7-K0q3VPEWI4DQ_lH9TQ1BXM=/206x305/v2/https://flxt.tmsimg.com/assets/p11819886_p_v13_ap.jpg,Bridge of Spies,50000,309,2015.0,Drama/Mystery and thriller,0 days 02:21:00.000000000,3
31,15,,Sinister 2,25000,91,2015.0,Horror/Mystery and thriller,0 days 01:37:00.000000000,-16
52,42,https://resizing.flixster.com/UiUrJnAhWm2Hci4QPYpus19i0e0=/206x305/v2/https://flxt.tmsimg.com/assets/p11206250_p_v10_ab.jpg,Comet,2500,31,2014.0,Romance/Comedy,0 days 01:30:00.000000000,-10
61,69,,The Night Before,25000,160,2015.0,Other/Comedy,0 days 01:41:00.000000000,8
40,22,,Jem and the Holograms,5000,79,2015.0,Drama/Musical,0 days 01:58:00.000000000,-18
15,40,,Ejecta,100,10,2014.0,Sci fi,0 days 01:27:00.000000000,25
64,78,,Time Lapse,2500,18,2014.0,Sci fi/Mystery and thriller,0 days 01:44:00.000000000,14
50,88,,Jauja,1000,68,2014.0,Drama,0 days 01:48:00.000000000,38
49,88,,Amour fou,500,51,2014.0,Drama/History,0 days 01:36:00.000000000,39
26,43,,Madame Bovary,2500,69,2014.0,Romance/Drama,0 days 01:58:00.000000000,17
92,94,,Wild Tales,10000,156,2014.0,Comedy/Drama,0 days 02:02:00.000000000,2
70,37,,Max,10000,99,2015.0,Drama/Adventure,0 days 01:51:00.000000000,-33
74,82,,Heaven Adores You,100,17,2014.0,Documentary/Drama,0 days 01:44:00.000000000,8
42,52,https://resizing.flixster.com/szufWCZFiPITD5KbClrVANbh_wU=/206x305/v2/https://flxt.tmsimg.com/assets/p11183455_p_v10_ac.jpg,In the Name of My Daughter,250,48,2014.0,Drama/Mystery and thriller,0 days 02:02:00.000000000,10
60,62,,The Water Diviner,10000,151,2014.0,Drama/History,0 days 01:52:00.000000000,2
43,65,,Ricki and the Flash,10000,200,2015.0,Comedy/Drama,0 days 01:40:00.000000000,22
66,95,https://resizing.flixster.com/3KFCh2FPgn3Wrj0uAmqe_5o1b_s=/206x305/v2/https://flxt.tmsimg.com/NowShowing/139921/139921_ab.jpg,It Follows,25000,261,2014.0,Horror/Mystery and thriller,0 days 01:41:00.000000000,29
66,79,/assets/pizza-pie/images/poster_default.c8c896e70c3.gif,Fighters,500,34,2014.0,Romance,0 days 01:38:00.000000000,13
50,88,https://resizing.flixster.com/7P166KDMR7U43x5ChDka7JznS1g=/206x305/v2/https://flxt.tmsimg.com/assets/p11256884_p_v7_aa.jpg,Natural Resistance,50,8,2014.0,Documentary,0 days 01:25:00.000000000,38
76,66,,Kahlil Gibran's The Prophet,1000,73,2014.0,Kids and family/Animation,0 days 01:25:00.000000000,-10
45,77,https://resizing.flixster.com/4I-GF6CXG4yLA8ll68xUZS4gFxU=/206x305/v2/https://flxt.tmsimg.com/assets/p11606674_p_v10_az.jpg,The Kindergarten Teacher,250,35,2014.0,Drama,0 days 01:59:00.000000000,32
90,95,https://resizing.flixster.com/tcN9D8sCSpdB9aHtrWWcfqUisZg=/206x305/v2/https://flxt.tmsimg.com/assets/p11118634_p_v10_aa.jpg,The Salt of the Earth,5000,94,2014.0,Documentary,0 days 01:49:00.000000000,5
50,100,,Of Men and War,100,15,2014.0,Documentary,0 days 02:22:00.000000000,50
62,73,https://resizing.flixster.com/Qjo6vD-dp6IlzZ4KodPNpBzNf5E=/206x305/v2/https://flxt.tmsimg.com/assets/p11175192_p_v10_ab.jpg,The Salvation,5000,80,2014.0,Western/Drama,0 days 01:29:00.000000000,11
42,76,,Welcome to New York,500,55,2014.0,Drama,0 days 02:05:00.000000000,34
71,88,https://resizing.flixster.com/QksZtlgV3F37TjM2-0gglyWteFY=/206x305/v2/https://flxt.tmsimg.com/assets/p10802182_p_v8_aa.jpg,White God,5000,112,2014.0,Drama,0 days 01:59:00.000000000,17
55,86,https://resizing.flixster.com/m8p4AY9u2jI1cjLGFKce9bkJgpI=/206x305/v2/https://flxt.tmsimg.com/assets/p11194193_p_v10_ab.jpg,Xenia,250,14,2014.0,Gay and lesbian/Drama,0 days 02:08:00.000000000,31
77,83,,A Hard Day,500,35,2014.0,Action/Mystery and thriller,0 days 01:50:00.000000000,6
71,95,https://resizing.flixster.com/oHiBbib-MIs-VC_8lv7pc94HDLI=/206x305/v2/https://flxt.tmsimg.com/assets/p11222790_p_v10_aa.jpg,National Gallery,1000,66,2014.0,Documentary,0 days 03:00:00.000000000,24
78,92,,Breathe,1000,53,2014.0,Drama,0 days 01:31:00.000000000,14
77,98,,Timbuktu,5000,123,2014.0,Drama,0 days 01:37:00.000000000,21
69,88,,The Tribe,5000,132,2014.0,Crime/Drama,0 days 02:10:00.000000000,19
66,100,,You're Sleeping Nicole,500,17,2014.0,Drama,0 days 01:33:00.000000000,34
11,0,https://resizing.flixster.com/R8YaVpIW-SWLXwvH5Xa7lH2vWjc=/206x305/v2/https://flxt.tmsimg.com/assets/p10871764_p_v10_aa.jpg,United Passions,250,16,2014.0,Drama/History,0 days 01:50:00.000000000,-11
69,73,https://resizing.flixster.com/VAwnf36BF4kqlN03atVAcNrzPNI=/206x305/v2/https://resizing.flixster.com/A3sVrXnwWZOJGmHK0GQnXXLfmko=/ems.ZW1zLXByZC1hc3NldHMvbW92aWVzLzVjY2M0MmUzLTVmMmItNDM4Ni04ZDI3LTViZTZjOWQxMDZmNS53ZWJw,Seve: The Movie,250,11,2014.0,Drama/Biography,0 days 02:04:00.000000000,4
91,91,,The Martian,100000,380,2015.0,Sci fi/Adventure,0 days 02:22:00.000000000,0
61,50,https://resizing.flixster.com/en2ZLG6zUL6ICzAMT1MRWnomKV4=/206x305/v2/https://flxt.tmsimg.com/assets/p11063872_p_v10_ab.jpg,The Human Experiment,100,10,2013.0,Documentary,0 days 00:52:00.000000000,-11
22,10,https://resizing.flixster.com/hq8fIFnm33eZG_D7bXICrO25Cew=/206x305/v2/https://resizing.flixster.com/HqVpBTf3xZWT3SUY7ULFccP71Lo=/ems.ZW1zLXByZC1hc3NldHMvbW92aWVzLzA1MWI4ODVmLWEwYzYtNDViYS05ZjQxLWY4YTYwMjQwODNhMS53ZWJw,The Forest,10000,137,2016.0,Horror/Mystery and thriller,0 days 01:33:00.000000000,-12
60,100,,Teacher of the Year,500,7,2014.0,Comedy,0 days 01:20:00.000000000,40
63,89,,Blood Punch,100,9,2013.0,Horror/Mystery and thriller,0 days 01:44:00.000000000,26
69,79,,The Suicide Theory,250,19,2014.0,Drama,0 days 01:38:00.000000000,10
33,64,https://resizing.flixster.com/EPxVWwpEAe8IzgnBSObBh28lUJU=/206x305/v2/https://flxt.tmsimg.com/assets/p11067555_p_v10_aa.jpg,Inner Demons,250,11,2014.0,Horror,0 days 01:25:00.000000000,31
53,27,https://resizing.flixster.com/8lmQyErEY4N3tDTb67vg7sfIS5U=/206x305/v2/https://resizing.flixster.com/FpOnO0OIDE62ViLmIp-MPXyz-wY=/ems.ZW1zLXByZC1hc3NldHMvbW92aWVzL2YxNzM0NGEwLTNiMWQtNDUwNy04OGYwLTJhMGVjODRmNDcyYi53ZWJw,My Big Fat Greek Wedding 2,5000,176,2016.0,Romance,0 days 01:34:00.000000000,-26
55,71,https://resizing.flixster.com/OS30RzQCGAMOZO2Mc0DZOQIT2Bw=/206x305/v2/https://flxt.tmsimg.com/assets/p11339942_p_v10_aa.jpg,Uncertain Terms,100,17,2014.0,Comedy/Drama,0 days 01:15:00.000000000,16
57,60,,Joy,25000,272,2015.0,Comedy/Drama,0 days 02:03:00.000000000,3
43,54,https://resizing.flixster.com/Ezo00kDPujxndr1OHvNMhdG-XRc=/206x305/v2/https://flxt.tmsimg.com/assets/p11183624_p_v13_ag.jpg,Gemma Bovery,500,90,2014.0,Romance/Comedy,0 days 01:39:00.000000000,11
60,74,https://resizing.flixster.com/FchsbSyfzWijZ3dOgpMk2SV7nYk=/206x305/v2/https://flxt.tmsimg.com/assets/p10926396_p_v10_aa.jpg,Take Me to the River,250,27,2014.0,Documentary,0 days 01:37:00.000000000,14
40,8,https://resizing.flixster.com/EATle1oy4pHIKO-muAWeKhj5dd0=/206x305/v2/https://flxt.tmsimg.com/assets/p10854431_p_v10_ak.jpg,Hitman: Agent 47,25000,130,2015.0,Action/Adventure,0 days 01:36:00.000000000,-32
62,47,,No Escape,10000,156,2015.0,Action/Mystery and thriller,0 days 01:43:00.000000000,-15
39,35,,Dragon Blade,2500,48,2015.0,Action/Drama,0 days 01:43:00.000000000,-4
38,58,https://resizing.flixster.com/36GzbkRFwxAuWffXbO_TpQt61Sw=/206x305/v2/https://flxt.tmsimg.com/assets/p11231564_p_v10_aa.jpg,Set Fire to the Stars,250,43,2014.0,Drama/Biography,0 days 01:36:00.000000000,20
18,32,,We'll Never Have Paris,500,25,2014.0,Romance,0 days 01:35:00.000000000,14
42,67,,The Great Museum,100,15,2014.0,Documentary,0 days 01:34:00.000000000,25
66,95,https://resizing.flixster.com/exWgpNiiqGGJg7VH-1zxqbcSRzg=/206x305/v2/https://flxt.tmsimg.com/assets/p11391245_p_v8_aa.jpg,Hard to Be a God,1000,43,2013.0,Sci fi/Drama,0 days 02:57:00.000000000,29
30,6,https://resizing.flixster.com/mB9GuAL_RAwijKShsNXgrpTIQBA=/206x305/v2/https://flxt.tmsimg.com/assets/p11835235_p_v10_aa.jpg,Some Kind of Beautiful,1000,34,2014.0,Romance,0 days 01:39:00.000000000,-24
86,92,,Ex Machina,50000,281,2015.0,Sci fi/Mystery and thriller,0 days 01:47:00.000000000,6
70,71,,Gringo Trails,100,7,2013.0,Documentary,0 days 01:19:00.000000000,1
68,73,https://resizing.flixster.com/hMkIdw6H03l0a_PiHu5FDW-wU8g=/206x305/v2/https://flxt.tmsimg.com/assets/p11729985_p_v10_ak.jpg,Black Mass,10000,290,2015.0,Crime/Drama,0 days 02:02:00.000000000,5
42,72,https://resizing.flixster.com/RLO1y8RA3mQOEJW7LJcSVUQrhO4=/206x305/v2/https://flxt.tmsimg.com/assets/p10933393_p_v10_ab.jpg,The Harvest,500,25,2013.0,Mystery and thriller,0 days 01:44:00.000000000,30
51,0,https://resizing.flixster.com/FWLzC6Sbeb81YLTgox30C1R3l6g=/206x305/v2/https://flxt.tmsimg.com/assets/p11740045_p_v10_aa.jpg,Freedom,250,15,2014.0,Drama/History,0 days 01:33:00.000000000,-51
46,100,,Tiger Orange,50,5,2014.0,Gay and lesbian/Drama,0 days 01:15:00.000000000,54
36,100,https://resizing.flixster.com/B-5ZceUnJ7Rc76lL9s5YGNx8UoM=/206x305/v2/https://resizing.flixster.com/1q_AbOe6u3aAAQPIDpBoV4qEtKA=/ems.ZW1zLXByZC1hc3NldHMvbW92aWVzLzAyNmI4NzZiLTQzMmEtNDg1Yy05NDJmLTZlMWI1YmRkOTE2YS53ZWJw,Lyle,100,11,2014.0,Horror/Gay and lesbian,0 days 01:05:00.000000000,64
46,82,https://resizing.flixster.com/E-QieAmy16Ep7gKAaIIDXVE3KJw=/206x305/v2/https://flxt.tmsimg.com/assets/p12005086_p_v10_aa.jpg,Entertainment,1000,55,2015.0,Comedy,0 days 01:42:00.000000000,36
38,15,,The 5th Wave,25000,141,2016.0,Mystery and thriller/Adventure,0 days 01:52:00.000000000,-23
43,80,/assets/pizza-pie/images/poster_default.c8c896e70c3.gif,Three Hearts,250,40,2014.0,Romance/Drama,0 days 01:46:00.000000000,37
69,45,,The Road Within,500,20,2014.0,Comedy/Drama,0 days 01:41:00.000000000,-24
75,83,,The Bélier Family,1000,24,2014.0,Drama/Comedy,0 days 01:46:00.000000000,8
50,63,,Mateo,50,8,2014.0,Documentary,0 days 01:28:00.000000000,13
65,100,,The Winding Stream,100,9,2014.0,Documentary,0 days 01:30:00.000000000,35
78,84,https://resizing.flixster.com/jej-GoXPeS40xVfIkjoJm9eN9ko=/206x305/v2/https://flxt.tmsimg.com/assets/p11007722_p_v13_at.jpg,Testament of Youth,5000,126,2014.0,War/Drama,0 days 02:09:00.000000000,6
47,58,,Paper Towns,25000,141,2015.0,Mystery and thriller/Comedy,0 days 01:49:00.000000000,11
13,23,,The Pact II,250,13,2014.0,Horror/Mystery and thriller,0 days 01:36:00.000000000,10
43,18,,The Last Witch Hunter,25000,137,2015.0,Action/Fantasy,0 days 01:46:00.000000000,-25
87,100,,Lost Soul: The Doomed Journey of Richard Stanley's Island of Dr. Moreau,250,8,2014.0,Documentary/Adventure,0 days 01:37:00.000000000,13
39,38,,Another,100,8,2014.0,Horror/Mystery and thriller,0 days 01:20:00.000000000,-1
59,65,,The Second Best Exotic Marigold Hotel,10000,187,2015.0,Comedy/Drama,0 days 02:02:00.000000000,6
66,69,,Sunset Edge,100,16,2015.0,Drama/Mystery and thriller,0 days 01:23:00.000000000,3
84,18,,Old Fashioned,1000,22,2014.0,Romance,0 days 01:55:00.000000000,-66
61,70,,The Outrageous Sophie Tucker,100,20,2014.0,Documentary,0 days 01:36:00.000000000,9
57,76,,Northern Soul,1000,38,2014.0,Comedy/Drama,0 days 01:42:00.000000000,19
49,48,,A Little Chaos,2500,92,2014.0,Romance/Drama,0 days 01:56:00.000000000,-1
57,69,,The Dead Lands,1000,52,2014.0,Action/Horror,0 days 01:48:00.000000000,12
67,80,https://resizing.flixster.com/u_bBwjpCFxXeju5j4v7C1KExOt0=/206x305/v2/https://flxt.tmsimg.com/assets/p11090305_p_v8_aa.jpg,In Search of Chopin,1,5,2014.0,Documentary,0 days 01:50:00.000000000,13
34,25,,Jenny's Wedding,1000,16,2015.0,Romance/Gay and lesbian,0 days 01:34:00.000000000,-9
59,55,https://resizing.flixster.com/0_XUoU5weoB5VQwRvskx-AmDblU=/206x305/v2/https://flxt.tmsimg.com/assets/p11089389_p_v10_aa.jpg,The Editor,100,11,2014.0,Comedy/Horror,0 days 01:42:00.000000000,-4
88,100,,Glen Campbell... I'll Be Me,2500,33,2014.0,Documentary/Music,0 days 01:45:00.000000000,12
41,56,,Over Your Dead Body,100,9,2014.0,Horror,0 days 01:34:00.000000000,15
56,88,,Guidance,250,16,2014.0,Comedy,0 days 01:21:00.000000000,32
34,36,https://resizing.flixster.com/pWca_Wd7IBhOerAu79ds1ktKuTk=/206x305/v2/https://flxt.tmsimg.com/assets/p12004386_p_v10_ab.jpg,Our Brand Is Crisis,5000,174,2015.0,Comedy,0 days 01:48:00.000000000,2
51,67,,Krampus,25000,129,2015.0,,,16
70,64,https://resizing.flixster.com/m_ec9wF1mHHkjDx9TD8sT3xogh0=/206x305/v2/https://flxt.tmsimg.com/assets/p11020597_p_v10_ad.jpg,Awake: The Life of Yogananda,500,11,2014.0,Documentary,0 days 01:27:00.000000000,-6
73,91,https://resizing.flixster.com/dNMvusvRyesclXFEpKosCpLHYHU=/206x305/v2/https://flxt.tmsimg.com/assets/p11992120_p_v10_aa.jpg,Bone Tomahawk,10000,95,2015.0,Western/Action,0 days 02:12:00.000000000,18
43,25,,After the Ball,250,16,2015.0,Romance,0 days 01:42:00.000000000,-18
90,96,,The Look of Silence,5000,138,2014.0,Documentary,0 days 01:39:00.000000000,6
47,55,,Tokyo Tribe,250,33,2014.0,Comedy/Action,0 days 01:56:00.000000000,8
78,85,,Merchants of Doubt,2500,89,2014.0,Documentary,0 days 01:36:00.000000000,7
78,92,,99 Homes,10000,159,2014.0,Drama,0 days 01:50:00.000000000,14
53,92,https://resizing.flixster.com/yL67PLoH-qVChElB1KsXq8MQwP8=/206x305/v2/https://flxt.tmsimg.com/assets/p11218401_p_v10_av.jpg,Backcountry,2500,51,2014.0,Adventure/Drama,0 days 01:32:00.000000000,39
50,100,,How to Smell a Rose: A Visit With Ricky Leacock in Normandy,50,7,2014.0,Documentary/Drama,0 days 01:04:00.000000000,50
77,87,,X Plus Y,5000,77,2014.0,Comedy/Drama,0 days 01:51:00.000000000,10
73,84,,Far From Men,1000,32,2014.0,Drama,0 days 01:42:00.000000000,11
18,13,,American Heist,1000,16,2014.0,Crime/Action,0 days 01:30:00.000000000,-5
56,27,,Before We Go,5000,30,2014.0,Romance/Comedy,0 days 01:35:00.000000000,-29
46,69,https://resizing.flixster.com/wAFL6rljdo3855baQSkwxLfli18=/206x305/v2/https://flxt.tmsimg.com/assets/p11570371_p_v10_aa.jpg,Cut Snake,100,16,2014.0,Crime/Drama,0 days 01:34:00.000000000,23
57,83,,Eden,2500,107,2014.0,Drama,0 days 02:11:00.000000000,26
10,36,,The Face of an Angel,1000,50,2014.0,Drama,0 days 01:41:00.000000000,26
31,9,https://resizing.flixster.com/7qr_bmBqsJdfzO14IrdajKOvF6w=/206x305/v2/https://flxt.tmsimg.com/assets/p11539792_p_v10_af.jpg,The Forger,500,44,2014.0,Drama/Mystery and thriller,0 days 01:35:00.000000000,-22
65,85,,Goodnight Mommy,10000,149,2014.0,Horror/Mystery and thriller,0 days 01:40:00.000000000,20
58,66,,Learning to Drive,2500,99,2014.0,Romance/Comedy,0 days 01:30:00.000000000,8
55,40,,Lucky Stiff,1,5,2014.0,Comedy/Musical,0 days 01:18:00.000000000,-15
59,50,https://resizing.flixster.com/NURbM5au3avO8DVvmvvY1CAHQ1A=/206x305/v2/https://flxt.tmsimg.com/assets/p11908003_p_v10_ab.jpg,Meet Me in Montenegro,100,8,2014.0,Romance,0 days 01:30:00.000000000,-9
20,21,https://resizing.flixster.com/ZfgFKwd4EyjDDmUljFWduaMqfxg=/206x305/v2/https://flxt.tmsimg.com/assets/p11412947_p_v10_ab.jpg,October Gale,100,28,2014.0,Drama/Mystery and thriller,0 days 01:31:00.000000000,1
78,98,,Phoenix,10000,131,2014.0,Drama/History,0 days 01:38:00.000000000,20
36,47,,Preggoland,100,19,2014.0,Comedy/Drama,0 days 01:49:00.000000000,11
20,37,,Beyond the Reach,500,68,2014.0,Action/Mystery and thriller,0 days 01:31:00.000000000,17
46,94,,Sand Dollars,100,16,2014.0,Romance/Gay and lesbian,0 days 01:24:00.000000000,48
78,100,https://resizing.flixster.com/CqfGG_srHfu11K52NIk4VycXn34=/206x305/v2/https://flxt.tmsimg.com/assets/p11435588_p_v10_aa.jpg,Seymour: An Introduction,5000,68,2014.0,Documentary,0 days 01:21:00.000000000,22
67,92,,Sunshine Superman,1000,60,2014.0,Documentary,0 days 01:40:00.000000000,25
42,80,https://resizing.flixster.com/2pOVbbyabLQxq583irWoA_JyzYU=/206x305/v2/https://flxt.tmsimg.com/assets/p11140452_p_v8_ap.jpg,Time Out of Mind,1000,88,2014.0,Drama,0 days 02:00:00.000000000,38
51,84,,While We're Young,10000,205,2014.0,Drama/Comedy,0 days 01:34:00.000000000,33
48,82,https://resizing.flixster.com/tkwx7GIfAqDEElr5bWqk27iP_uo=/206x305/v2/https://flxt.tmsimg.com/assets/p11234472_p_v13_af.jpg,1001 Grams,250,22,2014.0,Drama,0 days 01:33:00.000000000,34
30,48,,Adult Beginners,2500,79,2014.0,Comedy/Drama,0 days 01:32:00.000000000,18
33,38,https://resizing.flixster.com/FyCSZpE-9FX150G1G9u8IqU4weA=/206x305/v2/https://flxt.tmsimg.com/assets/p11085744_p_v10_ab.jpg,Cub,250,24,2014.0,Horror,0 days 01:25:00.000000000,5
47,81,https://resizing.flixster.com/hsB07nIEhDKiqwdNXGLG-gPuxLU=/206x305/v2/https://flxt.tmsimg.com/assets/p11459664_p_v10_ab.jpg,Do I Sound Gay?,2500,48,2014.0,Documentary/Gay and lesbian,0 days 01:17:00.000000000,34
73,94,https://resizing.flixster.com/XR0vZ339Mh4dFFDizyArBEGLGz0=/206x305/v2/https://flxt.tmsimg.com/assets/p11459544_p_v10_ad.jpg,The Farewell Party,1000,34,2014.0,Comedy/Drama,0 days 01:30:00.000000000,21
62,78,,Felix and Meira,1000,45,2014.0,Romance/Drama,0 days 01:46:00.000000000,16
49,75,,Good Kill,5000,125,2014.0,Drama/War,0 days 01:42:00.000000000,26
66,87,,Heaven Knows What,2500,71,2014.0,Drama,0 days 01:35:00.000000000,21
56,63,,Hungry Hearts,1000,38,2014.0,Drama/Mystery and thriller,0 days 01:52:00.000000000,7
30,16,https://resizing.flixster.com/6HVaWEa-OTmrzbGQSiY3bOOxKvw=/206x305/v2/https://flxt.tmsimg.com/assets/p11319334_p_v10_aa.jpg,Kill Me Three Times,2500,56,2014.0,Action/Mystery and thriller,0 days 01:30:00.000000000,-14
50,88,,La Sapienza,100,25,2014.0,Drama,0 days 01:37:00.000000000,38
64,61,,The Little Death,1000,57,2014.0,Romance,0 days 01:36:00.000000000,-3
63,85,https://resizing.flixster.com/4SthaZsFIIy6DKd1wyqF5zZaMXg=/206x305/v2/https://flxt.tmsimg.com/assets/p11664690_p_v10_ab.jpg,Paper Planes,1000,27,2014.0,Kids and family/Adventure,0 days 01:36:00.000000000,22
38,76,,Second Coming,100,21,2014.0,Drama,0 days 01:45:00.000000000,38
42,100,,Songs From the North,100,6,2014.0,Documentary,0 days 01:12:00.000000000,58
75,97,,Theeb,5000,72,2014.0,Mystery and thriller/Drama,0 days 01:40:00.000000000,22
38,45,,True Story,10000,171,2015.0,Crime/Drama,0 days 01:44:00.000000000,7
55,81,https://resizing.flixster.com/kmQNo1sjNIjbFzG_82qgb8KoKSk=/206x305/v2/https://flxt.tmsimg.com/assets/p11394467_p_v10_aa.jpg,The Yes Men Are Revolting,250,32,2014.0,Documentary,0 days 01:31:00.000000000,26
68,83,,Urok,100,23,2014.0,Drama,0 days 01:47:00.000000000,15
40,64,,Jackie & Ryan,250,22,2014.0,Romance/Drama,0 days 01:30:00.000000000,24
29,28,https://resizing.flixster.com/3YI3P3tVxcsAptFpXNA3w3NnnXY=/206x305/v2/https://flxt.tmsimg.com/assets/p11675616_p_v10_ac.jpg,Burying the Ex,500,39,2014.0,Romance/Horror,0 days 01:25:00.000000000,-1
44,11,,Dirty Grandpa,25000,137,2016.0,Comedy,0 days 01:42:00.000000000,-33
57,75,https://resizing.flixster.com/wn8ty8ySipFmrxEaK7HLhctt7Vg=/206x305/v2/https://flxt.tmsimg.com/assets/p10630702_p_v8_aa.jpg,Patch Town,100,8,2014.0,Fantasy/Musical,0 days 01:24:00.000000000,18
50,82,https://resizing.flixster.com/nKt-zASlVtCiFMSExJrgyTwY9-o=/206x305/v2/https://flxt.tmsimg.com/NowShowing/156961/156961_aa.jpg,Chi-Raq,5000,148,2015.0,Comedy/Drama,0 days 02:07:00.000000000,32
72,82,,Noble,1000,34,2014.0,Drama/Biography,0 days 01:40:00.000000000,10
87,96,https://resizing.flixster.com/M3EiaovloM1_4zheJ4ORyKR4cFk=/206x305/v2/https://flxt.tmsimg.com/assets/p11098261_p_v13_ad.jpg,Citizenfour,10000,146,2014.0,Documentary,0 days 01:54:00.000000000,9
86,100,,Mr. Dynamite: The Rise of James Brown,100,11,2014.0,,,14
90,85,https://resizing.flixster.com/k8sqy2AI32z2QJNdAzD1LFVcsXg=/206x305/v2/https://resizing.flixster.com/FQ9SS59M0qKg7f7U91ofk2UVy_s=/ems.ZW1zLXByZC1hc3NldHMvbW92aWVzLzg3NGEwM2NkLTI2N2QtNDk4ZS05OGY5LWU0MmQ5NzAyZGJmMC53ZWJw,Deadpool,100000,346,2016.0,Action/Fantasy,0 days 01:48:00.000000000,-5
54,47,https://resizing.flixster.com/Ocbe9Pk2RoHoG4mXC2F5l6ykIg0=/206x305/v2/https://flxt.tmsimg.com/assets/p11659455_p_v10_ab.jpg,Maze Runner: The Scorch Trials,50000,152,2015.0,Mystery and thriller/Action,0 days 02:11:00.000000000,-7
37,62,https://resizing.flixster.com/sTH-lAcU4arYDfQhtggzZn31bto=/206x305/v2/https://flxt.tmsimg.com/assets/p11082088_p_v10_aa.jpg,Felt,250,34,2014.0,Horror/Mystery and thriller,0 days 01:20:00.000000000,25
45,89,,Red Knot,100,9,2014.0,Drama,0 days 01:20:00.000000000,44
49,67,,Wolf Totem,250,30,2015.0,Action/Drama,0 days 01:58:00.000000000,18
27,14,,Paranormal Activity: The Ghost Dimension,25000,77,2015.0,Horror/Mystery and thriller,0 days 01:28:00.000000000,-13
32,20,https://resizing.flixster.com/nKHqJjBeVavYacaXmJhzrJBU4Co=/206x305/v2/https://flxt.tmsimg.com/assets/p11308894_p_v10_aa.jpg,Alien Outpost,500,15,2014.0,Action/Sci fi,0 days 01:30:00.000000000,-12
80,29,https://resizing.flixster.com/Xv-Ap8fGpUAUQs_VEzQzlPkPRkI=/206x305/v2/https://flxt.tmsimg.com/assets/p11153595_p_v10_aa.jpg,Helicopter Mom,250,7,2014.0,Comedy/Gay and lesbian,0 days 01:23:00.000000000,-51
75,100,,Banksy Does New York,250,12,2014.0,Documentary,0 days 01:19:00.000000000,25
28,36,https://resizing.flixster.com/BGfavv-mNEMk9TFbZ-JPnd2rI78=/206x305/v2/https://flxt.tmsimg.com/assets/p11560110_p_v10_ae.jpg,Sharknado 3: Oh Hell No!,500,33,2015.0,Comedy/Sci fi,0 days 01:28:00.000000000,8
42,30,https://resizing.flixster.com/cQcmyoJU2x7l-WF44sq63rIjQy4=/206x305/v2/https://flxt.tmsimg.com/assets/p12027686_p_v10_aa.jpg,Gravy,100,10,2015.0,Other/Horror,0 days 01:35:00.000000000,-12
66,64,,Reality,250,25,2014.0,Comedy,0 days 01:35:00.000000000,-2
35,52,,Dark Was the Night,500,21,2014.0,Horror/Drama,0 days 01:38:00.000000000,17
78,94,https://resizing.flixster.com/r8OQvx3I6L2pthuPsMubIVEKy3Q=/206x305/v2/https://resizing.flixster.com/oxwTVBYWd0NuJ8Zyj7tMtSbK4RQ=/ems.ZW1zLXByZC1hc3NldHMvbW92aWVzL2EwYTgzZDJmLWI0NmUtNDhmMi1iYTIzLWU5MzcxYjRhZTdhMi53ZWJw,The Last Man on the Moon,2500,47,2014.0,Documentary/Adventure,0 days 01:35:00.000000000,16
76,87,,Meet the Patels,2500,54,2014.0,Documentary/Comedy,0 days 01:28:00.000000000,11
67,76,,A Murder in the Park,250,17,2014.0,Documentary,0 days 01:31:00.000000000,9
36,62,,Unfriended,25000,186,2014.0,Horror/Mystery and thriller,0 days 01:23:00.000000000,26
66,29,,The Letters,2500,38,2014.0,Drama/History,0 days 01:59:00.000000000,-37
51,100,https://resizing.flixster.com/qI9ASGBmT0tJ9W1iDVYZMFwa1IQ=/206x305/v2/https://flxt.tmsimg.com/assets/p11225500_p_v13_ad.jpg,Last Shift,1000,8,2014.0,Horror/Mystery and thriller,0 days 01:30:00.000000000,49
57,75,,Kung Fu Jungle,1000,24,2014.0,Action/Mystery and thriller,0 days 01:40:00.000000000,18
51,18,https://resizing.flixster.com/l9Q8r7GQUH8d-CLShoXX5iKf-uY=/206x305/v2/https://flxt.tmsimg.com/assets/p11659499_p_v10_ac.jpg,The Perfect Guy,10000,45,2015.0,Mystery and thriller,0 days 01:40:00.000000000,-33
17,14,,Hangar 10,100,7,2014.0,Sci fi/Horror,0 days 01:47:00.000000000,-3
64,89,https://resizing.flixster.com/UeXrIYuhGJDVskE1jJ9RlUsVtxQ=/206x305/v2/https://flxt.tmsimg.com/assets/p11548808_p_v10_aa.jpg,The Lady in the Van,10000,150,2015.0,Comedy/Drama,0 days 01:44:00.000000000,25
6,0,https://resizing.flixster.com/uCNX6lPol8_0ZcYzV-an1gD-K00=/206x305/v2/https://flxt.tmsimg.com/assets/p11244728_p_v13_ad.jpg,L.A. Slasher,250,6,2015.0,Comedy/Horror,0 days 01:26:00.000000000,-6
35,44,,She's Funny That Way,5000,96,2014.0,Romance,0 days 01:33:00.000000000,9
80,98,,Iris,5000,99,2014.0,Documentary/Drama,0 days 01:23:00.000000000,18
24,17,,Air,500,12,2015.0,Sci fi/Mystery and thriller,0 days 01:35:00.000000000,-7
51,68,,The Visit,25000,229,2015.0,Comedy/Horror,0 days 01:34:00.000000000,17
66,82,https://resizing.flixster.com/C26RYsPzwoPUPnwRlf_7_COusxE=/206x305/v2/https://flxt.tmsimg.com/assets/p11338212_p_v10_ab.jpg,Deli Man,1000,38,2014.0,Documentary,0 days 01:31:00.000000000,16
60,89,https://resizing.flixster.com/YNK3n2yEGsNaGPMxQCWtLzbyozw=/206x305/v2/https://resizing.flixster.com/1cCAJoIw4CNfC3i6Tkub3tHgdls=/ems.ZW1zLXByZC1hc3NldHMvbW92aWVzLzY4MGUwNzNhLTA4OTgtNGU1MS1iYWM1LTI1YmQ3Y2RiMzI4OC53ZWJw,Bill,250,19,2015.0,Comedy/Adventure,0 days 01:34:00.000000000,29
82,91,,Toy Story That Time Forgot,500,11,2014.0,,,9
44,28,https://resizing.flixster.com/GSDMkDoxGjK79PpQTVHHlqlf-2s=/206x305/v2/https://flxt.tmsimg.com/assets/p11819804_p_v13_bd.jpg,Burnt,10000,159,2015.0,Drama,0 days 01:40:00.000000000,-16
61,11,,The Choice,10000,85,2016.0,Romance/Drama,0 days 01:51:00.000000000,-50
6,20,,Turkey Shoot,50,5,2014.0,Action,0 days 01:30:00.000000000,14
79,57,https://resizing.flixster.com/hTtHE7PgFfC9bA-SXCaf2XdhHvY=/206x305/v2/https://flxt.tmsimg.com/assets/p11326539_p_v10_aa.jpg,Woman in Gold,10000,153,2015.0,Drama,0 days 01:51:00.000000000,-22
50,63,,MI-5,5000,41,2015.0,Crime/Action,0 days 01:44:00.000000000,13
83,25,,Do You Believe?,10000,20,2015.0,Drama,0 days 01:55:00.000000000,-58
36,100,https://resizing.flixster.com/wS0LHHWaBDDB1hzZPRLZH-VoktQ=/206x305/v2/https://flxt.tmsimg.com/assets/p11759280_p_v13_aa.jpg,"One Cut, One Life",100,11,2014.0,Biography,0 days 01:47:00.000000000,64
88,91,https://resizing.flixster.com/ZpDBL_k9HPTInC9hSbxRxHiEBC0=/206x305/v2/https://flxt.tmsimg.com/NowShowing/150707/150707_aa.jpg,When Marnie Was There,5000,99,2014.0,Drama/Kids and family,0 days 01:43:00.000000000,3
15,29,https://resizing.flixster.com/SXTeIhZiLzhDqhvVeSRYah304N4=/206x305/v2/https://flxt.tmsimg.com/assets/p11371829_p_v10_ab.jpg,Dark Summer,250,24,2015.0,Horror/Mystery and thriller,0 days 01:22:00.000000000,14
41,89,,Elf: Buddy's Musical Christmas,100,9,2014.0,,,48
75,43,/assets/pizza-pie/images/poster_default.c8c896e70c3.gif,Falling for Mala,1000,7,2015.0,Romance,0 days 01:46:00.000000000,-32
67,100,,Gloria,250,13,2014.0,Drama/Biography,0 days 02:06:00.000000000,33
39,91,,Sembene!,50,23,2015.0,Biography,0 days 01:22:00.000000000,52
45,79,https://resizing.flixster.com/7haBKw2AW2n2AOAp_BLytZx234Q=/206x305/v2/https://flxt.tmsimg.com/assets/p11455248_p_v10_aa.jpg,Z for Zachariah,5000,92,2015.0,Sci fi/Drama,0 days 01:37:00.000000000,34
69,80,https://resizing.flixster.com/WVaIgCSmPc3j6LSQd2cFh9OHFOg=/206x305/v2/https://flxt.tmsimg.com/assets/p11736416_p_v10_ab.jpg,Man Up,10000,79,2015.0,Romance,0 days 01:28:00.000000000,11
56,74,,A Royal Night Out,2500,73,2015.0,Comedy/Drama,0 days 01:37:00.000000000,18
74,94,,Carol,25000,310,2015.0,Romance/Gay and lesbian,0 days 01:58:00.000000000,20
47,80,,The Lady in the Car With Glasses and a Gun,250,5,2015.0,Mystery and thriller,0 days 01:33:00.000000000,33
33,50,https://resizing.flixster.com/dHb2HU5UQloo0BWn5sV28qrYOVc=/206x305/v2/https://flxt.tmsimg.com/assets/p11464343_p_v8_aa.jpg,The Other Man: F.W. de Klerk and the End of Apartheid,50,6,2014.0,Documentary/Drama,0 days 01:16:00.000000000,17
43,46,,5 Flights Up,2500,63,2014.0,Comedy/Drama,0 days 01:32:00.000000000,3
16,25,https://resizing.flixster.com/UkDoerQgUj8StnyhKkxllhvDOhM=/206x305/v2/https://flxt.tmsimg.com/assets/p11810123_p_v8_aa.jpg,The Stranger,100,12,2014.0,Horror/Mystery and thriller,0 days 01:33:00.000000000,9
48,67,https://resizing.flixster.com/JM7hqaP_HPACF954CsW6NjM0puA=/206x305/v2/https://flxt.tmsimg.com/assets/p11988214_p_v10_ab.jpg,Bloodsucking Bastards,250,24,2015.0,Comedy/Horror,0 days 01:27:00.000000000,19
83,82,,Batkid Begins: The Wish Heard Around the World,2500,60,2015.0,Documentary,0 days 01:29:00.000000000,-1
81,92,https://resizing.flixster.com/ZH7qUe0qZnBR-uEmtqDUqJaiP1Q=/206x305/v2/https://flxt.tmsimg.com/assets/p11623960_p_v10_ab.jpg,The End of the Tour,10000,160,2015.0,Drama,0 days 01:46:00.000000000,11
24,41,,Strangerland,500,68,2015.0,Drama/Mystery and thriller,0 days 01:51:00.000000000,17
69,88,https://resizing.flixster.com/uPn1mf5hUNuEjnnHArqAQpirF54=/206x305/v2/https://flxt.tmsimg.com/assets/p11715389_p_v10_ab.jpg,Drunk Stoned Brilliant Dead: The Story of the National Lampoon,1000,65,2015.0,Documentary,0 days 01:34:00.000000000,19
55,91,,Mississippi Grind,5000,119,2015.0,Drama,0 days 01:48:00.000000000,36
48,47,https://resizing.flixster.com/44XynrDke7HDxuTFB0FnCmM-2wk=/206x305/v2/https://flxt.tmsimg.com/assets/p11436702_p_v10_aa.jpg,A Walk in the Woods,10000,166,2015.0,Comedy/Adventure,0 days 01:44:00.000000000,-1
29,33,,Laugh Killer Laugh,50,6,2015.0,Crime/Drama,0 days 01:40:00.000000000,4
83,97,,Being Evel,500,39,2015.0,Documentary/Biography,0 days 01:42:00.000000000,14
85,93,https://resizing.flixster.com/8UfhNq-uungoNR78HLfRdjMVRbc=/206x305/v2/https://flxt.tmsimg.com/assets/p11663654_p_v10_ab.jpg,Best of Enemies,5000,121,2015.0,Documentary/Drama,0 days 01:28:00.000000000,8
72,92,https://resizing.flixster.com/3B2w0DigvvBxvByFYOoT0adEnAo=/206x305/v2/https://flxt.tmsimg.com/assets/p11460186_p_v10_ab.jpg,The Black Panthers: Vanguard of the Revolution,1000,64,2015.0,Documentary/Drama,0 days 01:54:00.000000000,20
82,90,,Cartel Land,5000,100,2015.0,Documentary,0 days 01:38:00.000000000,8
53,81,,Cop Car,5000,89,2015.0,Mystery and thriller,0 days 01:28:00.000000000,28
73,95,https://resizing.flixster.com/HtDyvzWOdxL25dNntWvtLrhmvws=/206x305/v2/https://flxt.tmsimg.com/assets/p11455471_p_v10_aa.jpg,The Diary of a Teenage Girl,10000,166,2015.0,Drama,0 days 01:42:00.000000000,22
41,64,,Digging for Fire,1000,70,2015.0,Drama/Mystery and thriller,0 days 01:23:00.000000000,23
61,85,https://resizing.flixster.com/AAQdI2MKrsgtfoRzn3J5cZTyW_I=/206x305/v2/https://flxt.tmsimg.com/assets/p11911870_p_v8_aa.jpg,Experimenter,5000,80,2015.0,Drama/History,0 days 01:37:00.000000000,24
50,96,,The Forbidden Room,1000,69,2015.0,Comedy/Drama,0 days 02:10:00.000000000,46
56,91,,Fresh Dressed,250,34,2015.0,Documentary,0 days 01:24:00.000000000,35
44,84,,Glassland,1000,50,2014.0,Drama,0 days 01:29:00.000000000,40
90,95,,Going Clear: Scientology & the Prison of Belief,5000,93,2015.0,Documentary,0 days 01:59:00.000000000,5
43,70,,The Hallow,5000,60,2015.0,Horror,0 days 01:37:00.000000000,27
16,29,,Hellions,250,31,2015.0,Other/Horror,0 days 01:20:00.000000000,13
87,95,,How to Change the World,250,21,2015.0,Documentary,0 days 01:53:00.000000000,8
85,93,https://resizing.flixster.com/Go_x0vI14kBYheko8-HLbiiza84=/206x305/v2/https://flxt.tmsimg.com/assets/p11443434_p_v10_ab.jpg,The Hunting Ground,2500,73,2015.0,Documentary,0 days 01:42:00.000000000,8
43,49,,I Smile Back,1000,71,2015.0,Drama,0 days 01:25:00.000000000,6
70,92,https://resizing.flixster.com/XV3gfmDOxY_7aWXmCLZJ9LO2_TY=/206x305/v2/https://flxt.tmsimg.com/assets/p12052900_p_v10_ab.jpg,James White,2500,75,2015.0,Drama,0 days 01:26:00.000000000,22
20,36,,Knock Knock,5000,72,2015.0,Mystery and thriller,0 days 01:39:00.000000000,16
81,97,,Kurt Cobain: Montage of Heck,5000,94,2015.0,Documentary,0 days 02:12:00.000000000,16
75,67,,The Mask You Live In,100,6,2015.0,Documentary,0 days 01:37:00.000000000,-8
86,81,,Me and Earl and the Dying Girl,25000,212,2015.0,Comedy/Drama,0 days 01:45:00.000000000,-5
91,89,https://resizing.flixster.com/FJFaMVX1ymoUNgtmnhDyiS4IpS8=/206x305/v2/https://flxt.tmsimg.com/assets/p11738496_p_v10_am.jpg,Meru,5000,76,2015.0,Documentary,0 days 01:30:00.000000000,-2
40,68,https://resizing.flixster.com/rW2Fz4th8g4FvzHAlsvv42zMvjE=/206x305/v2/https://flxt.tmsimg.com/assets/p11886676_p_v10_aa.jpg,Nasty Baby,500,56,2015.0,Comedy/Drama,0 days 01:41:00.000000000,28
43,67,,The Nightmare,2500,61,2015.0,Documentary/Horror,0 days 01:30:00.000000000,24
54,82,https://resizing.flixster.com/bfzyFKi102QPrGe-M1l3TlI109Y=/206x305/v2/https://flxt.tmsimg.com/assets/p11738169_p_v10_ab.jpg,The Overnight,10000,135,2015.0,Comedy,0 days 01:18:00.000000000,28
38,58,,Partisan,1000,48,2015.0,Drama/Mystery and thriller,0 days 01:38:00.000000000,20
72,76,,"People, Places, Things",2500,55,2015.0,Comedy,0 days 01:26:00.000000000,4
90,97,,The Second Mother,1000,90,2015.0,Drama,0 days 01:52:00.000000000,7
74,92,https://resizing.flixster.com/5WwCPF-gChlR5bFR8a2uoI4DbhE=/206x305/v2/https://flxt.tmsimg.com/assets/p11520890_p_v10_an.jpg,Slow West,10000,134,2015.0,Western/Mystery and thriller,0 days 01:31:00.000000000,18
75,84,,The Stanford Prison Experiment,10000,100,2015.0,Drama/History,0 days 01:57:00.000000000,9
50,22,https://resizing.flixster.com/Tm0kKeHiJ1ISxtsSqc35D1gBIJM=/206x305/v2/https://flxt.tmsimg.com/assets/p11567871_p_v8_aa.jpg,The Strongest Man,100,9,2015.0,Comedy,0 days 01:40:00.000000000,-28
76,96,,Tangerine,10000,156,2015.0,Comedy/Drama,0 days 01:27:00.000000000,20
36,58,,Ten Thousand Saints,500,36,2015.0,Comedy/Drama,0 days 01:46:00.000000000,22
44,66,,Unexpected,2500,58,2015.0,Comedy/Drama,0 days 01:25:00.000000000,22
68,86,,The Wolfpack,5000,147,2015.0,Documentary/Biography,0 days 01:29:00.000000000,18
83,88,,Dope,25000,160,2015.0,Comedy,0 days 01:43:00.000000000,5
80,85,,Call Me Lucky,500,26,2015.0,Documentary,0 days 01:46:00.000000000,5
23,29,,Don Verdean,1000,38,2015.0,Comedy,0 days 01:36:00.000000000,6
67,91,,Grandma,10000,174,2015.0,Comedy/Drama,0 days 01:18:00.000000000,24
41,40,https://resizing.flixster.com/A0YjCVMJTQ5La4De6499oGSWYQg=/206x305/v2/https://flxt.tmsimg.com/assets/p10523838_p_v13_aq.jpg,Lila & Eve,1000,40,2015.0,Crime/Drama,0 days 01:34:00.000000000,-1
27,20,https://resizing.flixster.com/o1rdLdt12VoSjdoSlJS4pB-2bM4=/206x305/v2/https://flxt.tmsimg.com/assets/p11871168_p_v10_ad.jpg,Zipper,250,30,2015.0,Drama/Mystery and thriller,0 days 01:52:00.000000000,-7
36,60,,Flutter,100,5,2011.0,Drama/Mystery and thriller,0 days 01:25:00.000000000,24
59,90,,The Witch,25000,328,2015.0,Horror/Mystery and thriller,0 days 01:32:00.000000000,31
61,82,,Nightingale,250,22,2014.0,Drama,0 days 01:23:00.000000000,21
24,61,https://resizing.flixster.com/pFIxCevOnn3AYTDOOdjkpR0hs4A=/206x305/v2/https://flxt.tmsimg.com/assets/p11663803_p_v10_ab.jpg,Robot Overlords,500,18,2014.0,Sci fi/Action,0 days 01:29:00.000000000,37
70,73,,The Final Girls,5000,70,2015.0,Comedy/Horror,0 days 01:28:00.000000000,3
74,68,,That Sugar Film,1000,38,2014.0,Documentary,0 days 01:34:00.000000000,-6
14,27,https://resizing.flixster.com/gCX78EHXDKTYnpeUT1evCckM3fA=/206x305/v2/https://flxt.tmsimg.com/assets/p11871186_p_v10_an.jpg,Amnesiac,250,15,2014.0,Mystery and thriller,0 days 01:24:00.000000000,13
74,59,,Concussion,25000,205,2015.0,Drama/Biography,0 days 02:01:00.000000000,-15
87,34,https://resizing.flixster.com/M8fbX909fxjotHpEk3NSeUKWnvw=/206x305/v2/https://flxt.tmsimg.com/assets/p11667784_p_v10_ac.jpg,War Room,10000,35,2015.0,Drama,0 days 02:00:00.000000000,-53
70,88,,Mr. Holmes,25000,187,2015.0,Drama/Mystery and thriller,0 days 01:45:00.000000000,18
73,85,https://resizing.flixster.com/ifBywubXG1BqH54SWtAm_hm3hD8=/206x305/v2/https://flxt.tmsimg.com/assets/p11491197_p_v10_aq.jpg,Steve Jobs,25000,315,2015.0,Drama/Biography,0 days 02:01:00.000000000,12
89,95,https://resizing.flixster.com/15f4bEPJsvuMCbBm2vwBLanx6Lo=/206x305/v2/https://flxt.tmsimg.com/assets/p11491087_p_v10_ad.jpg,Creed,50000,310,2015.0,Drama,0 days 02:13:00.000000000,6
46,47,,Irrational Man,5000,204,2015.0,Comedy,0 days 01:34:00.000000000,1
76,50,https://resizing.flixster.com/49lEQb_xf_KEuDYi71ieu8WWp3k=/206x305/v2/https://flxt.tmsimg.com/assets/p11520475_p_v13_ac.jpg,Road Hard,2500,22,2015.0,Comedy,0 days 01:38:00.000000000,-26
23,53,https://resizing.flixster.com/nFx1dMieR7c9LLYW0mRxuR94jjY=/206x305/v2/https://flxt.tmsimg.com/assets/p11447903_p_v10_av.jpg,The D Train,2500,134,2015.0,Comedy/Drama,0 days 01:40:00.000000000,30
47,95,https://resizing.flixster.com/Ej4WQBgQ-2eX3ZQmTqBramt47nE=/206x305/v2/https://flxt.tmsimg.com/assets/p11632828_p_v10_ab.jpg,We Are Still Here,2500,44,2015.0,Horror,0 days 01:24:00.000000000,48
66,88,,Deathgasm,1000,32,2015.0,Comedy/Horror,0 days 01:30:00.000000000,22
46,16,https://resizing.flixster.com/5_5w0YTu2Wp-9SzqEDmNZJMdy5w=/206x305/v2/https://flxt.tmsimg.com/assets/p11508862_p_v10_aa.jpg,Last Knights,2500,31,2015.0,Adventure/Action,0 days 01:55:00.000000000,-30
59,93,,Queen of Earth,2500,83,2015.0,Comedy/Drama,0 days 01:29:00.000000000,34
79,96,,Jafar Panahi's Taxi,2500,106,2015.0,,,17
36,84,https://resizing.flixster.com/ZmULElBBM1ijY8RPCqoKc4oJY5I=/206x305/v2/https://flxt.tmsimg.com/assets/p11447164_p_v10_aa.jpg,Results,2500,96,2015.0,Romance,0 days 01:44:00.000000000,48
70,91,,I Am Thor,100,11,2015.0,Biography,0 days 01:24:00.000000000,21
50,89,,The Iron Ministry,100,19,2014.0,Documentary,0 days 01:22:00.000000000,39
30,25,,Skin Trade,500,16,2014.0,Crime/Action,0 days 01:36:00.000000000,-5
75,50,https://resizing.flixster.com/v5jyZMr7-YhZLylpii4hgNANlYA=/206x305/v2/https://flxt.tmsimg.com/assets/p11553797_p_v10_aj.jpg,Where Hope Grows,1000,14,2014.0,Drama,0 days 01:36:00.000000000,-25
85,92,,Sicario,50000,278,2015.0,Crime/Drama,0 days 02:01:00.000000000,7
33,14,,Playing It Cool,1000,28,2014.0,Romance/Comedy,0 days 01:34:00.000000000,-19
78,91,,Raiders!,500,54,2015.0,Documentary,0 days 01:35:00.000000000,13
41,39,,Secret in Their Eyes,10000,149,2015.0,Mystery and thriller,0 days 01:51:00.000000000,-2
38,29,,The Boy,10000,63,2016.0,Horror/Mystery and thriller,0 days 01:37:00.000000000,-9
59,61,,Legend,25000,171,2015.0,Crime/Drama,0 days 02:11:00.000000000,2
72,66,https://resizing.flixster.com/UGzoNl4Oh4YK4Q30gZgohgdZ21A=/206x305/v2/https://flxt.tmsimg.com/assets/p11822719_p_v10_ad.jpg,The Danish Girl,25000,243,2015.0,Drama/History,0 days 02:00:00.000000000,-6
26,86,https://resizing.flixster.com/cEh8YlPs-pOwYcOnpxIqA9TKnfw=/206x305/v2/https://flxt.tmsimg.com/assets/p12146269_p_v10_av.jpg,Close Range,250,7,2015.0,Action,0 days 01:30:00.000000000,60
65,100,https://resizing.flixster.com/jFGpr5f95x9WsHnz4wIHIH4CzO4=/206x305/v2/https://flxt.tmsimg.com/assets/p11815367_p_v8_aa.jpg,The Damned: Don't You Wish That We Were Dead,100,12,2015.0,Biography,0 days 01:50:00.000000000,35
56,87,,A Poem Is a Naked Person,100,39,1974.0,Documentary/Music,0 days 01:30:00.000000000,31
57,75,,Steve Jobs: The Man in the Machine,5000,79,2015.0,Documentary,0 days 02:08:00.000000000,18
20,22,,Zoolander No. 2,25000,234,2016.0,Comedy/Adventure,0 days 01:42:00.000000000,2
38,67,,The Boy,500,21,2015.0,Horror/Drama,0 days 01:45:00.000000000,29
82,82,,Eddie the Eagle,10000,200,2016.0,Comedy/Drama,0 days 01:45:00.000000000,0
43,27,,Captive,2500,52,2015.0,Crime/Drama,0 days 01:37:00.000000000,-16
69,80,https://resizing.flixster.com/YC0dn4bQFHccsqnuFO9XCxlBau0=/206x305/v2/https://flxt.tmsimg.com/assets/p11613066_p_v10_aa.jpg,My Italian Secret: The Forgotten Heroes,100,5,2014.0,Biography,0 days 01:32:00.000000000,11
24,28,,Every Thing Will Be Fine,500,40,2015.0,Drama,0 days 01:58:00.000000000,4
79,74,,Trumbo,10000,207,2015.0,Drama/History,0 days 02:04:00.000000000,-5
52,75,,Theory of Obscurity: A Film About The Residents,50,8,2015.0,Documentary/Music,0 days 01:27:00.000000000,23
30,16,,The Transporter Refueled,10000,103,2015.0,Action/Mystery and thriller,0 days 01:31:00.000000000,-14
32,8,,Survivor,5000,52,2015.0,Action/Mystery and thriller,0 days 01:36:00.000000000,-24
20,0,,Any Day,100,7,2015.0,Drama,0 days 01:38:00.000000000,-20
36,18,,Love the Coopers,10000,122,2015.0,Other/Drama,0 days 01:47:00.000000000,-18
75,91,,The Gift,50000,195,2015.0,Mystery and thriller,0 days 01:48:00.000000000,16
38,60,https://resizing.flixster.com/AVZP2yMQD7nvVvpEPsT0qqRM0RQ=/206x305/v2/https://resizing.flixster.com/5RIZam4-x25rhOzsBtWfh7OPWQM=/ems.ZW1zLXByZC1hc3NldHMvbW92aWVzLzk5NzMxNjVlLWIzM2YtNDQ0Yi1iZDkzLTA5MjQxMGZlMzVkMy53ZWJw,Creative Control,500,55,2015.0,Comedy/Drama,0 days 01:37:00.000000000,22
44,31,,Echoes of War,100,13,2015.0,Western/Drama,0 days 01:40:00.000000000,-13
81,73,,Woodlawn,5000,15,2015.0,Drama/History,0 days 02:03:00.000000000,-8
67,90,,Bessie,250,29,2015.0,Drama/Music,0 days 02:00:00.000000000,23
17,20,,Club Life,100,5,2015.0,Drama,0 days 01:30:00.000000000,3
55,100,,King Georges,100,9,2015.0,Documentary,0 days 01:17:00.000000000,45
15,17,https://resizing.flixster.com/4ZFVimpMKV1bHI690VhcPYEwWzo=/206x305/v2/https://flxt.tmsimg.com/assets/p11602241_p_v10_ak.jpg,Wild Horses,500,12,2015.0,Mystery and thriller,0 days 01:42:00.000000000,2
84,9,,Stonewall,2500,76,2015.0,Gay and lesbian/Drama,0 days 02:09:00.000000000,-75
70,53,,Risen,10000,132,2016.0,Drama/History,0 days 01:48:00.000000000,-17
11,0,,Dawn Patrol,100,6,2014.0,Drama,0 days 01:28:00.000000000,-11
56,9,https://resizing.flixster.com/1xzIiCbDiXtlxABS2onr76Uqh68=/206x305/v2/https://flxt.tmsimg.com/assets/p11739090_p_v10_aa.jpg,Faith of Our Fathers,1000,11,2015.0,Drama,0 days 01:36:00.000000000,-47
72,72,,He Named Me Malala,5000,135,2015.0,Documentary,0 days 01:27:00.000000000,0
33,100,/assets/pizza-pie/images/poster_default.c8c896e70c3.gif,GTFO: Get the F&#% Out,1,5,2015.0,,,67
68,71,,Miss You Already,5000,117,2015.0,Drama/Comedy,0 days 01:52:00.000000000,3
73,76,https://resizing.flixster.com/TJILy81ekEOl4F94T8uTEJrQVIo=/206x305/v2/https://resizing.flixster.com/aoxvS-7xCO-x8BHg5N4I4qdc3mE=/ems.ZW1zLXByZC1hc3NldHMvbW92aWVzLzk4ZjQ2NzA3LTJiZDctNDc0My1hYWQxLTVkZTRlNjI3MDE0Yi53ZWJw,Ip Man 3,10000,51,2015.0,Action/Sports and fitness,0 days 01:45:00.000000000,3
70,80,,Bad Hurt,250,15,2015.0,Drama,0 days 01:41:00.000000000,10
52,73,,Slow Learners,500,11,2015.0,Comedy,0 days 01:36:00.000000000,21
44,78,https://resizing.flixster.com/AokY1q7QIBUyNrDLT7mLIFDRox4=/206x305/v2/https://flxt.tmsimg.com/assets/p11952410_p_v10_aa.jpg,7 Chinese Brothers,500,36,2015.0,Comedy,0 days 01:15:00.000000000,34
91,91,,Winning: The Racing Life of Paul Newman,1000,11,2015.0,Documentary/Biography,0 days 01:23:00.000000000,0
57,63,,Rise of the Legend,250,8,2014.0,Action/Sports and fitness,0 days 02:11:00.000000000,6
50,25,https://resizing.flixster.com/wh_WHYYZ514mcCUt-IS2v8dlwW4=/206x305/v2/https://resizing.flixster.com/fMnpr87yzfjTmj_kae_1qZhjGyQ=/ems.ZW1zLXByZC1hc3NldHMvbW92aWVzL2ZmNzdlYmMwLTUxNTgtNDJhZi05NTliLTYzMTNiYWE5YWE5ZS53ZWJw,Anesthesia,500,44,2015.0,Drama,0 days 01:29:00.000000000,-25
48,52,https://resizing.flixster.com/eIZ-icuknqLyDkMg-LoQ1OdHfhM=/206x305/v2/https://flxt.tmsimg.com/assets/p12039857_p_v10_aa.jpg,Ashby,1000,21,2015.0,Comedy/Drama,0 days 01:42:00.000000000,4
40,10,https://resizing.flixster.com/ugDdZAWFX1eak9WM7iendXeWP18=/206x305/v2/https://flxt.tmsimg.com/assets/p12328632_p_v10_aa.jpg,Dixieland,100,10,2015.0,Crime/Drama,0 days 01:32:00.000000000,-30
23,25,,The Benefactor,1000,55,2015.0,Drama,0 days 01:32:00.000000000,2
42,92,,In My Father's House,100,13,2015.0,Documentary,0 days 01:33:00.000000000,50
53,91,,Killing Them Safely,250,11,2015.0,Documentary/Drama,0 days 01:40:00.000000000,38
37,38,,The Wannabe,100,8,2015.0,Crime/Drama,0 days 01:30:00.000000000,1
28,53,,One More Time,250,30,2015.0,Comedy/Drama,0 days 01:38:00.000000000,25
56,60,,Bikes vs Cars,50,15,2015.0,Documentary,0 days 01:30:00.000000000,4
87,95,,Amy,10000,223,2015.0,Documentary/Music,0 days 02:08:00.000000000,8
21,10,https://resizing.flixster.com/VX28pOoLuJ5zkYWNsWJMamFR7_s=/206x305/v2/https://flxt.tmsimg.com/assets/p11831652_p_v10_ab.jpg,Joe Dirt 2: Beautiful Loser,2500,10,2015.0,Comedy,0 days 01:47:00.000000000,-11
40,88,,Emelie,1000,34,2015.0,Mystery and thriller,0 days 01:26:00.000000000,48
71,88,,Justice League: Gods and Monsters,1000,8,2015.0,Action/Animation,0 days 01:12:00.000000000,17
24,31,,Final Girl,500,13,2015.0,Action/Mystery and thriller,0 days 01:30:00.000000000,7
68,92,,Grease: Live!,250,36,2016.0,,,24
22,14,https://resizing.flixster.com/FSSW6EW17Cc8RODvbTb8QG4VHj0=/206x305/v2/https://flxt.tmsimg.com/assets/p11424499_p_v10_at.jpg,The Gallows,10000,118,2015.0,Horror/Mystery and thriller,0 days 01:21:00.000000000,-8
54,49,https://resizing.flixster.com/lmrE_7QGCYtfimwlOoImeGKI7LA=/206x305/v2/https://flxt.tmsimg.com/assets/p11730158_p_v10_ad.jpg,Freeheld,2500,139,2015.0,Romance/Gay and lesbian,0 days 01:43:00.000000000,-5
76,85,,"Hello, My Name Is Doris",10000,128,2015.0,Comedy/Drama,0 days 01:30:00.000000000,9
81,94,,All Things Must Pass,2500,35,2015.0,Documentary,0 days 01:40:00.000000000,13
46,80,https://resizing.flixster.com/LYtWmRyDYztYcIClMwxryDJKZs4=/206x305/v2/https://resizing.flixster.com/ghlsoqWyVcN96TGb7wxUG7n3L2Q=/ems.ZW1zLXByZC1hc3NldHMvbW92aWVzL2UxMzBkZjMzLTJiNDctNGYwYS1hZGYwLTEwZWEzMmNmMTU0Ny53ZWJw,Gored,50,10,2015.0,Documentary,0 days 01:15:00.000000000,34
84,75,,Unbranded,250,16,2015.0,Documentary,0 days 01:45:00.000000000,-9
70,75,,Once I Was a Beehive,250,8,2015.0,Comedy/Drama,0 days 01:59:00.000000000,5
56,83,,Tale of Tales,5000,105,2015.0,Adventure/Fantasy,0 days 02:05:00.000000000,27
79,96,,Son of Saul,10000,232,2015.0,Drama/History,0 days 01:47:00.000000000,17
62,63,https://resizing.flixster.com/nFlSS4ORFA9KsYNvzAKVlrxHh04=/206x305/v2/https://flxt.tmsimg.com/assets/p12009105_p_v10_ae.jpg,Truth,5000,180,2015.0,Drama,0 days 02:01:00.000000000,1
56,71,,A Perfect Day,1000,58,2015.0,Comedy/Drama,0 days 01:46:00.000000000,15
69,71,,Youth,10000,216,2015.0,Drama,0 days 01:58:00.000000000,2
38,40,/assets/pizza-pie/images/poster_default.c8c896e70c3.gif,Love,2500,93,2015.0,,,2
48,80,https://resizing.flixster.com/7FZke5m6wFAVUIDP81Gh0diQ9xY=/206x305/v2/https://flxt.tmsimg.com/assets/p12052768_p_v10_ab.jpg,The Assassin,5000,126,2015.0,Action/Drama,0 days 01:45:00.000000000,32
77,92,,Marshland,1000,36,2014.0,Mystery and thriller,0 days 01:45:00.000000000,15
53,36,,Big Stone Gap,1000,22,2014.0,Romance,0 days 01:36:00.000000000,-17
94,100,https://resizing.flixster.com/HDSUzPPJFMDRgCgUelYv2lIX5LI=/206x305/v2/https://flxt.tmsimg.com/assets/p12299513_p_v10_aa.jpg,Roger Waters: The Wall,500,6,2014.0,Documentary,0 days 02:12:00.000000000,6
77,71,https://resizing.flixster.com/j2qO7uyfXNe6_COPt58fV3bQ-F4=/206x305/v2/https://flxt.tmsimg.com/assets/p11883267_p_v10_aa.jpg,I Am Chris Farley,1000,31,2015.0,Documentary,0 days 01:35:00.000000000,-6
56,80,https://resizing.flixster.com/PtMOI6umPxWInGWa8x6LjULSyG4=/206x305/v2/https://resizing.flixster.com/OWSHirvKNK8YZnglHD28vmEOSxo=/ems.ZW1zLXByZC1hc3NldHMvbW92aWVzL2NhNWUyZWI2LTZiZDktNDU2NS04ODc5LTczNzJkNGE5OTVlZi53ZWJw,Those People,250,10,2015.0,Romance/Gay and lesbian,0 days 01:28:00.000000000,24
84,83,https://resizing.flixster.com/OyEr8B-3dPReUFPZLh9M9DxZMV8=/206x305/v2/https://flxt.tmsimg.com/assets/p11832319_p_v10_aa.jpg,Dragon Ball Z: Resurrection F,5000,18,2015.0,Kids and family/Fantasy,0 days 01:33:00.000000000,-1
33,18,,Extinction,1000,11,2015.0,Sci fi/Horror,0 days 01:53:00.000000000,-15
62,89,https://resizing.flixster.com/kY2um3waFRtW0Vn_Ws4OpNDTsGk=/206x305/v2/https://flxt.tmsimg.com/assets/p11842649_p_v10_aa.jpg,Stink!,100,9,2015.0,Documentary,0 days 01:31:00.000000000,27
19,7,https://resizing.flixster.com/LJdnvv584yIPbkhqk0YE1yQKsPI=/206x305/v2/https://resizing.flixster.com/yCuW03TSKqIs5xdNw96XrQSsfBo=/ems.ZW1zLXByZC1hc3NldHMvbW92aWVzLzZiOWU3OTc2LTA1NDYtNDI2Ny1iMzY3LTg0MWJmYzkxZjg0OS53ZWJw,Fifty Shades of Black,10000,46,2016.0,Comedy,0 days 01:32:00.000000000,-12
36,33,,Puerto Ricans in Paris,250,24,2015.0,Comedy,0 days 01:22:00.000000000,-3
19,38,https://resizing.flixster.com/GeHs8jI2GxQICdkTcb7N5MLiJEw=/206x305/v2/https://flxt.tmsimg.com/assets/p11958901_p_v10_aa.jpg,Harbinger Down,250,8,2015.0,Sci fi/Horror,0 days 01:22:00.000000000,19
93,97,https://resizing.flixster.com/pvp8RoBL1wNH9qxq2H-njbl3UPI=/206x305/v2/https://flxt.tmsimg.com/assets/p11897076_p_v10_aa.jpg,Spotlight,50000,371,2015.0,Drama,0 days 02:08:00.000000000,4
43,62,,The Program,2500,110,2015.0,Drama/Biography,0 days 01:43:00.000000000,19
25,40,https://resizing.flixster.com/H080GcM7FeXMwO35ukM4qxE_qfQ=/206x305/v2/https://flxt.tmsimg.com/assets/p11819681_p_v8_ac.jpg,6 Ways to Sundown,100,5,2015.0,Action/Mystery and thriller,0 days 01:43:00.000000000,15
40,17,,Walt Before Mickey,500,6,2015.0,Drama/History,0 days 02:00:00.000000000,-23
67,92,https://resizing.flixster.com/bSuiTeqfCAvjUiTbTll-l9vsBJE=/206x305/v2/https://resizing.flixster.com/FQLKS_tDRQlWdLRG6jdHy_wc8FE=/ems.ZW1zLXByZC1hc3NldHMvbW92aWVzLzNhMzM0ZmIwLTc4OWUtNGM2MC1hN2RmLTE1NTE1ZDg0Yzk4NS53ZWJw,The Absent One,250,12,2014.0,Crime/Drama,0 days 01:59:00.000000000,25
42,80,,Mountain Men,250,10,2014.0,Comedy/Adventure,0 days 01:30:00.000000000,38
37,20,https://resizing.flixster.com/gdoECetTDz5SA4Qxpx5Ry_Qzoxk=/206x305/v2/https://resizing.flixster.com/o7S2xc-lCRhHNbZBEcRiCd5zlcM=/ems.ZW1zLXByZC1hc3NldHMvbW92aWVzL2Y0ODJlMTEyLWU3MzgtNGQ4Ni05M2ZmLWE5YjU0YmNkOWMxMi53ZWJw,Bound to Vengeance,250,15,2015.0,Horror/Mystery and thriller,0 days 01:20:00.000000000,-17
72,94,https://resizing.flixster.com/B9VWCBzujvwxYFxSOTnjkuS5T-g=/206x305/v2/https://resizing.flixster.com/CvdL4HSSCgd2mt2-yg3zyvLQ2_o=/ems.ZW1zLXByZC1hc3NldHMvbW92aWVzL2U0NDNjZWU4LWI3NzktNDcyYi1iNTgyLTI2ZDk0NzY2YjhkYi53ZWJw,King Jack,500,35,2015.0,Drama,0 days 01:21:00.000000000,22
35,0,,Safelight,250,17,2015.0,Drama,0 days 01:24:00.000000000,-35
59,86,,Tap World,50,7,2015.0,Documentary/Drama,0 days 01:12:00.000000000,27
28,43,https://resizing.flixster.com/VZKMUeK8GCY8YW9M1b4rY5hx780=/206x305/v2/https://flxt.tmsimg.com/assets/p11803949_p_v10_aa.jpg,10 Cent Pistol,100,7,2014.0,Crime/Drama,0 days 01:31:00.000000000,15
82,51,https://resizing.flixster.com/baTkZJNTM3E3rY_K95z9r7Dros8=/206x305/v2/https://resizing.flixster.com/zRr9bvlIPH2j5QMYRTcv5nbV8S4=/ems.ZW1zLXByZC1hc3NldHMvbW92aWVzLzY2MmNlY2E0LTAzN2EtNDEzNS05NGM4LTBmYjQ5NDAwNWUwOS53ZWJw,13 Hours: The Secret Soldiers of Benghazi,25000,224,2016.0,Drama/Mystery and thriller,0 days 02:24:00.000000000,-31
82,94,https://resizing.flixster.com/Z8iLXuHUfq-TI8RF-fz4Yr5-xs4=/206x305/v2/https://resizing.flixster.com/vwb52PDXMqTEyRTR_UviQEzW49c=/ems.ZW1zLXByZC1hc3NldHMvbW92aWVzLzBhMTQ5NDRjLTE2ODQtNDRjZi1iOTI2LWQzODRiN2I4NTE4MC53ZWJw,The Pearl Button,250,47,2015.0,Documentary,0 days 01:22:00.000000000,12
50,26,https://resizing.flixster.com/LXtynZwZcKfaNAIBZksxjd7dOjk=/206x305/v2/https://flxt.tmsimg.com/assets/p11962002_p_v10_ab.jpg,90 Minutes in Heaven,5000,23,2015.0,Drama,0 days 02:01:00.000000000,-24
63,100,https://resizing.flixster.com/YQ4scnXH-hucXfAYom8HoHEbYDk=/206x305/v2/https://resizing.flixster.com/3ado2pAaZMvC58VisEaK1ZjN8lA=/ems.ZW1zLXByZC1hc3NldHMvbW92aWVzL2E1YTJlZGVkLTEwYjktNGUwYS1hYzY3LWViMWMzY2RhMjM2ZS53ZWJw,SPL 2: A Time for Consequences,500,22,2015.0,Action/Mystery and thriller,0 days 02:00:00.000000000,37
28,26,,Momentum,500,31,2015.0,Action/Mystery and thriller,0 days 01:36:00.000000000,-2
9,18,,Big Sky,100,11,2015.0,Drama/Mystery and thriller,0 days 01:30:00.000000000,9
28,18,,Mothers and Daughters,250,22,2016.0,Drama,0 days 01:30:00.000000000,-10
48,44,,Scouts Guide to the Zombie Apocalypse,5000,97,2015.0,Comedy/Horror,0 days 01:33:00.000000000,-4
14,38,https://resizing.flixster.com/Nen4OODnEtYV27jRwDdtmJmqLvY=/206x305/v2/https://flxt.tmsimg.com/assets/p12040247_p_v10_aa.jpg,Contracted: Phase II,250,13,2015.0,Horror/Mystery and thriller,0 days 01:18:00.000000000,24
34,47,,One & Two,100,17,2015.0,Drama/Mystery and thriller,0 days 01:30:00.000000000,13
25,18,,Narcopolis,100,11,2014.0,Sci fi/Mystery and thriller,0 days 01:36:00.000000000,-7
51,61,,Eisenstein in Guanajuato,250,54,2015.0,Comedy/Gay and lesbian,0 days 01:46:00.000000000,10
35,50,,Wild City,100,8,2015.0,Action/Mystery and thriller,0 days 01:44:00.000000000,15
30,31,https://resizing.flixster.com/gtL3SPD8SUmJSmGAXfyB-Usc1Gs=/206x305/v2/https://flxt.tmsimg.com/assets/p12188907_p_v10_al.jpg,Mojave,250,68,2015.0,Mystery and thriller,0 days 01:33:00.000000000,1
56,71,https://resizing.flixster.com/5A2l-Reyg3dO1UnMJ1K-QciT0LU=/206x305/v2/https://flxt.tmsimg.com/assets/p11980840_p_v10_aa.jpg,Prince,100,21,2015.0,Drama,0 days 01:18:00.000000000,15
41,29,,Heist,1000,28,2015.0,Action/Mystery and thriller,0 days 01:30:00.000000000,-12
55,44,,After Words,100,9,2015.0,Romance/Drama,0 days 01:31:00.000000000,-11
59,20,,The Vatican Tapes,2500,45,2015.0,Horror/Mystery and thriller,0 days 01:29:00.000000000,-39
34,50,,Synchronicity,2500,28,2015.0,Sci fi/Mystery and thriller,0 days 01:41:00.000000000,16
25,80,,Pod,250,10,2015.0,Horror,0 days 01:18:00.000000000,55
93,93,,Room,25000,317,2015.0,Drama,0 days 01:58:00.000000000,0
19,40,https://resizing.flixster.com/s4O92sYkxQgR1YKMSLyy5EpuLfM=/206x305/v2/https://flxt.tmsimg.com/assets/p11997253_p_v10_aa.jpg,The Diabolical,250,10,2015.0,Horror/Mystery and thriller,0 days 01:26:00.000000000,21
35,69,,6 Years,500,13,2015.0,Romance/Drama,0 days 01:25:00.000000000,34
21,8,https://resizing.flixster.com/yXwCaxRFRbdWW0YGaOXsL_6V9gk=/206x305/v2/https://flxt.tmsimg.com/assets/p12154708_p_v10_aa.jpg,Cherry Tree,100,12,2015.0,Horror,0 days 01:25:00.000000000,-13
88,97,,Mustang,5000,152,2015.0,Drama,0 days 01:37:00.000000000,9
54,90,,Mediterranea,250,20,2015.0,Drama,0 days 01:50:00.000000000,36
73,87,,What Our Fathers Did: A Nazi Legacy,250,30,2015.0,Documentary/Drama,0 days 01:33:00.000000000,14
61,63,https://resizing.flixster.com/HCKuDx9Dd3x3gkg4zF0nHTrBGIA=/206x305/v2/https://flxt.tmsimg.com/assets/p12033216_p_v8_aa.jpg,Applesauce,50,8,2015.0,Comedy,0 days 01:31:00.000000000,2
54,75,,Memories of the Sword,250,8,2015.0,Action,0 days 02:01:00.000000000,21
50,58,https://resizing.flixster.com/D6UqPKwBRSeoBDLAEO-PxjdBmJo=/206x305/v2/https://flxt.tmsimg.com/assets/p12102462_p_v10_aa.jpg,Extraordinary Tales,500,19,2013.0,Animation/Horror,0 days 01:10:00.000000000,8
59,57,https://resizing.flixster.com/vmY957okk6l0UOrCWLzRFV9kKgA=/206x305/v2/https://resizing.flixster.com/VmmaVADBPH05epjQrtrzWddcH3A=/ems.ZW1zLXByZC1hc3NldHMvbW92aWVzL2I0NjQzMDUzLWVkYWMtNDU0Ny04ZmZiLTQwNTM5MDY1MjljYi53ZWJw,Hyena Road,1000,23,2015.0,Drama/War,0 days 02:00:00.000000000,-2
79,69,https://resizing.flixster.com/NpeqQAJx1BJWhETE7bsfnpDA1b0=/206x305/v2/https://resizing.flixster.com/NL7iGqR1oV08ejttIAP85CEGJi4=/ems.ZW1zLXByZC1hc3NldHMvbW92aWVzLzM4NGI4ZjQ3LWIxYzUtNDIyYy1iNTE1LTZjZDNjYjlhMjU5MC53ZWJw,Remember,2500,98,2015.0,Drama/Mystery and thriller,0 days 01:35:00.000000000,-10
62,54,https://resizing.flixster.com/agOh3tuFSJtBcfN1SAchTF2_qaA=/206x305/v2/https://flxt.tmsimg.com/assets/p12269176_p_v10_aa.jpg,Jack of the Red Hearts,250,13,2015.0,Drama,0 days 01:40:00.000000000,-8
39,61,https://resizing.flixster.com/KY7CdcOYn05NQe5RYEtxdNPe55A=/206x305/v2/https://flxt.tmsimg.com/assets/p12066319_p_v10_av.jpg,Yakuza Apocalypse,250,41,2015.0,Action/Horror,0 days 01:55:00.000000000,22
71,92,,Anomalisa,10000,275,2015.0,Comedy/Drama,0 days 01:30:00.000000000,21
56,93,,Manson Family Vacation,250,15,2015.0,Comedy/Drama,0 days 01:24:00.000000000,37
66,60,,Ratter,500,5,2015.0,Drama/Mystery and thriller,0 days 01:20:00.000000000,-6
77,78,https://resizing.flixster.com/xMfgLR8umUflr99ObyKjrbyDelg=/206x305/v2/https://resizing.flixster.com/WPhL2XLO9TfQtRjsrlXVu14spNg=/ems.ZW1zLXByZC1hc3NldHMvbW92aWVzL2FjZTlhOGNhLTk5NmUtNDU0MS04OTIyLTAzYWU3NzhkMGU1OS53ZWJw,Where to Invade Next,10000,198,2015.0,Documentary/Comedy,0 days 01:59:00.000000000,1
46,79,https://resizing.flixster.com/RiLT7DHEI4LgjIgLWwRdRhHm42g=/206x305/v2/https://resizing.flixster.com/xGwAqcFr0SV4HuQPDXSpjmURt9I=/ems.ZW1zLXByZC1hc3NldHMvbW92aWVzL2JlMGQ0MzlkLTk3ZWQtNDRhNS1iMzAzLTk4MzgwZDgzYWQwZS53ZWJw,Baskin,1000,43,2015.0,Fantasy/Horror,0 days 01:37:00.000000000,33
63,80,,Hidden,50,5,2015.0,Horror/Mystery and thriller,0 days 01:23:00.000000000,17
49,60,,Lost in Hong Kong,500,5,2015.0,Comedy/Adventure,0 days 01:54:00.000000000,11
43,84,https://resizing.flixster.com/Y8-HoHL377sL7GfOpXxIzpWSKBk=/206x305/v2/https://resizing.flixster.com/rOuyU-GqMkYXM_RoN-32Et9q2Hs=/ems.ZW1zLXByZC1hc3NldHMvbW92aWVzLzc1MzY3YTQ5LWQ0NzAtNGRhNi05YjQwLTkyYmRjOGZkMTAzYy53ZWJw,Road Games,250,19,2015.0,Mystery and thriller,0 days 01:35:00.000000000,41
84,95,https://resizing.flixster.com/_Zq8lz5vUI6TyxJZxPpZtVSRUGo=/206x305/v2/https://flxt.tmsimg.com/assets/p12154921_p_v10_aa.jpg,Palio,250,20,2015.0,Documentary/Drama,0 days 01:31:00.000000000,11
34,83,,Hangman,100,6,2015.0,Mystery and thriller,0 days 01:25:00.000000000,49
31,50,https://resizing.flixster.com/FzbcEstyfuLBsWuu4qejXxWKoLg=/206x305/v2/https://flxt.tmsimg.com/assets/p12117200_p_v10_aa.jpg,Endgame,50,8,2015.0,Drama,0 days 01:30:00.000000000,19
87,42,,Forsaken,2500,45,2015.0,Western/Drama,0 days 01:30:00.000000000,-45
56,44,https://resizing.flixster.com/KQw_3gdoKacr8tY2_6wDBxrrwEU=/206x305/v2/https://resizing.flixster.com/ZnqWVHIf0X5y37SGYTCaT5A-NHE=/ems.ZW1zLXByZC1hc3NldHMvbW92aWVzL2JmZTdhYjM1LTRhZDEtNDQ4MC05M2Y4LTAxYzU2NjA0NTBkYy53ZWJw,Mr. Right,5000,54,2015.0,Romance/Action,0 days 01:33:00.000000000,-12
61,29,,Colonia,2500,49,2015.0,Romance/Drama,0 days 01:50:00.000000000,-32
51,81,https://resizing.flixster.com/njr_94fAFrRtQqDIvdicnHrPif0=/206x305/v2/https://flxt.tmsimg.com/assets/p12137228_p_v10_ad.jpg,Southbound,2500,52,2015.0,Horror/Mystery and thriller,0 days 01:29:00.000000000,30
66,83,,The Wave,5000,109,2015.0,Adventure/Mystery and thriller,0 days 01:45:00.000000000,17
48,50,https://resizing.flixster.com/jfVqqprYTdw3wEq-vsEZD2HCDoU=/206x305/v2/https://flxt.tmsimg.com/assets/p12680608_p_v10_ab.jpg,Sky,250,6,2015.0,Drama,0 days 01:43:00.000000000,2
88,88,https://resizing.flixster.com/WKVWuWQzyPGTjnSampb4Vjvsc8s=/206x305/v2/https://resizing.flixster.com/Nbcx3bwXuiQF81CO_9P_b8_D79I=/ems.ZW1zLXByZC1hc3NldHMvbW92aWVzL2E4N2I3Njk0LTAxNDMtNGFiOS1hZTNiLWViOTk4Zjc0Nzg1Yy53ZWJw,The Boy and the Beast,2500,69,2015.0,Animation/Action,0 days 01:59:00.000000000,0
85,96,,Embrace of the Serpent,5000,148,2015.0,Drama/Adventure,0 days 02:03:00.000000000,11
76,94,,Janis: Little Girl Blue,5000,79,2015.0,Documentary,0 days 01:43:00.000000000,18
37,67,,Howl,500,15,2015.0,Horror,0 days 01:29:00.000000000,30
14,0,,Wrecker,100,7,2015.0,Action/Mystery and thriller,0 days 01:23:00.000000000,-14
38,88,https://resizing.flixster.com/5R4xxxVdelXrzNF2D1kh9_gjTys=/206x305/v2/https://resizing.flixster.com/4IFBTEp5MfwrmthZFwn1__5wTKg=/ems.ZW1zLXByZC1hc3NldHMvbW92aWVzL2U1N2U0ZTY5LWJkY2YtNDJjMS1iNTc3LWIyMTRiM2VmY2MyZi53ZWJw,Havana Motor Club,100,8,2015.0,Documentary/Drama,0 days 01:24:00.000000000,50
72,17,,"Sex, Death and Bowling",100,6,2015.0,Comedy/Drama,0 days 01:32:00.000000000,-55
48,17,https://resizing.flixster.com/v0NVx9_MC7wi3FF2_-BCguWrKl4=/206x305/v2/https://resizing.flixster.com/pZeeAjrZHEBi8XKpUURjRfaHcI4=/ems.ZW1zLXByZC1hc3NldHMvbW92aWVzL2MyM2IzYWM3LTUzODItNDY4Yy1iYjMzLTU4MmRlYzJlZDAzNy53ZWJw,A Country Called Home,100,12,2015.0,Drama,0 days 01:30:00.000000000,-31
12,0,https://resizing.flixster.com/ruxs0xoIYktxRWd4EjlK2kcTJxo=/206x305/v2/https://flxt.tmsimg.com/assets/p12462566_p_v8_ab.jpg,Cabin Fever,500,28,2016.0,Horror,0 days 01:39:00.000000000,-12
45,75,,Dreams Rewired,100,16,2015.0,Documentary,0 days 01:28:00.000000000,30
61,83,https://resizing.flixster.com/pgNgFzaDa_sntK2GR6s-4Svry9M=/206x305/v2/https://flxt.tmsimg.com/assets/p12235380_p_v10_ab.jpg,The Messenger,100,12,2015.0,Documentary,0 days 01:30:00.000000000,22
29,37,https://resizing.flixster.com/dUNMGNUflW3DXGmSJXPY7DVBqKA=/206x305/v2/https://flxt.tmsimg.com/assets/p12177593_p_v13_ao.jpg,The Other Side of the Door,2500,38,2016.0,Horror/Mystery and thriller,0 days 01:36:00.000000000,8
44,71,,Darling,250,28,2015.0,Horror/Mystery and thriller,0 days 01:18:00.000000000,27
47,56,,This Changes Everything,100,18,2015.0,Documentary,0 days 01:29:00.000000000,9
12,71,,The Inhabitants,50,7,2015.0,Horror/Mystery and thriller,0 days 01:30:00.000000000,59
73,98,,Finders Keepers,1000,47,2015.0,Documentary,0 days 01:24:00.000000000,25
45,42,,The Girl King,100,19,2015.0,Gay and lesbian/Drama,0 days 01:46:00.000000000,-3
53,100,https://resizing.flixster.com/g5moW0ng4Alt51wfqCey62zskqM=/206x305/v2/https://flxt.tmsimg.com/assets/p12207852_p_v10_aa.jpg,Crush the Skull,100,6,2015.0,Comedy/Horror,0 days 01:20:00.000000000,47
48,75,,Rabid Dogs,100,8,2015.0,Action,0 days 01:40:00.000000000,27
61,70,,Tumbledown,1000,37,2015.0,Romance,0 days 01:43:00.000000000,9
47,14,,Ronaldo,500,7,2015.0,Documentary/Biography,0 days 01:32:00.000000000,-33
42,48,,Criminal Activities,500,21,2015.0,Mystery and thriller/Drama,0 days 01:34:00.000000000,6
89,67,https://resizing.flixster.com/HSrXJtL0vlAaDt9Abke2LuuilzA=/206x305/v2/https://flxt.tmsimg.com/assets/p12207766_p_v10_ab.jpg,Touched With Fire,2500,52,2015.0,Romance/Drama,0 days 01:46:00.000000000,-22
10,46,,#Horror,500,13,2015.0,Horror/Mystery and thriller,0 days 01:30:00.000000000,36
37,20,,Lost in the Sun,250,10,2015.0,Crime/Drama,0 days 01:35:00.000000000,-17
18,55,,The Pack,100,11,2015.0,Horror/Mystery and thriller,0 days 01:30:00.000000000,37
37,73,https://resizing.flixster.com/jCe-RATUQwmWl4epy5guMGAMSN8=/206x305/v2/https://flxt.tmsimg.com/assets/p12282499_p_v10_ab.jpg,The Funhouse Massacre,250,15,2015.0,Other/Horror,0 days 01:30:00.000000000,36
17,6,,Extraction,1000,18,2015.0,Action/Mystery and thriller,0 days 01:23:00.000000000,-11
35,100,,Estranged,100,6,2015.0,Horror/Mystery and thriller,0 days 01:41:00.000000000,65
21,25,https://resizing.flixster.com/u0m6oEvoEScipz0s3GqTdF409cc=/206x305/v2/https://flxt.tmsimg.com/assets/p12299375_p_v10_aa.jpg,Submerged,100,8,2015.0,Drama/Mystery and thriller,0 days 01:39:00.000000000,4
42,39,,We Are Your Friends,5000,135,2015.0,Romance/Drama,0 days 01:36:00.000000000,-3
71,60,https://resizing.flixster.com/U1DO2XIO80GPvnba277WOtVz5jE=/206x305/v2/https://flxt.tmsimg.com/assets/p12259032_p_v10_aa.jpg,CodeGirl,100,5,2015.0,Documentary,0 days 01:47:00.000000000,-11
79,90,https://resizing.flixster.com/dx4HXzBeP10BkQFBcb2Bb1-Atf4=/206x305/v2/https://flxt.tmsimg.com/assets/p12388374_p_v10_ae.jpg,A War,1000,94,2015.0,Drama/War,0 days 01:55:00.000000000,11
25,62,,Anguish,250,13,2015.0,Horror/Mystery and thriller,0 days 01:31:00.000000000,37
63,67,,All Mistakes Buried,100,9,2015.0,Mystery and thriller,0 days 01:24:00.000000000,4
27,19,https://resizing.flixster.com/aza_jMeHylWB10YTot4FKWnVJJA=/206x305/v2/https://flxt.tmsimg.com/assets/p12399276_p_v10_ab.jpg,Diablo,500,21,2015.0,Western/Action,0 days 01:23:00.000000000,-8
56,56,,The Ghouls,500,9,2015.0,Horror/Action,0 days 02:07:00.000000000,0
40,69,,Ava's Possessions,250,16,2015.0,Comedy/Horror,0 days 01:29:00.000000000,29
0,22,https://resizing.flixster.com/B9xp28aGMrZOSNMFbJmr4G93mN0=/206x305/v2/https://flxt.tmsimg.com/assets/p12324456_p_v10_al.jpg,400 Days,1000,9,2015.0,Sci fi/Mystery and thriller,0 days 01:31:00.000000000,22
33,15,,The Curse of Sleeping Beauty,250,13,2016.0,Adventure/Fantasy,0 days 01:27:00.000000000,-18
54,82,,Lamb,500,34,2015.0,Drama,0 days 01:37:00.000000000,28
22,30,https://resizing.flixster.com/Rpm2dBJJGqerzBGcj6PLVqPtYhg=/206x305/v2/https://resizing.flixster.com/f9WNpUl-9OJwH0TuaMFPsVFnCZo=/ems.ZW1zLXByZC1hc3NldHMvbW92aWVzLzUyN2Y1ZThjLWFmODItNDVjYi1hNDc4LWM3MzVmOWQ2MTVlOC53ZWJw,Backtrack,50,40,2015.0,Mystery and thriller,0 days 01:30:00.000000000,8
42,42,https://resizing.flixster.com/uADpXlIf4HsNg0vstS8VvHFjX2s=/206x305/v2/https://resizing.flixster.com/FRPvwjyt-Qc31iG8jmbS4vGLZEA=/ems.ZW1zLXByZC1hc3NldHMvbW92aWVzL2ZjMDgyZjNiLWYwZGMtNDgxNy05ZTdiLWM5MDNhZmQ4OGIxOS53ZWJw,Moonwalkers,500,38,2015.0,Action/Comedy,0 days 01:47:00.000000000,0
55,93,https://resizing.flixster.com/Z2RqTzFZLxYt6WYHDiWJUmAOFV0=/206x305/v2/https://flxt.tmsimg.com/assets/p12243363_p_v10_ak.jpg,The Girl in the Book,500,14,2015.0,Drama,0 days 01:28:00.000000000,38
39,81,,Elstree 1976,250,27,2015.0,Documentary,0 days 01:30:00.000000000,42
16,0,https://resizing.flixster.com/C6tvNTfUGH2DquFvQXAhniyNwz0=/206x305/v2/https://resizing.flixster.com/a1bDdNpo8MkEpG36b9eO995-ADQ=/ems.ZW1zLXByZC1hc3NldHMvbW92aWVzL2Q3ZmE2MGJkLTBmZjUtNGIzOS1iOTY1LTY0ZDhkODQ5YzNhYy53ZWJw,All Roads Lead to Rome,250,7,2015.0,Romance/Comedy,0 days 01:27:00.000000000,-16
16,8,,Exposed,1000,25,2016.0,Mystery and thriller,0 days 01:42:00.000000000,-8
64,100,,Batman: Bad Blood,1000,5,2016.0,Action/Animation,0 days 01:12:00.000000000,36
68,78,,Busco novio para mi mujer,1000,9,2016.0,Romance,0 days 01:32:00.000000000,10
68,46,https://resizing.flixster.com/iX8zNzEgFvpBCO-fgjT7RjfEWaE=/206x305/v2/https://resizing.flixster.com/UMEjK6bbt4fByDqrBOvjbok1cCY=/ems.ZW1zLXByZC1hc3NldHMvbW92aWVzLzc3N2U2YzY1LTU3YWEtNDYwNC1iOGQwLWI5MzA3ZDc5NzgxZC53ZWJw,The Abandoned,500,13,2015.0,Horror/Mystery and thriller,0 days 01:28:00.000000000,-22
31,48,,Shut In,500,23,2015.0,Horror/Mystery and thriller,0 days 01:30:00.000000000,17
43,89,,Sweaty Betty,50,9,2015.0,Drama,0 days 01:34:00.000000000,46
44,56,https://resizing.flixster.com/xzdORRI9It5ePxZA9lYOTYAaPK4=/206x305/v2/https://resizing.flixster.com/gncYC5k8r-a8JN0W5hunnZyFx5c=/ems.ZW1zLXByZC1hc3NldHMvbW92aWVzL2RjOWM4ZDhhLWRiZTMtNDU1ZC05MmY2LTg0ODhiYmRmNTQ2Yi53ZWJw,Standoff,500,16,2016.0,Mystery and thriller,0 days 01:25:00.000000000,12
22,7,https://resizing.flixster.com/XrnAFlSr8uTlnP5R_2NaJbYn610=/206x305/v2/https://resizing.flixster.com/K2Lv7jzplAJNJ8hLMt-ZsStNTlM=/ems.ZW1zLXByZC1hc3NldHMvbW92aWVzL2QxNGFiMjQwLWNhNDQtNGRmNS1iZmQ5LWVjODA3Mjc5OGZlNi53ZWJw,Misconduct,1000,28,2016.0,Drama/Mystery and thriller,0 days 01:46:00.000000000,-15
32,20,,Marguerite & Julien,50,10,2015.0,Romance/Drama,0 days 01:48:00.000000000,-12
50,11,https://resizing.flixster.com/7FTyT5q_qgJku2PUvkfXXMpfl_k=/206x305/v2/https://resizing.flixster.com/7nWU8y0QwEtzXPiCR5MEQJWlgz4=/ems.ZW1zLXByZC1hc3NldHMvbW92aWVzLzQyZjg2NjA2LTRkOGUtNDBjOC1iYjU1LTgyZWFjNmVkNGFjZC53ZWJw,The Preppie Connection,250,9,2015.0,Drama,0 days 01:35:00.000000000,-39
42,100,,Under the Gun,250,10,2016.0,Documentary,0 days 01:50:00.000000000,58
83,77,,The Fundamentals of Caring,5000,35,2016.0,Drama/Mystery and thriller,0 days 01:33:00.000000000,-6
29,17,https://resizing.flixster.com/VH95s4nY98Wb5KBubz6cq51ZvJo=/206x305/v2/https://resizing.flixster.com/tj5OexxTO1bC-Oc1PicBkeD2ypk=/ems.ZW1zLXByZC1hc3NldHMvbW92aWVzLzczZGNhODk3LWUwMTMtNDcyZi1iNzYwLWM3MmI0ZDlkM2FiMi53ZWJw,Special Correspondents,500,36,2016.0,Comedy,0 days 01:41:00.000000000,-12
79,90,,10 Cloverfield Lane,50000,312,2016.0,Mystery and thriller,0 days 01:43:00.000000000,11
36,27,https://resizing.flixster.com/56A7GVVpqVO-hKIsUmrmTDL-rIM=/206x305/v2/https://flxt.tmsimg.com/assets/p12532237_p_v10_aa.jpg,Crazy About Tiffany's,50,15,2016.0,Documentary,0 days 01:27:00.000000000,-9
61,80,https://resizing.flixster.com/BVs0L4Z6MqeqPaoXEBU7QpLfP4Q=/206x305/v2/https://flxt.tmsimg.com/assets/p11871364_p_v10_aa.jpg,We Are Twisted F...ing Sister!,250,10,2014.0,Documentary/Music,0 days 02:15:00.000000000,19
25,29,,Kindergarten Cop 2,250,7,2016.0,Comedy,0 days 01:40:00.000000000,4
57,91,,The Confirmation,500,32,2016.0,Comedy/Drama,0 days 01:41:00.000000000,34
32,43,https://resizing.flixster.com/JL_s2p1lNY7wTe0EOloj_2xtp0k=/206x305/v2/https://resizing.flixster.com/GrgyzspNWbQN0kfNDQe_A8RSCMI=/ems.ZW1zLXByZC1hc3NldHMvbW92aWVzLzNjM2VlYTYwLTU3ZDAtNGMwMS1hMWUwLTg3ZDA1ZjJiNzMzNy53ZWJw,Bleed,100,7,2016.0,Horror/Mystery and thriller,0 days 01:22:00.000000000,11
21,5,,Get a Job,5000,22,2016.0,Comedy,0 days 01:23:00.000000000,-16
35,47,,They're Watching,250,17,2016.0,Horror/Mystery and thriller,0 days 01:35:00.000000000,12
52,35,https://resizing.flixster.com/httT_GEzn4SlEhhVxZCuiIEMaOs=/206x305/v2/https://resizing.flixster.com/xiTAtUqwFenEss8NDLoR2aCEagA=/ems.ZW1zLXByZC1hc3NldHMvbW92aWVzL2UzMTE4ZGNhLWU3N2ItNDY4OS04YTkwLTQ4Y2YyYTc3NjA5OS53ZWJw,Manhattan Night,500,23,2016.0,Crime/Drama,0 days 01:53:00.000000000,-17
77,58,,The Brainwashing of My Dad,250,12,2015.0,Documentary,0 days 01:35:00.000000000,-19
41,60,,About Scout,100,5,2015.0,Drama,0 days 01:49:00.000000000,19
55,67,,Pocha: Manifest Destiny,100,6,2015.0,Crime/Drama,0 days 01:24:00.000000000,12
48,100,,Memoria,250,5,2016.0,Drama,0 days 01:10:00.000000000,52
24,0,https://resizing.flixster.com/ApWfhf_tyk-rMlt-F8mQ144GGOI=/206x305/v2/https://resizing.flixster.com/dl6vvhQDf-Q__iygO6cJWAKW9NI=/ems.ZW1zLXByZC1hc3NldHMvbW92aWVzLzkzMTg4ZGE3LThlZTYtNGYyNS1iMmE0LWY0YjhmM2IzMTA2NC53ZWJw,Urge,250,6,2015.0,Mystery and thriller,0 days 01:29:00.000000000,-24
73,93,https://resizing.flixster.com/QVlJDvUzHCwlRbtwbyZr4X4Z1WE=/206x305/v2/https://resizing.flixster.com/QjDEycgsDpm45TrJbI5_gpfdGos=/ems.ZW1zLXByZC1hc3NldHMvbW92aWVzLzVhMzg5N2ExLTM5YjItNGUxYS05OWExLWFmNTc3OTI1NzgzYS53ZWJw,Hush,5000,41,2016.0,Horror/Mystery and thriller,0 days 01:27:00.000000000,20
66,80,,Justice League vs. Teen Titans,1000,5,2016.0,Action/Fantasy,0 days 01:18:00.000000000,14
28,20,,Go With Me,500,5,2015.0,Mystery and thriller,0 days 01:30:00.000000000,-8
60,33,,Hard Sell,100,9,2016.0,Comedy/Drama,0 days 01:36:00.000000000,-27
42,9,,The Do Over,1000,23,2016.0,Comedy/Action,0 days 01:48:00.000000000,-33
66,100,https://resizing.flixster.com/UEioyMgxNlssNs4FzYl3SUinpQ0=/206x305/v2/https://resizing.flixster.com/hplSSXxFCfs9rde702FM9lJhyL0=/ems.ZW1zLXByZC1hc3NldHMvbW92aWVzLzI1MDk1MTY0LWE0M2ItNDBmNC1hYTIzLTI1ZDkxYWM5MjI3MC53ZWJw,A Conspiracy of Faith,250,6,2016.0,Crime/Drama,0 days 01:59:00.000000000,34
43,89,https://resizing.flixster.com/c6p5GlqF6E8QYeE2elPoSsobF-4=/206x305/v2/https://resizing.flixster.com/KY5wA6Bs6WLZ2lIptelpFe_MzYs=/ems.ZW1zLXByZC1hc3NldHMvbW92aWVzLzY5ZTFhMTkzLTNmYmItNGZkZi1hNTdjLWYxNWRkMTQ5NDgyOS53ZWJw,The Last King,250,9,2016.0,Action/Drama,0 days 01:39:00.000000000,46
38,79,https://resizing.flixster.com/Kqr8Ce_M6sqKQjUspmdnX5o_Jn0=/206x305/v2/https://resizing.flixster.com/5-j-V_3Xr8CWYen8U3ZqTr3DqFU=/ems.ZW1zLXByZC1hc3NldHMvbW92aWVzLzk2ZDI1Y2YzLTkwOWMtNDFkMi04OThkLTQ1MmQ2ZmFjNTJjNC53ZWJw,The Phenom,500,47,2016.0,Drama,0 days 01:30:00.000000000,41
77,100,,Ali Wong: Baby Cobra,1,9,2016.0,,,23
25,23,,Intruder,100,13,2016.0,Horror/Mystery and thriller,0 days 01:35:00.000000000,-2
93,100,,Lemonade,100,6,2015.0,Comedy/Drama,0 days 01:50:00.000000000,7
96,100,,John Mulaney: The Comeback Kid,1,8,2015.0,Comedy/Stand up,0 days 01:02:00.000000000,4
58,100,https://resizing.flixster.com/LEi3N_YGlITT3bnpfhIKpDgIPuM=/206x305/v2/https://resizing.flixster.com/ezswAFTC7NOvkjUTjJYUQhM0eKU=/ems.ZW1zLXByZC1hc3NldHMvbW92aWVzLzA3ZmExMjZmLTYzNDUtNGEwMy05OTEwLTMxOGI3Njc4ODRmMC53ZWJw,Hannibal Buress: Comedy Camisado,1,7,2016.0,,,42
100,100,https://resizing.flixster.com/UeTMUTrB7NnDU5DFsQyfMJq9U9A=/206x305/v2/https://resizing.flixster.com/L1HkZMx3t_V1MvzVt9VUoyBC1mw=/ems.ZW1zLXByZC1hc3NldHMvbW92aWVzL2RiOTYyYTdhLTI1YjYtNDVkNy1hNDQ2LTM5NDhhYmQwNWY2NC53ZWJw,Anthony Jeselnik: Thoughts and Prayers,1,5,2015.0,Comedy/Stand up,0 days 01:00:00.000000000,0
88,100,,Make Happy,100,6,2016.0,,,12
83,98,,A Summer's Tale,5000,47,1996.0,Romance,0 days 01:53:00.000000000,15
59,81,https://resizing.flixster.com/YQBZfdM07yjM5_831Mxb0zryGro=/206x305/v2/https://flxt.tmsimg.com/assets/p4387_p_v10_aa.jpg,The Missouri Breaks,2500,27,1976.0,Western/Drama,0 days 02:05:00.000000000,22
61,86,,White Lightning,1000,7,1973.0,Action,0 days 01:41:00.000000000,25
43,0,https://resizing.flixster.com/4StMa9ZB085zBvlMMuHsKedkVWc=/206x305/v2/https://flxt.tmsimg.com/assets/p819_p_v8_aa.jpg,Gator,1000,6,1976.0,Action,0 days 01:55:00.000000000,-43
88,93,,The Long Goodbye,10000,46,1973.0,Crime/Drama,0 days 01:52:00.000000000,5
53,37,,Firestarter,50000,27,1984.0,Horror,0 days 01:53:00.000000000,-16
49,57,https://resizing.flixster.com/nrDWlXB36-K7pWlj66oB-RsFNpM=/206x305/v2/https://flxt.tmsimg.com/assets/p4422_p_v8_aa.jpg,Neighbors,5000,7,1981.0,Comedy,0 days 01:34:00.000000000,8
65,60,,Demons,10000,10,1985.0,Horror,0 days 01:30:00.000000000,-5
87,94,,Elmer Gantry,2500,31,1960.0,Drama,0 days 02:25:00.000000000,7
67,90,,Topkapi,1000,21,1964.0,Comedy/Mystery and thriller,0 days 02:00:00.000000000,23
41,50,,Billion Dollar Brain,2500,6,1967.0,Drama,0 days 01:51:00.000000000,9
79,100,,"Run Silent, Run Deep",5000,9,1958.0,War,0 days 01:33:00.000000000,21
52,42,,Teen Wolf,50000,33,1985.0,Fantasy/Comedy,0 days 01:28:00.000000000,-10
52,89,https://resizing.flixster.com/nfNqv6NmElr0-NW8CY2OlcuSPYE=/206x305/v2/https://flxt.tmsimg.com/assets/p2523_p_v8_aa.jpg,Bedlam,1000,19,1946.0,Horror,0 days 01:19:00.000000000,37
48,50,,Nekromantik,2500,6,1987.0,Horror,0 days 01:15:00.000000000,2
81,80,,"Come Back to the 5 & Dime Jimmy Dean, Jimmy Dean",2500,5,1982.0,Comedy/Drama,0 days 01:50:00.000000000,-1
85,96,,Los Angeles Plays Itself,1000,45,2003.0,Documentary,0 days 02:49:00.000000000,11
70,67,,The Masque of the Red Death,5000,15,1990.0,Horror,0 days 01:34:00.000000000,-3
49,67,https://resizing.flixster.com/AoSm7VOfgYQQlsCCbQOhZ-1IMUs=/206x305/v2/https://flxt.tmsimg.com/assets/p45275_p_v8_aa.jpg,Buffalo Bill and the Indians,1000,15,1976.0,Western,0 days 02:03:00.000000000,18
65,100,,Every Man for Himself,500,5,1980.0,Drama,0 days 01:29:00.000000000,35
89,100,/assets/pizza-pie/images/poster_default.c8c896e70c3.gif,Love Streams,1000,17,1984.0,Drama,0 days 02:16:00.000000000,11
86,100,,Odd Man Out,1000,30,1947.0,Mystery and thriller,0 days 01:55:00.000000000,14
83,100,,Jour de Fete,2500,22,1948.0,Comedy,0 days 01:20:00.000000000,17
72,78,,Too Late Blues,250,9,1962.0,Drama,0 days 01:40:00.000000000,6
54,71,,True Confessions,2500,14,1981.0,Crime/Drama,0 days 01:50:00.000000000,17
85,89,,The Soft Skin,1000,27,1964.0,Romance,0 days 01:50:00.000000000,4
41,14,,Bloody Mama,1000,7,1970.0,Crime/Drama,0 days 01:30:00.000000000,-27
86,44,/assets/pizza-pie/images/poster_default.c8c896e70c3.gif,Sundays and Cybele,250,9,1962.0,Romance,0 days 01:50:00.000000000,-42
32,29,,Last Embrace,500,7,1979.0,Mystery and thriller,0 days 01:43:00.000000000,-3
44,43,https://resizing.flixster.com/W7DMVt-p8FM6RcRC3lgCiKwT0Ho=/206x305/v2/https://flxt.tmsimg.com/assets/p9970082_p_v10_aa.jpg,Frank Miller's Sin City: A Dame to Kill For,100000,190,2014.0,Crime/Action,0 days 01:41:00.000000000,-1
67,67,,Paris Blues,500,12,1961.0,Romance,0 days 01:38:00.000000000,0
85,100,https://resizing.flixster.com/1NwAjhZel1JMF61PKH7SenpNB2c=/206x305/v2/https://flxt.tmsimg.com/assets/p37011_p_v10_aa.jpg,Ride the Pink Horse,250,8,1947.0,Crime/Drama,0 days 01:41:00.000000000,15
79,100,,Days of Wrath,250,7,2008.0,Drama,0 days 01:34:00.000000000,21
73,100,,Boy Meets Girl,500,11,1984.0,Drama,0 days 01:40:00.000000000,27
77,95,,My Winnipeg,2500,92,2007.0,Documentary/Drama,0 days 01:20:00.000000000,18
85,100,,The Confession,250,6,1970.0,Mystery and thriller,0 days 02:20:00.000000000,15
81,95,/assets/pizza-pie/images/poster_default.c8c896e70c3.gif,A Winter's Tale,500,20,1992.0,Romance,0 days 01:53:00.000000000,14
70,100,,Sidewalk Stories,100,7,1989.0,Comedy,0 days 01:37:00.000000000,30
76,89,https://resizing.flixster.com/_GOCwvj52UN_DP7AlG35LQIdl8o=/206x305/v2/https://flxt.tmsimg.com/assets/p6957_p_v10_ab.jpg,The Incredible Journey,500,9,1963.0,Kids and family/Adventure,0 days 01:20:00.000000000,13
78,83,,Ivory Tower,1000,52,2014.0,Documentary/Drama,0 days 01:30:00.000000000,5
48,50,,The Young Savages,100,8,1961.0,Drama/Mystery and thriller,0 days 01:50:00.000000000,2
46,10,,Dangerously Close,100,10,1986.0,Mystery and thriller,0 days 01:34:00.000000000,-36
68,72,,Big Eyes,25000,194,2014.0,Drama/Biography,0 days 01:46:00.000000000,4
15,9,,Accidental Love,2500,35,2015.0,Comedy,0 days 01:40:00.000000000,-6
74,100,,Modern Life,250,19,2008.0,Documentary,0 days 01:28:00.000000000,26
54,79,,Killing Kasztner: The Jew Who Dealt With Nazis,50,19,2008.0,Documentary,0 days 02:09:00.000000000,25
73,100,https://resizing.flixster.com/rxsSiNXDWlgePqh_dAxBhLION18=/206x305/v2/https://flxt.tmsimg.com/assets/p18068_p_v8_ab.jpg,We Won't Grow Old Together,100,9,1972.0,Drama,0 days 01:43:00.000000000,27
52,94,,Level Five,100,18,1997.0,Romance/Documentary,0 days 01:46:00.000000000,42
33,19,,Reunion,1000,16,2009.0,Drama,0 days 01:35:00.000000000,-14
48,29,,The Hero of Color City,250,21,2014.0,Animation/Kids and family,0 days 01:17:00.000000000,-19
71,86,https://resizing.flixster.com/WfXD_PGix3D7rnlF3r7HLAM1ztE=/206x305/v2/https://flxt.tmsimg.com/assets/p34053_p_v8_aa.jpg,Favourites of the Moon,50,7,1984.0,Crime/Comedy,0 days 01:41:00.000000000,15
44,86,https://resizing.flixster.com/Kk1Pad-UGBiC6YNPX4jRvh_dymA=/206x305/v2/https://flxt.tmsimg.com/assets/p8095250_p_v13_ab.jpg,Bananas!,100,7,2009.0,Crime/Documentary,0 days 01:27:00.000000000,42
67,80,,Uncle Harry,50,5,1945.0,Mystery and thriller,0 days 01:20:00.000000000,13
82,85,,Breathless,500,26,2009.0,Crime/Drama,0 days 02:10:00.000000000,3
59,21,https://resizing.flixster.com/anDN0rVW6MZIcPzN9XVGjBoN6P8=/206x305/v2/https://flxt.tmsimg.com/assets/p8379769_p_v10_aa.jpg,Frankie & Alice,10000,33,2010.0,Drama,0 days 01:40:00.000000000,-38
74,87,/assets/pizza-pie/images/poster_default.c8c896e70c3.gif,La Danse -- Le Ballet de l'Opera de Paris,500,55,2009.0,,,13
52,69,,14 Blades,1000,13,2010.0,Action/Drama,0 days 01:56:00.000000000,17
73,60,,Floored,100,5,2009.0,Documentary,0 days 01:18:00.000000000,-13
22,57,https://resizing.flixster.com/6w262fMUR4BcgbikPpVVqehNUAQ=/206x305/v2/https://flxt.tmsimg.com/assets/p10705761_p_v10_ac.jpg,War Story,100,21,2014.0,Drama,0 days 01:30:00.000000000,35
58,61,,"Alexander and the Terrible, Horrible, No Good, Very Bad Day",25000,119,2014.0,Comedy/Kids and family,0 days 01:21:00.000000000,3
61,35,https://resizing.flixster.com/X92iXU9YkXh6be7nNLKWr9b_Lh8=/206x305/v2/https://flxt.tmsimg.com/assets/p10471438_p_v8_ac.jpg,If I Stay,25000,141,2014.0,Romance/Drama,0 days 01:46:00.000000000,-26
40,75,/assets/pizza-pie/images/poster_default.c8c896e70c3.gif,Red Hollywood,1,8,2014.0,,,35
69,48,https://resizing.flixster.com/zrF_9ompkYLfrb71T8bwPj_ono8=/206x305/v2/https://flxt.tmsimg.com/assets/p8045212_p_v8_aa.jpg,The Cartel,100,29,2009.0,Documentary,0 days 01:30:00.000000000,-21
75,95,https://resizing.flixster.com/U44vsK1i_6_BNcuHGWHNt78coTU=/206x305/v2/https://flxt.tmsimg.com/assets/p8353255_p_v10_aa.jpg,Boxing Gym,1000,42,2010.0,Documentary,0 days 01:31:00.000000000,20
90,92,https://resizing.flixster.com/a3No4mQR-CmJcdWNmaCDMPAI2jw=/206x305/v2/https://flxt.tmsimg.com/NowShowing/130620/130620_ab.jpg,How to Train Your Dragon 2,100000,189,2014.0,Comedy/Kids and family,0 days 01:42:00.000000000,2
49,67,,Gone With the Pope,100,6,2010.0,Crime/Drama,0 days 01:23:00.000000000,18
73,81,,Mr. Peabody & Sherman,50000,139,2014.0,Sci fi/Animation,0 days 01:31:00.000000000,8
74,59,https://resizing.flixster.com/KAS1osy4ZHNsmytnMfhjYtf_QM4=/206x305/v2/https://flxt.tmsimg.com/assets/p10569555_p_v10_ag.jpg,The Hobbit: The Battle of the Five Armies,100000,265,2014.0,Action/Fantasy,0 days 02:24:00.000000000,-15
50,21,,Teenage Mutant Ninja Turtles,100000,163,2014.0,Action/Adventure,0 days 01:41:00.000000000,-29
68,16,https://resizing.flixster.com/13jm84OlO1m2JgeG4L14JbLjyZE=/206x305/v2/https://flxt.tmsimg.com/assets/p10623535_p_v10_ae.jpg,Legends of Oz: Dorothy's Return,10000,62,2014.0,Kids and family/Animation,0 days 01:31:00.000000000,-52
63,67,,Jews and Baseball: An American Love Story,100,12,2010.0,Documentary,0 days 01:30:00.000000000,4
53,33,,Radio Free Albemuth,250,12,2010.0,Sci fi/Mystery and thriller,0 days 01:51:00.000000000,-20
78,83,https://resizing.flixster.com/8GCIp-sDa4ROU0J8kBD2dQHBKpU=/206x305/v2/https://flxt.tmsimg.com/assets/p9479394_p_v10_aa.jpg,Ways to Live Forever,500,6,2010.0,Drama,0 days 01:30:00.000000000,5
65,50,,Fort McCoy,100,6,2011.0,Drama/History,0 days 01:41:00.000000000,-15
58,96,https://resizing.flixster.com/vKgo-DesLxTip67RxVx7zIEZAQ0=/206x305/v2/https://flxt.tmsimg.com/assets/p8547992_p_v8_aa.jpg,Archipelago,1000,24,2010.0,Drama,0 days 01:54:00.000000000,38
44,60,,Uncle Kent,100,10,2011.0,Comedy/Drama,0 days 01:12:00.000000000,16
66,76,,Godzilla,100000,327,2014.0,Action/Sci fi,0 days 02:03:00.000000000,10
59,28,https://resizing.flixster.com/HvauljMiFrNWrxNixBRIsT9qKYg=/206x305/v2/https://flxt.tmsimg.com/assets/p10569925_p_v10_ax.jpg,Annie,50000,162,2014.0,Comedy/Kids and family,0 days 01:58:00.000000000,-31
64,92,,El Sicario: Room 164,500,13,2010.0,Documentary,0 days 01:20:00.000000000,28
33,40,,The Year Dolly Parton Was My Mom,100,5,2011.0,Comedy/Drama,0 days 01:35:00.000000000,7
62,80,https://resizing.flixster.com/YLRmZUuKhvPoHKfc7kIo-eOBmpc=/206x305/v2/https://flxt.tmsimg.com/NowShowing/113140/113140_aa.jpg,Tales of the Night,2500,25,2011.0,Fantasy/Animation,0 days 01:24:00.000000000,18
46,90,,Ornette: Made in America,50,20,1985.0,Documentary,0 days 01:30:00.000000000,44
17,57,,Big Muddy,50,7,2015.0,Drama,0 days 01:44:00.000000000,40
62,65,https://resizing.flixster.com/Fi5PLV5h89sr_fia2Y7I6rqfQUU=/206x305/v2/https://flxt.tmsimg.com/assets/p9896736_p_v10_ab.jpg,Days of Grace,100,20,2011.0,Mystery and thriller,0 days 02:13:00.000000000,3
75,89,https://resizing.flixster.com/e3opUdyrDG4VpjaFBPyR_iIjYLQ=/206x305/v2/https://flxt.tmsimg.com/assets/p10767949_p_v10_aa.jpg,Advanced Style,250,38,2014.0,Documentary/Comedy,0 days 01:13:00.000000000,14
77,90,,Breathing,500,21,2011.0,Drama,0 days 01:28:00.000000000,13
21,14,,The Pyramid,10000,44,2014.0,Adventure/Horror,0 days 01:28:00.000000000,-7
50,57,https://resizing.flixster.com/XpKaGBLN_Dw5O6QJSnyFwrgXhSc=/206x305/v2/https://flxt.tmsimg.com/assets/p8757080_p_v8_ae.jpg,Aarakshan,500,7,2011.0,Drama,0 days 02:44:00.000000000,7
34,12,https://resizing.flixster.com/LNrn3Bgs4lt1G-im3pkF0kaezFk=/206x305/v2/https://flxt.tmsimg.com/assets/p9980618_p_v10_ai.jpg,Seventh Son,50000,121,2014.0,Action/Fantasy,0 days 01:42:00.000000000,-22
64,51,,The Amazing Spider-Man 2,100000,310,2014.0,Action/Adventure,0 days 02:21:00.000000000,-13
72,95,https://resizing.flixster.com/20zy6UX1eUQsJ2YAmNJiJEo2yuw=/206x305/v2/https://flxt.tmsimg.com/assets/p9284172_p_v10_aa.jpg,Himizu,250,22,2011.0,Drama,0 days 02:09:00.000000000,23
60,73,,Collaborator,1000,26,2011.0,Comedy/Drama,0 days 01:27:00.000000000,13
65,8,/assets/pizza-pie/images/poster_default.c8c896e70c3.gif,After,100,12,2014.0,Drama,0 days 01:41:00.000000000,-57
73,92,,Found Memories,250,12,2011.0,Drama,0 days 01:38:00.000000000,19
76,81,https://resizing.flixster.com/L90ijongf5j3FtiXh2z3XujsxY8=/206x305/v2/https://flxt.tmsimg.com/assets/p9288437_p_v13_ac.jpg,A Letter to Momo,1000,31,2011.0,Drama/Anime,0 days 02:00:00.000000000,5
66,87,https://resizing.flixster.com/zwK_gxLg3vTpicEEtRe7tiGD9ec=/206x305/v2/https://flxt.tmsimg.com/assets/p10171609_p_v10_aj.jpg,Foxcatcher,50000,250,2014.0,Crime/Drama,0 days 02:14:00.000000000,21
36,18,,A Few Best Men,1000,39,2011.0,Comedy/Drama,0 days 01:37:00.000000000,-18
47,86,,The Devil's Business,100,7,2011.0,Horror,0 days 01:15:00.000000000,39
21,0,,Joker,500,6,2012.0,Fantasy/Adventure,0 days 01:44:00.000000000,-21
55,59,,Jackpot,500,37,2011.0,Crime/Comedy,0 days 01:22:00.000000000,4
33,43,,Mother's Milk,1,7,2012.0,Drama,0 days 01:34:00.000000000,10
64,88,,Middle of Nowhere,2500,51,2012.0,Romance/Drama,0 days 01:41:00.000000000,24
25,38,,Agent Vinod,2500,13,2012.0,Action/Adventure,0 days 02:37:00.000000000,13
65,20,https://resizing.flixster.com/e82UNmb5EQwzJ9141jGaIeRONdo=/206x305/v2/https://flxt.tmsimg.com/assets/p9451225_p_v13_aa.jpg,Hollow,250,15,2012.0,Horror,0 days 01:29:00.000000000,-45
37,68,https://resizing.flixster.com/euXuEsg2Bm2WnAk8HEsVWwLMxx8=/206x305/v2/https://flxt.tmsimg.com/assets/p10210268_p_v10_ab.jpg,Life of Crime,5000,81,2013.0,Crime/Comedy,0 days 01:39:00.000000000,31
26,50,https://resizing.flixster.com/xNIqM9gjSRWp5qQvRKQoVprc3IM=/206x305/v2/https://flxt.tmsimg.com/assets/p9115569_p_v8_aa.jpg,Penumbra,500,6,2011.0,Horror/Mystery and thriller,0 days 01:25:00.000000000,24
50,17,,Transformers: Age of Extinction,100000,212,2014.0,Action/Sci fi,0 days 02:45:00.000000000,-33
59,65,/assets/pizza-pie/images/poster_default.c8c896e70c3.gif,The Road,2500,17,2011.0,Horror,0 days 01:50:00.000000000,6
75,63,/assets/pizza-pie/images/poster_default.c8c896e70c3.gif,"Philip Roth, Without Complexes",100,16,2011.0,Documentary/Biography,0 days 00:52:00.000000000,-12
41,43,https://resizing.flixster.com/JaGNY_yQdpRw8eFF1Zh3kEj_U3g=/206x305/v2/https://flxt.tmsimg.com/assets/p9536895_p_v10_aa.jpg,Paris-Manhattan,1000,23,2012.0,Romance,0 days 01:17:00.000000000,2
46,60,,Hellion,2500,50,2014.0,Drama,0 days 01:38:00.000000000,14
68,66,https://resizing.flixster.com/BPCnK9FcZEV4w7JjUEzukzQ7Mw8=/206x305/v2/https://flxt.tmsimg.com/assets/p10414860_p_v8_ac.jpg,The Railway Man,10000,125,2013.0,Drama/History,0 days 01:48:00.000000000,-2
55,12,,No Good Deed,25000,57,2014.0,Mystery and thriller,0 days 01:24:00.000000000,-43
41,53,https://resizing.flixster.com/X3Ku5GJKQ0b6PhAmE-guVSwElZ0=/206x305/v2/https://flxt.tmsimg.com/assets/p10205095_p_v10_ag.jpg,Fading Gigolo,5000,146,2013.0,Comedy/Drama,0 days 01:38:00.000000000,12
91,75,https://resizing.flixster.com/3zRrwsaPEkxZcJapLdxHtuF1r4Y=/206x305/v2/https://flxt.tmsimg.com/NowShowing/138784/138784_aa.jpg,Alive Inside,500,44,2014.0,Documentary,0 days 01:17:00.000000000,-16
47,50,,Clip,250,10,2012.0,Drama,0 days 01:40:00.000000000,3
22,8,,Are You Here,5000,51,2013.0,Comedy/Drama,0 days 01:53:00.000000000,-14
24,23,,The Woman in Black 2: Angel of Death,10000,81,2014.0,Horror/Mystery and thriller,0 days 01:38:00.000000000,-1
70,54,,Maleficent,100000,273,2014.0,Action/Fantasy,0 days 01:38:00.000000000,-16
40,40,https://resizing.flixster.com/XXFqd4XSWJhYZyI9U_tVqJnsIVM=/206x305/v2/https://flxt.tmsimg.com/assets/p9630498_p_v10_ab.jpg,Elza,1,5,2011.0,Drama,0 days 01:22:00.000000000,0
41,76,,Noah,100000,262,2014.0,Fantasy/Adventure,0 days 02:17:00.000000000,35
29,0,,Outside Bet,50,9,2012.0,Comedy,0 days 01:41:00.000000000,-29
69,61,,In Your Eyes,1000,18,2014.0,Romance/Comedy,0 days 01:46:00.000000000,-8
23,16,https://resizing.flixster.com/dBoqWXHy05UcGflphi0ZcXJiYbQ=/206x305/v2/https://flxt.tmsimg.com/assets/p10573118_p_v10_ap.jpg,Serena,10000,111,2014.0,Romance/Drama,0 days 01:49:00.000000000,-7
24,33,,Victim,1,9,2011.0,Action/Drama,0 days 01:26:00.000000000,9
36,67,,Jimi: All Is by My Side,5000,83,2013.0,Drama/Biography,0 days 01:56:00.000000000,31
77,100,https://resizing.flixster.com/KZ3v3OT2_1Pwz2lmMbQmEF54-UY=/206x305/v2/https://flxt.tmsimg.com/assets/p9748501_p_v10_ad.jpg,Horses of God,500,13,2012.0,Drama,0 days 01:55:00.000000000,23
39,69,,They Came Together,10000,94,2014.0,Romance,0 days 01:23:00.000000000,30
63,73,,Neighbors,100000,225,2014.0,Comedy,0 days 01:37:00.000000000,10
88,90,,Dawn of the Planet of the Apes,100000,315,2014.0,Adventure/Action,0 days 02:10:00.000000000,2
91,90,https://resizing.flixster.com/JqVgXNcy1zEi5xLTN3UX8QByonw=/206x305/v2/https://flxt.tmsimg.com/assets/p10063537_p_v10_aa.jpg,X-Men: Days of Future Past,250000,329,2014.0,Sci fi/Action,0 days 02:11:00.000000000,-1
40,26,https://resizing.flixster.com/69teobvcMMZpheRybmhujKXYBs8=/206x305/v2/https://flxt.tmsimg.com/assets/p10542704_p_v13_ae.jpg,"As Above, So Below",10000,78,2014.0,Horror/Mystery and thriller,0 days 01:33:00.000000000,-14
11,0,,Leprechaun: Origins,500,7,2014.0,Horror,0 days 01:30:00.000000000,-11
82,20,https://resizing.flixster.com/pFm8fn2FDbqhyConOX1SPA0pN90=/206x305/v2/https://flxt.tmsimg.com/assets/p9335608_p_v8_aa.jpg,My Uncle Rafael,250,5,2011.0,Comedy,0 days 01:42:00.000000000,-62
75,90,,Nuclear Nation,100,10,2012.0,Documentary,0 days 02:25:00.000000000,15
92,92,,Guardians of the Galaxy,250000,330,2014.0,Comedy/Sci fi,0 days 02:01:00.000000000,0
41,24,,Fifty Shades of Grey,50000,282,2015.0,Romance/Drama,0 days 02:05:00.000000000,-17
57,22,,Need for Speed,50000,187,2014.0,Action,0 days 02:10:00.000000000,-35
71,68,https://resizing.flixster.com/qIBD_2YzbAIkdo8snFwnPwxsbxA=/206x305/v2/https://flxt.tmsimg.com/assets/p10318081_p_v10_af.jpg,"The Hunger Games: Mockingjay, Part 1",100000,301,2014.0,Action/Sci fi,0 days 02:03:00.000000000,-3
92,90,https://resizing.flixster.com/U_be0EesHZtFjTipJYAEIaVeDXo=/206x305/v2/https://flxt.tmsimg.com/assets/p9895254_p_v10_ak.jpg,Captain America: The Winter Soldier,250000,305,2014.0,Action/Fantasy,0 days 02:15:00.000000000,-2
85,90,,Out of the Clear Blue Sky,250,10,2012.0,Documentary,0 days 01:48:00.000000000,5
51,66,,The Rover,10000,169,2014.0,Drama/Mystery and thriller,0 days 01:42:00.000000000,15
78,77,,St. Vincent,25000,192,2014.0,Comedy/Drama,0 days 01:43:00.000000000,-1
76,60,,The Equalizer,50000,203,2014.0,Action/Mystery and thriller,0 days 02:12:00.000000000,-16
69,74,,What If,25000,134,2013.0,Romance,0 days 01:42:00.000000000,5
49,50,,Student of the Year,1000,6,2012.0,Romance,0 days 02:27:00.000000000,1
62,17,https://resizing.flixster.com/5Lpx-mpDT2IZr1Z7_IzhlUiqASI=/206x305/v2/https://flxt.tmsimg.com/assets/p9407592_p_v8_ab.jpg,Coming Up Roses,100,6,2011.0,Drama,0 days 01:33:00.000000000,-45
18,47,https://resizing.flixster.com/3_dWCckoabzS6JuZT1csA6Syzf8=/206x305/v2/https://flxt.tmsimg.com/assets/p10831011_p_v10_ap.jpg,Aftermath,250,17,2015.0,Horror/Mystery and thriller,0 days 01:32:00.000000000,29
65,86,,A Most Wanted Man,25000,195,2014.0,Drama/Mystery and thriller,0 days 02:01:00.000000000,21
38,32,https://resizing.flixster.com/m4JrCKnXW7dHgGvJkR9WXcG1xRw=/206x305/v2/https://flxt.tmsimg.com/assets/p10637767_p_v10_ab.jpg,Lost River,2500,73,2014.0,Fantasy/Mystery and thriller,0 days 01:45:00.000000000,-6
58,70,,"Once Upon a Time Was I, Verônica",50,10,2012.0,Drama,0 days 01:31:00.000000000,12
76,57,https://resizing.flixster.com/5r3x1-lcARZ42DKj2Bsx_HgIvDc=/206x305/v2/https://flxt.tmsimg.com/assets/p9451317_p_v10_aa.jpg,Blackbird,100,7,2012.0,Drama,0 days 01:46:00.000000000,-19
62,47,https://resizing.flixster.com/UykhAEAzaVFlVNJZtAhXukAvMQs=/206x305/v2/https://flxt.tmsimg.com/assets/p9451108_p_v8_aa.jpg,Mr. Pip,1000,17,2012.0,War/Drama,0 days 01:55:00.000000000,-15
72,82,https://resizing.flixster.com/lI1Au2HYCCoxuBub_nrRd_lgQ_c=/206x305/v2/https://flxt.tmsimg.com/assets/p9451219_p_v10_aa.jpg,When I Saw You,100,11,2012.0,Drama,0 days 01:33:00.000000000,10
79,94,https://resizing.flixster.com/3FZCW3Sd--ZMwd7mpfQMC2svYiM=/206x305/v2/https://resizing.flixster.com/i5Oc9pPzhCCAJVMKhZxTGtA09q4=/ems.ZW1zLXByZC1hc3NldHMvbW92aWVzL2YyODUxMTViLTMwNDMtNGNmZC1iZWU1LWRhZmJmZWQ4NjAyNy53ZWJw,Casting By,1000,16,2012.0,Documentary,0 days 01:29:00.000000000,15
39,80,,Dormant Beauty,250,25,2012.0,Drama,0 days 01:55:00.000000000,41
63,73,https://resizing.flixster.com/BvIGCBu7nXPwGWCEZ4fUirdx2HM=/206x305/v2/https://flxt.tmsimg.com/NowShowing/139637/139637_ab.jpg,Penguins of Madagascar,50000,115,2014.0,Animation/Comedy,0 days 01:32:00.000000000,10
49,41,https://resizing.flixster.com/1j3szVbCxQSXT4CJEXH2c1JDpDA=/206x305/v2/https://flxt.tmsimg.com/assets/p10223014_p_v10_aj.jpg,Horns,10000,126,2013.0,Mystery and thriller/Comedy,0 days 02:01:00.000000000,-8
57,63,https://resizing.flixster.com/zHrbnVTlimaPq86u-PmPmwr1zzY=/206x305/v2/https://flxt.tmsimg.com/assets/p9522401_p_v10_aa.jpg,Private Peaceful,500,27,2012.0,Drama/War,0 days 01:40:00.000000000,6
69,41,,Divergent,100000,236,2014.0,Action/Sci fi,0 days 02:20:00.000000000,-28
40,57,https://resizing.flixster.com/plmfqMsS2f_GYL4xIJqWoNuztPw=/206x305/v2/https://flxt.tmsimg.com/assets/p9450775_p_v10_aa.jpg,The Girl Is in Trouble,250,14,2012.0,Mystery and thriller,0 days 01:34:00.000000000,17
90,91,https://resizing.flixster.com/eoUyQkm-hdIp4KDfhxk0XCK2CZY=/206x305/v2/https://resizing.flixster.com/-7nMH-f2F8Vya4I8yR2WfsAL0aA=/ems.ZW1zLXByZC1hc3NldHMvbW92aWVzLzUxNWFlMGQ0LWU0ZTUtNDkzMC04NGQ4LTk0ZWM5MzRjMzRhNy53ZWJw,Edge of Tomorrow,100000,326,2014.0,Sci fi/Action,0 days 01:53:00.000000000,1
59,83,,Witching & Bitching,1000,30,2013.0,Horror/Comedy,0 days 01:54:00.000000000,24
48,79,,The Two Faces of January,10000,124,2014.0,Romance/Mystery and thriller,0 days 01:37:00.000000000,31
60,63,,For No Good Reason,2500,62,2012.0,Documentary,0 days 01:29:00.000000000,3
33,20,https://resizing.flixster.com/K2nJjZvfy-cLH_ZKTBqwSnmNGqM=/206x305/v2/https://flxt.tmsimg.com/assets/p10667511_p_v10_ag.jpg,Tarzan,2500,30,2013.0,Animation/Kids and family,0 days 01:34:00.000000000,-13
63,60,,Wasteland,500,25,2012.0,Crime/Drama,0 days 01:49:00.000000000,-3
78,90,,Bears,10000,60,2014.0,Documentary,0 days 01:17:00.000000000,12
54,94,,Bound by Flesh,250,16,2012.0,Documentary,0 days 01:30:00.000000000,40
74,77,,A Coffee in Berlin,1000,52,2012.0,Comedy/Drama,0 days 01:28:00.000000000,3
43,45,https://resizing.flixster.com/-eAl9NTI1p2PYH24-TUTkysQ_P0=/206x305/v2/https://flxt.tmsimg.com/assets/p11060931_p_v10_aa.jpg,The Better Angels,500,49,2014.0,Drama/History,0 days 01:35:00.000000000,2
60,85,,The Immigrant,10000,112,2013.0,Drama/History,0 days 01:57:00.000000000,25
38,1,,Left Behind,10000,70,2014.0,Mystery and thriller/Action,0 days 01:51:00.000000000,-37
41,74,,The Last Sentence,250,31,2012.0,Drama/History,0 days 02:06:00.000000000,33
70,20,,Tyler Perry's A Madea Christmas,50000,35,2013.0,Other/Comedy,0 days 01:40:00.000000000,-50
49,32,https://resizing.flixster.com/SM_0JM-7rN1x6smQjrd9iiIEarM=/206x305/v2/https://flxt.tmsimg.com/assets/p10431188_p_v10_aa.jpg,The Expendables 3,50000,173,2014.0,Action/Adventure,0 days 02:07:00.000000000,-17
53,56,,Focus,10000,228,2015.0,Romance/Comedy,0 days 01:45:00.000000000,3
47,63,,The Sacrament,2500,71,2013.0,Mystery and thriller,0 days 01:39:00.000000000,16
44,61,https://resizing.flixster.com/QUeMiQ-YIUXGs6f_C6VNPJKdNTM=/206x305/v2/https://flxt.tmsimg.com/assets/p10921865_p_v10_ay.jpg,Maps to the Stars,10000,159,2014.0,Comedy/Drama,0 days 01:52:00.000000000,17
69,86,https://resizing.flixster.com/jQbepPXd-6AajbYyXgeCXhtgTrs=/206x305/v2/https://flxt.tmsimg.com/assets/p10553070_p_v13_ai.jpg,The Skeleton Twins,25000,168,2014.0,Drama/Gay and lesbian,0 days 01:31:00.000000000,17
58,80,,Muppets Most Wanted,50000,201,2014.0,Comedy/Kids and family,0 days 01:46:00.000000000,22
48,4,https://resizing.flixster.com/ydb-QhqViw4YC79n2ZZGl47XLkw=/206x305/v2/https://flxt.tmsimg.com/assets/p10971433_p_v10_at.jpg,Reach Me,500,24,2014.0,Drama,0 days 01:35:00.000000000,-44
77,83,https://resizing.flixster.com/2TipCsCC3IQYZ_yEKyQmnVOJpm4=/206x305/v2/https://flxt.tmsimg.com/assets/p10569669_p_v10_aa.jpg,The Book of Life,25000,126,2014.0,Comedy/Kids and family,0 days 01:35:00.000000000,6
75,85,,Only Lovers Left Alive,10000,206,2013.0,Drama/Sci fi,0 days 02:02:00.000000000,10
63,54,https://resizing.flixster.com/mPmoNNdeamPcdKhE4sgPzZQxwoU=/206x305/v2/https://flxt.tmsimg.com/assets/p9794121_p_v8_aa.jpg,Sagrada - The Mystery of Creation,100,13,2012.0,Documentary,0 days 01:29:00.000000000,-9
41,56,,Breathe In,2500,80,2013.0,Romance/Drama,0 days 01:37:00.000000000,15
33,19,,Very Good Girls,2500,36,2013.0,Drama,0 days 01:31:00.000000000,-14
47,60,https://resizing.flixster.com/t7BnMO5hkxI2pE29Anr6efuGXkM=/206x305/v2/https://flxt.tmsimg.com/assets/p9718386_p_v10_aa.jpg,Running From Crazy,100,20,2012.0,Drama/Biography,0 days 01:45:00.000000000,13
94,100,https://resizing.flixster.com/lQdn4KqFjz_FuekuBsWTy6yOpDA=/206x305/v2/https://flxt.tmsimg.com/assets/p9719274_p_v10_aa.jpg,Which Way Is the Front Line From Here? The Life and Time of Tim Hetherington,250,15,2013.0,Drama/Documentary,0 days 01:19:00.000000000,6
83,72,,Bhaag Milkha Bhaag,1000,18,2013.0,Drama/Biography,0 days 03:08:00.000000000,-11
82,100,,Stolen Seas,250,8,2012.0,Crime/Documentary,0 days 01:30:00.000000000,18
58,86,/assets/pizza-pie/images/poster_default.c8c896e70c3.gif,Last Passenger,2500,21,2013.0,Action/Mystery and thriller,0 days 01:32:00.000000000,28
48,58,,Hercules,100000,121,2014.0,Adventure/Action,0 days 01:37:00.000000000,10
73,72,,American Promise,500,25,2013.0,Documentary,0 days 02:20:00.000000000,-1
55,54,,Citizen Koch,250,35,2013.0,Documentary,0 days 01:50:00.000000000,-1
43,84,,It Felt Like Love,1000,25,2013.0,Drama,0 days 01:22:00.000000000,41
46,58,,May in the Summer,100,26,2013.0,Comedy/Drama,0 days 01:37:00.000000000,12
22,34,https://resizing.flixster.com/YMH4HI5tT2ss59c-eEAF1ZO8BFs=/206x305/v2/https://flxt.tmsimg.com/assets/p10005766_p_v10_aa.jpg,A Teacher,500,32,2013.0,Drama,0 days 01:15:00.000000000,12
85,91,,Valentine Road,100,11,2013.0,Documentary/Gay and lesbian,0 days 01:29:00.000000000,6
73,88,https://resizing.flixster.com/DgFsnrTn7S4gEm9cl-yGSFD2HWA=/206x305/v2/https://flxt.tmsimg.com/assets/p9960326_p_v10_aa.jpg,When I Walk,100,17,2013.0,Documentary,0 days 01:24:00.000000000,15
79,80,https://resizing.flixster.com/MOL4LgUXd12kO_n_qaGSREb4U_Q=/206x305/v2/https://flxt.tmsimg.com/assets/p9718348_p_v10_an.jpg,Who is Dayani Cristal?,250,25,2013.0,Documentary,0 days 01:22:00.000000000,1
52,88,https://resizing.flixster.com/5MQoP6TggTLe-aC2KacZN8VehNM=/206x305/v2/https://flxt.tmsimg.com/assets/p10192672_p_v10_ab.jpg,Kink,500,8,2013.0,Documentary,0 days 01:20:00.000000000,36
30,28,,Jessabelle,10000,36,2014.0,Horror/Mystery and thriller,0 days 01:30:00.000000000,-2
56,58,https://resizing.flixster.com/sq_-ikzk_WHZxMUeO0dbPK6URwc=/206x305/v2/https://flxt.tmsimg.com/assets/p9734850_p_v13_aa.jpg,Five Dances,250,12,2013.0,Gay and lesbian/Drama,0 days 01:23:00.000000000,2
52,73,,Inherent Vice,25000,251,2014.0,Comedy/Mystery and thriller,0 days 02:28:00.000000000,21
22,28,https://resizing.flixster.com/mOivdGQogMfzl_Lh4n1k1pcXO94=/206x305/v2/https://flxt.tmsimg.com/assets/p10593184_p_v10_aa.jpg,Alien Abduction,500,18,2014.0,Horror/Sci fi,0 days 01:26:00.000000000,6
43,54,https://resizing.flixster.com/wO3RA98x5qObQvyihrudap3-YoU=/206x305/v2/https://flxt.tmsimg.com/assets/p9636243_p_v10_ag.jpg,Cuban Fury,5000,96,2014.0,Comedy,0 days 01:38:00.000000000,11
52,71,,Papadopoulos & Sons,250,14,2012.0,Comedy/Drama,0 days 01:45:00.000000000,19
29,23,,Enter the Dangerous Mind,100,13,2013.0,Mystery and thriller,0 days 01:28:00.000000000,-6
10,24,,All Things to All Men,100,17,2012.0,Crime/Drama,0 days 01:24:00.000000000,14
29,31,,Wild Card,5000,58,2015.0,Crime/Action,0 days 01:32:00.000000000,2
58,64,,The Nun,100,14,2013.0,Drama,0 days 01:51:00.000000000,6
72,94,,Snowpiercer,50000,255,2013.0,Action/Sci fi,0 days 02:05:00.000000000,22
67,50,,First Comes Love,100,12,2013.0,Documentary,0 days 01:46:00.000000000,-17
68,65,https://resizing.flixster.com/yHj1Xy3Vc2bXHOMZwyTRV3TVD5g=/206x305/v2/https://flxt.tmsimg.com/assets/p10172717_p_v8_ad.jpg,The Maze Runner,50000,172,2014.0,Mystery and thriller/Action,0 days 01:53:00.000000000,-3
57,47,,Night at the Museum: Secret of the Tomb,100000,113,2014.0,Fantasy/Comedy,0 days 01:37:00.000000000,-10
63,77,https://resizing.flixster.com/OEx9zy9gbzsTLV2kewOH4Zt2kig=/206x305/v2/https://flxt.tmsimg.com/assets/p10550833_p_v10_ab.jpg,The Boxtrolls,25000,173,2014.0,Comedy/Kids and family,0 days 01:36:00.000000000,14
41,33,https://resizing.flixster.com/c3iEOB1fOK2ISyiNM1OyUzbc5_Y=/206x305/v2/https://flxt.tmsimg.com/assets/p10372514_p_v10_az.jpg,A Million Ways to Die in the West,50000,211,2014.0,Western/Comedy,0 days 01:55:00.000000000,-8
43,50,https://resizing.flixster.com/1A_X46yUHHFD8kPY_e-aFHs-N90=/206x305/v2/https://flxt.tmsimg.com/assets/p9562020_p_v8_ad.jpg,Bring Me the Head of the Machine Gun Woman,50,6,2012.0,Crime/Action,0 days 01:15:00.000000000,7
47,48,https://resizing.flixster.com/IcrQcqZeL-syNm762mrSL6NYzK4=/206x305/v2/https://flxt.tmsimg.com/assets/p10247876_p_v10_aa.jpg,Honour,100,27,2013.0,Mystery and thriller,0 days 01:44:00.000000000,1
20,5,https://resizing.flixster.com/7glUS6-z6j6SDG8bPFL82sO6m9c=/206x305/v2/https://flxt.tmsimg.com/assets/p10690835_p_v10_au.jpg,The Color of Time,1000,21,2012.0,Romance/Drama,0 days 01:12:00.000000000,-15
72,85,,Stephen Hawking Biography,250,27,2013.0,Documentary/Comedy,0 days 01:29:00.000000000,13
61,64,https://resizing.flixster.com/5-KSJI9rLNZprUlk-__hB8dL-I4=/206x305/v2/https://flxt.tmsimg.com/assets/p10680419_p_v10_ae.jpg,Coldwater,250,22,2013.0,Drama/Mystery and thriller,0 days 01:44:00.000000000,3
59,44,,This Is Where I Leave You,25000,170,2014.0,Comedy/Drama,0 days 01:43:00.000000000,-15
65,92,,12 O'Clock Boys,1000,50,2013.0,Documentary,0 days 01:14:00.000000000,27
53,74,https://resizing.flixster.com/2ENuuMw4vkqt-3Z7Nvgij7ZP37E=/206x305/v2/https://flxt.tmsimg.com/assets/p10198269_p_v8_aa.jpg,Go for Sisters,250,54,2013.0,Crime/Drama,0 days 02:03:00.000000000,21
73,93,https://resizing.flixster.com/A_3V_34WKthn4-7agAA3utHc9yY=/206x305/v2/https://flxt.tmsimg.com/assets/p10147645_p_v8_aa.jpg,The Retrieval,500,28,2013.0,Drama/History,0 days 01:34:00.000000000,20
59,75,,Free the Mind,500,12,2012.0,Documentary/Adventure,0 days 01:20:00.000000000,16
86,72,https://resizing.flixster.com/2FPFkgJ7NtwC961wcjtKeh7dGT4=/206x305/v2/https://flxt.tmsimg.com/assets/p10543523_p_v13_aq.jpg,Interstellar,100000,366,2014.0,Sci fi/Adventure,0 days 02:45:00.000000000,-14
47,35,,Horrible Bosses 2,50000,161,2014.0,Comedy,0 days 01:48:00.000000000,-12
62,78,,Cupcakes,100,23,2013.0,Comedy/Gay and lesbian,0 days 01:32:00.000000000,16
38,27,,Jupiter Ascending,50000,270,2015.0,Action/Sci fi,0 days 02:07:00.000000000,-11
28,30,https://resizing.flixster.com/4JTlprqAcPEwPvE5SzlMEYMN_fk=/206x305/v2/https://flxt.tmsimg.com/assets/p10008578_p_v10_af.jpg,Summer in February,1000,43,2013.0,Romance/Drama,0 days 01:41:00.000000000,2
25,37,,The Quiet Ones,10000,84,2014.0,Horror,0 days 01:38:00.000000000,12
72,49,https://resizing.flixster.com/wxjABYOzxy0IIUownI4utI0xWx0=/206x305/v2/https://flxt.tmsimg.com/assets/p10569417_p_v10_at.jpg,The Judge,25000,200,2014.0,Drama,0 days 02:21:00.000000000,-23
48,51,https://resizing.flixster.com/1xYRFyoXZHU-PBCnBmnxSAWiGIg=/206x305/v2/https://flxt.tmsimg.com/assets/p10569374_p_v13_ae.jpg,The Interview,50000,154,2014.0,Action/Adventure,0 days 01:51:00.000000000,3
79,83,,Aftermath,500,35,2013.0,Comedy/Mystery and thriller,0 days 01:24:00.000000000,4
84,74,,Kingsman: The Secret Service,100000,261,2014.0,Action/Adventure,0 days 02:09:00.000000000,-10
72,91,,The Kill Team,2500,43,2013.0,Documentary,0 days 01:19:00.000000000,19
43,8,https://resizing.flixster.com/_1FYOUdLk5LtkHFFYSsu1sdBT_U=/206x305/v2/https://flxt.tmsimg.com/assets/p10230629_p_v10_ab.jpg,A Haunted House 2,25000,40,2014.0,Comedy/Horror,0 days 01:27:00.000000000,-35
53,61,,Mood Indigo,2500,109,2013.0,Fantasy/Romance,0 days 01:34:00.000000000,8
44,78,,Floating Skyscrapers,100,9,2013.0,Romance/Drama,0 days 01:25:00.000000000,34
84,76,https://resizing.flixster.com/qmbjgp75RB69vC4lsH7_-TocrNE=/206x305/v2/https://flxt.tmsimg.com/NowShowing/138615/138615_ab.jpg,Fury,100000,260,2014.0,Drama/History,0 days 02:14:00.000000000,-8
73,88,,Dancing in Jaffa,250,41,2013.0,Documentary,0 days 01:26:00.000000000,15
33,67,,Flex Is Kings,1,6,2013.0,Documentary,0 days 01:23:00.000000000,34
5,11,https://resizing.flixster.com/Jqg3Ji-MtbNYEhtmf014gMenn0g=/206x305/v2/https://flxt.tmsimg.com/assets/p9914595_p_v10_aa.jpg,The Moment,100,9,2013.0,Mystery and thriller,0 days 01:32:00.000000000,6
75,86,,Richard Pryor: Omit the Logic,250,7,2013.0,Documentary/Comedy,0 days 01:30:00.000000000,11
49,77,https://resizing.flixster.com/5ImaNCpgNNO0mUYLR21t0CJMEhA=/206x305/v2/https://flxt.tmsimg.com/assets/p9912764_p_v10_aa.jpg,Teenage,2500,66,2013.0,Documentary,0 days 01:20:00.000000000,28
38,52,,Trust Me,1000,33,2013.0,Comedy,0 days 01:30:00.000000000,14
67,66,https://resizing.flixster.com/egCFEAucwM5BkEKRQMdnsSh4JkE=/206x305/v2/https://resizing.flixster.com/oY122B-_qpNyXjQFUmGUQ1erfhQ=/ems.ZW1zLXByZC1hc3NldHMvbW92aWVzL2IxNDU5MmQ2LTczMTEtNDkzYi1iZDM0LTY3OTdlYTFmM2U1ZS53ZWJw,Filth,10000,97,2013.0,Crime/Comedy,0 days 01:37:00.000000000,-1
82,87,,The Good Lie,10000,89,2014.0,Drama,0 days 01:49:00.000000000,5
52,84,,Expedition to the End of the World,250,19,2013.0,Documentary,0 days 01:30:00.000000000,32
72,20,https://resizing.flixster.com/XfDq92Wh8hO7nnVYNl_ZhNTGY4c=/206x305/v2/https://flxt.tmsimg.com/assets/p10461893_p_v10_ar.jpg,When the Game Stands Tall,10000,71,2014.0,Drama,0 days 01:55:00.000000000,-52
77,84,https://resizing.flixster.com/aoq-20KFQzKO0Yigc6a5Art7k90=/206x305/v2/https://flxt.tmsimg.com/assets/p10372543_p_v10_av.jpg,22 Jump Street,100000,223,2014.0,Comedy/Action,0 days 01:52:00.000000000,7
33,16,https://resizing.flixster.com/FVf-wyA-IdNMfx4l7tbneVtdt5o=/206x305/v2/https://flxt.tmsimg.com/assets/p10438646_p_v10_av.jpg,Sex Tape,50000,156,2014.0,Comedy,0 days 01:34:00.000000000,-17
58,25,https://resizing.flixster.com/21544CRDSF2lXsEF3GZoJrIenyo=/206x305/v2/https://flxt.tmsimg.com/assets/p10569751_p_v10_ak.jpg,Dracula Untold,25000,137,2014.0,Action/Fantasy,0 days 01:32:00.000000000,-33
61,74,,Young & Beautiful,2500,84,2013.0,Drama,0 days 01:35:00.000000000,13
36,24,https://resizing.flixster.com/dtHHmIo4NupjY74f7xQJAO9vadA=/206x305/v2/https://flxt.tmsimg.com/assets/p10411593_p_v10_aa.jpg,Tammy,50000,185,2014.0,Comedy,0 days 01:37:00.000000000,-12
45,37,,Project Almanac,25000,98,2015.0,Sci fi/Mystery and thriller,0 days 01:46:00.000000000,-8
91,89,https://resizing.flixster.com/DePjxJ9ALHewOanzHTAgF6gMMvY=/206x305/v2/https://flxt.tmsimg.com/NowShowing/136679/136679_aa.jpg,Big Hero 6,100000,226,2014.0,Comedy/Sci fi,0 days 01:42:00.000000000,-2
57,26,,The Other Woman,50000,167,2014.0,Romance,0 days 01:49:00.000000000,-31
82,92,,I Am Breathing,250,25,2013.0,Documentary,0 days 01:13:00.000000000,10
69,87,https://resizing.flixster.com/PFaW97_KogjQV7btTbdbJCeFNHs=/206x305/v2/https://flxt.tmsimg.com/assets/p10184119_p_v7_ae.jpg,Borgman,2500,62,2013.0,Drama/Mystery and thriller,0 days 01:53:00.000000000,18
32,67,,Grigris,50,15,2013.0,Drama,0 days 01:41:00.000000000,35
67,100,,Honey,250,16,2013.0,Drama,0 days 01:36:00.000000000,33
79,93,,"Norte, the End of History",1000,40,2013.0,Drama,0 days 04:10:00.000000000,14
53,73,,The Congress,5000,107,2013.0,Sci fi,0 days 02:02:00.000000000,20
78,100,https://resizing.flixster.com/rcCgRevUIA2UZ4iuPi-yDS56g_U=/206x305/v2/https://flxt.tmsimg.com/assets/p10004403_p_v10_ac.jpg,Ilo Ilo,2500,45,2013.0,Drama,0 days 01:39:00.000000000,22
78,96,https://resizing.flixster.com/AmnRCXQ78fRHafBeCHr4tWDyvEU=/206x305/v2/https://flxt.tmsimg.com/assets/p10205032_p_v10_aa.jpg,The Last of the Unjust,500,48,2013.0,Documentary/Biography,0 days 03:38:00.000000000,18
64,71,,Nothing Bad Can Happen,250,28,2013.0,Drama/Mystery and thriller,0 days 01:50:00.000000000,7
47,75,,Salvo,250,24,2013.0,Crime/Romance,0 days 01:44:00.000000000,28
22,53,https://resizing.flixster.com/U406uxvHUjVmrgWEowJh9LT7OU8=/206x305/v2/https://flxt.tmsimg.com/assets/p10607984_p_v10_aa.jpg,Tip Top,50,15,2013.0,Comedy/Mystery and thriller,0 days 01:46:00.000000000,31
63,75,,The German Doctor,2500,63,2013.0,Drama/Mystery and thriller,0 days 01:33:00.000000000,12
78,93,,Manuscripts Don't Burn,250,27,2013.0,Drama,0 days 02:05:00.000000000,15
71,88,https://resizing.flixster.com/vjgayIlSu0IsUS5rniRk4_Y78lA=/206x305/v2/https://flxt.tmsimg.com/assets/p10003988_p_v10_ad.jpg,Venus in Fur,5000,117,2013.0,Comedy/Drama,0 days 01:35:00.000000000,17
35,31,https://resizing.flixster.com/RFy_fYr37nnM5l5h3rdg9hfKcu4=/206x305/v2/https://flxt.tmsimg.com/assets/p10450373_p_v10_ag.jpg,Exodus: Gods and Kings,50000,209,2014.0,History/Adventure,0 days 02:30:00.000000000,-4
65,80,,The Battery,500,10,2012.0,Horror,0 days 01:41:00.000000000,15
26,60,,Down and Dangerous,50,5,2013.0,Crime/Drama,0 days 01:35:00.000000000,34
47,43,,Postman Pat: The Movie - You Know You're the One,1000,28,2013.0,Animation/Kids and family,0 days 01:28:00.000000000,-4
83,64,,Rudderless,2500,47,2014.0,Drama,0 days 01:45:00.000000000,-19
47,50,,Earth to Echo,25000,127,2014.0,Sci fi/Kids and family,0 days 01:29:00.000000000,3
65,60,,Draft Day,25000,159,2014.0,Drama,0 days 01:49:00.000000000,-5
48,64,,I Travel Alone,500,33,2013.0,Drama,0 days 01:25:00.000000000,16
49,71,,Into the Woods,50000,225,2014.0,Fantasy/Musical,0 days 02:04:00.000000000,22
31,29,,The Love Punch,2500,56,2013.0,Comedy,0 days 01:34:00.000000000,-2
84,72,,American Sniper,100000,298,2014.0,Drama/War,0 days 02:12:00.000000000,-12
85,87,https://resizing.flixster.com/hKAxGlRyO3V7d3tkQwDooZTy4Xo=/206x305/v2/https://flxt.tmsimg.com/assets/p10367270_p_v13_aa.jpg,Chef,50000,191,2014.0,Comedy/Drama,0 days 01:55:00.000000000,2
72,90,https://resizing.flixster.com/6YddHqEpxq7R4-N2sZh0uwSAszc=/206x305/v2/https://flxt.tmsimg.com/assets/p10455677_p_v10_ab.jpg,Locke,25000,217,2013.0,Drama,0 days 01:24:00.000000000,18
63,32,,"Love, Rosie",5000,57,2014.0,Romance,0 days 01:42:00.000000000,-31
59,47,https://resizing.flixster.com/PEr7Tc7XNAJ2j58eSWpxUkMkVHI=/206x305/v2/https://flxt.tmsimg.com/assets/p10595821_p_v10_aa.jpg,Wish I Was Here,10000,132,2014.0,Comedy/Drama,0 days 01:47:00.000000000,-12
38,73,,ABCs of Death 2,1000,33,2014.0,Horror,0 days 02:03:00.000000000,35
29,33,,Song One,2500,52,2014.0,Romance/Musical,0 days 01:28:00.000000000,4
46,55,,When Comedy Went to School,250,33,2013.0,Documentary,0 days 01:17:00.000000000,9
40,22,,A Long Way Down,5000,54,2014.0,Comedy/Drama,0 days 01:36:00.000000000,-18
51,75,https://resizing.flixster.com/chB0yBizmNUq-OR3EnGpke-EMME=/206x305/v2/https://flxt.tmsimg.com/assets/p10001279_p_v10_ab.jpg,Spark: A Burning Man Story,250,24,2013.0,Documentary,0 days 01:52:00.000000000,24
26,43,https://resizing.flixster.com/ZfP3IqElcDGR3h8HGak5V5ILb84=/206x305/v2/https://flxt.tmsimg.com/assets/p11206162_p_v10_aa.jpg,The Sleepwalker,100,14,2014.0,Drama/Mystery and thriller,0 days 01:31:00.000000000,17
68,65,,Million Dollar Arm,25000,148,2014.0,Drama,0 days 02:03:00.000000000,-3
80,88,https://resizing.flixster.com/PMU3iR3d9pLpPfa-negP0_VdiRI=/206x305/v2/https://flxt.tmsimg.com/assets/p10647552_p_v8_aa.jpg,Code Black,2500,42,2013.0,Documentary/Drama,0 days 01:22:00.000000000,8
47,83,,Evergreen: The Road to Legalization,100,12,2013.0,Documentary,0 days 01:26:00.000000000,36
78,67,https://resizing.flixster.com/40aZaOBNSj-2jyK4Fl57Ik_6dQI=/206x305/v2/https://flxt.tmsimg.com/assets/p10058390_p_v10_aa.jpg,Lootera,500,6,2013.0,Romance/Drama,0 days 02:16:00.000000000,-11
72,83,,Terms and Conditions May Apply,2500,30,2013.0,Documentary,0 days 01:19:00.000000000,11
56,57,https://resizing.flixster.com/2NInZhZE6qAamX0eTgHOvivEMV0=/206x305/v2/https://flxt.tmsimg.com/assets/p10558648_p_v10_ak.jpg,The Purge: Anarchy,50000,142,2014.0,Action/Horror,0 days 01:43:00.000000000,1
63,88,https://resizing.flixster.com/cP5JMMoR8qDNYS1ySco9ISvohyg=/206x305/v2/https://flxt.tmsimg.com/assets/p10230403_p_v10_aa.jpg,Stretch,2500,16,2014.0,Action/Comedy,0 days 01:42:00.000000000,25
40,18,,And So It Goes,10000,90,2014.0,Romance/Drama,0 days 01:34:00.000000000,-22
31,15,https://resizing.flixster.com/HH_xP8SU7ssSZxF_coPdF72XKEs=/206x305/v2/https://flxt.tmsimg.com/assets/p10693429_p_v10_ax.jpg,Revenge of the Green Dragons,1000,26,2014.0,Crime/Action,0 days 01:34:00.000000000,-16
23,17,,Tasting Menu,100,18,2013.0,Comedy/Drama,0 days 01:27:00.000000000,-6
80,89,,Calvary,10000,172,2014.0,Comedy/Drama,0 days 01:45:00.000000000,9
59,23,https://resizing.flixster.com/HY4eBmfILn-v3JNwwEIiXxoHHg4=/206x305/v2/https://flxt.tmsimg.com/assets/p10372601_p_v13_ag.jpg,Think Like a Man Too,25000,86,2014.0,Romance,0 days 01:45:00.000000000,-36
56,64,https://resizing.flixster.com/AE7qPCrdOLXmYct_uJo94qaNXDc=/206x305/v2/https://flxt.tmsimg.com/assets/p10047700_p_v7_aa.jpg,The Cold Lands,100,11,2013.0,Drama,0 days 01:41:00.000000000,8
81,68,,The Hundred-Foot Journey,25000,148,2014.0,Comedy/Drama,0 days 02:02:00.000000000,-13
88,98,,Keep on Keepin' On,1000,43,2014.0,Documentary,0 days 01:26:00.000000000,10
56,44,,Planes: Fire & Rescue,10000,95,2014.0,Animation/Comedy,0 days 01:23:00.000000000,-12
50,40,,Northern Borders,1,5,2013.0,Drama,0 days 01:48:00.000000000,-10
76,90,,In Bloom,1000,51,2013.0,Drama,0 days 01:42:00.000000000,14
51,65,https://resizing.flixster.com/9MbnfZa6oH6Zldut3XDSuM2mlNk=/206x305/v2/https://flxt.tmsimg.com/assets/p10771007_p_v10_aa.jpg,The Disappearance of Eleanor Rigby,5000,92,2013.0,Romance/Drama,0 days 02:03:00.000000000,14
59,83,https://resizing.flixster.com/5w3gZkGSQ04MHUR6Djg5uM-g5Cw=/206x305/v2/https://flxt.tmsimg.com/assets/p10193546_p_v10_af.jpg,The Double,10000,133,2013.0,Comedy,0 days 01:32:00.000000000,24
81,77,,A Will for the Woods,100,13,2013.0,Drama,0 days 01:42:00.000000000,-4
72,66,,Dolphin Tale 2,25000,88,2014.0,Kids and family/Adventure,0 days 01:47:00.000000000,-6
35,30,,Dumb and Dumber To,50000,153,2014.0,Comedy,0 days 01:49:00.000000000,-5
59,80,,Black Sea,10000,139,2014.0,Mystery and thriller/Adventure,0 days 01:55:00.000000000,21
58,90,https://resizing.flixster.com/LS0pwtKaY8N8badibSPn4IuPDvU=/206x305/v2/https://flxt.tmsimg.com/assets/p10459399_p_v8_aa.jpg,For a Woman,250,10,2013.0,Drama,0 days 01:50:00.000000000,32
36,31,https://resizing.flixster.com/AYnjDvEQh1p8JI2VMNPk_yYVNLE=/206x305/v2/https://flxt.tmsimg.com/assets/p10263088_p_v10_aa.jpg,Not Another Happy Ending,250,16,2013.0,Romance,0 days 01:42:00.000000000,-5
34,80,https://resizing.flixster.com/W492XZ_pVULwlJa4NEhl04t3N6c=/206x305/v2/https://flxt.tmsimg.com/assets/p10233420_p_v10_aa.jpg,Willow Creek,5000,59,2013.0,Horror,0 days 01:18:00.000000000,46
74,21,,The Christmas Candle,2500,24,2013.0,Other/Kids and family,0 days 01:40:00.000000000,-53
69,77,,Kill the Messenger,10000,130,2014.0,Drama/Mystery and thriller,0 days 01:52:00.000000000,8
40,53,https://resizing.flixster.com/F68pjhDIuhtnBBE0MzBGGy3_UMg=/206x305/v2/https://resizing.flixster.com/JsUyFkZ9UnLOOr_p88UHi8_ffUc=/ems.ZW1zLXByZC1hc3NldHMvbW92aWVzLzcyNTE2ZTZjLWZkMzItNGRlYi1hOWUxLWZhYjc4ZDQxMzMzMi53ZWJw,Life's a Breeze,100,15,2013.0,Comedy/Drama,0 days 01:30:00.000000000,13
88,80,,"McFarland, USA",25000,133,2015.0,Drama/Biography,0 days 02:09:00.000000000,-8
32,24,,Wolves,500,21,2014.0,Horror,0 days 01:30:00.000000000,-8
75,86,https://resizing.flixster.com/E-62F0aKpzDWTiLLpkXX_Oj3-Og=/206x305/v2/https://flxt.tmsimg.com/assets/p9894089_p_v10_ab.jpg,The Forgotten Kingdom,50,7,2013.0,Romance/Drama,0 days 01:37:00.000000000,11
70,51,https://resizing.flixster.com/Is3OpqDwO4DwGTcKDg7RSV55avU=/206x305/v2/https://flxt.tmsimg.com/assets/p10570028_p_v10_ae.jpg,Unbroken,50000,232,2014.0,War/Drama,0 days 02:17:00.000000000,-19
70,40,,"Three Holes, Two Brads, and a Smoking Gun",1,5,2014.0,Drama/Mystery and thriller,0 days 01:30:00.000000000,-30
43,49,https://resizing.flixster.com/Da2AVWX0iQ1siBbktl-RoEzxiII=/206x305/v2/https://flxt.tmsimg.com/assets/p10277435_p_v10_aa.jpg,The Zero Theorem,5000,129,2013.0,Fantasy/Sci fi,0 days 01:47:00.000000000,6
87,87,,Gone Girl,100000,364,2014.0,Crime/Drama,0 days 02:29:00.000000000,0
47,67,,Lucy,100000,239,2014.0,Action/Sci fi,0 days 01:28:00.000000000,20
45,31,https://resizing.flixster.com/8bQoBi9tp90XMVqaQ84S8J0owYQ=/206x305/v2/https://flxt.tmsimg.com/assets/p10623759_p_v10_ac.jpg,The Devil's Violinist,250,13,2013.0,Drama/History,0 days 02:02:00.000000000,-14
81,87,https://resizing.flixster.com/STODP85JDjWW4GgAtqqi7o2xoU4=/206x305/v2/https://flxt.tmsimg.com/assets/p10242748_p_v10_aa.jpg,Antarctica: A Year on Ice,2500,30,2013.0,Documentary,0 days 01:31:00.000000000,6
62,51,,Jersey Boys,25000,222,2014.0,Drama/Musical,0 days 02:12:00.000000000,-11
29,37,,Cut Bank,1000,38,2014.0,Mystery and thriller,0 days 01:29:00.000000000,8
82,84,https://resizing.flixster.com/ynvyxS9rGPil6OihLX3-8sPgVk4=/206x305/v2/https://flxt.tmsimg.com/assets/p10205013_p_v10_ad.jpg,Belle,25000,153,2013.0,Drama/History,0 days 01:43:00.000000000,2
49,55,,Eliza Graves,5000,58,2014.0,Mystery and thriller,0 days 01:52:00.000000000,6
70,90,,Minuscule: Valley of the Lost Ants,250,10,2013.0,Animation/Kids and family,0 days 01:29:00.000000000,20
39,32,,The Possession of Michael King,500,19,2014.0,Horror,0 days 01:23:00.000000000,-7
24,45,,Missionary,100,11,2013.0,Mystery and thriller,0 days 01:30:00.000000000,21
67,79,,Chinese Puzzle,2500,66,2013.0,Romance/Comedy,0 days 01:57:00.000000000,12
46,81,https://resizing.flixster.com/H0u03NictVJF3EOtUbzi9qwxbC8=/206x305/v2/https://flxt.tmsimg.com/assets/p10311226_p_v10_av.jpg,The Borderlands,500,16,2013.0,Horror/Mystery and thriller,0 days 01:29:00.000000000,35
67,67,,The Notebook,500,36,2013.0,Drama/War,0 days 01:50:00.000000000,0
54,81,https://resizing.flixster.com/CuYujuei_XU-C7aaERScYwE3kz4=/206x305/v2/https://flxt.tmsimg.com/NowShowing/140297/140297_ac.jpg,The SpongeBob Movie: Sponge Out of Water,50000,105,2015.0,Comedy/Kids and family,0 days 01:32:00.000000000,27
37,14,,The Loft,10000,42,2014.0,Mystery and thriller,0 days 01:43:00.000000000,-23
66,60,https://resizing.flixster.com/oNIwpjgiDswqjCRMUHznM3XqCSg=/206x305/v2/https://flxt.tmsimg.com/assets/p10193655_p_v10_ac.jpg,The Grand Seduction,5000,70,2013.0,Comedy,0 days 01:55:00.000000000,-6
55,62,,The French Minister,250,21,2013.0,Drama,0 days 01:53:00.000000000,7
81,83,,Begin Again,25000,167,2013.0,Romance/Comedy,0 days 01:44:00.000000000,2
69,86,,Violette,500,50,2013.0,Romance/Drama,0 days 02:19:00.000000000,17
51,80,https://resizing.flixster.com/E25Q0nzepZX2dwyBQcd0O5ThUYI=/206x305/v2/https://flxt.tmsimg.com/assets/p10205079_p_v8_ab.jpg,We Gotta Get Out of This Place,1000,41,2013.0,Crime/Drama,0 days 01:31:00.000000000,29
42,86,,Night Moves,10000,152,2013.0,Drama/Mystery and thriller,0 days 01:52:00.000000000,44
79,96,,Ida,10000,164,2013.0,Drama,0 days 01:20:00.000000000,17
36,51,,Half of a Yellow Sun,1000,53,2013.0,Drama,0 days 01:53:00.000000000,15
42,51,/assets/pizza-pie/images/poster_default.c8c896e70c3.gif,The Strange Color of Your Body's Tears,250,47,2013.0,Mystery and thriller,0 days 01:42:00.000000000,9
83,79,,Supermensch: The Legend of Shep Gordon,1000,80,2013.0,Documentary,0 days 01:24:00.000000000,-4
35,67,,Cannibal,250,15,2013.0,Mystery and thriller,0 days 01:57:00.000000000,32
34,25,https://resizing.flixster.com/jYXZB31zk6ihCjNxhN76qlnC6xI=/206x305/v2/https://flxt.tmsimg.com/assets/p10204988_p_v10_ar.jpg,Third Person,5000,107,2013.0,Romance/Drama,0 days 02:16:00.000000000,-9
60,69,,Beyond the Edge,250,26,2013.0,Documentary/Adventure,,9
49,79,https://resizing.flixster.com/A6SBwUAH5zLopxvwrNEUF2ryNP0=/206x305/v2/https://flxt.tmsimg.com/assets/p10384426_p_v10_aa.jpg,Burt's Buzz,250,14,2013.0,Documentary,0 days 01:28:00.000000000,30
89,95,https://resizing.flixster.com/BRfEQeZMCnqXMr5MzS0rKdpjD7E=/206x305/v2/https://flxt.tmsimg.com/NowShowing/131755/131755_aa.jpg,Finding Vivian Maier,5000,102,2013.0,Documentary/Mystery and thriller,0 days 01:23:00.000000000,6
36,50,https://resizing.flixster.com/hSm8eaobtT7HJ-hB0tJE9yUQ83s=/206x305/v2/https://flxt.tmsimg.com/assets/p10221903_p_v10_aa.jpg,Hateship Loveship,1000,54,2013.0,Comedy/Drama,0 days 01:42:00.000000000,14
53,74,https://resizing.flixster.com/DmFVlpJm-1PqdHW14gybQUBkYv0=/206x305/v2/https://flxt.tmsimg.com/assets/p10205083_p_v10_ag.jpg,Oculus,25000,156,2013.0,Horror/Mystery and thriller,0 days 01:45:00.000000000,21
64,92,,Mystery Road,2500,36,2013.0,Crime/Drama,0 days 02:02:00.000000000,28
38,65,https://resizing.flixster.com/49Kc151mLM3r7f73rI5cs1Nk_oM=/206x305/v2/https://flxt.tmsimg.com/assets/p10231582_p_v10_ay.jpg,Proxy,500,26,2013.0,Horror/Drama,0 days 02:00:00.000000000,27
84,99,,Starred Up,10000,115,2013.0,Crime/Drama,0 days 01:40:00.000000000,15
52,100,,I Am Yours,50,9,2013.0,Drama,0 days 01:36:00.000000000,48
46,70,,Felony,2500,33,2013.0,Crime/Drama,0 days 01:45:00.000000000,24
76,89,https://resizing.flixster.com/vu1J4bvOQ_mixni2Hm18ZZJp244=/206x305/v2/https://flxt.tmsimg.com/assets/p10194221_p_v10_ap.jpg,Gabrielle,500,27,2013.0,Romance/Drama,0 days 01:44:00.000000000,13
83,67,,Southern Baptist Sissies,50,6,2013.0,Gay and lesbian/Drama,0 days 02:18:00.000000000,-16
82,40,,Faith Connections,50,5,2013.0,Documentary/Drama,0 days 01:55:00.000000000,-42
50,71,,R100,500,28,2013.0,Comedy/Drama,0 days 01:40:00.000000000,21
80,80,,Why Don't You Play in Hell?,2500,41,2013.0,Action/Comedy,0 days 02:09:00.000000000,0
28,43,,The Station,250,21,2013.0,Horror,0 days 01:37:00.000000000,15
54,73,https://resizing.flixster.com/oVckpnX6ZCjun9IWbJr26lUqc4E=/206x305/v2/https://flxt.tmsimg.com/assets/p10709694_p_v10_at.jpg,The House of Magic,2500,30,2013.0,Animation/Comedy,0 days 01:25:00.000000000,19
18,0,https://resizing.flixster.com/XKPJZexUgGUuGaFye3x8taoYpXQ=/206x305/v2/https://flxt.tmsimg.com/assets/p10850620_p_v8_aa.jpg,Kite,1000,15,2014.0,Action/Mystery and thriller,0 days 01:30:00.000000000,-18
28,14,,Electric Slide,100,7,2014.0,Crime/Action,0 days 01:35:00.000000000,-14
20,42,,Open Windows,1000,43,2014.0,Mystery and thriller,0 days 01:40:00.000000000,22
68,76,,Rosewater,10000,154,2014.0,Drama,0 days 01:43:00.000000000,8
52,71,https://resizing.flixster.com/10MHFyPlmYtOV1_tTZaaHg_ufqA=/206x305/v2/https://flxt.tmsimg.com/assets/p10294691_p_v13_ac.jpg,Defender,1000,14,2013.0,Sci fi,0 days 02:15:00.000000000,19
91,89,,See You Next Tuesday,1,9,2013.0,Comedy/Drama,0 days 01:22:00.000000000,-2
33,55,,Pioneer,250,44,2013.0,Mystery and thriller,0 days 01:46:00.000000000,22
28,54,https://resizing.flixster.com/y9nElco5Yfb2uRnZ2Hm8XIkv8uU=/206x305/v2/https://flxt.tmsimg.com/assets/p10495157_p_v10_aa.jpg,Little Accidents,2500,39,2014.0,Drama,0 days 01:45:00.000000000,26
66,33,,The Dark Valley,250,6,2014.0,Drama,0 days 01:55:00.000000000,-33
18,8,/assets/pizza-pie/images/poster_default.c8c896e70c3.gif,The Damned,250,12,2010.0,Crime/Documentary,0 days 00:28:00.000000000,-10
85,88,,The Wind Rises,10000,179,2013.0,Anime/Drama,0 days 02:06:00.000000000,3
55,86,/assets/pizza-pie/images/poster_default.c8c896e70c3.gif,Abuse of Weakness,250,35,2013.0,Drama,0 days 01:45:00.000000000,31
66,62,https://resizing.flixster.com/KmhP6uJWYjSmUifWAJeP7JV14XU=/206x305/v2/https://flxt.tmsimg.com/assets/p10204977_p_v13_aa.jpg,Beneath the Harvest Sky,250,21,2013.0,Drama,0 days 01:56:00.000000000,-4
84,96,,Burning Bush,250,23,2014.0,,,12
35,75,,Canopy,250,24,2013.0,War/Drama,0 days 01:24:00.000000000,40
26,42,https://resizing.flixster.com/2tYvSdOMkCcpJ5_--RBP8oYNRDA=/206x305/v2/https://flxt.tmsimg.com/assets/p10193740_p_v10_ab.jpg,Child of God,1000,50,2013.0,Drama,0 days 01:44:00.000000000,16
68,91,,The Dog,500,58,2013.0,Documentary/Gay and lesbian,0 days 01:41:00.000000000,23
42,48,,Gerontophilia,250,27,2013.0,Romance/Gay and lesbian,0 days 01:30:00.000000000,6
65,38,https://resizing.flixster.com/syrF0HuK8ZY37udw4MdEwBQYMZM=/206x305/v2/https://flxt.tmsimg.com/assets/p10215384_p_v10_aa.jpg,The Liberator,1000,26,2013.0,Drama/History,0 days 01:59:00.000000000,-27
58,78,,Lucky Them,1000,41,2013.0,Comedy/Drama,0 days 01:36:00.000000000,20
61,96,,Manakamana,1000,54,2013.0,Documentary,0 days 01:58:00.000000000,35
58,79,,Moebius,500,43,2013.0,Drama/Mystery and thriller,0 days 01:29:00.000000000,21
49,69,https://resizing.flixster.com/MXL9e6HYtn1eWVLllRDbeZWHUMw=/206x305/v2/https://flxt.tmsimg.com/assets/p10542595_p_v10_ab.jpg,Palo Alto,10000,127,2013.0,Drama,0 days 01:37:00.000000000,20
24,13,,A Promise,250,24,2013.0,Romance/Drama,0 days 01:35:00.000000000,-11
75,83,,Rhymes for Young Ghouls,250,6,2013.0,Drama,0 days 01:26:00.000000000,8
41,77,,Salvation Army,100,13,2013.0,Gay and lesbian/Drama,0 days 01:22:00.000000000,36
77,90,,Siddharth,250,41,2013.0,Drama,0 days 01:36:00.000000000,13
50,43,https://resizing.flixster.com/2dGS8KuC2UiKOq6OxkNA9VypgG8=/206x305/v2/https://flxt.tmsimg.com/assets/p10596111_p_v13_am.jpg,Words and Pictures,2500,94,2013.0,Romance/Comedy,0 days 01:51:00.000000000,-7
57,100,https://resizing.flixster.com/fs7HrnDuKvF53ixE-E-fHQWaBho=/206x305/v2/https://flxt.tmsimg.com/assets/p10756446_p_v8_aa.jpg,The Pleasures of Being Out of Step,100,16,2013.0,Documentary,0 days 01:27:00.000000000,43
64,84,,These Final Hours,5000,58,2013.0,Mystery and thriller/Sci fi,0 days 01:27:00.000000000,20
53,86,,Stray Dogs,250,36,2013.0,Drama,0 days 02:18:00.000000000,33
80,100,,The Amazing Catfish,500,8,2013.0,Comedy/Drama,0 days 01:29:00.000000000,20
38,67,,Around the Block,250,9,2013.0,Drama,0 days 01:44:00.000000000,29
77,89,,Eastern Boys,500,37,2013.0,Gay and lesbian/Drama,0 days 02:08:00.000000000,12
23,27,,The Last of Robin Hood,1000,66,2013.0,Romance/Drama,0 days 01:32:00.000000000,4
39,48,,Premature,500,21,2014.0,Comedy/Fantasy,0 days 01:33:00.000000000,9
69,71,,Wolf,50,7,2013.0,Action,0 days 02:03:00.000000000,2
73,67,,Project Wild Thing,50,6,2013.0,Documentary/Drama,0 days 01:23:00.000000000,-6
82,76,,Plot for Peace,100,17,2013.0,Documentary/Drama,0 days 01:24:00.000000000,-6
63,83,,The Galapagos Affair: Satan Came to Eden,1000,53,2014.0,Crime/Drama,0 days 02:00:00.000000000,20
51,7,,Addicted,10000,14,2014.0,Drama/Mystery and thriller,0 days 01:45:00.000000000,-44
30,12,https://resizing.flixster.com/X3BEt8HubzoigkW7NryOaTBQYmU=/206x305/v2/https://flxt.tmsimg.com/assets/p10688488_p_v10_ag.jpg,Mortdecai,25000,112,2015.0,Comedy/Adventure,0 days 01:46:00.000000000,-18
35,22,,Jake Squared,100,9,2013.0,Comedy/Drama,0 days 01:40:00.000000000,-13
55,35,https://resizing.flixster.com/Ys-MCChlQ2i-bNSKIleckoLjFUQ=/206x305/v2/https://flxt.tmsimg.com/assets/p10479443_p_v10_al.jpg,The Giver,50000,169,2014.0,Action/Sci fi,0 days 01:37:00.000000000,-20
42,21,https://resizing.flixster.com/Z6h3BuvJi4XsxDh1q6j0GCo7C2g=/206x305/v2/https://flxt.tmsimg.com/assets/p10479247_p_v10_aa.jpg,Into the Storm,25000,159,2014.0,Mystery and thriller/Action,0 days 01:29:00.000000000,-21
39,74,https://resizing.flixster.com/KANbob8imU7eX3srVXGWlkHgEZw=/206x305/v2/https://flxt.tmsimg.com/assets/p10616168_p_v10_aa.jpg,Memphis,250,27,2013.0,Drama,0 days 01:19:00.000000000,35
34,84,,Whitewash,250,25,2013.0,Comedy/Drama,0 days 01:30:00.000000000,50
67,100,,LFO,100,6,2013.0,Sci fi/Drama,0 days 01:34:00.000000000,33
44,85,,Exhibition,500,33,2013.0,Drama,0 days 01:44:00.000000000,41
65,81,,Island of Lemurs: Madagascar,10000,37,2014.0,Documentary,0 days 00:40:00.000000000,16
84,94,,Toy Story of Terror!,2500,16,2013.0,,,10
43,69,,Ragnarok,500,13,2013.0,Action/Adventure,0 days 01:40:00.000000000,26
85,81,https://resizing.flixster.com/vE5cRs_CjjuTCMAB9tvMFbpWoG8=/206x305/v2/https://flxt.tmsimg.com/assets/p10372532_p_v10_aa.jpg,The Fault in Our Stars,100000,226,2014.0,Romance/Drama,0 days 02:06:00.000000000,-4
42,56,,Decoding Annie Parker,500,25,2013.0,Drama,0 days 01:31:00.000000000,14
52,86,,The Empty Hours,250,7,2013.0,Romance,0 days 01:40:00.000000000,34
70,29,https://resizing.flixster.com/mwIRGnMETw85K6h1RtkLlexm-ao=/206x305/v2/https://flxt.tmsimg.com/assets/p10323867_p_v8_ab.jpg,50 to 1,1000,7,2014.0,Drama,0 days 01:50:00.000000000,-41
84,80,,The Theory of Everything,50000,272,2014.0,Romance/Drama,0 days 02:03:00.000000000,-4
30,71,https://resizing.flixster.com/KZIYQYvje4iTGQwfje9UloOl-CE=/206x305/v2/https://flxt.tmsimg.com/assets/p10254831_p_v13_ab.jpg,Delivery,250,7,2013.0,Horror/Mystery and thriller,0 days 01:27:00.000000000,41
80,88,https://resizing.flixster.com/dbrpbuOCABkSSXA_ByWKWFK2rrY=/206x305/v2/https://flxt.tmsimg.com/assets/p10491527_p_v10_ac.jpg,Dragon Ball Z: Battle of Gods,5000,8,2013.0,Fantasy/Action,0 days 01:25:00.000000000,8
76,67,,Winter in the Blood,100,12,2013.0,Drama,0 days 01:38:00.000000000,-9
21,10,,The Longest Week,2500,20,2014.0,Romance,0 days 01:26:00.000000000,-11
61,21,,White Rabbit,250,14,2013.0,Drama,0 days 01:30:00.000000000,-40
73,92,https://resizing.flixster.com/mrl4w0rvMLApN5041IjvKpoH6Mk=/206x305/v2/https://flxt.tmsimg.com/assets/p10389995_p_v10_aa.jpg,Kids for Cash,2500,36,2013.0,Crime/Documentary,0 days 01:42:00.000000000,19
75,88,,Wild,50000,276,2014.0,Drama/Adventure,0 days 01:55:00.000000000,13
31,18,,Jinn,2500,11,2014.0,Mystery and thriller,0 days 01:37:00.000000000,-13
80,97,,Paddington,50000,163,2014.0,Comedy/Kids and family,0 days 01:35:00.000000000,17
86,67,,Life Inside Out,50,9,2013.0,Drama,0 days 01:43:00.000000000,-19
38,20,,Autumn Blood,100,5,2013.0,Mystery and thriller,0 days 01:40:00.000000000,-18
79,73,,Patema Inverted,500,15,2013.0,Animation/Adventure,0 days 01:39:00.000000000,-6
75,100,,Levitated Mass: The Story of Michael Heizer's Monolithic Sculpture,100,6,2014.0,,,25
53,67,,A Walk Among the Tombstones,25000,163,2014.0,Crime/Action,0 days 01:54:00.000000000,14
40,37,,Before I Go to Sleep,10000,120,2014.0,Drama/Mystery and thriller,0 days 01:32:00.000000000,-3
45,51,,Magic in the Moonlight,10000,189,2014.0,Romance,0 days 01:37:00.000000000,6
66,71,https://resizing.flixster.com/RmgBwMEz16N1yY90oBxzPtMucaQ=/206x305/v2/https://flxt.tmsimg.com/assets/p10229317_p_v13_ai.jpg,A Thousand Times Goodnight,1000,55,2013.0,Drama/War,0 days 01:57:00.000000000,5
39,88,,Savaged,250,8,2013.0,Action/Horror,0 days 01:31:00.000000000,49
70,63,,Magical Universe,100,8,2013.0,Documentary,0 days 01:18:00.000000000,-7
77,94,,Living Is Easy With Eyes Closed,500,16,2013.0,Drama,0 days 01:48:00.000000000,17
59,12,https://resizing.flixster.com/MDitx0U7ZZ_i-v1ZAEZ2Y6v8sjo=/206x305/v2/https://flxt.tmsimg.com/assets/p10569607_p_v10_aj.jpg,The Best of Me,25000,83,2014.0,Romance/Drama,0 days 01:58:00.000000000,-47
59,17,,One Small Hitch,250,6,2013.0,Romance,0 days 01:44:00.000000000,-42
42,17,,Saving Santa,250,6,2013.0,Other/Kids and family,0 days 01:24:00.000000000,-25
32,17,,The Protector 2,2500,23,2013.0,Action/Sports and fitness,0 days 01:44:00.000000000,-15
29,33,,Drones,100,6,2013.0,Mystery and thriller,0 days 01:39:00.000000000,4
26,13,,Hot Tub Time Machine 2,25000,109,2015.0,Comedy/Fantasy,0 days 01:33:00.000000000,-13
50,71,,Web Junkie,100,24,2013.0,Drama/Biography,0 days 01:14:00.000000000,21
52,25,,Burning Blue,100,12,2014.0,Gay and lesbian/Drama,0 days 01:44:00.000000000,-27
38,50,,The Scribbler,250,14,2014.0,Action/Sci fi,0 days 01:30:00.000000000,12
57,77,,Algorithms,100,13,2013.0,Documentary,0 days 01:40:00.000000000,20
38,60,,The Remaining,2500,10,2014.0,Horror/Mystery and thriller,0 days 01:23:00.000000000,22
80,84,https://resizing.flixster.com/LyQ6bNFBKfhOYozIGs3ESXPsqQA=/206x305/v2/https://flxt.tmsimg.com/assets/p10615714_p_v13_an.jpg,Lilting,1000,55,2014.0,Gay and lesbian/Drama,0 days 01:31:00.000000000,4
38,33,,Anna,500,21,2013.0,Sci fi/Mystery and thriller,0 days 01:38:00.000000000,-5
81,88,,Coherence,5000,89,2013.0,Sci fi/Mystery and thriller,0 days 01:29:00.000000000,7
59,54,https://resizing.flixster.com/990_PiVT88dr89Ilnx6M1c8eCG0=/206x305/v2/https://flxt.tmsimg.com/assets/p10372732_p_v8_ab.jpg,Frontera,1000,24,2013.0,Drama,0 days 01:43:00.000000000,-5
23,0,,The Prince,2500,10,2014.0,Crime/Action,0 days 01:31:00.000000000,-23
33,12,,The Boy Next Door,25000,138,2015.0,Mystery and thriller,0 days 01:30:00.000000000,-21
66,77,https://resizing.flixster.com/mBSaYeP1kepzmce7zHa06MPQkrY=/206x305/v2/https://flxt.tmsimg.com/assets/p10760393_p_v8_ak.jpg,The Boy With the Cuckoo-Clock Heart,500,13,2013.0,Fantasy/Adventure,0 days 01:34:00.000000000,11
76,100,,Jingle Bell Rocks!,100,7,2013.0,Other/Documentary,0 days 01:34:00.000000000,24
45,38,,Two Night Stand,5000,47,2014.0,Romance/Comedy,0 days 01:26:00.000000000,-7
75,83,,Beyond the Lights,10000,93,2014.0,Romance/Drama,0 days 01:56:00.000000000,8
88,81,,As the Palaces Burn,100,16,2014.0,Documentary/Music,0 days 02:00:00.000000000,-7
62,31,,Cas & Dylan,100,13,2013.0,Comedy/Drama,0 days 01:30:00.000000000,-31
42,28,,Deliver Us From Evil,25000,134,2014.0,Horror/Mystery and thriller,0 days 01:57:00.000000000,-14
44,33,,"Men, Women & Children",5000,138,2014.0,Drama,0 days 01:59:00.000000000,-11
63,75,,Camp X-Ray,5000,59,2014.0,Drama,0 days 01:57:00.000000000,12
72,92,,Frank,10000,165,2014.0,Comedy/Drama,0 days 01:35:00.000000000,20
66,93,https://resizing.flixster.com/1Dh5-PR4iIlVMag78FupFC8pr4g=/206x305/v2/https://flxt.tmsimg.com/assets/p10705131_p_v10_ak.jpg,Love Is Strange,10000,177,2014.0,Gay and lesbian/Drama,0 days 01:34:00.000000000,27
57,87,,The Trip to Italy,5000,133,2014.0,Comedy,0 days 01:46:00.000000000,30
57,75,,The Voices,10000,96,2014.0,Comedy/Horror,0 days 01:43:00.000000000,18
70,80,,Whitey: United States of America v. James J. Bulger,500,50,2014.0,Documentary,0 days 01:47:00.000000000,10
34,49,,Young Ones,1000,35,2014.0,Sci fi/Drama,0 days 01:39:00.000000000,15
43,54,,White Bird in a Blizzard,5000,90,2014.0,Drama/Mystery and thriller,0 days 01:30:00.000000000,11
66,53,,Under the Electric Sky,100,15,2014.0,Documentary,0 days 01:25:00.000000000,-13
76,82,https://resizing.flixster.com/dRpJ1TUducOnMCQKmlXpMehcW2k=/206x305/v2/https://flxt.tmsimg.com/assets/p10498594_p_v8_ab.jpg,The One I Love,10000,93,2014.0,Romance/Fantasy,0 days 01:31:00.000000000,6
76,86,,Watchers of the Sky,500,21,2014.0,Documentary,0 days 02:00:00.000000000,10
94,94,,Whiplash,50000,298,2014.0,Drama/Music,0 days 01:46:00.000000000,0
75,90,,To Be Takei,2500,49,2014.0,Documentary/Gay and lesbian,0 days 01:33:00.000000000,15
73,61,,Through a Lens Darkly: Black Photographers and the Emergence of a People,100,18,2014.0,Documentary,0 days 01:30:00.000000000,-12
38,61,,The Signal,10000,92,2014.0,Sci fi/Mystery and thriller,0 days 01:37:00.000000000,23
81,84,,Rich Hill,1000,51,2014.0,Documentary,0 days 01:31:00.000000000,3
32,59,https://resizing.flixster.com/BVCn3eXJLb2xsbknSmm8rDNHMbk=/206x305/v2/https://flxt.tmsimg.com/assets/p10691857_p_v10_aa.jpg,Ping Pong Summer,500,34,2014.0,Comedy,0 days 01:32:00.000000000,27
85,97,,The Overnighters,2500,73,2014.0,Documentary/Drama,0 days 01:41:00.000000000,12
72,90,https://resizing.flixster.com/A20-k_Bw4Ch42aSKjA_fLIj5vRE=/206x305/v2/https://flxt.tmsimg.com/assets/p10510318_p_v10_aa.jpg,Obvious Child,10000,167,2014.0,Comedy,0 days 01:23:00.000000000,18
50,49,,Low Down,500,49,2014.0,Drama,0 days 01:58:00.000000000,-1
54,82,https://resizing.flixster.com/pxg572ByThiovvDW9gYYcBWhzjg=/206x305/v2/https://flxt.tmsimg.com/assets/p10867126_p_v10_aa.jpg,Listen Up Philip,2500,133,2014.0,Drama/Comedy,0 days 01:49:00.000000000,28
88,98,,Life Itself,10000,202,2014.0,Documentary,0 days 02:00:00.000000000,10
31,45,,Life After Beth,5000,96,2014.0,Comedy/Horror,0 days 01:30:00.000000000,14
84,95,https://resizing.flixster.com/QLhOWlIbsayj5xWTl9rLAr3Enxk=/206x305/v2/https://flxt.tmsimg.com/assets/p10703693_p_v10_ac.jpg,Last Days in Vietnam,5000,62,2014.0,War/Documentary,0 days 01:38:00.000000000,11
54,82,,Land Ho!,1000,91,2014.0,Comedy/Adventure,0 days 01:34:00.000000000,28
50,65,,Laggies,5000,117,2014.0,Romance/Comedy,0 days 01:40:00.000000000,15
45,59,,Jamie Marks Is Dead,250,17,2014.0,Horror/Drama,0 days 01:41:00.000000000,14
57,42,https://resizing.flixster.com/8LMb3-A7GfzOz09L7FHErPRaV9I=/206x305/v2/https://flxt.tmsimg.com/assets/p10438552_p_v10_ao.jpg,Step Up: All In,25000,52,2014.0,Drama,0 days 01:52:00.000000000,-15
75,12,,God's Not Dead,25000,26,2014.0,Drama,0 days 01:53:00.000000000,-63
91,93,https://resizing.flixster.com/bJWms-eEQNMi2F9eW-EJQyHNxNw=/206x305/v2/https://flxt.tmsimg.com/assets/p10669728_p_v10_aa.jpg,The Internet's Own Boy: The Story of Aaron Swartz,2500,60,2014.0,Documentary,0 days 01:45:00.000000000,2
16,29,,I Am Happiness on Earth,100,7,2014.0,Gay and lesbian/Drama,0 days 02:02:00.000000000,13
69,53,https://resizing.flixster.com/7iY5n8FfmUfttGU7pd1EqAGh_6c=/206x305/v2/https://flxt.tmsimg.com/assets/p10704263_p_v10_ar.jpg,I Origins,5000,106,2014.0,Sci fi/Drama,0 days 01:57:00.000000000,-16
37,76,,Happy Christmas,5000,79,2014.0,Other/Drama,0 days 01:18:00.000000000,39
69,91,https://resizing.flixster.com/wff96rZ1p53NM8veeX0M0G_PEJ4=/206x305/v2/https://resizing.flixster.com/baJYPVIuelb-M9oK7OFQU5D4AAQ=/ems.ZW1zLXByZC1hc3NldHMvbW92aWVzLzhhZDQ5ZWM1LWRjNTAtNGY3Yi1hZjlkLTI5NTMyMzQ3MmY0MS53ZWJw,The Guest,10000,116,2014.0,Mystery and thriller/Comedy,0 days 01:39:00.000000000,22
83,77,,The Green Prince,1000,52,2014.0,Documentary/Biography,0 days 01:35:00.000000000,-6
32,37,,God's Pocket,1000,98,2014.0,Comedy/Drama,0 days 01:28:00.000000000,5
59,67,,God Help the Girl,2500,76,2014.0,Romance/Drama,0 days 01:51:00.000000000,8
75,96,,A Girl Walks Home Alone at Night,10000,134,2014.0,Horror/Mystery and thriller,0 days 01:45:00.000000000,21
68,59,,Finding Fela,250,56,2014.0,Documentary,0 days 02:00:00.000000000,-9
84,80,https://resizing.flixster.com/0eCAR4Ic9VNdEvtJ4MYkAoYERZk=/206x305/v2/https://flxt.tmsimg.com/assets/p10558585_p_v13_ad.jpg,Fed Up,10000,70,2014.0,Documentary,0 days 01:32:00.000000000,-4
76,73,,Dinosaur 13,1000,49,2014.0,Documentary,0 days 01:46:00.000000000,-3
61,91,,Dear White People,10000,135,2014.0,Comedy/Drama,0 days 01:46:00.000000000,30
68,81,,Dead Snow: Red vs. Dead,5000,31,2014.0,Comedy/Horror,0 days 01:40:00.000000000,13
71,90,,Concerning Violence,250,31,2014.0,Drama,0 days 01:18:00.000000000,19
67,84,,Cold in July,10000,116,2014.0,Drama/Mystery and thriller,0 days 01:49:00.000000000,17
72,98,,The Babadook,25000,239,2014.0,Horror/Mystery and thriller,0 days 01:33:00.000000000,26
65,95,,Appropriate Behavior,1000,59,2014.0,Comedy/Gay and lesbian,0 days 01:26:00.000000000,30
78,95,https://resizing.flixster.com/qgsvQmyCr6az3aO2oM8Kjj29ZB4=/206x305/v2/https://flxt.tmsimg.com/NowShowing/137642/137642_aa.jpg,"20,000 Days on Earth",2500,87,2014.0,Drama,0 days 01:37:00.000000000,17
8,17,,Jersey Shore Massacre,100,12,2014.0,Comedy/Horror,0 days 01:28:00.000000000,9
36,45,https://resizing.flixster.com/O_vEJ_5nhIrYgIDL4qIB0y7dEjw=/206x305/v2/https://flxt.tmsimg.com/assets/p10905368_p_v13_ai.jpg,Tusk,10000,132,2014.0,Horror,0 days 01:41:00.000000000,9
91,89,,The Imitation Game,100000,285,2014.0,Gay and lesbian/Drama,0 days 01:53:00.000000000,-2
30,60,,Three Night Stand,250,10,2013.0,Romance,0 days 01:26:00.000000000,30
77,81,https://resizing.flixster.com/vT-7b3zo9_oCSmN3vlS32BfSD5c=/206x305/v2/https://flxt.tmsimg.com/assets/p10912080_p_v10_ad.jpg,Human Capital,2500,67,2013.0,Drama,0 days 01:49:00.000000000,4
36,72,,"If You Don't, I Will",100,18,2014.0,Comedy,0 days 01:42:00.000000000,36
14,24,,Cabin Fever: Patient Zero,500,21,2014.0,Horror/Mystery and thriller,0 days 01:34:00.000000000,10
53,100,,The Samurai,100,9,2014.0,Horror/Fantasy,0 days 01:20:00.000000000,47
77,91,,Birdman or (The Unexpected Virtue of Ignorance),50000,354,2014.0,Comedy/Drama,0 days 01:59:00.000000000,14
47,26,,Brick Mansions,25000,99,2014.0,Drama/Action,0 days 01:30:00.000000000,-21
70,89,https://resizing.flixster.com/t2tq9lZnfyMz6UkwtA7zhV2D1p4=/206x305/v2/https://flxt.tmsimg.com/assets/p11200869_p_v8_aa.jpg,Happy Valley,1000,35,2014.0,Documentary/Drama,0 days 01:38:00.000000000,19
65,73,https://resizing.flixster.com/i-TCXBoYrnO79PYUNd-ghhy30t0=/206x305/v2/https://flxt.tmsimg.com/assets/p10945561_p_v10_ab.jpg,Killers,1000,15,2014.0,Crime/Horror,0 days 02:17:00.000000000,8
90,100,,The Tale of the Princess Kaguya,10000,96,2013.0,Fantasy/Anime,0 days 02:17:00.000000000,10
51,18,,Let's Be Cops,50000,83,2014.0,Comedy/Action,0 days 01:44:00.000000000,-33
76,89,https://resizing.flixster.com/f4EjoSEW9NiGKlWbLVZgpPXwdAc=/206x305/v2/https://flxt.tmsimg.com/assets/p10487634_p_v10_ab.jpg,The Drop,10000,201,2014.0,Crime/Drama,0 days 01:47:00.000000000,13
36,33,,I'll Follow You Down,250,9,2013.0,Sci fi/Mystery and thriller,0 days 01:32:00.000000000,-3
36,29,,Annabelle,25000,134,2014.0,Horror/Mystery and thriller,0 days 01:38:00.000000000,-7
56,97,https://resizing.flixster.com/_NwfpAgjKtJeAfH_nGlDSIgp5jQ=/206x305/v2/https://flxt.tmsimg.com/assets/p10780026_p_v10_aa.jpg,Mr. Turner,10000,193,2014.0,Drama/History,0 days 02:29:00.000000000,41
43,62,https://resizing.flixster.com/91_o05MIERyNqIxYw9Q51hjPIC0=/206x305/v2/https://flxt.tmsimg.com/assets/p10912476_p_v10_ay.jpg,My Old Lady,2500,93,2014.0,Comedy/Drama,0 days 01:47:00.000000000,19
80,97,/assets/pizza-pie/images/poster_default.c8c896e70c3.gif,Boyhood,50000,326,2014.0,Drama,0 days 02:45:00.000000000,17
40,72,,Beloved Sisters,250,43,2014.0,Drama/History,0 days 02:20:00.000000000,32
69,89,,A Most Violent Year,25000,227,2014.0,Crime/Drama,0 days 02:04:00.000000000,20
75,84,https://resizing.flixster.com/twYl6acq0yd54hAP5U0VlywPhKU=/206x305/v2/https://flxt.tmsimg.com/assets/p11111906_p_v13_at.jpg,Predestination,10000,111,2014.0,Action/Sci fi,0 days 01:37:00.000000000,9
79,72,https://resizing.flixster.com/KishVbGjM8xc2i4I0J-ueT0pY5g=/206x305/v2/https://flxt.tmsimg.com/assets/p10670396_p_v8_ab.jpg,The Hornet's Nest,2500,18,2014.0,Documentary/History,0 days 01:35:00.000000000,-7
46,40,,John Doe: Vigilante,250,5,2014.0,Crime/Drama,0 days 01:33:00.000000000,-6
63,29,,The Wedding Ringer,25000,112,2015.0,Comedy,0 days 01:41:00.000000000,-34
66,20,,Moms' Night Out,10000,44,2014.0,Comedy,0 days 01:39:00.000000000,-46
44,12,https://resizing.flixster.com/BkGx4gt1KEzgMxnkqEB6fdzuhXc=/206x305/v2/https://flxt.tmsimg.com/assets/p10988874_p_v13_bf.jpg,Taken 3,50000,122,2014.0,Action/Mystery and thriller,0 days 01:49:00.000000000,-32
24,6,https://resizing.flixster.com/BWH4yN8irpf-vGbKITstrYpSInk=/206x305/v2/https://flxt.tmsimg.com/assets/p10542827_p_v10_an.jpg,Ouija,25000,89,2014.0,Horror/Mystery and thriller,0 days 01:25:00.000000000,-18
52,21,,Shirin in Love,100,14,2014.0,Romance,0 days 01:44:00.000000000,-31
9,17,,Ironclad: Battle for Blood,250,12,2014.0,Action/Drama,0 days 01:48:00.000000000,8
36,10,https://resizing.flixster.com/eiSbtokC8jv2Iu7lQRQiAZrkV9Y=/206x305/v2/https://flxt.tmsimg.com/assets/p11436510_p_v10_ad.jpg,The Cobbler,5000,72,2014.0,Fantasy/Comedy,0 days 01:39:00.000000000,-26
42,76,,Life of Riley,100,29,2014.0,Comedy,0 days 01:48:00.000000000,34
21,28,,Bad Johnson,500,18,2014.0,Comedy/Fantasy,0 days 01:28:00.000000000,7
70,48,,You're Not You,1000,23,2014.0,Drama,0 days 01:42:00.000000000,-22
82,75,https://resizing.flixster.com/JmeUGneQT0xcMHUKM1dPElmtirk=/206x305/v2/https://flxt.tmsimg.com/assets/p10571621_p_v8_aa.jpg,Leave the World Behind,100,8,2014.0,Documentary/Music,0 days 01:35:00.000000000,-7
77,53,,The Fluffy Movie,10000,15,2014.0,Comedy,0 days 01:41:00.000000000,-24
85,91,https://resizing.flixster.com/OCp0BwfncpULvqzowa_Fi63W0cE=/206x305/v2/https://flxt.tmsimg.com/assets/p11050828_p_v8_aa.jpg,Food Chains,250,11,2014.0,Documentary,0 days 01:22:00.000000000,6
88,94,,The Normal Heart,5000,50,2014.0,Gay and lesbian/Drama,0 days 02:15:00.000000000,6
31,70,,Zombeavers,2500,37,2014.0,Comedy/Horror,0 days 01:17:00.000000000,39
12,8,https://resizing.flixster.com/gvmnmycl33hFSsPOV7_FzSY7U0c=/206x305/v2/https://flxt.tmsimg.com/assets/p10768266_p_v10_aa.jpg,Drive Hard,250,26,2014.0,Crime/Action,0 days 01:36:00.000000000,-4
69,93,,Ai Weiwei: The Fake Case,250,27,2013.0,Documentary,0 days 01:26:00.000000000,24
27,20,https://resizing.flixster.com/952fhVw72APk3P8YR2yAbf8rqzU=/206x305/v2/https://flxt.tmsimg.com/assets/p11076769_p_v10_aa.jpg,Iceman,250,5,2014.0,Action/Sci fi,0 days 01:44:00.000000000,-7
22,12,,Good People,2500,33,2014.0,Mystery and thriller,0 days 01:31:00.000000000,-10
72,62,,Beside Still Waters,100,13,2013.0,Romance/Comedy,0 days 01:16:00.000000000,-10
58,0,,Persecuted,1000,14,2014.0,Drama/Mystery and thriller,0 days 01:31:00.000000000,-58
42,60,,All the Wilderness,250,25,2014.0,Drama,0 days 01:57:00.000000000,18
56,74,,Starry Eyes,1000,23,2014.0,Horror,0 days 01:36:00.000000000,18
46,36,,The November Man,10000,132,2014.0,Action/Mystery and thriller,0 days 01:48:00.000000000,-10
89,91,https://resizing.flixster.com/SzJkUXU_3BMbjKet1s_5mQMl9hw=/206x305/v2/https://flxt.tmsimg.com/NowShowing/140908/140908_aa.jpg,Pride,10000,150,2014.0,Comedy/Drama,0 days 01:59:00.000000000,2
64,87,,Korengal,500,38,2014.0,Documentary/Drama,0 days 01:30:00.000000000,23
22,20,,Affluenza,250,15,2014.0,Drama,0 days 01:24:00.000000000,-2
65,25,,Manny,1000,12,2014.0,Documentary,0 days 01:28:00.000000000,-40
84,38,,Farmland,100,13,2014.0,Documentary,0 days 01:17:00.000000000,-46
30,68,,Space Station 76,2500,25,2014.0,Sci fi/Comedy,0 days 01:33:00.000000000,38
64,15,https://resizing.flixster.com/dcr6IvW6UV5dBRU7m6399Ob5atY=/206x305/v2/https://flxt.tmsimg.com/assets/p10372479_p_v8_ac.jpg,Blended,50000,140,2014.0,Romance,0 days 01:57:00.000000000,-49
33,17,,Plastic,1000,30,2014.0,Action/Drama,0 days 01:42:00.000000000,-16
50,91,,"Farewell, Herr Schwarz",50,11,2014.0,Documentary,0 days 01:36:00.000000000,41
44,76,,Honeymoon,5000,58,2014.0,Mystery and thriller,0 days 01:28:00.000000000,32
29,33,,Exists,1000,24,2014.0,Horror,0 days 01:26:00.000000000,4
46,20,,The Lookalike,100,5,2014.0,Crime/Drama,0 days 01:40:00.000000000,-26
62,6,https://resizing.flixster.com/D1A40MrYXZqKuzb1h-zfpzu5QMY=/206x305/v2/https://flxt.tmsimg.com/assets/p10704881_p_v10_aa.jpg,The Identical,5000,69,2014.0,Drama,0 days 01:47:00.000000000,-56
58,80,,Cyber-Seniors,100,15,2013.0,Documentary,0 days 01:15:00.000000000,22
84,27,https://resizing.flixster.com/JNpoxv3k-CdYhZOehSu7Pn7xgjg=/206x305/v2/https://flxt.tmsimg.com/assets/p11247204_p_v10_aa.jpg,Supremacy,1000,11,2014.0,Drama/Mystery and thriller,0 days 01:46:00.000000000,-57
77,100,,The Circle,250,24,2014.0,Romance/Gay and lesbian,0 days 01:42:00.000000000,23
25,47,,Two Men in Town,100,17,2014.0,Drama,0 days 01:56:00.000000000,22
62,87,https://resizing.flixster.com/Y0-zCukdviNdZFevdXpjFXMs9Z4=/206x305/v2/https://flxt.tmsimg.com/assets/p10780281_p_v8_aa.jpg,Ballet 422,1000,45,2014.0,Documentary/Music,0 days 01:12:00.000000000,25
68,80,,Get On Up,25000,171,2014.0,Drama/Biography,0 days 02:18:00.000000000,12
89,93,,The Way He Looks,5000,42,2014.0,Romance/Gay and lesbian,0 days 01:35:00.000000000,4
43,45,,About Alex,2500,42,2014.0,Comedy/Drama,0 days 01:38:00.000000000,2
71,80,,A Brony Tale,250,10,2014.0,Documentary,0 days 01:19:00.000000000,9
49,71,https://resizing.flixster.com/ORUvcHJuxzB8TQtHON9IyQ5ymoY=/206x305/v2/https://flxt.tmsimg.com/assets/p10918291_p_v10_aa.jpg,The Canal,1000,24,2014.0,Horror/Mystery and thriller,0 days 01:32:00.000000000,22
95,67,,Champs,1000,27,2015.0,Documentary/Biography,0 days 01:25:00.000000000,-28
26,29,,Extraterrestrial,5000,38,2014.0,Comedy/Sci fi,0 days 01:41:00.000000000,3
59,10,,Just Before I Go,1000,10,2014.0,Comedy/Drama,0 days 01:30:00.000000000,-49
46,67,,Life Partners,2500,36,2014.0,Romance/Gay and lesbian,0 days 01:33:00.000000000,21
26,33,,Loitering With Intent,100,27,2014.0,Comedy/Drama,0 days 01:15:00.000000000,7
35,25,https://resizing.flixster.com/xBvIR15bykTKXg4gwIQ61VdqyaY=/206x305/v2/https://flxt.tmsimg.com/assets/p10878021_p_v10_ab.jpg,Miss Meadows,1000,20,2014.0,Comedy,0 days 01:28:00.000000000,-10
29,27,,Murder of a Cat,100,11,2014.0,Comedy/Mystery and thriller,0 days 01:36:00.000000000,-2
71,72,https://resizing.flixster.com/utSQWhdCNYoZn8_D0YYmj1mSPMQ=/206x305/v2/https://flxt.tmsimg.com/assets/p10732984_p_v13_aa.jpg,Point and Shoot,500,54,2014.0,Documentary,0 days 00:55:00.000000000,1
23,58,https://resizing.flixster.com/bFjK8U11rFfZ_JCXQXJSWXfd9Vo=/206x305/v2/https://flxt.tmsimg.com/assets/p10918234_p_v10_ab.jpg,Preservation,500,12,2014.0,Horror/Mystery and thriller,0 days 01:30:00.000000000,35
38,50,,Summer of Blood,100,12,2014.0,Horror,0 days 01:26:00.000000000,12
83,98,,Time Is Illmatic,1000,40,2014.0,Documentary/Drama,0 days 01:13:00.000000000,15
67,37,https://resizing.flixster.com/vXLa324UZ2Is6Dx0HwzF7ydezhI=/206x305/v2/https://flxt.tmsimg.com/assets/p10640005_p_v10_aa.jpg,Before I Disappear,1000,30,2014.0,Drama,0 days 01:39:00.000000000,-30
28,12,,Tokarev,5000,42,2014.0,Action/Mystery and thriller,0 days 01:38:00.000000000,-16
26,5,,Home Sweet Hell,2500,21,2015.0,Comedy/Mystery and thriller,0 days 01:38:00.000000000,-21
46,65,,WolfCop,500,20,2014.0,Comedy/Horror,0 days 01:19:00.000000000,19
29,0,,Behaving Badly,2500,17,2014.0,Romance,0 days 01:38:00.000000000,-29
47,88,,Goodbye to Language,2500,78,2014.0,Drama,0 days 01:10:00.000000000,41
83,87,,Winter Sleep,5000,83,2014.0,Drama,0 days 03:16:00.000000000,4
34,29,https://resizing.flixster.com/hhyCkReCaeFA7DqNml5iYRztzn8=/206x305/v2/https://flxt.tmsimg.com/assets/p11016564_p_v13_am.jpg,The Captive,100,55,2014.0,Mystery and thriller,0 days 01:52:00.000000000,-5
52,80,https://resizing.flixster.com/jKsqH3qWA3xAfKsWHCmBoPOn4aY=/206x305/v2/https://flxt.tmsimg.com/assets/p10798908_p_v13_ah.jpg,The Homesman,10000,156,2014.0,Western/Drama,0 days 02:02:00.000000000,28
74,91,,Art and Craft,1000,46,2014.0,Documentary,0 days 01:30:00.000000000,17
42,79,,Beyond Clueless,100,24,2014.0,Drama,0 days 01:29:00.000000000,37
89,88,,Mommy,5000,129,2014.0,Drama,0 days 02:19:00.000000000,-1
61,38,,Hector and the Search for Happiness,5000,87,2014.0,Comedy/Drama,0 days 01:54:00.000000000,-23
36,17,,Come Back to Me,250,6,2014.0,Horror,0 days 01:36:00.000000000,-19
93,100,,Butterfly Girl,100,6,2014.0,Documentary,0 days 01:18:00.000000000,7
51,90,,The Blue Room,1000,78,2014.0,Mystery and thriller,0 days 01:15:00.000000000,39
80,97,,Leviathan,10000,150,2014.0,Drama,0 days 02:22:00.000000000,17
44,68,,The Decent One,100,31,2014.0,Documentary/Drama,0 days 01:34:00.000000000,24
16,17,https://resizing.flixster.com/2rqGlAe4Gqbx3EEaAa9L6poL5_g=/206x305/v2/https://flxt.tmsimg.com/assets/p10912113_p_v10_ab.jpg,Monsters: Dark Continent,2500,35,2014.0,Sci fi/Mystery and thriller,0 days 01:59:00.000000000,1
40,60,,Bird People,250,35,2014.0,Romance/Drama,0 days 02:08:00.000000000,20
50,32,https://resizing.flixster.com/F-ZTqi57B8rNODg97bDwNt_9xdQ=/206x305/v2/https://flxt.tmsimg.com/assets/p10728947_p_v10_ab.jpg,Elsa & Fred,500,28,2014.0,Romance,0 days 01:44:00.000000000,-18
67,50,https://resizing.flixster.com/6kSu1uda_N1Ge-8fx59emWNUF34=/206x305/v2/https://flxt.tmsimg.com/assets/p10765445_p_v8_aa.jpg,Know How,50,6,2014.0,Drama/Musical,0 days 01:46:00.000000000,-17
86,50,,The Reckoning,100,6,2014.0,Crime/Drama,0 days 01:26:00.000000000,-36
33,52,https://resizing.flixster.com/Py1zm0cdBuMXPonWNTXOoSHlYxA=/206x305/v2/https://flxt.tmsimg.com/assets/p10880077_p_v10_ae.jpg,The Calling,2500,46,2014.0,Mystery and thriller,0 days 01:48:00.000000000,19
44,29,,4 Minute Mile,250,14,2014.0,Drama,0 days 01:36:00.000000000,-15
75,94,https://resizing.flixster.com/RI_AAYd6bIMAo0yYH_sTuegH9LE=/206x305/v2/https://flxt.tmsimg.com/assets/p10811786_p_v8_ah.jpg,Force majeure,10000,159,2014.0,Comedy/Drama,0 days 02:00:00.000000000,19
85,92,,Red Army,5000,101,2014.0,Documentary,0 days 01:25:00.000000000,7
86,54,,On Any Sunday: The Next Chapter,500,13,2014.0,Documentary/Adventure,0 days 01:34:00.000000000,-32
73,96,,Girlhood,2500,81,2014.0,Drama,0 days 01:52:00.000000000,23
92,99,,Song of the Sea,10000,97,2014.0,Animation/Fantasy,0 days 01:34:00.000000000,7
81,100,,Gett: The Trial of Viviane Amsalem,2500,80,2014.0,Drama,0 days 01:55:00.000000000,19
36,18,https://resizing.flixster.com/PFmMa46pQ3JNO5-FKllIj3lijdw=/206x305/v2/https://flxt.tmsimg.com/assets/p10759088_p_v13_ab.jpg,Video Games: The Movie,2500,17,2014.0,Documentary,0 days 01:40:00.000000000,-18
15,16,,Septic Man,100,19,2013.0,Horror,0 days 01:27:00.000000000,1
67,45,https://resizing.flixster.com/sfmO4mPBWHaWQMlasVe0nbpBjv0=/206x305/v2/https://flxt.tmsimg.com/assets/p10777871_p_v10_ad.jpg,Cantinflas,2500,20,2014.0,Drama/Biography,0 days 01:43:00.000000000,-22
82,31,,The Song,1000,13,2014.0,Drama,0 days 01:57:00.000000000,-51
30,31,https://resizing.flixster.com/k7RALyuNwrjkMk4j-LbedQgW6j8=/206x305/v2/https://flxt.tmsimg.com/assets/p10971391_p_v10_aa.jpg,Automata,2500,35,2014.0,Sci fi/Mystery and thriller,0 days 01:49:00.000000000,1
29,29,https://resizing.flixster.com/Jcy5FyNgJ6Sy4oLl1VGEfWTe4AY=/206x305/v2/https://flxt.tmsimg.com/assets/p11082074_p_v10_ad.jpg,Everly,2500,58,2014.0,Mystery and thriller/Action,0 days 01:32:00.000000000,0
84,8,,America: Imagine the World Without Her,10000,24,2014.0,Documentary,0 days 01:43:00.000000000,-76
42,66,,The Rewrite,5000,62,2014.0,Comedy/Romance,0 days 01:47:00.000000000,24
85,95,https://resizing.flixster.com/Dchd47mdNloWisMJS-gCfKfZz-s=/206x305/v2/https://flxt.tmsimg.com/assets/p10939779_p_v10_ad.jpg,Nightcrawler,50000,273,2014.0,Crime/Drama,0 days 01:57:00.000000000,10
34,38,/assets/pizza-pie/images/poster_default.c8c896e70c3.gif,Last Weekend,250,21,2014.0,Comedy/Drama,0 days 01:34:00.000000000,4
55,40,,21 Years: Richard Linklater,250,15,2014.0,Documentary,0 days 01:19:00.000000000,-15
73,95,,Housebound,5000,43,2014.0,Comedy/Horror,0 days 01:49:00.000000000,22
13,34,https://resizing.flixster.com/U0qvg-aIIZFcgYZWHWXzuYCcjq0=/206x305/v2/https://flxt.tmsimg.com/assets/p10928572_p_v7_ab.jpg,VHS: Viral,5000,32,2014.0,Horror,0 days 01:22:00.000000000,21
32,43,,Animal,500,7,2014.0,Horror,0 days 01:26:00.000000000,11
55,33,,No Tears for the Dead,250,6,2014.0,Action,0 days 01:56:00.000000000,-22
66,73,,The DUFF,25000,121,2015.0,Romance,0 days 01:36:00.000000000,7
76,75,/assets/pizza-pie/images/poster_default.c8c896e70c3.gif,TinkerBell and the Legend of the NeverBeast,1000,20,2014.0,,,-1
31,60,https://resizing.flixster.com/sLR_v9WTkdzvg2O20rpyUwjXJf0=/206x305/v2/https://flxt.tmsimg.com/assets/p11082586_p_v10_aa.jpg,See No Evil 2,500,5,2014.0,Horror,0 days 01:30:00.000000000,29
67,80,,Spanish Lake,50,5,2014.0,Documentary,0 days 01:18:00.000000000,13
31,61,,Sharknado 2: The Second One,1000,31,2014.0,Comedy/Sci fi,0 days 01:30:00.000000000,30
20,9,,Heatstroke,250,11,2013.0,Mystery and thriller,0 days 01:32:00.000000000,-11
79,88,,Boy Meets Girl,500,17,2014.0,Romance/Comedy,0 days 01:35:00.000000000,9
69,75,,Fort Bliss,500,16,2014.0,Drama,0 days 01:49:00.000000000,6
21,32,https://resizing.flixster.com/D7NGTip-xKg7yBCXE6Zv2h6b6dY=/206x305/v2/https://flxt.tmsimg.com/assets/p11006434_p_v10_aa.jpg,A Good Marriage,1000,22,2014.0,Mystery and thriller,0 days 01:43:00.000000000,11
36,50,,The Living,100,8,2014.0,Mystery and thriller,0 days 01:30:00.000000000,14
44,83,,Let Us Prey,500,12,2014.0,Horror,0 days 01:28:00.000000000,39
67,82,,Monk With a Camera: The Life and Journey of Nicholas Vreeland,250,17,2014.0,Documentary,0 days 01:30:00.000000000,15
57,94,,Last Hijack,100,16,2014.0,Documentary,0 days 01:25:00.000000000,37
85,80,,Pay 2 Play: Democracy's High Stakes,100,5,2014.0,,,-5
33,19,https://resizing.flixster.com/hZpe6YA38oWYVFZv0lswy8GWkPg=/206x305/v2/https://flxt.tmsimg.com/assets/p10956632_p_v8_ab.jpg,Innocence,1000,26,2013.0,Horror/Mystery and thriller,0 days 01:36:00.000000000,-14
82,56,,Spare Parts,5000,32,2015.0,Drama,0 days 01:53:00.000000000,-26
40,0,https://resizing.flixster.com/lEPHyjl9RmLHBnAaphFRlu22xis=/206x305/v2/https://flxt.tmsimg.com/assets/p10962787_p_v8_ab.jpg,Atlas Shrugged: Who Is John Galt?,2500,10,2014.0,Drama,0 days 01:39:00.000000000,-40
57,82,,A Master Builder,250,33,2013.0,Drama,0 days 02:07:00.000000000,25
27,0,https://resizing.flixster.com/OPSVssg_i2q9Nqpimp-OIDhttqk=/206x305/v2/https://flxt.tmsimg.com/assets/p10924879_p_v10_ae.jpg,Reclaim,500,10,2014.0,Mystery and thriller,0 days 01:36:00.000000000,-27
21,43,,At the Devil's Door,1000,23,2013.0,Horror,0 days 01:33:00.000000000,22
42,43,,Falcon Rising,500,7,2014.0,Action/Adventure,0 days 01:43:00.000000000,1
86,99,,Selma,50000,312,2014.0,Drama/History,0 days 02:08:00.000000000,13
65,38,,Black or White,10000,107,2014.0,Drama,0 days 02:01:00.000000000,-27
85,75,,Batman: Assault on Arkham,2500,8,2014.0,Animation/Action,0 days 01:15:00.000000000,-10
36,0,,Days and Nights,100,13,2013.0,Drama,0 days 01:32:00.000000000,-36
81,92,,Pelican Dreams,100,24,2014.0,Documentary,0 days 01:20:00.000000000,11
61,40,https://resizing.flixster.com/TqolYoyg3dzYFkN6vYY4yfNHk14=/206x305/v2/https://flxt.tmsimg.com/assets/p10970963_p_v8_ab.jpg,Believe Me,250,20,2014.0,Comedy/Drama,0 days 01:34:00.000000000,-21
53,71,,Kelly & Cal,250,35,2014.0,Comedy/Drama,0 days 01:49:00.000000000,18
50,40,,Field of Lost Shoes,250,5,2014.0,War/Drama,0 days 01:36:00.000000000,-10
47,67,,Found,250,6,2012.0,Horror/Mystery and thriller,0 days 01:43:00.000000000,20
31,44,,The Gambler,10000,143,2014.0,Crime/Drama,0 days 01:51:00.000000000,13
32,0,,Catch Hell,250,6,2014.0,Crime/Drama,0 days 01:38:00.000000000,-32
22,13,,The White Haired Witch of Lunar Kingdom,100,8,2014.0,Fantasy,0 days 01:44:00.000000000,-9
25,52,,Miss Julie,500,54,2014.0,Drama,0 days 02:09:00.000000000,27
68,82,,Kundo: Age of the Rampant,500,11,2014.0,Action,0 days 02:17:00.000000000,14
7,0,https://resizing.flixster.com/CK2r-CUQZ0a4hl1cuoswdUYU-Vg=/206x305/v2/https://flxt.tmsimg.com/assets/p10981343_p_v10_aa.jpg,Cam2Cam,100,8,2014.0,Horror/Mystery and thriller,0 days 01:31:00.000000000,-7
24,32,https://resizing.flixster.com/s1F_Jek9yaoYy9hEHC3fZ2dLCRM=/206x305/v2/https://flxt.tmsimg.com/assets/p10981549_p_v10_ae.jpg,Blackhat,10000,190,2015.0,Crime/Action,0 days 02:14:00.000000000,8
19,11,https://resizing.flixster.com/Xpi2oL4NYO5OF35LHhqb5AuaFcQ=/206x305/v2/https://flxt.tmsimg.com/assets/p11037058_p_v10_ac.jpg,Hit by Lightning,100,9,2014.0,Comedy,0 days 01:29:00.000000000,-8
19,40,,By the Gun,250,5,2014.0,Crime/Drama,0 days 01:49:00.000000000,21
28,53,,The Humbling,1000,64,2014.0,Comedy/Drama,0 days 01:53:00.000000000,25
63,62,https://resizing.flixster.com/3a9rVzmTMsAB4_0tc3ujcsH9JUo=/206x305/v2/https://flxt.tmsimg.com/assets/p11007467_p_v10_au.jpg,Son of a Gun,5000,76,2015.0,Crime/Drama,0 days 01:48:00.000000000,-1
42,60,,Digging Up the Marrow,500,20,2014.0,Horror/Mystery and thriller,0 days 01:28:00.000000000,18
44,62,https://resizing.flixster.com/eZoCz1TeiaCwIif9Qu4gzjeoObE=/206x305/v2/https://flxt.tmsimg.com/assets/p10915972_p_v10_ab.jpg,Late Phases,500,21,2014.0,Horror/Mystery and thriller,0 days 01:35:00.000000000,18
70,20,,Brush With Danger,50,5,2014.0,Crime/Action,0 days 01:30:00.000000000,-50
87,92,,The Kingdom of Dreams and Madness,1000,25,2013.0,Documentary,0 days 01:58:00.000000000,5
81,86,https://resizing.flixster.com/6IZ5391JPdrTumQvDabaztXZ-Io=/206x305/v2/https://flxt.tmsimg.com/NowShowing/142082/142082_ac.jpg,John Wick,50000,217,2014.0,Action/Mystery and thriller,0 days 01:41:00.000000000,5
21,14,,A Merry Friggin' Christmas,2500,21,2014.0,Other/Comedy,0 days 01:28:00.000000000,-7
13,0,,Viktor,1,7,2014.0,Action/Mystery and thriller,0 days 01:38:00.000000000,-13
75,71,,This Ain't No Mouse Music!,50,7,2013.0,Documentary,0 days 01:32:00.000000000,-4
52,57,https://resizing.flixster.com/dS1TRrHOXFWpZmHO_ooybhBmagk=/206x305/v2/https://flxt.tmsimg.com/assets/p11046298_p_v10_aa.jpg,The Pirates,250,7,2014.0,Adventure,0 days 02:10:00.000000000,5
85,85,https://resizing.flixster.com/c7C9TL4Z_gJ-PI1ZUKnCSnpEvVg=/206x305/v2/https://flxt.tmsimg.com/NowShowing/142897/142897_aa.jpg,Still Alice,25000,204,2014.0,Drama,0 days 01:37:00.000000000,0
22,4,,Outcast,1000,23,2014.0,History/Sports and fitness,0 days 01:38:00.000000000,-18
65,40,,3 Nights in the Desert,100,5,2014.0,Drama,0 days 01:30:00.000000000,-25
45,47,,Maya the Bee Movie,250,17,2014.0,Animation/Comedy,0 days 01:19:00.000000000,2
89,18,,Meet the Mormons,5000,11,2014.0,Documentary,0 days 01:18:00.000000000,-71
69,77,,Amira & Sam,500,31,2014.0,Romance/Comedy,0 days 01:28:00.000000000,8
71,85,,Spring,5000,59,2014.0,Mystery and thriller,0 days 01:49:00.000000000,14
46,62,,The World Made Straight,250,21,2015.0,Drama,0 days 01:59:00.000000000,16
57,60,,The Last Five Years,5000,104,2014.0,Romance/Musical,0 days 01:34:00.000000000,3
44,48,https://resizing.flixster.com/NP4qW1FxqhvuFTyp4udot8NzaSo=/206x305/v2/https://flxt.tmsimg.com/assets/p11069125_p_v10_ab.jpg,Cake,10000,129,2014.0,Comedy/Drama,0 days 01:42:00.000000000,4
64,85,,Top Five,25000,186,2014.0,Comedy,0 days 01:41:00.000000000,21
65,50,,"Like Sunday, Like Rain",500,18,2014.0,Drama,0 days 01:44:00.000000000,-15
71,14,,Not Cool,1000,7,2014.0,Comedy,0 days 01:33:00.000000000,-57
65,94,,The Duke of Burgundy,2500,104,2014.0,Gay and lesbian/Drama,0 days 01:46:00.000000000,29
34,68,https://resizing.flixster.com/-hJbMvxu5VbtOKpw6ybpoglc1sE=/206x305/v2/https://flxt.tmsimg.com/assets/p11226050_p_v10_ab.jpg,Rec 4: Apocalypse,1000,22,2014.0,Action/Horror,0 days 01:32:00.000000000,34
59,64,https://resizing.flixster.com/dU6VACuU9PWUaIG0JEETrWeSk90=/206x305/v2/https://flxt.tmsimg.com/assets/p11082360_p_v10_aj.jpg,I Am Ali,500,25,2014.0,Documentary/Biography,0 days 01:54:00.000000000,5
70,87,,The Mule,1000,31,2014.0,Crime/Comedy,0 days 01:42:00.000000000,17
38,33,,My Mistress,100,9,2014.0,Drama,0 days 01:44:00.000000000,-5
30,60,,The Houses October Built,500,15,2014.0,Horror,0 days 01:31:00.000000000,30
48,91,,The Taking of Deborah Logan,1000,11,2014.0,Mystery and thriller,0 days 01:30:00.000000000,43
69,67,,The Immortalists,250,12,2014.0,Documentary/Drama,0 days 01:18:00.000000000,-2
15,11,,Dying of the Light,500,37,2014.0,Action/Mystery and thriller,0 days 01:35:00.000000000,-4
12,7,,There's Always Woodstock,100,14,2014.0,Romance,0 days 01:30:00.000000000,-5
29,50,https://resizing.flixster.com/VfLp7KMiCWTtvfCbzpXiORelkVs=/206x305/v2/https://flxt.tmsimg.com/assets/p10869862_p_v10_ab.jpg,Big Driver,250,10,2014.0,Mystery and thriller,0 days 01:30:00.000000000,21
19,13,,Sword of Vengeance,100,8,2015.0,Action/Drama,0 days 01:27:00.000000000,-6
29,43,https://resizing.flixster.com/2rw1d4o5WBs0mF3EomFgn0xdHkQ=/206x305/v2/https://flxt.tmsimg.com/assets/p10572181_p_v10_aa.jpg,Killing Jesus,100,7,2015.0,Drama/History,0 days 01:30:00.000000000,14
90,86,,Love Hunter,50,7,2013.0,Drama,0 days 01:26:00.000000000,-4
84,83,https://resizing.flixster.com/yQEEqn5gSHKRo-mjX0fhp5-iw7o=/206x305/v2/https://flxt.tmsimg.com/assets/p11579953_p_v10_aa.jpg,The Seven Five,1000,29,2014.0,Documentary/Biography,0 days 01:42:00.000000000,-1
39,27,https://resizing.flixster.com/ANYrVsZrJQNe_UshMHs-arRBQyA=/206x305/v2/https://flxt.tmsimg.com/assets/p11141204_p_v10_aa.jpg,Grumpy Cat's Worst Christmas Ever,250,11,2014.0,Other/Comedy,0 days 01:25:00.000000000,-12
15,33,https://resizing.flixster.com/X1_zJihe8fY4JWDSVMpiWIbtMxE=/206x305/v2/https://flxt.tmsimg.com/assets/p11044485_p_v10_aa.jpg,After the Fall,100,15,2014.0,Crime/Drama,0 days 01:50:00.000000000,18
60,50,/assets/pizza-pie/images/poster_default.c8c896e70c3.gif,How Murray Saved Christmas,1,6,2014.0,,,-10
84,27,,Mad as Hell,250,11,2014.0,Documentary/Comedy,0 days 01:22:00.000000000,-57
90,10,,All Relative,500,10,2014.0,Romance/Comedy,0 days 01:25:00.000000000,-80
29,17,,Let's Kill Ward's Wife,500,6,2014.0,Comedy,0 days 01:32:00.000000000,-12
63,57,,Justice League: Throne of Atlantis,1000,7,2015.0,Animation/Action,0 days 01:12:00.000000000,-6
50,70,,Against the Sun,500,10,2014.0,Drama/History,0 days 01:40:00.000000000,20
21,29,,Lovesick,100,14,2014.0,Romance,0 days 01:24:00.000000000,8
52,18,https://resizing.flixster.com/tPWSx1a-HhUlTRWmR8c44mcJGtk=/206x305/v2/https://flxt.tmsimg.com/assets/p11256537_p_v10_aa.jpg,Strange Magic,10000,62,2015.0,Musical/Fantasy,0 days 01:39:00.000000000,-34
42,50,,Poker Night,250,10,2014.0,Mystery and thriller,0 days 01:45:00.000000000,8
31,18,,Free the Nipple,250,11,2014.0,Comedy,0 days 01:19:00.000000000,-13
19,45,,Da Sweet Blood of Jesus,250,44,2014.0,Comedy/Drama,0 days 02:03:00.000000000,26
15,4,,Vice,1000,27,2015.0,Action/Sci fi,0 days 01:35:00.000000000,-11
40,58,,My Life Directed By Nicolas Winding Refn,250,24,2014.0,Documentary,0 days 00:58:00.000000000,18
15,0,,Muck,250,7,2015.0,Horror,0 days 01:30:00.000000000,-15
79,100,,Li'l Quinquin,250,22,2015.0,,,21
94,100,https://resizing.flixster.com/mOWHpWnIGKh_s8JAdFjN33jo_cU=/206x305/v2/https://resizing.flixster.com/ECr6h4_TqcG9HA1Fg92AjAUcb5w=/ems.ZW1zLXByZC1hc3NldHMvbW92aWVzLzhkMTFlYTE4LWZhNDctNDQ2YS04ODY4LTYzZWYyZDMxNzM3NS5qcGc=,Bill Burr: I'm Sorry You Feel That Way,50,5,2014.0,,,6
12,14,,Nightlight,100,7,2015.0,Horror/Mystery and thriller,0 days 01:24:00.000000000,2
37,23,,Tracers,5000,30,2014.0,Action/Mystery and thriller,0 days 01:34:00.000000000,-14
66,71,,The Taking of Tiger Mountain,500,17,2014.0,Action/Adventure,0 days 02:21:00.000000000,5
37,23,,Black November,100,13,2012.0,Action/Drama,0 days 01:36:00.000000000,-14
26,0,,The Walking Deceased,250,11,2015.0,Comedy/Horror,0 days 01:28:00.000000000,-26
26,20,,The Barber,250,10,2014.0,Mystery and thriller,0 days 01:35:00.000000000,-6
43,15,,The Squeeze,100,13,2015.0,Drama/Mystery and thriller,0 days 01:35:00.000000000,-28
15,33,,Cymbeline,1000,30,2014.0,Drama,0 days 01:25:00.000000000,18
49,54,https://resizing.flixster.com/Dt_o2zzLlysukFqHeIVEU-N0uuM=/206x305/v2/https://flxt.tmsimg.com/assets/p10273484_p_v10_aa.jpg,Walter,250,13,2015.0,Drama,0 days 01:34:00.000000000,5
22,24,,Out of the Dark,500,21,2014.0,Horror/Mystery and thriller,0 days 01:32:00.000000000,2
24,19,,Kidnapping Mr. Heineken,500,64,2015.0,Crime/Drama,0 days 01:35:00.000000000,-5
65,80,,The Sisterhood of Night,500,20,2014.0,Drama,0 days 01:22:00.000000000,15
78,100,,Batman vs. Robin,1000,5,2015.0,Animation/Action,0 days 01:19:00.000000000,22
21,17,,The Intruders,250,6,2015.0,Mystery and thriller,0 days 01:30:00.000000000,-4
33,14,,Playing It Cool,1000,28,2014.0,Romance/Comedy,0 days 01:34:00.000000000,-19
39,71,,Dial a Prayer,100,7,2015.0,Comedy/Drama,0 days 01:38:00.000000000,32
23,25,,Ghoul,100,8,2015.0,Horror,0 days 01:29:00.000000000,2
33,0,,See You in Valhalla,250,6,2015.0,Comedy/Drama,0 days 01:30:00.000000000,-33
47,25,https://resizing.flixster.com/jlomGoo0hnv0xrRaVaBuwICVbUU=/206x305/v2/https://flxt.tmsimg.com/assets/p11669380_p_v10_aa.jpg,Bravetown,250,16,2015.0,Drama,0 days 01:50:00.000000000,-22
34,31,https://resizing.flixster.com/oSG1smrn_-RK6F3-Q59RGxFQ6Nc=/206x305/v2/https://flxt.tmsimg.com/assets/p11613740_p_v10_af.jpg,Infini,500,16,2015.0,Sci fi/Mystery and thriller,0 days 01:50:00.000000000,-3
82,88,https://resizing.flixster.com/buFnxxHzr5NWzRfy7MEQ6e4poFg=/206x305/v2/https://flxt.tmsimg.com/assets/p55309_p_v10_av.jpg,The Jungle Book,250000,40,1967.0,Animation/Kids and family,0 days 01:18:00.000000000,6
28,38,https://resizing.flixster.com/XPzMrFxtMCZW9uVTuXaCOuXH0SM=/206x305/v2/https://flxt.tmsimg.com/assets/p5418_p_v10_aa.jpg,Raise the Titanic,5000,8,1980.0,Adventure,0 days 01:54:00.000000000,10
27,10,,Embrace of the Vampire,10000,10,2013.0,Horror,0 days 01:30:00.000000000,-17
79,86,,Young at Heart,2500,7,1954.0,Romance/Musical,0 days 01:57:00.000000000,7
83,89,,Stella Dallas,1000,9,1937.0,Drama,0 days 01:51:00.000000000,6
75,45,,The Legend of Billie Jean,5000,11,1985.0,Drama,0 days 01:36:00.000000000,-30
34,10,https://resizing.flixster.com/Y1kX2w3i5XDHCBCq7OIfe1iGcvQ=/206x305/v2/https://flxt.tmsimg.com/assets/p11661_p_v8_ab.jpg,No Holds Barred,5000,21,1989.0,Action,0 days 01:31:00.000000000,-24
95,96,,"Sherlock, Jr.",5000,23,1924.0,Comedy/Drama,0 days 00:48:00.000000000,1
75,100,/assets/pizza-pie/images/poster_default.c8c896e70c3.gif,Master of the House,500,7,1925.0,Comedy/Drama,0 days 01:58:00.000000000,25
52,28,https://resizing.flixster.com/IYUoGdwgg9iHLp8jCeZodR0VaNI=/206x305/v2/https://flxt.tmsimg.com/assets/p3050_p_v8_am.jpg,Endless Love,5000,18,1981.0,Romance/Drama,0 days 01:55:00.000000000,-24
65,79,,Twins of Evil,1000,19,1971.0,Horror,0 days 01:25:00.000000000,14
50,0,,Boss,500,5,2013.0,Action/Comedy,0 days 02:23:00.000000000,-50
65,100,,Mischief Night,1000,5,2006.0,Comedy/Drama,0 days 01:33:00.000000000,35
81,71,,The Secret Life of Walter Mitty,2500,7,1947.0,Comedy,0 days 01:48:00.000000000,-10
95,100,https://resizing.flixster.com/1gxjFagGGcQHwk8bqU5wa4Z5x4w=/206x305/v2/https://flxt.tmsimg.com/assets/p3676_p_v8_ab.jpg,Investigation of a Citizen Above Suspicion,1000,15,1970.0,Crime/Drama,0 days 01:55:00.000000000,5
80,20,,Ode to Billy Joe,500,5,1976.0,Gay and lesbian/Drama,0 days 01:46:00.000000000,-60
83,100,https://resizing.flixster.com/gxvFJx1a5XFdm8gk43Z7V7G1XCU=/206x305/v2/https://flxt.tmsimg.com/assets/p2332_p_v8_ac.jpg,A New Leaf,1000,36,1971.0,Comedy,0 days 01:42:00.000000000,17
65,97,,Home of the Brave,250,38,1949.0,War,0 days 01:25:00.000000000,32
90,100,,Mickey's Christmas Carol,2500,7,1983.0,Fantasy/Other,0 days 00:25:00.000000000,10
78,100,,Caught,500,9,1949.0,Drama,0 days 01:28:00.000000000,22
92,94,,The Lovely Month of May,250,16,1963.0,Documentary,0 days 02:04:00.000000000,2
31,46,,All the Boys Love Mandy Lane,25000,68,2006.0,Horror/Mystery and thriller,0 days 01:30:00.000000000,15
91,100,,The Big Parade,500,12,1925.0,War,0 days 02:06:00.000000000,9
76,100,,Sometimes a Great Notion,500,14,1970.0,Drama,0 days 01:54:00.000000000,24
65,62,https://resizing.flixster.com/9qC_KPlyzV-eIJmig9twSLofEos=/206x305/v2/https://flxt.tmsimg.com/assets/p9983313_p_v10_ak.jpg,Ender's Game,100000,224,2013.0,Action/Sci fi,0 days 01:54:00.000000000,-3
74,89,,Men in War,250,9,1957.0,War,0 days 01:44:00.000000000,15
81,95,,A Brief History of Time,1000,19,1992.0,Documentary,0 days 01:24:00.000000000,14
39,57,,Curtains,500,7,1983.0,Horror,0 days 01:29:00.000000000,18
36,75,https://resizing.flixster.com/SKr4BymsPjTcwlXHW6VEimyThqc=/206x305/v2/https://flxt.tmsimg.com/assets/p190474_p_v8_aa.jpg,Fear and Desire,1000,16,1953.0,Drama/War,0 days 01:08:00.000000000,39
81,100,,Summer Interlude,500,11,1950.0,Drama,0 days 01:34:00.000000000,19
83,81,,Face to Face,500,16,1975.0,Drama,0 days 02:16:00.000000000,-2
34,40,,Who Is Harry Kellerman and Why Is He Saying Those Terrible Things About Me?,250,5,1971.0,Comedy/Drama,0 days 01:48:00.000000000,6
72,80,,Pete 'n' Tillie,100,5,1972.0,Comedy/Drama,0 days 01:40:00.000000000,8
82,90,,Judex,250,10,1963.0,Drama,0 days 01:35:00.000000000,8
41,42,https://resizing.flixster.com/7e1pauuCR3N_hWTtL7wnQUh_9EM=/206x305/v2/https://flxt.tmsimg.com/assets/p9076_p_v8_aa.jpg,Skidoo,250,12,1968.0,Comedy,0 days 01:37:00.000000000,1
36,38,,Stick,250,8,1985.0,Crime/Drama,0 days 01:49:00.000000000,2
79,94,,The Freshman,250,16,1925.0,Comedy,0 days 01:10:00.000000000,15
75,56,https://resizing.flixster.com/9COcGeKTdYzgXu8Lh-23kWEGcUY=/206x305/v2/https://flxt.tmsimg.com/assets/p9259673_p_v10_an.jpg,Man of Steel,250000,337,2013.0,Fantasy/Action,0 days 02:23:00.000000000,-19
94,100,/assets/pizza-pie/images/poster_default.c8c896e70c3.gif,The Easy Life,500,7,2011.0,Comedy,0 days 01:42:00.000000000,6
69,95,,I Married a Witch,500,22,1942.0,Fantasy,0 days 01:16:00.000000000,26
76,68,https://resizing.flixster.com/paKI2MGoyLfX6iDs5Jz18JhQoms=/206x305/v2/https://flxt.tmsimg.com/assets/p8198671_p_v13_ab.jpg,Mr. Nobody,25000,31,2009.0,Sci fi/Drama,0 days 02:17:00.000000000,-8
50,40,,The Strange Woman,100,5,1946.0,Drama,0 days 01:40:00.000000000,-10
25,29,,Deadly Eyes,100,7,1982.0,Horror,0 days 01:27:00.000000000,4
78,83,/assets/pizza-pie/images/poster_default.c8c896e70c3.gif,Separate But Equal,100,6,1991.0,,,5
71,89,https://resizing.flixster.com/jFV-2I4Qxi2UlUIRx4mnmshxE2A=/206x305/v2/https://flxt.tmsimg.com/assets/p9864040_p_v8_aa.jpg,The World's End,50000,243,2013.0,Comedy/Sci fi,0 days 01:49:00.000000000,18
72,66,https://resizing.flixster.com/a2nKfzjSmQTKgrAAcHItXsoxUjI=/206x305/v2/https://flxt.tmsimg.com/assets/p9087912_p_v10_av.jpg,World War Z,250000,278,2013.0,Horror/Adventure,0 days 01:55:00.000000000,-6
67,33,,Dear Heart,100,6,1965.0,Comedy,0 days 01:54:00.000000000,-34
61,60,,Good Sam,50,5,1948.0,Comedy,0 days 01:53:00.000000000,-1
30,0,,I Spit on Your Grave 2,1000,9,2013.0,Horror,0 days 01:40:00.000000000,-30
86,73,,Prayers for Bobby,1000,15,2009.0,Drama,0 days 01:30:00.000000000,-13
49,48,,RoboCop,100000,221,2014.0,Action/Sci fi,0 days 01:57:00.000000000,-1
91,64,,Far From Vietnam,50,11,1967.0,Documentary,0 days 01:50:00.000000000,-27
62,100,,Strongman,500,17,2009.0,Documentary,0 days 01:53:00.000000000,38
76,100,,Riot in Cell Block 11,100,15,1954.0,Action,0 days 01:20:00.000000000,24
45,14,,St Trinian's 2: The Legend of Fritton's Gold,25000,21,2009.0,Comedy/Adventure,0 days 01:46:00.000000000,-31
74,87,/assets/pizza-pie/images/poster_default.c8c896e70c3.gif,La Danse -- Le Ballet de l'Opera de Paris,500,55,2009.0,,,13
77,72,,The Croods,100000,144,2013.0,Animation/Comedy,0 days 01:31:00.000000000,-5
54,35,,Labor Day,10000,201,2013.0,Drama/Romance,0 days 01:51:00.000000000,-19
66,48,https://resizing.flixster.com/qlFAf17FQVbPO_tr2C66u-bhqHw=/206x305/v2/https://flxt.tmsimg.com/assets/p7935389_p_v8_az.jpg,Nativity!,1000,29,2009.0,Other/Comedy,0 days 01:45:00.000000000,-18
64,60,,"Lila, Lila",1000,5,2009.0,Comedy,0 days 01:47:00.000000000,-4
55,46,https://resizing.flixster.com/RXqRwaPy6W53rUohVnQuthc99zg=/206x305/v2/https://flxt.tmsimg.com/assets/p8272988_p_v10_aa.jpg,22 Bullets,1000,13,2010.0,Crime/Drama,0 days 01:55:00.000000000,-9
76,87,,Ain't in It for My Health: A Film About Levon Helm,500,15,2010.0,Documentary,0 days 01:23:00.000000000,11
80,60,,When the Dragon Swallowed the Sun,50,10,2010.0,Documentary,0 days 01:55:00.000000000,-20
44,78,https://resizing.flixster.com/8QyQYlxNC_ZlmaQgqjmSPEWWgpI=/206x305/v2/https://flxt.tmsimg.com/assets/p186_p_v10_aa.jpg,The Visitor,250,18,1979.0,Sci fi/Horror,0 days 01:30:00.000000000,34
50,67,https://resizing.flixster.com/ikO41TUoKf4NnvT3oTmOAxv6uio=/206x305/v2/https://flxt.tmsimg.com/assets/p9928934_p_v10_aa.jpg,Scenic Route,2500,21,2013.0,Drama/Mystery and thriller,0 days 01:25:00.000000000,17
84,95,/assets/pizza-pie/images/poster_default.c8c896e70c3.gif,Snow White,5000,113,2012.0,Fantasy/Drama,0 days 01:44:00.000000000,11
51,30,,The Lone Ranger,25000,247,2013.0,Western/Action,0 days 02:29:00.000000000,-21
56,19,,Winnie,2500,37,2011.0,Drama/History,0 days 01:44:00.000000000,-37
26,67,,Corruption,50,6,1968.0,Horror,0 days 01:31:00.000000000,41
75,95,,Boxing Gym,1000,42,2010.0,Documentary,0 days 01:31:00.000000000,20
71,41,https://resizing.flixster.com/4aJgLx6frQh0yk60hX3yzhrDxEE=/206x305/v2/https://flxt.tmsimg.com/assets/p8573654_p_v10_aa.jpg,Footprints,1000,17,2009.0,Drama/Mystery and thriller,0 days 01:20:00.000000000,-30
94,100,,Never Sleep Again: The Elm Street Legacy,1000,7,2010.0,,,6
37,41,https://resizing.flixster.com/zLtgU3qWlBJ94m1obreNQ45OEjY=/206x305/v2/https://flxt.tmsimg.com/assets/p9169384_p_v13_aj.jpg,StreetDance 2,2500,27,2012.0,Romance/Drama,0 days 01:25:00.000000000,4
65,67,,August: Osage County,25000,206,2013.0,Comedy/Drama,0 days 01:59:00.000000000,2
89,84,,Star Trek Into Darkness,250000,293,2013.0,Fantasy/Action,0 days 02:12:00.000000000,-5
69,71,,The Wolverine,250000,258,2013.0,Fantasy/Adventure,0 days 02:06:00.000000000,2
79,94,https://resizing.flixster.com/0aC8eLny3rF_ijOE_yXG_SkhuT8=/206x305/v2/https://flxt.tmsimg.com/assets/p9543954_p_v10_ae.jpg,Stories We Tell,10000,146,2012.0,Documentary,0 days 01:48:00.000000000,15
10,0,,The Last Seven,250,8,2010.0,Mystery and thriller,0 days 01:24:00.000000000,-10
80,95,,Gravity,250000,355,2013.0,Sci fi/Drama,0 days 01:31:00.000000000,15
43,71,,Oka! Amerikee,100,14,2010.0,Drama,0 days 01:46:00.000000000,28
30,46,,The Lords of Salem,10000,65,2012.0,Horror,0 days 01:40:00.000000000,16
23,50,,Switch,50,6,2012.0,,,27
60,87,,Kawasaki's Rose,500,15,2009.0,Drama,0 days 01:40:00.000000000,27
78,79,,Iron Man 3,250000,326,2013.0,Fantasy/Action,0 days 02:10:00.000000000,1
48,16,,47 Ronin,50000,88,2013.0,Action/Fantasy,0 days 01:59:00.000000000,-32
40,75,,Romeo and Juliet in Yiddish,50,12,2010.0,Comedy/Drama,0 days 01:32:00.000000000,35
58,86,,Mars,50,7,2010.0,Romance/Animation,0 days 01:30:00.000000000,28
74,94,https://resizing.flixster.com/ICR1keNq6frZpszrBCqpidZkJS4=/206x305/v2/https://flxt.tmsimg.com/assets/p9109751_p_v7_aa.jpg,The Trouble With the Truth,250,17,2011.0,Drama,0 days 01:36:00.000000000,20
77,72,https://resizing.flixster.com/fHRVrl6fqqrD4_Hg-Jt-qy31WZw=/206x305/v2/https://flxt.tmsimg.com/assets/p9360990_p_v8_am.jpg,Pacific Rim,100000,294,2013.0,Action/Sci fi,0 days 02:11:00.000000000,-5
58,65,https://resizing.flixster.com/K9RBaG3S0i8RW3uWkZFT1U3ZqjY=/206x305/v2/https://flxt.tmsimg.com/assets/p9360879_p_v10_ar.jpg,Elysium,100000,261,2013.0,Action/Sci fi,0 days 01:49:00.000000000,7
65,67,https://resizing.flixster.com/eq47tzoh8pW7f1jS8xCpKN-Y5Zk=/206x305/v2/https://flxt.tmsimg.com/NowShowing/124957/124957_ab.jpg,Turbo,50000,114,2013.0,Adventure/Comedy,0 days 01:36:00.000000000,2
76,64,,Café de Flore,2500,55,2011.0,Drama,0 days 02:00:00.000000000,-12
69,89,,You Will Be My Son,2500,37,2011.0,Drama,0 days 01:41:00.000000000,20
23,18,https://resizing.flixster.com/2lwaQtFudbvHStTR6Rqbp2EK8K0=/206x305/v2/https://flxt.tmsimg.com/assets/p9249066_p_v13_ai.jpg,Gambit,5000,44,2012.0,Comedy,0 days 01:29:00.000000000,-5
81,80,,Monsters University,250000,203,2013.0,Comedy/Kids and family,0 days 01:42:00.000000000,-1
50,83,,Genius on Hold,100,6,2013.0,Documentary,0 days 01:32:00.000000000,33
65,38,,Odd Thomas,10000,47,2013.0,Comedy/Fantasy,0 days 01:36:00.000000000,-27
59,100,,Harold's Going Stiff,100,6,2010.0,Comedy/Horror,,41
49,68,,Great Expectations,5000,81,2012.0,Drama,0 days 02:08:00.000000000,19
85,86,https://resizing.flixster.com/zRL0hCgn2y7aVHCF4yXNL_G4pUU=/206x305/v2/https://flxt.tmsimg.com/assets/p9099205_p_v10_as.jpg,People of a Feather,100,7,2011.0,Documentary,0 days 01:30:00.000000000,1
49,67,https://resizing.flixster.com/7pPQ81dMpyJHdcNBZr59x4lJP9k=/206x305/v2/https://flxt.tmsimg.com/assets/p8656779_p_v10_ad.jpg,Going Down in LA-LA Land,100,9,2011.0,Romance/Comedy,0 days 01:45:00.000000000,18
34,27,,Pompeii,25000,168,2014.0,Action/Drama,0 days 01:45:00.000000000,-7
20,17,,Cell 213,50,6,2010.0,Horror,0 days 01:49:00.000000000,-3
70,50,https://resizing.flixster.com/Spc60Xz-JLU8_Xxlk4-o39FFddE=/206x305/v2/https://flxt.tmsimg.com/assets/p9418112_p_v10_aq.jpg,Now You See Me,100000,169,2013.0,Comedy/Drama,0 days 01:56:00.000000000,-20
61,62,https://resizing.flixster.com/H94alcoyphtxGIgVHgXTn_ZyNpI=/206x305/v2/https://flxt.tmsimg.com/assets/p8717786_p_v8_aa.jpg,Old Goats,250,13,2010.0,Comedy/Biography,0 days 01:41:00.000000000,1
85,75,,Despicable Me 2,250000,186,2013.0,Comedy/Animation,0 days 01:38:00.000000000,-10
85,90,https://resizing.flixster.com/UswpJWyntUYFMJIAhQsX3FgutMA=/206x305/v2/https://flxt.tmsimg.com/assets/p9991822_p_v8_ah.jpg,Frozen,250000,250,2013.0,Comedy/Kids and family,0 days 01:42:00.000000000,5
84,70,,Fast & Furious 6,250000,209,2013.0,Action,0 days 02:10:00.000000000,-14
38,13,https://resizing.flixster.com/mA8x9d1Yf5IIM92m1t6sLHgzsH0=/206x305/v2/https://flxt.tmsimg.com/assets/p9672434_p_v10_aj.jpg,R.I.P.D.,50000,104,2013.0,Comedy/Action,0 days 01:38:00.000000000,-25
75,66,https://resizing.flixster.com/8TYS8kPPfuo5aWIcjfpmtbWEKXc=/206x305/v2/https://flxt.tmsimg.com/assets/p9530219_p_v10_au.jpg,Thor: The Dark World,250000,282,2013.0,Action/Fantasy,0 days 01:51:00.000000000,-9
80,60,,American Meat,100,10,2010.0,Documentary,0 days 01:24:00.000000000,-20
28,61,,Nurse,1000,23,2014.0,Mystery and thriller,0 days 01:24:00.000000000,33
67,100,/assets/pizza-pie/images/poster_default.c8c896e70c3.gif,The Curse Of The Gothic Symphony,1,5,2011.0,,,33
51,45,https://resizing.flixster.com/bDHD-Mv6lEzCGdpSwa-jW2OfGNA=/206x305/v2/https://flxt.tmsimg.com/assets/p9497161_p_v10_at.jpg,300: Rise of an Empire,100000,197,2014.0,Action/Drama,0 days 01:43:00.000000000,-6
37,63,,Knights of Badassdom,2500,16,2014.0,Horror/Comedy,0 days 01:25:00.000000000,26
65,65,,Epic,100000,127,2013.0,Comedy/Kids and family,0 days 01:43:00.000000000,0
33,23,,Girl Most Likely,10000,95,2012.0,Comedy,0 days 01:42:00.000000000,-10
41,23,https://resizing.flixster.com/tmTi6MbdFMfanWYNAZJBlJ015SA=/206x305/v2/https://flxt.tmsimg.com/assets/p10029449_p_v10_ag.jpg,Walking With Dinosaurs,25000,77,2013.0,Animation/Comedy,0 days 01:27:00.000000000,-18
24,37,,Swerve,250,30,2011.0,Crime/Drama,0 days 01:23:00.000000000,13
89,90,,The Hunger Games: Catching Fire,250000,293,2013.0,Action/Sci fi,0 days 02:26:00.000000000,1
56,14,,The Smurfs 2,50000,95,2013.0,Fantasy/Comedy,0 days 01:45:00.000000000,-42
78,36,https://resizing.flixster.com/h7Uf8tBZSMrKgjaNMJN5bSV3nTg=/206x305/v2/https://flxt.tmsimg.com/assets/p8815242_p_v8_aa.jpg,Yogawoman,100,11,2011.0,Documentary,0 days 01:24:00.000000000,-42
55,66,,Faust,2500,38,2011.0,Drama/Mystery and thriller,0 days 02:14:00.000000000,11
52,85,,Crazy Horse,500,55,2011.0,Documentary,0 days 02:14:00.000000000,33
34,22,https://resizing.flixster.com/-vX2a2OVPcpev_ad1MBW-PGAcwk=/206x305/v2/https://flxt.tmsimg.com/assets/p9963993_p_v10_ab.jpg,Violet & Daisy,2500,51,2011.0,Crime/Action,0 days 01:28:00.000000000,-12
79,86,,From Up on Poppy Hill,10000,87,2011.0,Kids and family/Anime,0 days 01:31:00.000000000,7
50,56,,Night Number 1,250,16,2011.0,Drama,0 days 01:31:00.000000000,6
29,25,,Inbred,250,12,2011.0,Comedy/Horror,0 days 01:34:00.000000000,-4
42,25,https://resizing.flixster.com/M4nT9RSpGMqeA_aUMkFrQb9BTNo=/206x305/v2/https://flxt.tmsimg.com/assets/p9300645_p_v8_ac.jpg,War of the Buttons,1000,24,2011.0,Drama/Adventure,0 days 01:39:00.000000000,-17
39,41,,Midnight's Children,1000,63,2012.0,Drama,0 days 02:28:00.000000000,2
49,6,https://resizing.flixster.com/AZLK4M_oJWPH5QzMQaeqQ313JbI=/206x305/v2/https://flxt.tmsimg.com/assets/p9337497_p_v10_av.jpg,Battle of the Year,10000,54,2013.0,Drama,0 days 01:49:00.000000000,-43
46,80,,Lloyd the Conqueror,1,5,2011.0,Comedy,0 days 01:35:00.000000000,34
57,67,https://resizing.flixster.com/vSxd7nqvf_tT6MBU6uxgURRXbnE=/206x305/v2/https://flxt.tmsimg.com/assets/p8833702_p_v10_aa.jpg,Terraferma,250,24,2011.0,Drama,0 days 01:32:00.000000000,10
55,42,https://resizing.flixster.com/DhQPlkhhAaoX-G7cm94SxpdNZY0=/206x305/v2/https://flxt.tmsimg.com/assets/p9756823_p_v10_ai.jpg,Percy Jackson: Sea of Monsters,100000,118,2013.0,Fantasy/Kids and family,0 days 01:46:00.000000000,-13
61,75,,Bettie Page Reveals All,1000,40,2011.0,Documentary/Biography,0 days 01:30:00.000000000,14
83,73,https://resizing.flixster.com/puUqBglbe9LY0nQuSFea32eB00I=/206x305/v2/https://flxt.tmsimg.com/assets/p9028768_p_v8_aa.jpg,Violeta Went to Heaven,250,11,2011.0,Drama/History,0 days 01:50:00.000000000,-10
62,33,,Wedding Palace,100,9,2011.0,Romance,0 days 01:38:00.000000000,-29
91,100,,Burn,1000,17,2012.0,Documentary,0 days 01:26:00.000000000,9
85,64,,Nicky's Family,250,22,2011.0,Documentary,0 days 01:38:00.000000000,-21
77,86,,Much Ado About Nothing,25000,176,2012.0,Romance,0 days 01:49:00.000000000,9
63,44,,Red 2,50000,153,2013.0,Action/Comedy,0 days 01:56:00.000000000,-19
36,53,https://resizing.flixster.com/ij2TWm4Sx8ShxpDctXmUWoEpVZ0=/206x305/v2/https://flxt.tmsimg.com/assets/p9725923_p_v10_aa.jpg,Lovelace,10000,129,2013.0,Drama/Biography,0 days 01:33:00.000000000,17
50,71,,Man of Tai Chi,10000,68,2013.0,Action/Sports and fitness,0 days 01:45:00.000000000,21
89,98,,Call Me Kuchu,500,51,2012.0,Documentary/Drama,0 days 01:27:00.000000000,9
80,93,,Wrinkles,2500,28,2014.0,,,13
89,93,https://resizing.flixster.com/NRZADa-s8KivTNyQppIWzO9RSGI=/206x305/v2/https://flxt.tmsimg.com/assets/p9968629_p_v10_ae.jpg,Captain Phillips,100000,279,2013.0,Mystery and thriller/Drama,0 days 02:13:00.000000000,4
49,38,,Peeples,10000,63,2013.0,Romance,0 days 01:35:00.000000000,-11
51,70,,Grabbers,2500,33,2012.0,Horror/Comedy,0 days 01:34:00.000000000,19
50,77,https://resizing.flixster.com/PeTu6BWzN0oipsmd23nxlzz9ytc=/206x305/v2/https://flxt.tmsimg.com/assets/p9028830_p_v8_aa.jpg,Simon Killer,1000,61,2012.0,Drama,0 days 01:45:00.000000000,27
62,70,,A Fierce Green Fire,250,20,2012.0,Documentary,0 days 01:41:00.000000000,8
49,72,,Wish You Were Here,5000,67,2012.0,Drama/Mystery and thriller,0 days 01:33:00.000000000,23
53,8,,Grown Ups 2,100000,115,2013.0,Comedy,0 days 01:40:00.000000000,-45
85,96,,Chasing Ice,10000,72,2012.0,Documentary/Biography,0 days 01:14:00.000000000,11
70,90,,My Brother the Devil,2500,52,2012.0,Crime/Drama,0 days 01:51:00.000000000,20
60,82,https://resizing.flixster.com/SeTVdeR9E8Sqq7G-w6VkNMyhZCc=/206x305/v2/https://flxt.tmsimg.com/assets/p9161014_p_v8_aa.jpg,An Oversimplification of Her Beauty,500,38,2012.0,Romance/Comedy,0 days 01:24:00.000000000,22
55,94,,Room 237,10000,133,2012.0,Documentary,0 days 01:42:00.000000000,39
56,57,https://resizing.flixster.com/Lp1bED8v9ucVHw0rJvb0Ks3Rnqw=/206x305/v2/https://flxt.tmsimg.com/assets/p9835679_p_v13_at.jpg,Riddick,50000,172,2013.0,Adventure/Sci fi,0 days 01:58:00.000000000,1
40,35,https://resizing.flixster.com/qND9Px6ictgD7Y4WAAVUyYA4GDI=/206x305/v2/https://flxt.tmsimg.com/assets/p9816964_p_v13_ac.jpg,Jayne Mansfield's Car,1000,37,2012.0,Drama,0 days 02:02:00.000000000,-5
44,20,,The Hangover Part III,100000,206,2013.0,Comedy,0 days 01:40:00.000000000,-24
36,11,,After Earth,100000,211,2013.0,Action/Sci fi,0 days 01:39:00.000000000,-25
52,40,https://resizing.flixster.com/rRq_8RR4atAYs5_zc-bj1Wg4hAw=/206x305/v2/https://flxt.tmsimg.com/assets/p9095105_p_v10_ac.jpg,Fetih 1453,250,5,2012.0,Action/Drama,0 days 02:40:00.000000000,-12
71,78,,The Wall,1000,40,2012.0,Sci fi/Drama,0 days 01:48:00.000000000,7
56,56,,Simon and the Oaks,250,34,2011.0,Drama,0 days 02:02:00.000000000,0
55,20,,Electric Man,1,10,2011.0,Action/Drama,0 days 01:38:00.000000000,-35
55,50,,Escape Plan,50000,115,2013.0,Mystery and thriller/Action,0 days 01:50:00.000000000,-5
25,18,,Cassadaga,250,11,2011.0,Horror/Mystery and thriller,0 days 01:53:00.000000000,-7
38,37,,In the Blood,1000,41,2014.0,Action/Mystery and thriller,0 days 01:48:00.000000000,-1
75,71,,What's in a Name,1000,14,2012.0,Comedy,0 days 01:49:00.000000000,-4
76,94,,Barbara,2500,81,2012.0,Drama,0 days 01:45:00.000000000,18
88,74,,Blood Brother,1000,27,2013.0,Documentary,0 days 01:33:00.000000000,-14
75,96,,Sister,2500,70,2012.0,Drama,0 days 01:37:00.000000000,21
33,60,https://resizing.flixster.com/ViYd07VvrEhHNyUaJd7SSGDa_R8=/206x305/v2/https://flxt.tmsimg.com/assets/p9814203_p_v13_az.jpg,The Bling Ring,25000,208,2013.0,Crime/Comedy,0 days 01:30:00.000000000,27
83,92,,Big Star: Nothing Can Hurt Me,1000,38,2012.0,Documentary,0 days 01:53:00.000000000,9
65,91,https://resizing.flixster.com/Yq9otUN8uMvtrCx1jQrzY8s0OHg=/206x305/v2/https://flxt.tmsimg.com/assets/p9132363_p_v8_aa.jpg,Gimme the Loot,1000,69,2012.0,Crime/Drama,0 days 01:21:00.000000000,26
64,33,,Pilgrim Song,1,6,2012.0,Drama,0 days 01:56:00.000000000,-31
53,63,,Sellebrity,500,8,2012.0,Documentary,0 days 01:29:00.000000000,10
49,68,https://resizing.flixster.com/3GdkIeBSRGq0OCbGrgNJHIYqzJ8=/206x305/v2/https://flxt.tmsimg.com/assets/p9742453_p_v10_aa.jpg,Somebody Up There Likes Me,1000,28,2012.0,Comedy,0 days 01:15:00.000000000,19
65,0,,The Snow Queen,250,8,2012.0,Fantasy/Kids and family,0 days 01:20:00.000000000,-65
45,25,,CZ12,1000,8,2012.0,Action/Comedy,0 days 01:49:00.000000000,-20
78,72,https://resizing.flixster.com/G1_7A0EpEaKwdiNbEiqJdJwV3Xc=/206x305/v2/https://flxt.tmsimg.com/assets/p9980214_p_v8_ad.jpg,Lee Daniels' The Butler,50000,200,2013.0,History/Drama,0 days 02:12:00.000000000,-6
66,71,https://resizing.flixster.com/WhLw0FBSRtK7cDBJLXH3ki_muGM=/206x305/v2/https://flxt.tmsimg.com/NowShowing/127484/127484_aa.jpg,Cloudy With a Chance of Meatballs 2,100000,124,2013.0,Comedy/Kids and family,0 days 01:35:00.000000000,5
78,71,,Four Horsemen,100,7,2012.0,Documentary,0 days 01:37:00.000000000,-7
74,92,,Caesar Must Die,2500,50,2012.0,Drama,0 days 01:16:00.000000000,18
62,66,,The Iceman,10000,128,2012.0,Drama/Mystery and thriller,0 days 01:45:00.000000000,4
60,76,https://resizing.flixster.com/bSAt_YIw6ICqxTxtvt4IMkRqnIw=/206x305/v2/https://flxt.tmsimg.com/assets/p9719232_p_v10_aa.jpg,Kill Your Darlings,10000,153,2013.0,Gay and lesbian/Drama,0 days 01:42:00.000000000,16
78,89,https://resizing.flixster.com/60DtU0GfKiGtN5mdr6zAt2Obix4=/206x305/v2/https://flxt.tmsimg.com/assets/p9268799_p_v8_aa.jpg,The Angels' Share,5000,102,2012.0,Comedy/Drama,0 days 01:41:00.000000000,11
79,84,,Laurence Anyways,2500,62,2012.0,Romance/Drama,0 days 02:39:00.000000000,5
37,42,https://resizing.flixster.com/b9oymjSxztZZZZp1IsaVOfkVaKE=/206x305/v2/https://flxt.tmsimg.com/assets/p9899978_p_v10_bz.jpg,Only God Forgives,25000,166,2013.0,Crime/Drama,0 days 01:30:00.000000000,5
71,83,,This Is the End,100000,227,2013.0,Comedy/Fantasy,0 days 01:47:00.000000000,12
52,75,,Anchorman 2: The Legend Continues,100000,204,2013.0,Comedy,0 days 01:59:00.000000000,23
78,94,,War Witch,5000,63,2012.0,Drama/War,0 days 01:29:00.000000000,16
51,65,,Byzantium,10000,121,2012.0,Horror,0 days 01:58:00.000000000,14
36,63,,Free Samples,250,8,2012.0,Comedy/Drama,0 days 01:20:00.000000000,27
84,91,,Évocateur: The Morton Downey Jr. Movie,500,33,2012.0,Documentary,0 days 01:31:00.000000000,7
63,62,https://resizing.flixster.com/mciMz8t3yl7TU_VmD7r5wTsZpTE=/206x305/v2/https://flxt.tmsimg.com/assets/p10172993_p_v13_ay.jpg,Non-Stop,50000,228,2014.0,Action/Mystery and thriller,0 days 01:47:00.000000000,-1
48,50,,Sassy Pants,250,6,2012.0,Comedy/Gay and lesbian,0 days 01:27:00.000000000,2
53,66,,Tiger Eyes,500,29,2012.0,Drama,0 days 01:32:00.000000000,13
59,75,,Forgetting the Girl,100,8,2012.0,Drama/Mystery and thriller,0 days 01:25:00.000000000,16
52,54,,Out of the Furnace,25000,198,2013.0,Mystery and thriller/Drama,0 days 01:56:00.000000000,2
56,93,,The Great Flood,100,15,2012.0,Documentary,0 days 01:16:00.000000000,37
53,71,,I Declare War,1000,42,2012.0,Drama,0 days 01:30:00.000000000,18
44,50,,Carrie,50000,186,2013.0,Horror,0 days 01:39:00.000000000,6
73,20,https://resizing.flixster.com/dpif95gaYKJfysI2Ux4B6Tlo838=/206x305/v2/https://flxt.tmsimg.com/assets/p9152411_p_v10_aa.jpg,Hello Herman,250,10,2011.0,Drama,0 days 01:25:00.000000000,-53
58,48,,Rio 2,100000,115,2014.0,Comedy/Kids and family,0 days 01:41:00.000000000,-10
77,88,https://resizing.flixster.com/dQjnC7foGlLnOCP08X_m7EZnDSY=/206x305/v2/https://resizing.flixster.com/qyBGQtFtYjK3Pp2O6QgtE0WaJD0=/ems.ZW1zLXByZC1hc3NldHMvbW92aWVzLzViNTY5Y2VmLTU4ZDktNDc4Yy05YjhmLWJhNWU5YTNmNDJhYy53ZWJw,Tabu,1000,60,2012.0,Drama,0 days 01:58:00.000000000,11
26,18,,Jewtopia,250,11,2012.0,Romance,0 days 01:30:00.000000000,-8
86,100,,Free China: The Courage to Believe,100,7,2011.0,Documentary/Biography,0 days 00:53:00.000000000,14
83,79,,The Wolf of Wall Street,100000,287,2013.0,Comedy/Drama,0 days 02:59:00.000000000,-4
87,96,,The LEGO Movie,100000,254,2014.0,Animation/Comedy,0 days 01:35:00.000000000,9
74,90,,Portrait of Wally,100,31,2012.0,Documentary,0 days 01:30:00.000000000,16
64,92,,The Final Member,250,26,2012.0,Documentary,0 days 01:12:00.000000000,28
78,95,,Ping Pong,250,21,2012.0,Documentary,0 days 01:20:00.000000000,17
60,83,https://resizing.flixster.com/1ecNRYXuHW8Fn6E6MTrdC__TI44=/206x305/v2/https://flxt.tmsimg.com/assets/p9505705_p_v8_aa.jpg,Like Someone in Love,2500,102,2012.0,Drama,0 days 01:49:00.000000000,23
34,29,,Machete Kills,25000,125,2013.0,Action,0 days 01:47:00.000000000,-5
34,54,,The Look of Love,2500,74,2013.0,Drama/Biography,0 days 01:41:00.000000000,20
75,100,,The Waiting Room,1000,34,2012.0,Documentary,0 days 01:21:00.000000000,25
36,67,,The Wedding Video,1000,18,2012.0,Comedy/Drama,0 days 01:34:00.000000000,31
88,98,,Ernest & Célestine,5000,81,2014.0,,,10
62,51,,White House Down,100000,202,2013.0,Mystery and thriller/Action,0 days 02:11:00.000000000,-11
38,51,,I Give It a Year,10000,82,2013.0,Romance,0 days 01:37:00.000000000,13
54,83,,Aliyah,100,6,2012.0,Drama,0 days 01:27:00.000000000,29
51,74,,Augustine,500,38,2012.0,Drama,0 days 01:41:00.000000000,23
73,63,https://resizing.flixster.com/EDIdVPCaThF0hRCF9xH1p5-Fx7s=/206x305/v2/https://flxt.tmsimg.com/assets/p9575066_p_v10_aa.jpg,Broken,2500,56,2012.0,Drama,0 days 01:30:00.000000000,-10
76,86,,After Lucia,500,7,2012.0,Drama,0 days 01:33:00.000000000,10
93,93,,The Hunt,10000,134,2012.0,Drama,0 days 01:50:00.000000000,0
69,93,https://resizing.flixster.com/G6ZQ7JAK_QnIJhJP8wVJJtIw61w=/206x305/v2/https://flxt.tmsimg.com/assets/p9550634_p_v10_aa.jpg,Our Children,1000,44,2012.0,Drama,0 days 01:51:00.000000000,24
62,85,https://resizing.flixster.com/K122gtQSfnxgjQ1SoM8iuBGredM=/206x305/v2/https://flxt.tmsimg.com/assets/p9543890_p_v10_ac.jpg,Sightseers,5000,108,2012.0,Comedy,0 days 01:28:00.000000000,23
46,38,,Three Worlds,100,8,2012.0,Drama,0 days 01:40:00.000000000,-8
48,70,,The We and the I,1000,43,2012.0,Drama,0 days 01:43:00.000000000,22
60,87,,In the Fog,1000,31,2012.0,Drama/War,0 days 02:07:00.000000000,27
50,45,https://resizing.flixster.com/IiKUdQcVo8fz6Tl-6SJXUaHVJOM=/206x305/v2/https://flxt.tmsimg.com/assets/p9524742_p_v10_aa.jpg,Black Out,100,11,2012.0,Crime/Action,0 days 01:32:00.000000000,-5
35,7,,Paranoia,10000,108,2013.0,Drama/Mystery and thriller,0 days 01:46:00.000000000,-28
44,53,,Maniac,10000,74,2012.0,Horror,0 days 01:29:00.000000000,9
53,71,,Renoir,5000,70,2012.0,Drama,0 days 01:51:00.000000000,18
51,35,,The Internship,50000,170,2013.0,Comedy,0 days 01:59:00.000000000,-16
36,22,/assets/pizza-pie/images/poster_default.c8c896e70c3.gif,Sabotage,10000,114,2014.0,,,-14
33,63,https://resizing.flixster.com/Al5mQOfX9DAVIWGRJVR7RPjl0ms=/206x305/v2/https://flxt.tmsimg.com/assets/p9912655_p_v8_aa.jpg,Sunlight Jr.,2500,38,2013.0,Drama,0 days 01:30:00.000000000,30
37,52,https://resizing.flixster.com/_gB6TaFqabOW8OpOMIh6rlemKZI=/206x305/v2/https://flxt.tmsimg.com/assets/p9598146_p_v8_ad.jpg,Thérèse,1000,60,2012.0,Drama,0 days 01:50:00.000000000,15
79,63,https://resizing.flixster.com/vU3ffpofFiIenUUH5nr_pxmfZds=/206x305/v2/https://flxt.tmsimg.com/assets/p9863513_p_v10_ac.jpg,One Direction: This Is Us,25000,93,2013.0,Documentary,0 days 01:35:00.000000000,-16
71,51,https://resizing.flixster.com/wNtI-fS9eBDzGk8EgRxBPMv4G9A=/206x305/v2/https://flxt.tmsimg.com/assets/p10016880_p_v10_ai.jpg,The Secret Life of Walter Mitty,50000,197,2013.0,Comedy/Fantasy,0 days 01:54:00.000000000,-20
71,66,https://resizing.flixster.com/hvS2sRooFWrG3xPNwTvVH5xPod8=/206x305/v2/https://flxt.tmsimg.com/assets/p9434317_p_v10_ai.jpg,The Heat,100000,183,2013.0,Comedy/Action,0 days 01:57:00.000000000,-5
81,67,https://resizing.flixster.com/bWKZ6Pj-8r7qooGVfRRyUhOhxmc=/206x305/v2/https://flxt.tmsimg.com/assets/p9320520_p_v10_aa.jpg,My Father and the Man in Black,100,21,2012.0,Documentary,0 days 01:30:00.000000000,-14
53,85,,Berberian Sound Studio,2500,98,2012.0,Horror,0 days 01:28:00.000000000,32
52,58,,Day of the Flowers,50,12,2012.0,Romance/Comedy,0 days 01:42:00.000000000,6
64,100,,Radio Unnameable,250,13,2012.0,Documentary,0 days 01:31:00.000000000,36
66,65,https://resizing.flixster.com/Rhev-qj0A0CyC6P-BNYn7j9p4iI=/206x305/v2/https://flxt.tmsimg.com/assets/p9756367_p_v10_av.jpg,2 Guns,100000,189,2013.0,Action/Mystery and thriller,0 days 01:49:00.000000000,-1
41,50,,Vinyl,50,6,2012.0,Comedy,0 days 01:25:00.000000000,9
80,86,,Vampira and Me,1,7,2012.0,Documentary,0 days 01:45:00.000000000,6
56,53,,Shanghai Calling,250,15,2012.0,Romance,0 days 01:39:00.000000000,-3
25,33,,Passion,5000,75,2012.0,Drama/Mystery and thriller,0 days 01:40:00.000000000,8
25,7,,Diana,5000,108,2013.0,Drama/Biography,0 days 01:53:00.000000000,-18
54,17,,I Do,100,12,2012.0,Comedy/Drama,0 days 01:31:00.000000000,-37
75,70,https://resizing.flixster.com/bdw3BhoplAt8FnIm0Ce6FquzMtM=/206x305/v2/https://flxt.tmsimg.com/assets/p9535645_p_v10_aa.jpg,Disconnect,10000,79,2012.0,Drama,0 days 01:55:00.000000000,-5
92,95,,The Wolf Children Ame and Yuki,2500,19,2012.0,Fantasy/Animation,0 days 01:57:00.000000000,3
81,69,https://resizing.flixster.com/cteblXciV9WdeXHXobfry1puJiU=/206x305/v2/https://flxt.tmsimg.com/assets/p9564054_p_v10_ac.jpg,About Time,50000,161,2013.0,Romance/Fantasy,0 days 02:04:00.000000000,-12
49,25,,Planes,50000,122,2013.0,Animation/Comedy,0 days 01:32:00.000000000,-24
47,73,https://resizing.flixster.com/x6Z48LZDBWi2mSe9BbyxeXbkufw=/206x305/v2/https://flxt.tmsimg.com/assets/p9354828_p_v13_ac.jpg,"No God, No Master",250,15,2012.0,Crime/Drama,0 days 01:34:00.000000000,26
86,92,https://resizing.flixster.com/7OFn_uPiXzczYuq9jyIIVGC3FxM=/206x305/v2/https://flxt.tmsimg.com/assets/p10295153_p_v10_ap.jpg,The Grand Budapest Hotel,50000,310,2014.0,Comedy/Drama,0 days 01:39:00.000000000,6
58,13,https://resizing.flixster.com/3mekTvveRS2HU1OfBo-zsCbF5gI=/206x305/v2/https://flxt.tmsimg.com/assets/p9594305_p_v10_aj.jpg,The Mortal Instruments: City of Bones,50000,127,2013.0,Action/Fantasy,0 days 02:10:00.000000000,-45
64,67,,Four,100,6,2013.0,,,3
36,20,,Petunia,100,5,2012.0,Comedy/Drama,0 days 01:48:00.000000000,-16
33,7,https://resizing.flixster.com/kSXARASWjX1AjYhWtXwH8EZxbAw=/206x305/v2/https://flxt.tmsimg.com/assets/p9872855_p_v10_ag.jpg,Runner Runner,25000,121,2013.0,Crime/Drama,0 days 01:31:00.000000000,-26
83,86,,The Conjuring,100000,223,2013.0,Horror/Mystery and thriller,0 days 01:51:00.000000000,3
76,90,,The Iran Job,1000,21,2012.0,Documentary,0 days 01:30:00.000000000,14
45,76,https://resizing.flixster.com/YHdLWd9GTDXmGXCuvxcz5yVAu_A=/206x305/v2/https://flxt.tmsimg.com/assets/p9445264_p_v10_ak.jpg,Cockneys vs Zombies,5000,50,2012.0,Action/Horror,0 days 01:28:00.000000000,31
15,21,https://resizing.flixster.com/73gFJ1KwLcna5o357Vwzw2bItgs=/206x305/v2/https://flxt.tmsimg.com/assets/p10037966_p_v10_aq.jpg,The Canyons,2500,95,2013.0,Drama/Mystery and thriller,0 days 01:35:00.000000000,6
34,41,,Therese,5000,88,2013.0,Drama/Mystery and thriller,0 days 01:42:00.000000000,7
61,77,,Ain't Them Bodies Saints,10000,133,2013.0,Drama,0 days 01:35:00.000000000,16
61,42,https://resizing.flixster.com/Y-rpVlFb5WX0tk3T3akuEtCcrSs=/206x305/v2/https://flxt.tmsimg.com/assets/p10036553_p_v10_ac.jpg,Homefront,25000,118,2013.0,Mystery and thriller/Action,0 days 01:40:00.000000000,-19
31,33,,Plush,500,6,2013.0,Mystery and thriller,0 days 01:39:00.000000000,2
88,89,https://resizing.flixster.com/ivW21bzRMF6ZC4Trg6DgZ4ECDIA=/206x305/v2/https://flxt.tmsimg.com/assets/p9872516_p_v10_bb.jpg,Rush,50000,235,2013.0,Action/Drama,0 days 02:03:00.000000000,1
41,21,,The Seasoning House,500,14,2012.0,Horror/Mystery and thriller,0 days 01:30:00.000000000,-20
79,100,,More Than Honey,1000,41,2012.0,Documentary,0 days 01:35:00.000000000,21
57,32,https://resizing.flixster.com/d_e-zGFXekNhVg50Zk-K-AVGrhs=/206x305/v2/https://flxt.tmsimg.com/NowShowing/124545/124545_aa.jpg,Kick-Ass 2,100000,211,2013.0,Action/Comedy,0 days 01:43:00.000000000,-25
82,97,https://resizing.flixster.com/pENVts3t0WSA1beM-P2KzABFuvw=/206x305/v2/https://flxt.tmsimg.com/assets/p9874833_p_v10_aa.jpg,7 Boxes,500,31,2012.0,Action/Mystery and thriller,0 days 01:40:00.000000000,15
58,50,/assets/pizza-pie/images/poster_default.c8c896e70c3.gif,Outrage: Beyond,500,18,2012.0,Crime/Action,0 days 01:52:00.000000000,-8
41,78,,The End of Time,500,9,2012.0,Documentary,0 days 01:49:00.000000000,37
89,91,,Far Out Isn't Far Enough: The Tomi Ungerer Story,250,23,2012.0,Documentary,0 days 01:38:00.000000000,2
46,56,,The To Do List,10000,122,2013.0,Comedy,0 days 01:44:00.000000000,10
53,54,https://resizing.flixster.com/LT8XiyQ88c8aAlHOqN2b_h4yFII=/206x305/v2/https://flxt.tmsimg.com/assets/p9957386_p_v10_ab.jpg,Jack Ryan: Shadow Recruit,50000,187,2014.0,Action/Mystery and thriller,0 days 01:45:00.000000000,1
69,89,,Fill the Void,2500,74,2012.0,Drama,0 days 01:30:00.000000000,20
31,46,,Here Comes the Devil,2500,26,2012.0,Horror/Mystery and thriller,0 days 01:37:00.000000000,15
91,76,,How to Make Money Selling Drugs,5000,42,2012.0,Documentary,0 days 01:36:00.000000000,-15
50,67,/assets/pizza-pie/images/poster_default.c8c896e70c3.gif,One Track Heart: The Story of Krishna Das,100,15,2012.0,Documentary/Music,0 days 01:14:00.000000000,17
82,79,https://resizing.flixster.com/U6euTQJcHLaiNYazDOb6UMQnDyI=/206x305/v2/https://flxt.tmsimg.com/assets/p9817130_p_v10_ab.jpg,Out in the Dark,1000,29,2012.0,Romance/Gay and lesbian,0 days 01:36:00.000000000,-3
16,17,,Twenty8k,50,6,2012.0,Mystery and thriller,0 days 01:46:00.000000000,1
49,64,,The Fitzgerald Family Christmas,500,25,2012.0,Other/Drama,0 days 01:42:00.000000000,15
46,72,https://resizing.flixster.com/Jzk7_40vfoKBq7SUmxVSPtr6rlk=/206x305/v2/https://flxt.tmsimg.com/assets/p9785024_p_v10_aa.jpg,Greetings From Tim Buckley,1000,32,2012.0,Drama,0 days 01:39:00.000000000,26
58,65,,"Love, Marilyn",250,23,2012.0,Documentary,0 days 01:45:00.000000000,7
62,53,https://resizing.flixster.com/dwe4uhE3Y7fxOa4eeqS3EyAfS6A=/206x305/v2/https://flxt.tmsimg.com/assets/p9449168_p_v10_ax.jpg,Inch'Allah,500,17,2012.0,Drama,0 days 01:40:00.000000000,-9
54,83,,Leviathan,1000,54,2012.0,Documentary,0 days 01:27:00.000000000,29
93,100,,Shahid,250,5,2012.0,Drama/Biography,0 days 01:45:00.000000000,7
60,91,,What Richard Did,1000,47,2012.0,Drama,0 days 01:27:00.000000000,31
85,95,,The Act of Killing,10000,159,2012.0,Drama/Crime,0 days 02:02:00.000000000,10
25,20,https://resizing.flixster.com/77zkGkDgzXuUvnSYdfTeY2e4uiU=/206x305/v2/https://flxt.tmsimg.com/assets/p9589733_p_v10_ac.jpg,Arthur Newman,1000,51,2012.0,Romance/Comedy,0 days 01:41:00.000000000,-5
78,87,,The Attack,5000,61,2012.0,Drama,0 days 01:44:00.000000000,9
76,96,https://resizing.flixster.com/uVHWNJd1nESVMhc6usjOCcujGzw=/206x305/v2/https://flxt.tmsimg.com/assets/p9609224_p_v10_ar.jpg,A Hijacking,10000,112,2013.0,Drama/Mystery and thriller,0 days 01:39:00.000000000,20
90,98,,Mea Maxima Culpa: Silence in the House of God,1000,50,2012.0,Documentary,0 days 01:47:00.000000000,8
60,95,,Museum Hours,1000,74,2012.0,Drama,0 days 01:47:00.000000000,35
75,84,,The Patience Stone,1000,62,2012.0,Drama,0 days 01:38:00.000000000,9
65,80,,Resolution,1000,15,2012.0,Horror/Mystery and thriller,0 days 01:33:00.000000000,15
74,86,,Shepard & Dark,100,14,2012.0,Drama,0 days 01:32:00.000000000,12
79,93,https://resizing.flixster.com/y_7uY1SAidccetwk3J-pOgBkTrk=/206x305/v2/https://flxt.tmsimg.com/assets/p9762892_p_v8_aa.jpg,The Pervert's Guide to Ideology,2500,29,2012.0,Documentary,0 days 02:14:00.000000000,14
43,50,https://resizing.flixster.com/mWSOmLzfsoIfhSvKBxmcHjwTnEs=/206x305/v2/https://flxt.tmsimg.com/assets/p9467957_p_v10_bb.jpg,Thanks for Sharing,10000,119,2012.0,Romance/Drama,0 days 01:52:00.000000000,7
33,28,https://resizing.flixster.com/o8I6gHClVA0K2civToLhg8OYbOs=/206x305/v2/https://flxt.tmsimg.com/assets/p9463218_p_v13_aa.jpg,The Time Being,100,18,2012.0,Mystery and thriller,0 days 01:28:00.000000000,-5
68,17,https://resizing.flixster.com/hE6bx9XqPUZnDfqGzw77JF0eOco=/206x305/v2/https://flxt.tmsimg.com/assets/p9463195_p_v10_aa.jpg,Twice Born,1000,24,2012.0,Drama,0 days 02:07:00.000000000,-51
85,74,https://resizing.flixster.com/KHYo8n6kviY3SrlnEjrcAALsEr4=/206x305/v2/https://flxt.tmsimg.com/assets/p9458059_p_v10_ac.jpg,The Hobbit: The Desolation of Smaug,250000,250,2013.0,Fantasy/Adventure,0 days 02:40:00.000000000,-11
77,92,,Frances Ha,10000,184,2012.0,Comedy,0 days 01:25:00.000000000,15
75,88,,Hannah Arendt,2500,73,2012.0,Drama,0 days 01:53:00.000000000,13
59,75,,Love Is All You Need,5000,108,2012.0,Romance,0 days 01:56:00.000000000,16
56,76,,Curse of Chucky,5000,21,2013.0,Horror,0 days 01:35:00.000000000,20
59,46,,Last Vegas,50000,147,2013.0,Comedy,0 days 01:44:00.000000000,-13
36,13,https://resizing.flixster.com/AbMqY4VpQHDy-FmUoP9_2mt-4Kw=/206x305/v2/https://flxt.tmsimg.com/assets/p10194017_p_v8_ad.jpg,Justin and the Knights of Valor,500,15,2013.0,Animation/Kids and family,0 days 01:30:00.000000000,-23
42,74,https://resizing.flixster.com/2c4tFKqo6tQW_I0HrpkjcoB6vYY=/206x305/v2/https://flxt.tmsimg.com/assets/p9449239_p_v10_aa.jpg,Everyday,250,34,2012.0,Drama,0 days 01:46:00.000000000,32
82,98,https://resizing.flixster.com/gnDfx6KParq898yjW-miQj4m0AE=/206x305/v2/https://flxt.tmsimg.com/assets/p9720544_p_v10_ae.jpg,Before Midnight,25000,206,2013.0,Romance/Drama,0 days 01:49:00.000000000,16
73,68,https://resizing.flixster.com/xDsNk88TvkDEtFu3OEpkz72cW4Y=/206x305/v2/https://flxt.tmsimg.com/assets/p9465769_p_v10_aa.jpg,"Bless Me, Ultima",1000,37,2012.0,Drama/War,0 days 01:46:00.000000000,-5
46,59,,Capital,500,34,2012.0,Drama,0 days 01:54:00.000000000,13
47,81,https://resizing.flixster.com/Xg5hkVSjBIBSe2bcg-DTKydhiTk=/206x305/v2/https://flxt.tmsimg.com/assets/p9519127_p_v8_aa.jpg,Something in the Air,1000,75,2012.0,Romance/Drama,0 days 02:02:00.000000000,34
30,0,,The Knot,100,19,2012.0,Romance,0 days 01:32:00.000000000,-30
63,43,,All Stars,500,23,2013.0,Comedy,0 days 01:47:00.000000000,-20
69,75,https://resizing.flixster.com/GUBCZ4pBipx6fErUiTya0tEwjiU=/206x305/v2/https://flxt.tmsimg.com/assets/p9351646_p_v10_aa.jpg,"Doin' It in the Park: Pick-Up Basketball, NYC",250,8,2012.0,Documentary,0 days 01:30:00.000000000,6
54,61,,Clear History,1000,28,2013.0,Comedy,0 days 01:40:00.000000000,7
87,75,,Unconditional,2500,12,2012.0,Drama,0 days 01:32:00.000000000,-12
90,95,,12 Years a Slave,100000,371,2013.0,Drama/History,0 days 02:14:00.000000000,5
70,83,https://resizing.flixster.com/mJ7TX1W-gJqh99MiJsV-9bD7C9g=/206x305/v2/https://flxt.tmsimg.com/assets/p9535571_p_v10_ah.jpg,Una noche,500,23,2012.0,Drama,0 days 01:30:00.000000000,13
49,36,https://resizing.flixster.com/Ss04KQ9VM0ucFbKoBwGJAgJCqJw=/206x305/v2/https://flxt.tmsimg.com/assets/p9573184_p_v10_az.jpg,Nativity 2: Danger in the Manger!,1000,22,2012.0,Other/Comedy,0 days 01:45:00.000000000,-13
68,81,https://resizing.flixster.com/EYnocFrV9LsNxwwRBaE-oeeqKrY=/206x305/v2/https://flxt.tmsimg.com/assets/p9889620_p_v8_aa.jpg,Becoming Traviata,100,16,2012.0,Documentary/Music,0 days 01:53:00.000000000,13
25,31,https://resizing.flixster.com/Wtz_gNAoBXwuCZ7EolgprXwnm1U=/206x305/v2/https://flxt.tmsimg.com/assets/p10351062_p_v10_ab.jpg,Crave,100,16,2012.0,Drama/Mystery and thriller,0 days 01:53:00.000000000,6
55,70,,The Artist and the Model,500,44,2013.0,Comedy/Drama,0 days 01:44:00.000000000,15
39,82,/assets/pizza-pie/images/poster_default.c8c896e70c3.gif,+1,1000,11,2013.0,,,43
85,86,https://resizing.flixster.com/9JhY0S3ecxuDP4kZUCNmeM5Q3-k=/206x305/v2/https://flxt.tmsimg.com/assets/p9521938_p_v10_av.jpg,BB King: The Life of Riley,250,7,2014.0,Documentary,0 days 02:03:00.000000000,1
19,38,,Two Jacks,50,16,2012.0,Comedy/Drama,0 days 01:30:00.000000000,19
56,32,https://resizing.flixster.com/2Z4WtRX19MJwjOxtE2c5ixFXq4Y=/206x305/v2/https://flxt.tmsimg.com/assets/p9945833_p_v10_ar.jpg,Drift,1000,19,2013.0,Drama,0 days 01:53:00.000000000,-24
84,79,,Rising From Ashes,250,24,2012.0,Documentary,0 days 01:20:00.000000000,-5
41,28,,The Family,50000,139,2013.0,Action/Comedy,0 days 01:51:00.000000000,-13
33,55,,Blood,500,44,2012.0,Mystery and thriller/Drama,0 days 01:35:00.000000000,22
73,100,,16 Acres,100,8,2012.0,Documentary/Drama,0 days 01:35:00.000000000,27
45,50,/assets/pizza-pie/images/poster_default.c8c896e70c3.gif,Easy Money II,250,20,2012.0,Crime/Drama,0 days 01:39:00.000000000,5
63,65,,The Summit,1000,37,2012.0,Documentary,0 days 01:42:00.000000000,2
88,99,https://resizing.flixster.com/v6Nvqp4OgN_uHWyoHHEQ4YYi8Mo=/206x305/v2/https://flxt.tmsimg.com/assets/p9649221_p_v10_ag.jpg,Wadjda,10000,122,2012.0,Drama,0 days 01:38:00.000000000,11
83,100,/assets/pizza-pie/images/poster_default.c8c896e70c3.gif,Cousin Jules,100,17,1972.0,Documentary,0 days 01:31:00.000000000,17
87,81,https://resizing.flixster.com/3LKAnshSvp49Z7pIArCrfdpUDQw=/206x305/v2/https://flxt.tmsimg.com/assets/p9872448_p_v10_ah.jpg,Prisoners,100000,253,2013.0,Crime/Drama,0 days 02:33:00.000000000,-6
72,48,https://resizing.flixster.com/d4nctIDMhz57YHLmpwHLV-h70yk=/206x305/v2/https://flxt.tmsimg.com/assets/p9742380_p_v10_ai.jpg,We're the Millers,100000,159,2013.0,Comedy/Action,0 days 01:50:00.000000000,-24
84,79,,Saving Mr. Banks,100000,265,2013.0,Comedy/Drama,0 days 02:05:00.000000000,-5
44,71,,Greenwich Village: Music That Defined a Generation,100,7,2012.0,Documentary,0 days 02:01:00.000000000,27
21,20,,I Will Follow You Into the Dark,100,10,2013.0,Horror/Mystery and thriller,0 days 01:51:00.000000000,-1
58,100,,Lunch,100,6,2012.0,Documentary,0 days 01:18:00.000000000,42
53,44,https://resizing.flixster.com/5Zegcf7PVpZ13tR2PWkgNA_IM50=/206x305/v2/https://flxt.tmsimg.com/assets/p9572908_p_v8_aa.jpg,Buffalo Girls,1000,9,2012.0,Documentary,0 days 01:06:00.000000000,-9
53,73,,Paradise: Faith,500,41,2012.0,Drama,0 days 01:59:00.000000000,20
37,39,,Oldboy,25000,151,2013.0,Drama/Mystery and thriller,0 days 01:43:00.000000000,2
68,85,,Joe,10000,134,2013.0,Drama,0 days 01:57:00.000000000,17
21,0,,The Starving Games,2500,9,2013.0,Comedy,0 days 01:23:00.000000000,-21
35,3,,Getaway,10000,144,2013.0,Action/Mystery and thriller,0 days 01:29:00.000000000,-32
31,43,,Closed Circuit,10000,135,2013.0,Mystery and thriller,0 days 01:36:00.000000000,12
22,45,https://resizing.flixster.com/B-UzxVDXgzq0vxeWPC7LKpX5VPk=/206x305/v2/https://flxt.tmsimg.com/assets/p10214953_p_v13_ac.jpg,Almost Human,500,22,2013.0,Sci fi/Horror,0 days 01:20:00.000000000,23
85,83,https://resizing.flixster.com/FVhHQvRZCve-EUskst5mJBws5VI=/206x305/v2/https://flxt.tmsimg.com/assets/p9913539_p_v8_aa.jpg,The Broken Circle Breakdown,5000,103,2012.0,Romance/Drama,0 days 01:52:00.000000000,-2
73,92,,Two Lives,250,13,2012.0,Mystery and thriller,0 days 01:35:00.000000000,19
47,40,https://resizing.flixster.com/roQZ-5Ov2y2a-D8g8zc3UUsl0RM=/206x305/v2/https://flxt.tmsimg.com/assets/p9970012_p_v8_ah.jpg,Delivery Man,50000,148,2013.0,Comedy,0 days 01:45:00.000000000,-7
58,18,,Ride Along,50000,135,2014.0,Comedy/Action,0 days 01:39:00.000000000,-40
58,18,https://resizing.flixster.com/SacetAVvqvCoxnGwWLvuIV43kJY=/206x305/v2/https://flxt.tmsimg.com/assets/p10362866_p_v10_ab.jpg,Tyler Perry's The Single Moms Club,25000,28,2014.0,Comedy/Drama,0 days 01:50:00.000000000,-40
44,33,,A Girl and a Gun,100,9,2013.0,Documentary,0 days 01:16:00.000000000,-11
58,42,,The Human Race,500,12,2012.0,Sci fi/Mystery and thriller,0 days 01:30:00.000000000,-16
62,89,,Informant,250,19,2012.0,Documentary,0 days 01:22:00.000000000,27
39,38,,Men at Lunch,100,13,2012.0,Documentary,0 days 01:11:00.000000000,-1
37,43,https://resizing.flixster.com/wx0xDqRJ_m0bfv93H7ioib_hlss=/206x305/v2/https://flxt.tmsimg.com/assets/p9471126_p_v10_aa.jpg,And While We Were Here,500,21,2012.0,Romance/Drama,0 days 01:23:00.000000000,6
84,86,,Spinning Plates,500,35,2012.0,Documentary,0 days 01:35:00.000000000,2
44,20,https://resizing.flixster.com/7ix0KwH18a_aZAwCjAEE_Vc0IQA=/206x305/v2/https://flxt.tmsimg.com/assets/p9991381_p_v10_ab.jpg,Free Birds,25000,91,2013.0,Other/Kids and family,0 days 01:31:00.000000000,-24
22,0,,InAPPropriate Comedy,2500,5,2013.0,Comedy,0 days 01:24:00.000000000,-22
57,39,,Insidious: Chapter 2,50000,129,2013.0,Horror/Mystery and thriller,0 days 01:45:00.000000000,-18
30,39,,Haunt,10000,18,2014.0,Horror/Mystery and thriller,0 days 01:26:00.000000000,9
67,90,,Hava Nagila (The Movie),250,29,2012.0,Documentary,0 days 01:13:00.000000000,23
36,39,,The Purge,50000,156,2013.0,Horror/Mystery and thriller,0 days 01:25:00.000000000,3
34,48,,All Cheerleaders Die,2500,42,2013.0,Comedy/Horror,0 days 01:30:00.000000000,14
74,92,,Inside Llewyn Davis,25000,286,2013.0,Comedy/Drama,0 days 01:44:00.000000000,18
71,93,,Deceptive Practice: The Mysteries and Mentors of Ricky Jay,500,42,2012.0,Documentary,0 days 01:28:00.000000000,22
40,28,https://resizing.flixster.com/Dq1Q4mfQoDSY2j_dtiRxlTXIN4s=/206x305/v2/https://flxt.tmsimg.com/assets/p9726499_p_v10_ac.jpg,Jobs,25000,134,2013.0,Drama/Biography,0 days 02:05:00.000000000,-12
90,100,https://resizing.flixster.com/U_6NlEBUSSjL--54ZZFkRjzDv2o=/206x305/v2/https://flxt.tmsimg.com/assets/p9692537_p_v10_aa.jpg,Sound City,5000,46,2013.0,Documentary/Music,0 days 01:48:00.000000000,10
44,30,https://resizing.flixster.com/3Hrj6klgchejS0bE2hDIMcBvgNk=/206x305/v2/https://flxt.tmsimg.com/assets/p10016612_p_v13_ak.jpg,The Monuments Men,50000,255,2014.0,War/Drama,0 days 01:58:00.000000000,-14
73,50,https://resizing.flixster.com/Oyfi0RvcCf-DkX82tG8WbH11mUM=/206x305/v2/https://flxt.tmsimg.com/assets/p9693723_p_v8_ab.jpg,FrackNation,250,6,2013.0,Documentary,0 days 01:16:00.000000000,-23
37,19,https://resizing.flixster.com/TXKQLjnIfBuFDKgIFgfKThkT3Uw=/206x305/v2/https://flxt.tmsimg.com/assets/p9957510_p_v10_ao.jpg,Transcendence,50000,229,2014.0,Action/Sci fi,0 days 01:59:00.000000000,-18
20,22,,Welcome to the Jungle,1000,9,2013.0,Comedy,0 days 01:35:00.000000000,2
59,78,https://resizing.flixster.com/5wG75I2SrID8qAEeGkkjjWitBrY=/206x305/v2/https://flxt.tmsimg.com/assets/p9913789_p_v10_aj.jpg,The Grandmaster,10000,138,2013.0,Drama/Sports and fitness,0 days 02:10:00.000000000,19
37,49,,I'm So Excited!,2500,131,2013.0,Comedy/Gay and lesbian,0 days 01:29:00.000000000,12
50,100,,Pit Stop,100,5,2013.0,Gay and lesbian/Drama,0 days 01:20:00.000000000,50
50,83,,Crystal Fairy & the Magical Cactus,5000,94,2013.0,Comedy,0 days 01:40:00.000000000,33
77,76,,The Kings of Summer,10000,122,2013.0,Comedy/Drama,0 days 01:33:00.000000000,-1
76,91,https://resizing.flixster.com/IO01oGSKwkrzi4Y9RzhVshwIsrw=/206x305/v2/https://flxt.tmsimg.com/assets/p9718304_p_v10_ab.jpg,The Spectacular Now,25000,170,2013.0,Comedy/Drama,0 days 01:35:00.000000000,15
26,16,https://resizing.flixster.com/m3b7Q_mY7sVil4SG8_2al7Gzfdo=/206x305/v2/https://flxt.tmsimg.com/assets/p9721489_p_v13_ad.jpg,The Lifeguard,5000,32,2013.0,Comedy/Drama,0 days 01:38:00.000000000,-10
35,69,https://resizing.flixster.com/NxEflXXK14K0CbAHJ7JFLc7OCPM=/206x305/v2/https://flxt.tmsimg.com/assets/p9720623_p_v10_ab.jpg,C.O.G.,2500,36,2013.0,Comedy/Drama,0 days 01:28:00.000000000,34
65,69,,About Last Night,25000,99,2014.0,Romance/Drama,0 days 01:40:00.000000000,4
28,52,,A.C.O.D.,5000,58,2013.0,Comedy,0 days 01:27:00.000000000,24
82,80,,Girl Rising,1000,10,2013.0,Documentary,0 days 01:42:00.000000000,-2
84,83,,"The Way, Way Back",50000,185,2013.0,Comedy/Drama,0 days 01:43:00.000000000,-1
47,50,https://resizing.flixster.com/gUdmM8TSdEIhVKKDgVmKd4lz2o4=/206x305/v2/https://flxt.tmsimg.com/assets/p10149971_p_v8_ah.jpg,Parkland,5000,125,2013.0,Drama/History,0 days 01:34:00.000000000,3
34,37,,The Truth About Emanuel,2500,30,2013.0,Drama,0 days 01:36:00.000000000,3
36,73,,Jug Face,1000,22,2013.0,Horror,0 days 01:21:00.000000000,37
49,27,https://resizing.flixster.com/3Wy4KM0bSCqvWfWHGIHYrHwNRfg=/206x305/v2/https://flxt.tmsimg.com/assets/p10026405_p_v8_ag.jpg,The Necessary Death of Charlie Countryman,2500,66,2013.0,Crime/Romance,0 days 01:48:00.000000000,-22
77,90,,Blue Jasmine,25000,231,2013.0,Drama,0 days 01:38:00.000000000,13
72,61,,Kevin Hart: Let Me Explain,25000,44,2013.0,Comedy,0 days 01:15:00.000000000,-11
77,56,https://resizing.flixster.com/fdN9v5REL2Ar3_xIbs9M8-ETOTE=/206x305/v2/https://flxt.tmsimg.com/assets/p10082580_p_v10_ai.jpg,The Best Offer,5000,34,2013.0,Romance/Drama,0 days 02:04:00.000000000,-21
23,33,https://resizing.flixster.com/ZXZj8kJhcirCOwRGNfgXTQM4iVA=/206x305/v2/https://flxt.tmsimg.com/assets/p9991582_p_v10_ax.jpg,The Counselor,25000,218,2013.0,Crime/Drama,0 days 01:57:00.000000000,10
73,48,https://resizing.flixster.com/QlFgI9kNXKk_U1KtcvYIyfTEDq4=/206x305/v2/https://flxt.tmsimg.com/assets/p10088328_p_v10_ae.jpg,The Book Thief,50000,151,2013.0,Drama/History,0 days 02:07:00.000000000,-25
53,88,https://resizing.flixster.com/3GzFAXWa5Hqny8D--DT0HkhW8ro=/206x305/v2/https://flxt.tmsimg.com/assets/p9718883_p_v8_aa.jpg,Computer Chess,2500,82,2013.0,Comedy,0 days 01:31:00.000000000,35
91,50,/assets/pizza-pie/images/poster_default.c8c896e70c3.gif,Breath of the Gods,1,10,2011.0,Documentary,0 days 01:45:00.000000000,-41
69,65,https://resizing.flixster.com/Sw2FCg3qKkJDt7jgUbszQFLB434=/206x305/v2/https://flxt.tmsimg.com/assets/p9474647_p_v8_ag.jpg,Unfinished Song,2500,100,2012.0,Comedy/Drama,0 days 01:33:00.000000000,-4
70,93,https://resizing.flixster.com/9gPPWwvs2YXwUDUD-P0o2ucThpk=/206x305/v2/https://flxt.tmsimg.com/assets/p9718922_p_v10_aa.jpg,This Is Martin Bonner,500,30,2013.0,Drama,0 days 01:23:00.000000000,23
68,58,https://resizing.flixster.com/usW5B-4khHsDZoCh8RWxS8hW_C8=/206x305/v2/https://flxt.tmsimg.com/assets/p9816875_p_v10_bb.jpg,Stuck in Love,10000,45,2012.0,Comedy/Drama,0 days 01:37:00.000000000,-10
73,79,,Metallica: Through the Never,10000,68,2013.0,Adventure/Musical,0 days 01:32:00.000000000,6
85,92,,After Tiller,500,62,2013.0,Documentary/Drama,0 days 01:28:00.000000000,7
41,66,,Afternoon Delight,2500,83,2013.0,Comedy/Drama,0 days 01:39:00.000000000,25
17,27,https://resizing.flixster.com/E41jel0JeLEqxsnDEMYqi2zchIU=/206x305/v2/https://flxt.tmsimg.com/assets/p10135148_p_v8_aa.jpg,Ass Backwards,250,22,2013.0,Comedy,0 days 01:23:00.000000000,10
54,32,,Austenland,5000,114,2013.0,Romance,0 days 01:36:00.000000000,-22
38,44,,Big Sur,1000,25,2013.0,Drama,0 days 01:40:00.000000000,6
90,98,,Blackfish,25000,131,2013.0,Documentary,0 days 01:23:00.000000000,8
51,83,https://resizing.flixster.com/v-N_afyMSwOkBpytFS3EUDC-tes=/206x305/v2/https://flxt.tmsimg.com/assets/p9826631_p_v10_aa.jpg,Blue Caprice,5000,84,2013.0,Crime/Drama,0 days 01:33:00.000000000,32
58,75,https://resizing.flixster.com/TwG9BuhYnlxATZQ5BtVf2gTLf6Q=/206x305/v2/https://flxt.tmsimg.com/assets/p9724298_p_v10_af.jpg,Concussion,1000,59,2013.0,Gay and lesbian/Drama,0 days 01:36:00.000000000,17
94,96,,The Crash Reel,1000,46,2013.0,Documentary,0 days 01:49:00.000000000,2
75,95,,Cutie and the Boxer,2500,75,2013.0,Documentary/Biography,0 days 01:22:00.000000000,20
74,83,https://resizing.flixster.com/NqBB47di8hT6Ungh8SH19DrlFlQ=/206x305/v2/https://flxt.tmsimg.com/assets/p9719306_p_v10_ab.jpg,Dirty Wars,2500,72,2013.0,Documentary,0 days 01:26:00.000000000,9
64,76,,The East,10000,148,2013.0,Adventure/Drama,0 days 01:56:00.000000000,12
25,57,,Escape From Tomorrow,5000,87,2013.0,Horror,0 days 01:30:00.000000000,32
87,94,,Fruitvale Station,25000,213,2013.0,Drama,0 days 01:25:00.000000000,7
51,80,/assets/pizza-pie/images/poster_default.c8c896e70c3.gif,The Future,250,15,2013.0,Drama,0 days 01:34:00.000000000,29
77,100,,God Loves Uganda,2500,29,2013.0,Documentary/Gay and lesbian,0 days 01:30:00.000000000,23
27,31,,Hell Baby,2500,39,2013.0,Comedy/Horror,0 days 01:33:00.000000000,4
43,81,https://resizing.flixster.com/H-YT3lkcPsjGaoUgXnYQciJtoQY=/206x305/v2/https://flxt.tmsimg.com/assets/p10047678_p_v8_aa.jpg,I Used to Be Darker,250,21,2013.0,Drama,0 days 01:30:00.000000000,38
41,81,https://resizing.flixster.com/Ghj2yX1-t1dZZIYwSUVlaC9f-SE=/206x305/v2/https://flxt.tmsimg.com/assets/p9718656_p_v10_ak.jpg,In Fear,5000,58,2013.0,Mystery and thriller,0 days 01:25:00.000000000,40
71,92,,In a World ...,10000,132,2013.0,Comedy,0 days 01:33:00.000000000,21
88,90,,Inequality for All,5000,62,2013.0,Documentary,0 days 01:26:00.000000000,2
78,64,,Linsanity,500,25,2013.0,Documentary,0 days 01:28:00.000000000,-14
82,67,,The Machine Which Makes Everything Disappear,250,15,2012.0,Documentary,0 days 01:41:00.000000000,-15
65,91,,Mother of George,500,45,2013.0,Drama,0 days 01:47:00.000000000,26
77,89,,Narco cultura,1000,44,2012.0,Documentary,0 days 01:43:00.000000000,12
71,71,,Newlyweeds,250,17,2013.0,Comedy,0 days 01:27:00.000000000,0
71,65,,Pandora's Promise,1000,37,2013.0,Documentary,0 days 01:30:00.000000000,-6
53,82,,Prince Avalanche,10000,123,2013.0,Comedy/Drama,0 days 01:33:00.000000000,29
51,70,,VHS 2,10000,64,2013.0,Horror/Mystery and thriller,0 days 01:36:00.000000000,19
22,42,,Touchy Feely,1000,65,2013.0,Comedy/Drama,0 days 01:29:00.000000000,20
82,99,https://resizing.flixster.com/UO54ZLXYn7nrzL8n8VZmJ9qxO5Q=/206x305/v2/https://flxt.tmsimg.com/assets/p9728103_p_v10_ao.jpg,20 Feet From Stardom,10000,128,2013.0,Documentary,0 days 01:30:00.000000000,17
50,86,,We Are What We Are,10000,91,2013.0,Horror/Drama,0 days 01:46:00.000000000,36
75,92,,We Steal Secrets: The Story of WikiLeaks,5000,83,2013.0,Documentary,0 days 02:10:00.000000000,17
42,55,https://resizing.flixster.com/CKLXYq6N3tML6MbtjjndkV-4A3M=/206x305/v2/https://flxt.tmsimg.com/assets/p10347063_p_v10_aa.jpg,Wrong Cops,500,11,2013.0,Crime/Comedy,0 days 01:23:00.000000000,13
40,56,https://resizing.flixster.com/zqEXFgX4rr-cyGhMB3af0wFXFwY=/206x305/v2/https://flxt.tmsimg.com/assets/p9914765_p_v10_aa.jpg,Frankenstein's Army,2500,25,2013.0,Action/Horror,0 days 01:24:00.000000000,16
44,92,https://resizing.flixster.com/zANWRxol_wY2aqB926CTp4jTnKk=/206x305/v2/https://flxt.tmsimg.com/assets/p9844156_p_v8_aa.jpg,Viola,100,13,2012.0,Drama,0 days 01:05:00.000000000,48
58,79,,Don Jon,50000,206,2013.0,Romance/Comedy,0 days 01:29:00.000000000,21
73,83,https://resizing.flixster.com/sz5vlv-SNo_FCoQL1Tx7G8QglR8=/206x305/v2/https://flxt.tmsimg.com/NowShowing/125942/125942_ab.jpg,Pussy Riot - A Punk Prayer,250,36,2013.0,Drama/Crime,0 days 01:30:00.000000000,10
88,84,https://resizing.flixster.com/LTglAWrftPY1epR9wDu-yEVR5SY=/206x305/v2/https://flxt.tmsimg.com/assets/p10143572_p_v10_ap.jpg,The Inevitable Defeat of Mister & Pete,2500,38,2013.0,Drama,0 days 01:48:00.000000000,-4
85,56,,The Battle of Pussy Willow Creek,50,9,2010.0,Comedy,0 days 01:35:00.000000000,-29
30,60,,The Happy House,100,5,2013.0,Comedy,0 days 01:20:00.000000000,30
58,43,https://resizing.flixster.com/ZNzSzpi8a6ZQBCAfnXnaOalotCM=/206x305/v2/https://flxt.tmsimg.com/assets/p9734958_p_v10_af.jpg,The Berlin File,250,14,2013.0,Action/Drama,0 days 02:00:00.000000000,-15
36,35,,The Fifth Estate,10000,181,2013.0,Drama/Mystery and thriller,0 days 02:08:00.000000000,-1
46,31,,Grudge Match,25000,144,2013.0,Comedy,0 days 01:53:00.000000000,-15
37,16,https://resizing.flixster.com/QDvGUiqH5_SbAzQWTmaz4v_-fdk=/206x305/v2/https://flxt.tmsimg.com/assets/p10178716_p_v10_ae.jpg,The Right Kind of Wrong,1000,19,2013.0,Romance,0 days 01:37:00.000000000,-21
68,36,https://resizing.flixster.com/DDTcDNt1rEtRl52T00vOHItDGsk=/206x305/v2/https://flxt.tmsimg.com/assets/p9908144_p_v10_aa.jpg,Ghost Team One,500,11,2013.0,Comedy/Horror,0 days 01:23:00.000000000,-32
28,7,,Java Heat,500,14,2013.0,Mystery and thriller/Action,0 days 01:44:00.000000000,-21
49,67,/assets/pizza-pie/images/poster_default.c8c896e70c3.gif,Lost in Thailand,100,6,2012.0,Comedy,0 days 01:45:00.000000000,18
83,70,https://resizing.flixster.com/DesQ-YNMyCxiOu9BmkExE2wiXoU=/206x305/v2/https://flxt.tmsimg.com/assets/p9991476_p_v10_ab.jpg,The Best Man Holiday,50000,97,2013.0,Other/Drama,0 days 02:02:00.000000000,-13
55,77,,Zero Charisma,1000,26,2013.0,Comedy,0 days 01:28:00.000000000,22
82,67,https://resizing.flixster.com/zlWrq91oJGVHM-b-MasqaeaBa_A=/206x305/v2/https://flxt.tmsimg.com/assets/p9886386_p_v10_aa.jpg,Things Never Said,250,9,2012.0,Drama,0 days 01:51:00.000000000,-15
87,81,,The Raid 2,10000,176,2014.0,Crime/Action,0 days 02:28:00.000000000,-6
32,50,,Phil Spector,500,40,2013.0,Drama/Biography,0 days 01:33:00.000000000,18
83,96,https://resizing.flixster.com/cMaax1pFxCyLwj_XLZ57st4Jrtk=/206x305/v2/https://flxt.tmsimg.com/assets/p8936483_p_v8_aa.jpg,I Am Divine,2500,54,2012.0,Documentary,0 days 01:30:00.000000000,13
33,5,,The Legend of Hercules,25000,83,2014.0,Action/Fantasy,0 days 01:38:00.000000000,-28
82,92,,Still,5000,64,2012.0,Drama,0 days 01:43:00.000000000,10
73,86,,Alan Partridge,10000,108,2013.0,Comedy,0 days 01:29:00.000000000,13
57,56,,GMO OMG,500,16,2013.0,Documentary,0 days 01:30:00.000000000,-1
74,100,https://resizing.flixster.com/0o5xLknoUiU9M3GrxU3taqRuObw=/206x305/v2/https://flxt.tmsimg.com/assets/p9935677_p_v10_ab.jpg,Rewind This!,250,21,2013.0,Documentary,0 days 01:34:00.000000000,26
70,60,,Desperate Acts of Magic,100,10,2013.0,Comedy,0 days 01:26:00.000000000,-10
55,16,https://resizing.flixster.com/3PFwl0MvFYF2JC0By-7qQnoTCV0=/206x305/v2/https://flxt.tmsimg.com/assets/p10172818_p_v10_ae.jpg,Vampire Academy,25000,58,2014.0,Action/Fantasy,0 days 01:44:00.000000000,-39
57,81,,Europa Report,10000,80,2013.0,Sci fi/Mystery and thriller,0 days 01:29:00.000000000,24
48,80,https://resizing.flixster.com/RpLd99SLrAlJYexuozVMX81xXF0=/206x305/v2/https://flxt.tmsimg.com/assets/p10157644_p_v10_aa.jpg,"Camille Claudel, 1915",500,46,2013.0,Drama/Biography,0 days 01:35:00.000000000,32
90,100,,Alien Boy: The Life and Death of James Chasse,1,5,2013.0,Crime/Documentary,0 days 01:30:00.000000000,10
61,41,https://resizing.flixster.com/QHNUdAPPyF4jhGWM2rAGL-0zWRA=/206x305/v2/https://flxt.tmsimg.com/assets/p10362828_p_v10_aa.jpg,Night Train to Lisbon,500,29,2013.0,Romance/Mystery and thriller,0 days 01:51:00.000000000,-20
81,50,https://resizing.flixster.com/HkD7qLvZypwGvoBLzKYZqFXSetE=/206x305/v2/https://flxt.tmsimg.com/assets/p9781850_p_v10_ad.jpg,Home Run,2500,12,2013.0,Drama,0 days 01:53:00.000000000,-31
69,94,,Journey to the West: Conquering the Demons,2500,35,2013.0,Comedy/Fantasy,0 days 01:50:00.000000000,25
54,8,,Girl on a Bicycle,250,12,2013.0,Romance,0 days 01:41:00.000000000,-46
50,61,,The Frozen Ground,10000,57,2013.0,Mystery and thriller,0 days 01:45:00.000000000,11
79,83,,Maidentrip,500,23,2013.0,Documentary,0 days 01:22:00.000000000,4
90,78,,Murph: The Protector,1000,9,2013.0,Documentary,0 days 01:19:00.000000000,-12
35,13,,Savannah,250,15,2013.0,Drama,0 days 01:50:00.000000000,-22
68,62,https://resizing.flixster.com/S121IVFYE_qVMeqovjJ85JTOEXM=/206x305/v2/https://flxt.tmsimg.com/assets/p9991871_p_v13_at.jpg,Mandela: Long Walk to Freedom,10000,144,2013.0,Drama/History,0 days 02:26:00.000000000,-6
37,22,https://resizing.flixster.com/JDH-CnXfMrn2RHZGQKXGfXjPoy4=/206x305/v2/https://flxt.tmsimg.com/assets/p10460946_p_v10_aa.jpg,Awful Nice,100,9,2013.0,Comedy,0 days 01:28:00.000000000,-15
45,78,https://resizing.flixster.com/-ZzAUvbQP6GY_ASrmj6OZjbiOIc=/206x305/v2/https://flxt.tmsimg.com/assets/p9873245_p_v10_af.jpg,Big Ass Spider!,1000,27,2013.0,Comedy/Sci fi,0 days 01:20:00.000000000,33
69,88,,Cheap Thrills,5000,99,2013.0,Comedy/Mystery and thriller,0 days 01:25:00.000000000,19
49,84,https://resizing.flixster.com/T4FfoUvp2SS5kk9aHhl8JWgzdRo=/206x305/v2/https://flxt.tmsimg.com/assets/p9842858_p_v10_aa.jpg,Drinking Buddies,10000,122,2013.0,Drama/Romance,0 days 01:30:00.000000000,35
76,89,,Harry Dean Stanton: Partly Fiction,250,27,2012.0,Documentary/Biography,0 days 01:17:00.000000000,13
42,56,https://resizing.flixster.com/xmTfENmHKQrnZ5p7ZSqp7OJ3pMA=/206x305/v2/https://flxt.tmsimg.com/assets/p9864548_p_v10_ac.jpg,Haunter,5000,36,2013.0,Horror/Mystery and thriller,0 days 01:37:00.000000000,14
63,65,,Hey Bartender!,100,20,2013.0,Documentary,0 days 01:32:00.000000000,2
60,61,,Hours,10000,33,2013.0,Drama,0 days 01:37:00.000000000,1
74,50,https://resizing.flixster.com/w65URYVC5xvjWe-O1C1j75feaE4=/206x305/v2/https://flxt.tmsimg.com/assets/p9829195_p_v10_aa.jpg,Stevie Nicks: In Your Dreams,100,6,2012.0,Documentary,0 days 01:52:00.000000000,-24
54,75,,Loves Her Gun,50,8,2013.0,Drama,0 days 01:39:00.000000000,21
89,97,,Muscle Shoals,5000,87,2013.0,Documentary,0 days 01:51:00.000000000,8
74,91,,Our Nixon,1000,43,2013.0,Documentary,0 days 01:24:00.000000000,17
84,84,,The Short Game,250,19,2013.0,Documentary,0 days 01:35:00.000000000,0
92,98,https://resizing.flixster.com/2RB0LN8AcTPwtYiIavgkLeWcIH4=/206x305/v2/https://flxt.tmsimg.com/assets/p9989763_p_v10_aa.jpg,Short Term 12,10000,174,2013.0,Drama,0 days 01:36:00.000000000,6
73,96,https://resizing.flixster.com/AiR5jAolZ6BtdsTE0mzjq3ktqeI=/206x305/v2/https://flxt.tmsimg.com/assets/p10048409_p_v10_aa.jpg,These Birds Walk,500,27,2013.0,Drama,0 days 01:11:00.000000000,23
23,31,https://resizing.flixster.com/NVwcZZJeI-4f1yQXecugbw35C9w=/206x305/v2/https://flxt.tmsimg.com/assets/p10414742_p_v8_aa.jpg,The Wait,250,13,2013.0,Drama/Mystery and thriller,0 days 01:36:00.000000000,8
51,50,https://resizing.flixster.com/ZKwnQPxN4o8N7kYN6VJOE6ZyjdA=/206x305/v2/https://flxt.tmsimg.com/assets/p9991762_p_v10_az.jpg,Black Nativity,10000,90,2013.0,Other/Drama,0 days 01:33:00.000000000,-1
70,89,,The Great Hip Hop Hoax,50,18,2013.0,Documentary/Music,0 days 01:32:00.000000000,19
83,91,,The Punk Singer,2500,67,2013.0,Documentary/Music,0 days 01:20:00.000000000,8
73,62,,Broadway Idiot,250,21,2013.0,Documentary,0 days 01:21:00.000000000,-11
74,92,/assets/pizza-pie/images/poster_default.c8c896e70c3.gif,American Hustle,100000,293,2013.0,Crime/Drama,0 days 02:18:00.000000000,18
55,67,,Ip Man: The Final Fight,2500,18,2013.0,Action/Drama,0 days 01:40:00.000000000,12
33,62,,La Maison de la radio,100,21,2013.0,Documentary,0 days 01:39:00.000000000,29
29,33,https://resizing.flixster.com/FS3wtJdyl2YO0ChWSmoSNGBs0iA=/206x305/v2/https://flxt.tmsimg.com/assets/p10123052_p_v10_aa.jpg,Cottage Country,250,6,2013.0,Comedy/Mystery and thriller,0 days 01:31:00.000000000,4
63,11,https://resizing.flixster.com/RInBW4-ZgJfpbgjThzcJNoHtNv0=/206x305/v2/https://flxt.tmsimg.com/assets/p10217303_p_v10_ab.jpg,I'm in Love With a Church Girl,2500,19,2013.0,Romance/Drama,0 days 01:58:00.000000000,-52
52,36,,Salinger,5000,88,2013.0,Documentary,0 days 02:09:00.000000000,-16
45,61,https://resizing.flixster.com/bxQWeeMgAi3bWkU0dj46703AHME=/206x305/v2/https://flxt.tmsimg.com/assets/p10355856_p_v13_ae.jpg,At Middleton,1000,38,2013.0,Romance,0 days 01:40:00.000000000,16
51,62,,Dear Mr. Watterson,1000,34,2013.0,Documentary,0 days 01:29:00.000000000,11
49,91,,The Last Days,250,11,2013.0,Sci fi/Mystery and thriller,0 days 01:42:00.000000000,42
67,29,https://resizing.flixster.com/ad_tfF-EA-A_mXwML4t6YhGPNUM=/206x305/v2/https://flxt.tmsimg.com/assets/p9831926_p_v10_ac.jpg,Hammer of the Gods,100,21,2013.0,Action/Drama,0 days 01:39:00.000000000,-38
22,20,https://resizing.flixster.com/ixgI3mqA9d36nF_THC4EiTrRods=/206x305/v2/https://flxt.tmsimg.com/assets/p9868203_p_v10_ab.jpg,The Colony,5000,35,2013.0,Sci fi/Mystery and thriller,0 days 01:33:00.000000000,-2
25,10,https://resizing.flixster.com/RR_DMucP95SNc3LxVxJ8LrTxGXI=/206x305/v2/https://flxt.tmsimg.com/assets/p9875347_p_v10_ab.jpg,And Now a Word From Our Sponsor,100,10,2012.0,Comedy/Drama,0 days 01:27:00.000000000,-15
62,71,,Fists of Legend,250,7,2013.0,Action/Drama,0 days 02:33:00.000000000,9
44,21,,Copperhead,500,19,2013.0,Drama/History,0 days 01:58:00.000000000,-23
19,50,https://resizing.flixster.com/tp9E5BTIeq3qIxwSMzndzSyyikc=/206x305/v2/https://flxt.tmsimg.com/assets/p9913888_p_v8_aa.jpg,Mr. Jones,250,10,2013.0,Mystery and thriller,0 days 01:24:00.000000000,31
44,71,,The Philosophers,5000,14,2013.0,Action/Fantasy,0 days 01:47:00.000000000,27
25,14,https://resizing.flixster.com/8SUivj923EwiCP5h8xOsHCackhA=/206x305/v2/https://flxt.tmsimg.com/assets/p9901858_p_v10_aa.jpg,As Cool as I Am,500,7,2013.0,Comedy/Drama,0 days 01:32:00.000000000,-11
78,50,https://resizing.flixster.com/xN0l8F7rYVGJ0pOxzrsGZsSQ7Ak=/206x305/v2/https://flxt.tmsimg.com/assets/p10035741_p_v10_aa.jpg,Grace Unplugged,2500,8,2013.0,Drama,0 days 01:42:00.000000000,-28
35,25,https://resizing.flixster.com/IZ5KY8trQvxfKwKMIPaRpUl3KUI=/206x305/v2/https://flxt.tmsimg.com/assets/p9898941_p_v10_aa.jpg,Syrup,1000,8,2013.0,Comedy/Drama,0 days 01:30:00.000000000,-10
76,76,,The Stone Roses: Made of Stone,500,29,2013.0,Documentary,0 days 01:37:00.000000000,0
45,45,https://resizing.flixster.com/Y6M68ViVoE9bnGbHYziZFjZgBB4=/206x305/v2/https://flxt.tmsimg.com/assets/p9873802_p_v10_aa.jpg,He's Way More Famous Than You,100,11,2013.0,Comedy,0 days 01:36:00.000000000,0
71,94,https://resizing.flixster.com/HT1UklLR7oik5AMcJRqjnOoUeRU=/206x305/v2/https://flxt.tmsimg.com/assets/p9695858_p_v8_ax.jpg,Behind the Candelabra,10000,107,2013.0,Romance/Gay and lesbian,0 days 01:58:00.000000000,23
79,99,,Elaine Stritch: Shoot Me,2500,67,2013.0,Documentary,0 days 01:26:00.000000000,20
50,60,,"Turtle Hill, Brooklyn",50,5,2011.0,Comedy/Drama,0 days 01:35:00.000000000,10
37,12,https://resizing.flixster.com/FAl_t0sAZFNrTNVeFdqOiaRbRL0=/206x305/v2/https://flxt.tmsimg.com/assets/p9915745_p_v10_aa.jpg,Walk of Shame,10000,25,2014.0,Comedy,0 days 01:35:00.000000000,-25
38,56,,Adult World,5000,36,2013.0,Comedy,0 days 01:37:00.000000000,18
23,49,https://resizing.flixster.com/7-bGXikpmO_Dxve8KO0bmWPdlUA=/206x305/v2/https://flxt.tmsimg.com/assets/p9850466_p_v10_aa.jpg,All Is Bright,500,41,2013.0,Other/Comedy,0 days 01:47:00.000000000,26
29,48,,Devil's Pass,1000,23,2013.0,Mystery and thriller,0 days 01:29:00.000000000,19
69,65,,Reaching for the Moon,500,37,2013.0,Romance/Gay and lesbian,0 days 01:58:00.000000000,-4
89,57,https://resizing.flixster.com/eKuif-ptbxxL6-FXdYqeG0qg5gw=/206x305/v2/https://flxt.tmsimg.com/assets/p10094885_p_v10_ad.jpg,Instructions Not Included,25000,21,2013.0,Comedy/Drama,0 days 01:55:00.000000000,-32
43,12,https://resizing.flixster.com/5EVAuwmpMKZnvIucOn3uFC2tNiU=/206x305/v2/https://flxt.tmsimg.com/assets/p10092840_p_v10_as.jpg,The Nut Job,25000,97,2014.0,Animation/Comedy,0 days 01:26:00.000000000,-31
85,100,,Adjust Your Tracking: The Untold Story of the VHS Collector,50,6,2012.0,Documentary,0 days 01:24:00.000000000,15
69,76,https://resizing.flixster.com/dNV_dRqSOidAOnuMnmdlUedu6jc=/206x305/v2/https://flxt.tmsimg.com/assets/p9913797_p_v10_aa.jpg,Big Bad Wolves,5000,70,2013.0,Crime/Drama,0 days 01:50:00.000000000,7
68,86,,A Birder's Guide to Everything,1000,22,2013.0,Comedy/Drama,0 days 01:28:00.000000000,18
40,33,,Bottled Up,50,6,2013.0,Drama,0 days 01:24:00.000000000,-7
87,85,https://resizing.flixster.com/QmdJgiLK-zjPcWZC4V5hqzYDEyo=/206x305/v2/https://flxt.tmsimg.com/assets/p9914408_p_v10_ab.jpg,Bridegroom,500,13,2012.0,Documentary/Gay and lesbian,0 days 01:19:00.000000000,-2
26,47,https://resizing.flixster.com/LDZ9SVYwb6rFJ65JyorhEo4iAuA=/206x305/v2/https://flxt.tmsimg.com/assets/p10117963_p_v10_ab.jpg,A Case of You,1000,19,2013.0,Romance,0 days 01:32:00.000000000,21
28,64,,Dark Touch,500,11,2013.0,Horror,0 days 01:32:00.000000000,36
55,80,https://resizing.flixster.com/cGemGwb5wgRC700JlkiGPrxVlaM=/206x305/v2/https://flxt.tmsimg.com/assets/p9914785_p_v10_ab.jpg,GBF,5000,45,2013.0,Comedy/Gay and lesbian,0 days 01:34:00.000000000,25
53,87,https://resizing.flixster.com/7RuV7rGqpw5CSHRk2RncWa_krXs=/206x305/v2/https://flxt.tmsimg.com/assets/p9913395_p_v10_aa.jpg,Kiss the Water,100,15,2013.0,Documentary/Biography,0 days 01:20:00.000000000,34
90,98,,Let the Fire Burn,500,46,2012.0,Drama/Mystery and thriller,0 days 01:28:00.000000000,8
46,79,,The Machine,10000,33,2013.0,Sci fi/Mystery and thriller,0 days 01:31:00.000000000,33
60,0,https://resizing.flixster.com/bZu3Xnu6oZgzTL9GUhgEA_cMqgQ=/206x305/v2/https://flxt.tmsimg.com/assets/p9869058_p_v13_aa.jpg,Mission Park,100,6,2013.0,Crime/Drama,0 days 01:50:00.000000000,-60
45,50,https://resizing.flixster.com/B1UlFtqDovf-6LlPrneLIwc73-8=/206x305/v2/https://flxt.tmsimg.com/assets/p9914667_p_v10_av.jpg,The Pretty One,2500,34,2013.0,Comedy/Drama,0 days 01:30:00.000000000,5
29,45,https://resizing.flixster.com/OzDDYn1rLQwHS8-8oKgX1PP63Qc=/206x305/v2/https://flxt.tmsimg.com/assets/p9913447_p_v8_aa.jpg,Raze,500,33,2013.0,Action/Mystery and thriller,0 days 01:27:00.000000000,16
70,86,https://resizing.flixster.com/3L7ATZVkxZxCMu_AQl92KEcLthk=/206x305/v2/https://flxt.tmsimg.com/assets/p9913470_p_v10_aj.jpg,Red Obsession,2500,22,2013.0,Documentary,0 days 01:15:00.000000000,16
83,95,https://resizing.flixster.com/El44NKSu-DMmQ8FVORslfgrXPP0=/206x305/v2/https://flxt.tmsimg.com/assets/p9913748_p_v10_an.jpg,The Rocket,5000,64,2013.0,Drama,0 days 01:36:00.000000000,12
54,89,https://resizing.flixster.com/mQ4ISPe_tio4bL8MyPyxU2X9CR0=/206x305/v2/https://flxt.tmsimg.com/assets/p9913532_p_v10_ah.jpg,Run & Jump,1000,36,2013.0,Drama,0 days 01:42:00.000000000,35
36,54,https://resizing.flixster.com/qmEGaTF6iCQyYT2ASvxmftuJo-Q=/206x305/v2/https://flxt.tmsimg.com/assets/p10257903_p_v10_ak.jpg,Some Velvet Morning,250,37,2013.0,Drama,0 days 01:23:00.000000000,18
30,37,https://resizing.flixster.com/qqv0PJ6O4MoSWk4R6lHH4UL6XSI=/206x305/v2/https://flxt.tmsimg.com/assets/p9901919_p_v8_aa.jpg,Dealin' With Idiots,250,19,2013.0,Comedy,0 days 01:23:00.000000000,7
77,94,https://resizing.flixster.com/YcSdCwOtn_TJGxX9bx-6TLMgEXw=/206x305/v2/https://flxt.tmsimg.com/assets/p10068587_p_v10_av.jpg,Drug War,2500,54,2012.0,Crime/Action,0 days 01:45:00.000000000,17
59,53,,Justin Bieber's Believe,10000,15,2013.0,Documentary/Music,0 days 01:31:00.000000000,-6
83,92,https://resizing.flixster.com/xjKRPw28YQdKuMiVjDWmKnQza6g=/206x305/v2/https://flxt.tmsimg.com/assets/p10143732_p_v10_ag.jpg,The Past,10000,155,2013.0,Drama,0 days 02:10:00.000000000,9
72,96,,Plimpton! Starring George Plimpton as Himself,250,27,2011.0,Documentary,0 days 01:28:00.000000000,24
94,100,https://resizing.flixster.com/xMwK6BTnUDqpgSMp-UJY7I_IdkM=/206x305/v2/https://flxt.tmsimg.com/assets/p10171801_p_v10_aa.jpg,McConkey,100,5,2013.0,Documentary/Adventure,0 days 01:49:00.000000000,6
31,49,https://resizing.flixster.com/wpdkbIbOnz3sc2ycBI3uki7T1jQ=/206x305/v2/https://flxt.tmsimg.com/assets/p10112502_p_v8_aa.jpg,A Single Shot,2500,49,2013.0,Mystery and thriller,0 days 01:56:00.000000000,18
85,88,,The Trials of Muhammad Ali,250,42,2013.0,Documentary/Biography,0 days 01:34:00.000000000,3
63,94,,All Is Lost,25000,240,2013.0,Mystery and thriller/Drama,0 days 01:45:00.000000000,31
37,58,,The Returned,500,19,2013.0,Crime/Horror,0 days 01:38:00.000000000,21
78,86,https://resizing.flixster.com/rSy3rS0EuptTqm3k3_IF3dUlxWc=/206x305/v2/https://flxt.tmsimg.com/assets/p9872853_p_v10_ab.jpg,Good Ol' Freda,500,35,2013.0,Documentary,0 days 01:26:00.000000000,8
84,64,,The Human Scale,100,11,2012.0,Documentary,0 days 01:23:00.000000000,-20
71,88,https://resizing.flixster.com/X1eruuhkkK_Gny57jO7NtNAm47A=/206x305/v2/https://flxt.tmsimg.com/assets/p10242871_p_v8_aa.jpg,The Jewish Cardinal,100,8,2013.0,Drama/Biography,0 days 01:36:00.000000000,17
42,7,,CBGB,2500,45,2013.0,Drama,0 days 01:41:00.000000000,-35
66,51,,Heaven Is for Real,50000,89,2014.0,Drama,0 days 01:40:00.000000000,-15
65,43,,The Anonymous People,100,7,2013.0,Documentary,0 days 01:28:00.000000000,-22
53,67,https://resizing.flixster.com/hElVXjV27fR13p8RmzXCIumJ870=/206x305/v2/https://flxt.tmsimg.com/assets/p9945027_p_v10_aa.jpg,Geography Club,500,12,2013.0,Drama/Gay and lesbian,0 days 01:23:00.000000000,14
83,91,https://resizing.flixster.com/B8rpcrgG9FAPyiqihuWgunDFM6s=/206x305/v2/https://flxt.tmsimg.com/assets/p9991634_p_v13_ab.jpg,Nebraska,25000,251,2013.0,Drama,0 days 01:54:00.000000000,8
89,87,https://resizing.flixster.com/zBzkOUaJMb-XCHXsubtyr2CfBC0=/206x305/v2/https://flxt.tmsimg.com/assets/p10193332_p_v10_aa.jpg,"Like Father, Like Son",5000,102,2013.0,Drama,0 days 02:00:00.000000000,-2
45,17,,War of the Worlds: Goliath,250,6,2014.0,Action/Sci fi,0 days 01:28:00.000000000,-28
13,33,https://resizing.flixster.com/gzJQ0qR0xYGlKQWWy2SGtGobFL8=/206x305/v2/https://flxt.tmsimg.com/assets/p10062379_p_v10_ab.jpg,Beneath,100,15,2013.0,Mystery and thriller,0 days 01:29:00.000000000,20
80,91,,The Great Beauty,10000,134,2013.0,Comedy/Drama,0 days 02:22:00.000000000,11
58,14,,Cavemen,1000,14,2013.0,Romance,0 days 01:27:00.000000000,-44
58,86,https://resizing.flixster.com/ySfVZjMbs9UlPRsMaH6-FtOJCmM=/206x305/v2/https://flxt.tmsimg.com/assets/p10050256_p_v13_ac.jpg,A Field in England,2500,72,2013.0,Horror/Mystery and thriller,0 days 01:30:00.000000000,28
21,18,,Devil's Due,10000,56,2014.0,Horror,0 days 01:30:00.000000000,-3
15,55,,Some Girl(s),500,31,2013.0,Comedy/Drama,0 days 01:30:00.000000000,40
36,38,,As I Lay Dying,2500,29,2013.0,Drama,0 days 01:50:00.000000000,2
37,67,,Bastards,500,55,2013.0,Drama,0 days 01:40:00.000000000,30
39,52,,Blood Ties,2500,56,2013.0,Crime/Drama,0 days 02:08:00.000000000,13
76,99,,The Missing Picture,5000,88,2013.0,Documentary,0 days 01:30:00.000000000,23
84,90,,Omar,5000,88,2013.0,Drama/Mystery and thriller,0 days 01:38:00.000000000,6
65,94,,Stranger by the Lake,5000,97,2013.0,Gay and lesbian/Drama,0 days 01:37:00.000000000,29
79,96,,Blue Ruin,10000,143,2013.0,Crime/Drama,0 days 01:30:00.000000000,17
67,88,https://resizing.flixster.com/H1F_0dEuD776z_CXQvqOfx8CdQY=/206x305/v2/https://flxt.tmsimg.com/assets/p10252386_p_v13_ac.jpg,For Those in Peril,500,24,2013.0,Drama,0 days 01:32:00.000000000,21
39,52,https://resizing.flixster.com/mIzuJ-s5oELLTwkzV4WLEH0UcOg=/206x305/v2/https://flxt.tmsimg.com/assets/p10240094_p_v10_ae.jpg,Jimmy P.,250,33,2013.0,Drama,0 days 01:57:00.000000000,13
25,18,https://resizing.flixster.com/vBgnquBRMkTKJiLsq5ZqFQONUbY=/206x305/v2/https://flxt.tmsimg.com/assets/p10093232_p_v10_aa.jpg,The Last Days on Mars,10000,62,2013.0,Sci fi/Mystery and thriller,0 days 01:36:00.000000000,-7
87,97,https://resizing.flixster.com/hWOOEvquqUmBj8880-B6nM6Nbr8=/206x305/v2/https://flxt.tmsimg.com/assets/p10193521_p_v10_ao.jpg,The Lunchbox,10000,117,2013.0,Romance/Drama,0 days 01:45:00.000000000,10
81,98,,The Selfish Giant,5000,86,2013.0,Drama,0 days 01:31:00.000000000,17
74,94,,A Touch of Sin,2500,88,2013.0,Drama,0 days 02:09:00.000000000,20
75,73,,Weekend of a Champion,100,15,1972.0,Documentary,0 days 01:33:00.000000000,-2
89,98,https://resizing.flixster.com/jReJbT-30XQ971Ou59PkVK8l7n4=/206x305/v2/https://flxt.tmsimg.com/assets/p10171703_p_v10_af.jpg,Jodorowsky's Dune,10000,121,2013.0,Documentary,0 days 01:28:00.000000000,9
76,92,,Child's Pose,1000,85,2013.0,Drama,0 days 01:52:00.000000000,16
87,75,,Lone Survivor,100000,226,2013.0,War/Drama,0 days 02:01:00.000000000,-12
79,88,https://resizing.flixster.com/whAFhx8Qklebe2NqW2GGn3P4ztE=/206x305/v2/https://flxt.tmsimg.com/assets/p9992753_p_v10_aa.jpg,Springsteen & I,1000,17,2013.0,Documentary,0 days 02:04:00.000000000,9
89,94,/assets/pizza-pie/images/poster_default.c8c896e70c3.gif,On the Job,1000,17,2013.0,Crime/Action,0 days 02:01:00.000000000,5
47,77,,100 Bloody Acres,1000,39,2012.0,Comedy/Horror,0 days 01:31:00.000000000,30
55,57,https://resizing.flixster.com/noJM7CxlAXEm7Y8IFoX9XsJ8M5E=/206x305/v2/https://flxt.tmsimg.com/assets/p10003565_p_v10_aa.jpg,Return to Nuke 'Em High: Volume 1,100,14,2013.0,Comedy/Horror,0 days 01:25:00.000000000,2
82,94,,Her,100000,283,2013.0,Romance/Comedy,0 days 01:59:00.000000000,12
33,13,,Just Like a Woman,500,15,2012.0,Drama,0 days 01:30:00.000000000,-20
58,16,,Endless Love,25000,95,2014.0,Romance/Drama,0 days 01:45:00.000000000,-42
51,100,https://resizing.flixster.com/45731V62I2Ct81LkOaKNzVimxXY=/206x305/v2/https://flxt.tmsimg.com/assets/p10133609_p_v8_aa.jpg,Chastity Bites,100,5,2013.0,Comedy/Horror,0 days 01:35:00.000000000,49
55,65,,How I Live Now,5000,110,2013.0,Drama,0 days 01:41:00.000000000,10
75,95,https://resizing.flixster.com/t4jbTFDALt9u5N3Th-rYl5_E1ug=/206x305/v2/https://flxt.tmsimg.com/assets/p10116059_p_v10_af.jpg,Enough Said,25000,191,2013.0,Romance,0 days 01:33:00.000000000,20
39,22,https://resizing.flixster.com/UrEZoyccHEkF0LDJCC6I_TTekXY=/206x305/v2/https://flxt.tmsimg.com/assets/p10300682_p_v8_aa.jpg,Open Grave,5000,18,2013.0,Horror,0 days 01:42:00.000000000,-17
43,28,,3 Days to Kill,25000,123,2014.0,Action/Adventure,0 days 01:56:00.000000000,-15
44,74,,The Invisible Woman,5000,159,2013.0,Romance/Drama,0 days 01:51:00.000000000,30
89,91,https://resizing.flixster.com/l_NyR-70WuVHvHhktEvlS43Igf8=/206x305/v2/https://flxt.tmsimg.com/assets/p10197066_p_v10_ao.jpg,Philomena,50000,200,2013.0,Drama,0 days 01:37:00.000000000,2
31,43,,The Face of Love,1000,74,2013.0,Romance/Drama,0 days 01:32:00.000000000,12
57,100,,Bloody Daughter,1,5,2012.0,Documentary/Music,0 days 01:34:00.000000000,43
24,25,,Trap for Cinderella,100,16,2013.0,Drama,0 days 01:40:00.000000000,1
93,60,https://resizing.flixster.com/d1X4KIapOx6X7kFt-cpq2EDuArg=/206x305/v2/https://flxt.tmsimg.com/assets/p10025971_p_v8_aa.jpg,Assaulted: Civil Rights Under Fire,100,5,2013.0,Documentary,0 days 01:19:00.000000000,-33
57,60,,Mercedes Sosa: The Voice of Latin America,50,10,2013.0,Documentary,0 days 01:30:00.000000000,3
38,56,,Dom Hemingway,5000,128,2013.0,Drama/Comedy,0 days 01:33:00.000000000,18
63,67,,Breakup at a Wedding,100,6,2013.0,Romance,0 days 01:25:00.000000000,4
91,93,https://resizing.flixster.com/75CFsAduInPta5K7SOuOMCrYxtw=/206x305/v2/https://flxt.tmsimg.com/assets/p10035475_p_v13_bb.jpg,Dallas Buyers Club,50000,262,2013.0,Gay and lesbian/Drama,0 days 01:57:00.000000000,2
29,11,https://resizing.flixster.com/EQDV_Mo-rxA_Yf1E8Ul7zwUVb6A=/206x305/v2/https://flxt.tmsimg.com/assets/p10054329_p_v13_ac.jpg,Breaking the Girls,250,9,2013.0,Crime/Gay and lesbian,0 days 01:23:00.000000000,-18
39,22,,Angels in Stardust,100,9,2013.0,Comedy/Drama,0 days 01:41:00.000000000,-17
60,83,https://resizing.flixster.com/eMqMqbj3GjTWs2aVsyCHJ9cg0ZM=/206x305/v2/https://resizing.flixster.com/83kPNEaG2Avwn03o1hodatPozno=/ems.ZW1zLXByZC1hc3NldHMvbW92aWVzLzRiNzRmZjFjLTVjNWItNDM5NC1iNDAzLTViYTE2NmJhMmJjOS5qcGc=,Northern Light,100,6,2013.0,Documentary,0 days 01:45:00.000000000,23
41,58,,Milo,1000,36,2013.0,Comedy/Horror,0 days 01:23:00.000000000,17
16,9,,Nothing Left to Fear,500,11,2013.0,Horror,0 days 01:40:00.000000000,-7
46,22,,That Awkward Moment,25000,142,2014.0,Romance,0 days 01:34:00.000000000,-24
53,50,,Chennai Express,1000,16,2013.0,Action/Comedy,0 days 02:21:00.000000000,-3
29,44,,Cold Comes the Night,1000,43,2013.0,Crime/Drama,0 days 01:30:00.000000000,15
37,20,,Cold Turkey,50,15,2013.0,Comedy/Drama,0 days 01:24:00.000000000,-17
41,33,,Adore,5000,75,2013.0,Drama,0 days 01:51:00.000000000,-8
55,30,,Lullaby,500,30,2014.0,Drama,0 days 01:57:00.000000000,-25
42,77,https://resizing.flixster.com/7MbHE9ZApR3kRxztIPW-P-wBd6U=/206x305/v2/https://flxt.tmsimg.com/assets/p10288995_p_v8_ab.jpg,The Banshee Chapter,1000,22,2013.0,Horror/Mystery and thriller,0 days 01:27:00.000000000,35
61,36,https://resizing.flixster.com/aVaCyTLkiETuz6e9lAsQPEVLcSw=/206x305/v2/https://flxt.tmsimg.com/assets/p10137019_p_v10_aa.jpg,Flu,500,11,2013.0,Drama/Mystery and thriller,0 days 02:02:00.000000000,-25
58,68,,Rigor Mortis,500,22,2013.0,Horror/Mystery and thriller,0 days 01:41:00.000000000,10
56,18,,The Ultimate Life,1000,11,2013.0,Drama,0 days 01:44:00.000000000,-38
36,27,https://resizing.flixster.com/gpcjyUFN-4oWHdf3inhvzNlgY7U=/206x305/v2/https://flxt.tmsimg.com/assets/p9723645_p_v10_ac.jpg,Sweetwater,250,15,2013.0,Western,0 days 01:34:00.000000000,-9
78,79,,Veronica Mars,25000,136,2014.0,Crime/Drama,0 days 01:47:00.000000000,1
53,31,,Last Love,1000,39,2013.0,Drama,0 days 01:56:00.000000000,-22
75,40,,How Sherlock Changed the World,100,5,2013.0,,,-35
71,50,,Drew: The Man Behind the Poster,250,10,2013.0,Documentary/Biography,0 days 01:37:00.000000000,-21
33,74,,Sharknado,5000,19,2013.0,Comedy/Sci fi,0 days 01:30:00.000000000,41
62,88,,The Conspiracy,1000,8,2012.0,Mystery and thriller,0 days 01:25:00.000000000,26
48,78,https://resizing.flixster.com/YXZtzkga3MeebooBiN7lAceS0h4=/206x305/v2/https://resizing.flixster.com/4Ga_t0I3_JVa2EEffKkVuev7-rQ=/ems.ZW1zLXByZC1hc3NldHMvbW92aWVzLzkyYjAyY2U0LWI4MzAtNDZlZi1iMGZkLWQwY2FmMjg0YjE1OC53ZWJw,"2 Autumns, 3 Winters",100,9,2013.0,Romance,0 days 01:27:00.000000000,30
38,17,,Vendetta,250,12,2013.0,Action/Mystery and thriller,0 days 01:46:00.000000000,-21
60,61,,Jackass Presents: Bad Grandpa,100000,112,2013.0,Comedy,0 days 01:32:00.000000000,1
71,58,,Pulling Strings,2500,12,2013.0,Romance,0 days 01:52:00.000000000,-13
59,67,,A Short History of Decay,100,12,2013.0,Comedy,0 days 01:33:00.000000000,8
44,44,,Khumba,500,18,2013.0,Animation/Adventure,0 days 01:25:00.000000000,0
31,27,https://resizing.flixster.com/mMgb7pHgXV2nU-HkUe97Ezlc11g=/206x305/v2/https://flxt.tmsimg.com/assets/p10548260_p_v10_ab.jpg,Goodbye World,2500,26,2013.0,Comedy/Drama,0 days 01:40:00.000000000,-4
70,75,,It's Better to Jump,50,8,2013.0,Documentary,0 days 01:15:00.000000000,5
39,44,https://resizing.flixster.com/2btNBfO8M6sSrNclb1VWQMBT5gA=/206x305/v2/https://flxt.tmsimg.com/assets/p10213109_p_v10_ak.jpg,The Art of the Steal,5000,50,2013.0,Comedy,0 days 01:30:00.000000000,5
45,59,,Bounty Killer,500,27,2013.0,Action/Sci fi,0 days 01:33:00.000000000,14
12,11,https://resizing.flixster.com/Ary2j5oKwRkRylANyNYWzkZkUKU=/206x305/v2/https://flxt.tmsimg.com/assets/p10510497_p_v10_aa.jpg,Bullet,100,9,2014.0,Crime/Action,0 days 01:22:00.000000000,-1
37,0,,Best Night Ever,500,15,2013.0,Comedy,0 days 01:22:00.000000000,-37
29,53,https://resizing.flixster.com/rmweVcp35YMhiEbtySgOah2tlVw=/206x305/v2/https://flxt.tmsimg.com/assets/p10301600_p_v10_aa.jpg,Contracted,1000,17,2013.0,Horror/Mystery and thriller,0 days 01:24:00.000000000,24
73,96,,Year of the Living Dead,1000,25,2013.0,Documentary,0 days 01:16:00.000000000,23
40,11,,The Secret Lives of Dorks,250,9,2013.0,Comedy,0 days 01:31:00.000000000,-29
62,33,https://resizing.flixster.com/M8NMoEB23aBO8HwrG7y-iKGh8bo=/206x305/v2/https://flxt.tmsimg.com/assets/p10238663_p_v8_aa.jpg,Who Needs Enemies,1,6,2013.0,Crime/Drama,0 days 01:31:00.000000000,-29
78,81,https://resizing.flixster.com/jJnyEplXZ1CB_p2z2mS367sUapo=/206x305/v2/https://flxt.tmsimg.com/assets/p10164299_p_v10_aj.jpg,Generation Iron,5000,16,2013.0,Documentary,0 days 01:46:00.000000000,3
36,47,https://resizing.flixster.com/JDcpAEbkpBVVDBAdCAr-NPmlTMs=/206x305/v2/https://flxt.tmsimg.com/assets/p10187779_p_v10_ab.jpg,Mademoiselle C,250,17,2013.0,Documentary,0 days 01:33:00.000000000,11
71,80,,Snake and Mongoose,250,5,2013.0,Drama,0 days 01:42:00.000000000,9
19,25,,Antisocial,100,8,2013.0,Horror,0 days 01:29:00.000000000,6
25,56,https://resizing.flixster.com/GwEcsLwZg_LlvEH8PJQR7Nyx_QE=/206x305/v2/https://flxt.tmsimg.com/assets/p10301833_p_v10_aa.jpg,Special ID,500,9,2013.0,Crime/Action,0 days 01:39:00.000000000,31
39,25,https://resizing.flixster.com/PmG8GTE-jdFB4wefDqH8gVytQyA=/206x305/v2/https://flxt.tmsimg.com/assets/p10193514_p_v10_ae.jpg,Devil's Knot,5000,100,2013.0,Crime/Drama,0 days 01:54:00.000000000,-14
50,69,,Visitors,1000,55,2013.0,Documentary,0 days 01:27:00.000000000,19
55,84,https://resizing.flixster.com/UARWRSfmt2DJJELo1AbSL6BalPI=/206x305/v2/https://flxt.tmsimg.com/NowShowing/131595/131595_aa.jpg,Under the Skin,25000,255,2013.0,Sci fi,0 days 01:48:00.000000000,29
70,82,,The Unknown Known,5000,106,2013.0,Documentary,0 days 01:42:00.000000000,12
14,45,,Morning,100,11,2010.0,Drama,0 days 01:35:00.000000000,31
29,73,https://resizing.flixster.com/Q1DQffoH9XEJqM2yWymMzJ1lJS0=/206x305/v2/https://flxt.tmsimg.com/assets/p10304340_p_v10_ak.jpg,Patrick,1000,22,2013.0,Horror,0 days 01:35:00.000000000,44
32,71,,The Happy Sad,100,14,2013.0,Gay and lesbian/Drama,0 days 01:27:00.000000000,39
61,65,,Bad Words,25000,136,2014.0,Comedy/Drama,0 days 01:25:00.000000000,4
31,22,https://resizing.flixster.com/3M1bVa9dLSHXBpurhUJmr4ErxbU=/206x305/v2/https://flxt.tmsimg.com/assets/p10375024_p_v10_av.jpg,Reasonable Doubt,1000,9,2014.0,Crime/Drama,0 days 01:32:00.000000000,-9
36,67,,When Jews Were Funny,50,6,2013.0,Documentary,0 days 01:30:00.000000000,31
63,93,https://resizing.flixster.com/Fcb0VVzEOQUCksb8v2wcj0lpFP0=/206x305/v2/https://flxt.tmsimg.com/assets/p10046346_p_v13_aa.jpg,Sample This,100,14,2012.0,Documentary,0 days 01:25:00.000000000,30
74,0,https://resizing.flixster.com/uVj7EPPZ59_gRbkL1WlrRoLCLf0=/206x305/v2/https://flxt.tmsimg.com/assets/p10341336_p_v8_aa.jpg,Live at the Foxes Den,50,5,2013.0,Romance/Drama,0 days 01:43:00.000000000,-74
29,33,,Dark Tourist,100,9,2012.0,Mystery and thriller,0 days 01:20:00.000000000,4
43,13,https://resizing.flixster.com/vYtZzkYmvMdYbo0A1O97uR5Kc8E=/206x305/v2/https://flxt.tmsimg.com/assets/p10166504_p_v10_ab.jpg,Winter's Tale,25000,155,2014.0,Romance/Fantasy,0 days 01:58:00.000000000,-30
76,82,https://resizing.flixster.com/8BnMLMszcmrSfMQNQcYi5NONLPk=/206x305/v2/https://flxt.tmsimg.com/assets/p10171452_p_v8_aa.jpg,The Armstrong Lie,5000,122,2013.0,Documentary,0 days 02:02:00.000000000,6
15,13,,McCanick,100,16,2013.0,Crime/Drama,0 days 01:36:00.000000000,-2
86,89,https://resizing.flixster.com/luruTpAaqAEaJCGYiYG1Apn1YQU=/206x305/v2/https://flxt.tmsimg.com/assets/p10187292_p_v10_aa.jpg,Tim's Vermeer,5000,122,2013.0,Documentary,0 days 01:20:00.000000000,3
42,20,,Repentance,2500,5,2013.0,Mystery and thriller,0 days 01:33:00.000000000,-22
52,80,https://resizing.flixster.com/aEkY_3zJiX2Y-vhMxK2c5uhMkdU=/206x305/v2/https://flxt.tmsimg.com/assets/p10243044_p_v8_aa.jpg,Redwood Highway,250,10,2013.0,Drama,0 days 01:30:00.000000000,28
20,0,,Butcher Boys,100,5,2013.0,Horror,0 days 01:33:00.000000000,-20
25,43,https://resizing.flixster.com/BHb5m3TUOyUHOZqgDgjghN4mp7Y=/206x305/v2/https://flxt.tmsimg.com/assets/p10203154_p_v10_ab.jpg,Vikingdom,500,7,2012.0,Action/Adventure,0 days 01:50:00.000000000,18
42,100,https://resizing.flixster.com/_DF1_dc17ox0h2WytnDHlZHrELE=/206x305/v2/https://flxt.tmsimg.com/assets/p10378781_p_v10_ad.jpg,Ninja II: Shadow of a Tear,250,5,2013.0,Action/Sports and fitness,0 days 01:34:00.000000000,58
91,60,,Generation War,1000,30,2014.0,,,-31
58,77,https://resizing.flixster.com/Z8T1Wbz-hBgGhxO82UfESjtpfzE=/206x305/v2/https://flxt.tmsimg.com/assets/p10192162_p_v10_aa.jpg,Watermark,500,35,2013.0,Documentary,0 days 01:32:00.000000000,19
57,83,https://resizing.flixster.com/M1Uoj_x-xYoQgP6D_H-1M9qQPIU=/206x305/v2/https://flxt.tmsimg.com/assets/p10300646_p_v10_ag.jpg,Afflicted,10000,30,2013.0,Horror/Mystery and thriller,0 days 01:25:00.000000000,26
37,43,https://resizing.flixster.com/dGtUItxbeO91fzLnjt_vhZSBDfU=/206x305/v2/https://flxt.tmsimg.com/assets/p10192258_p_v10_ae.jpg,Antboy,250,7,2013.0,Drama/Comedy,0 days 01:17:00.000000000,6
63,71,https://resizing.flixster.com/TlcMJ7SGdIhSEiX_U0R6J2cqT2g=/206x305/v2/https://resizing.flixster.com/TMNmy_kD5YOPndSJCcZs84kn1Nk=/ems.ZW1zLXByZC1hc3NldHMvbW92aWVzLzkzYjllOTU5LWJjN2MtNDcwYS1hMjBhLTM3ODAzYjUyYzY4OS53ZWJw,Enemy,25000,120,2013.0,Mystery and thriller,0 days 01:30:00.000000000,8
24,24,https://resizing.flixster.com/kW1Yw9QoRMariMoop0XeMzVUaj8=/206x305/v2/https://flxt.tmsimg.com/assets/p10204948_p_v8_aa.jpg,Stay,100,17,2013.0,Drama,0 days 01:39:00.000000000,0
57,82,,Test,250,22,2013.0,Gay and lesbian/Drama,0 days 01:29:00.000000000,25
77,96,https://resizing.flixster.com/HSrBhVaXtCLxZl9C0vjQZ1mixow=/206x305/v2/https://flxt.tmsimg.com/assets/p10356147_p_v10_aa.jpg,We Are the Best!,5000,137,2013.0,Drama,0 days 01:42:00.000000000,19
39,50,,Wolf Creek 2,2500,52,2013.0,Horror/Mystery and thriller,0 days 01:46:00.000000000,11
24,0,https://resizing.flixster.com/h2UjSt5UQIyHOGX3vmTJZRtZpow=/206x305/v2/https://resizing.flixster.com/2D4hXIK5zz46gcVE8UvKBjedT80=/ems.ZW1zLXByZC1hc3NldHMvbW92aWVzLzRlYjg2NGE4LTc4N2MtNDJkNS04NjZmLTY1MTg4OGM3MDAxNC53ZWJw,Sir Billi,50,8,2013.0,,,-24
65,99,https://resizing.flixster.com/kaGU853euKIBUyXVYXnOmQCub3U=/206x305/v2/https://flxt.tmsimg.com/assets/p10193615_p_v10_ar.jpg,Gloria,10000,129,2013.0,Romance/Drama,0 days 01:49:00.000000000,34
11,0,,10 Rules for Sleeping Around,250,8,2013.0,Comedy,0 days 01:34:00.000000000,-11
72,79,,Bethlehem,500,48,2013.0,Drama/Mystery and thriller,0 days 01:39:00.000000000,7
67,25,https://resizing.flixster.com/O8LBkIlZXavWzpBrvcqKRgwcdJQ=/206x305/v2/https://flxt.tmsimg.com/assets/p10303335_p_v8_aa.jpg,House in the Alley,50,8,2012.0,Horror,0 days 01:33:00.000000000,-42
33,58,,Made in America,250,19,2013.0,Documentary/Music,0 days 01:33:00.000000000,25
34,39,,Paranormal Activity: The Marked Ones,25000,83,2014.0,Horror/Mystery and thriller,0 days 01:24:00.000000000,5
49,67,https://resizing.flixster.com/kwawFT0Nin0fOtEf3glZbW8vtgw=/206x305/v2/https://flxt.tmsimg.com/assets/p10248721_p_v10_aa.jpg,Toad Road,250,9,2012.0,Horror/Mystery and thriller,0 days 01:16:00.000000000,18
48,38,,Make Your Move,1000,16,2013.0,Musical,0 days 01:50:00.000000000,-10
41,54,https://resizing.flixster.com/9vLWnYOafmG7LNKPSStnlzqcBKw=/206x305/v2/https://flxt.tmsimg.com/assets/p10549920_p_v10_am.jpg,Small Time,250,24,2014.0,Drama,0 days 01:35:00.000000000,13
72,90,,Afternoon of a Faun: Tanaquil Le Clercq,100,30,2013.0,Documentary,0 days 01:31:00.000000000,18
23,20,https://resizing.flixster.com/WE4SqsF749rjdIKUnBfq91yKvKg=/206x305/v2/https://flxt.tmsimg.com/assets/p10208957_p_v10_aa.jpg,A Perfect Man,250,5,2012.0,Romance/Comedy,0 days 01:35:00.000000000,-3
22,33,https://resizing.flixster.com/0h3EloHamyd5QNFUzhpTgFI9ttE=/206x305/v2/https://flxt.tmsimg.com/assets/p10136772_p_v8_aa.jpg,Hellbenders,100,9,2012.0,Comedy/Horror,0 days 01:26:00.000000000,11
22,11,https://resizing.flixster.com/a3BezuqOMZ7YU0g91dIwQJfIXyg=/206x305/v2/https://flxt.tmsimg.com/assets/p10487644_p_v10_ah.jpg,The Bag Man,1000,46,2014.0,Crime/Drama,0 days 01:48:00.000000000,-11
80,20,https://resizing.flixster.com/b3DsvdeVvH2hBSFdZQjKz9ZXXfw=/206x305/v2/https://flxt.tmsimg.com/assets/p10208101_p_v8_ab.jpg,The Adventurer: The Curse of the Midas Box,500,15,2013.0,Action/Fantasy,0 days 01:38:00.000000000,-60
47,79,https://resizing.flixster.com/BeUS7VlaDOB1A2YmOK3VTShIjPM=/206x305/v2/https://flxt.tmsimg.com/assets/p10338155_p_v10_ae.jpg,Grand Piano,10000,72,2013.0,Drama/Mystery and thriller,0 days 01:30:00.000000000,32
82,88,https://resizing.flixster.com/3KkAsPysDf9E7JL8PEQSvRFVUZU=/206x305/v2/https://flxt.tmsimg.com/assets/p10307870_p_v8_aa.jpg,Home,50,8,2013.0,Drama,0 days 01:52:00.000000000,6
43,70,,The Motel Life,1000,43,2012.0,Drama,0 days 01:25:00.000000000,27
68,92,https://resizing.flixster.com/c6thO2v4Bcg-WitCgbkmKXQT-yg=/206x305/v2/https://flxt.tmsimg.com/assets/p10313592_p_v8_aa.jpg,Is the Man Who Is Tall Happy? An Animated Conversation With Noam Chomsky,2500,38,2013.0,Documentary/Animation,0 days 01:29:00.000000000,24
63,29,,Gimme Shelter,5000,77,2014.0,Drama,0 days 01:40:00.000000000,-34
26,44,https://resizing.flixster.com/il0pU82aEuQI9Cbhdnlzi4BIEr8=/206x305/v2/https://flxt.tmsimg.com/assets/p10273476_p_v10_ac.jpg,Gori Tere Pyaar Mein,500,9,2013.0,Romance,0 days 02:30:00.000000000,18
57,58,https://resizing.flixster.com/vLQIjrusjzLv-qlm6r0JB9xl4rU=/206x305/v2/https://flxt.tmsimg.com/assets/p10321481_p_v10_an.jpg,Ram-Leela,1000,12,2013.0,Romance/Drama,0 days 02:30:00.000000000,1
8,33,,SXTape,250,9,2013.0,Horror,0 days 01:25:00.000000000,25
47,11,,Back in the Day,250,9,2014.0,Comedy,0 days 01:33:00.000000000,-36
29,79,https://resizing.flixster.com/L9S0doAdFfzQymsOoHshzc_hr6c=/206x305/v2/https://flxt.tmsimg.com/assets/p10375104_p_v10_ag.jpg,Enemies Closer,1000,14,2013.0,Action/Mystery and thriller,0 days 01:25:00.000000000,50
73,21,,Son of God,25000,73,2014.0,Drama/History,0 days 02:18:00.000000000,-52
61,100,,Burton and Taylor,250,12,2013.0,Drama/Biography,0 days 01:23:00.000000000,39
27,33,,Freezer,1000,6,2014.0,Action/Mystery and thriller,0 days 01:31:00.000000000,6
66,43,,Life of a King,500,14,2013.0,Drama,0 days 01:41:00.000000000,-23
23,40,https://resizing.flixster.com/c9CvOm12rq5DPj_8gCn_U0uTKUQ=/206x305/v2/https://flxt.tmsimg.com/assets/p10431914_p_v10_ae.jpg,A Farewell to Fools,50,5,2013.0,War/Comedy,0 days 01:30:00.000000000,17
58,26,https://resizing.flixster.com/k73UUfcvNEiMB6yagMy8aSTgxcc=/206x305/v2/https://flxt.tmsimg.com/assets/p10360450_p_v10_aa.jpg,Jamesy Boy,500,19,2014.0,Drama,0 days 01:49:00.000000000,-32
56,100,,Aziz Ansari: Buried Alive,1,6,2013.0,Comedy/Stand up,0 days 01:19:00.000000000,44
58,40,/assets/pizza-pie/images/poster_default.c8c896e70c3.gif,Commitment,100,10,2013.0,Action,0 days 01:53:00.000000000,-18
84,88,,Our Vinyl Weighs a Ton: This Is Stones Throw Records,100,8,2013.0,Documentary,0 days 01:32:00.000000000,4
42,56,,Killing Kennedy,250,18,2013.0,Drama,0 days 01:30:00.000000000,14
33,64,https://resizing.flixster.com/uJgSujsoqfWDE4P-VEtg500V41U=/206x305/v2/https://flxt.tmsimg.com/assets/p10532013_p_v10_aa.jpg,The Patrol,100,11,2013.0,Drama/War,0 days 01:23:00.000000000,31
39,52,https://resizing.flixster.com/zd0ZbfvA1BiMtEVnXdYQr0eJYpE=/206x305/v2/https://flxt.tmsimg.com/assets/p10354079_p_v13_af.jpg,Flowers in the Attic,500,23,2014.0,Drama/Mystery and thriller,0 days 01:30:00.000000000,13
24,13,https://resizing.flixster.com/wMTBu14Er5lSHRaiso0pAvrQziA=/206x305/v2/https://flxt.tmsimg.com/assets/p10389434_p_v10_aa.jpg,Brightest Star,250,15,2013.0,Romance/Comedy,0 days 01:20:00.000000000,-11
51,80,,Sarah Silverman: We are Miracles,50,5,2013.0,,,29
70,81,,The Pirate Fairy,2500,21,2014.0,Fantasy/Kids and family,0 days 01:19:00.000000000,11
15,7,https://resizing.flixster.com/MoZAB5_jOb1bNQixiuUkBNfThDg=/206x305/v2/https://resizing.flixster.com/jrHcdWTjRJxowddjzriwrFFUyjI=/ems.ZW1zLXByZC1hc3NldHMvbW92aWVzLzI4OThjM2M3LTg2MjEtNGQ3MS1hOWM4LTUxYTAzMzc0MzY2OS53ZWJw,Authors Anonymous,500,14,2014.0,Comedy,0 days 01:35:00.000000000,-8
41,50,https://resizing.flixster.com/iZ9FdH7kQR19VRqnkGyKwKFJK80=/206x305/v2/https://flxt.tmsimg.com/assets/p10468676_p_v10_aa.jpg,Stalingrad,5000,74,2013.0,History/War,0 days 02:11:00.000000000,9
22,14,https://resizing.flixster.com/6enxVWGOtu-_P8gvXSqVTH_jXWY=/206x305/v2/https://flxt.tmsimg.com/assets/p10258487_p_v10_aa.jpg,Free Ride,250,7,2013.0,Drama,0 days 01:26:00.000000000,-8
45,65,,13 Sins,2500,43,2014.0,Horror/Mystery and thriller,0 days 01:32:00.000000000,20
60,38,,Cesar Chavez,5000,73,2014.0,Drama/History,0 days 01:41:00.000000000,-22
7,35,,24 Exposures,100,20,2013.0,Mystery and thriller,0 days 01:17:00.000000000,28
45,17,https://resizing.flixster.com/uS9Cd7qBetnTWp6FlBWw39uA1YQ=/206x305/v2/https://flxt.tmsimg.com/assets/p10403878_p_v8_ab.jpg,Barefoot,2500,23,2014.0,Romance/Comedy,0 days 01:29:00.000000000,-28
57,81,https://resizing.flixster.com/C5Hl2KuRs_gznO9u69tRhTvrrlo=/206x305/v2/https://flxt.tmsimg.com/assets/p10424699_p_v10_af.jpg,Rob the Mob,2500,42,2014.0,Crime/Drama,0 days 01:44:00.000000000,24
56,40,https://resizing.flixster.com/UaBqxuRAlU1d4QHl7rdGuEbpzCk=/206x305/v2/https://flxt.tmsimg.com/assets/p10437102_p_v8_aa.jpg,Black Coffee,250,10,2014.0,Romance,0 days 01:25:00.000000000,-16
79,50,,Justice League: War,2500,6,2014.0,Action/Animation,0 days 01:19:00.000000000,-29
25,22,,HairBrained,100,18,2013.0,Comedy,0 days 01:37:00.000000000,-3
38,30,,Date and Switch,500,10,2014.0,Romance/Gay and lesbian,0 days 01:31:00.000000000,-8
12,5,https://resizing.flixster.com/sofYSLf-u--hi2kEHUcPd_TtMLQ=/206x305/v2/https://flxt.tmsimg.com/assets/p10440111_p_v10_ab.jpg,The Outsider,100,20,2014.0,Crime/Drama,0 days 01:34:00.000000000,-7
34,40,,Lizzie Borden Took an Ax,250,15,2014.0,Drama,0 days 01:30:00.000000000,6
75,83,,Sparks,500,6,2013.0,Action/Mystery and thriller,0 days 01:30:00.000000000,8
87,75,,The Attorney,500,12,2013.0,Drama,0 days 02:07:00.000000000,-12
30,7,https://resizing.flixster.com/ajG-zqoXK-Kk_bNtmwjJDmz694g=/206x305/v2/https://flxt.tmsimg.com/assets/p10636134_p_v10_ab.jpg,Don Peyote,100,14,2014.0,Comedy/Drama,0 days 01:30:00.000000000,-23
38,22,https://resizing.flixster.com/zJv1OHbYq3hrNmOadR1RYPlCcCQ=/206x305/v2/https://flxt.tmsimg.com/assets/p10487687_p_v10_ah.jpg,Better Living Through Chemistry,1000,36,2014.0,Comedy/Drama,0 days 01:31:00.000000000,-16
51,33,https://resizing.flixster.com/ZGxwVTZ7dAKTsB6j-ZzRUGXFWn0=/206x305/v2/https://flxt.tmsimg.com/assets/p10609930_p_v10_aa.jpg,No Clue,100,6,2013.0,Comedy,0 days 01:36:00.000000000,-18
27,43,,Holy Ghost People,100,7,2013.0,Mystery and thriller,0 days 01:33:00.000000000,16
33,8,,Chlorine,50,13,2013.0,Drama,0 days 01:35:00.000000000,-25
86,40,/assets/pizza-pie/images/poster_default.c8c896e70c3.gif,Peter Gabriel: Back To Front,1,5,2014.0,,,-46
54,13,,Locker 13,100,8,2014.0,Drama/Mystery and thriller,0 days 01:35:00.000000000,-41
62,30,https://resizing.flixster.com/Am3GiGR8a6QGr2gr5nPxcO6O4aA=/206x305/v2/https://flxt.tmsimg.com/assets/p10459261_p_v8_ab.jpg,Boys of Abu Ghraib,250,10,2014.0,Drama/Mystery and thriller,0 days 01:42:00.000000000,-32
27,36,https://resizing.flixster.com/r7rQWLOxef5J4RIfw3UYaTUnc48=/206x305/v2/https://flxt.tmsimg.com/assets/p10506445_p_v10_aq.jpg,Stage Fright,500,53,2014.0,Comedy/Horror,0 days 01:30:00.000000000,9
23,9,https://resizing.flixster.com/hya8x6sxERbAipaVyoTb9pWvIy8=/206x305/v2/https://flxt.tmsimg.com/assets/p10566236_p_v8_aa.jpg,Dark House,100,11,2014.0,Horror/Mystery and thriller,0 days 01:43:00.000000000,-14
89,100,,Next Goal Wins,500,30,2014.0,Documentary,0 days 01:36:00.000000000,11
39,25,,Perfect Sisters,500,12,2014.0,Mystery and thriller,0 days 01:40:00.000000000,-14
64,71,https://resizing.flixster.com/boBb4hE-YZGuiCIINA5snZrNHhs=/206x305/v2/https://flxt.tmsimg.com/assets/p10641922_p_v10_am.jpg,Kid Cannabis,1000,7,2014.0,Crime/Comedy,0 days 01:50:00.000000000,7
32,43,https://resizing.flixster.com/Z-eSSL31bEMj53hB5-nsjULSqMM=/206x305/v2/https://flxt.tmsimg.com/assets/p10658521_p_v10_aa.jpg,A Night in Old Mexico,250,21,2013.0,Comedy/Drama,0 days 01:44:00.000000000,11
33,63,,American Jesus,50,8,2013.0,Documentary,0 days 01:20:00.000000000,30
74,57,https://resizing.flixster.com/nst8zgcpH8oBlktv9WQ7nNxR-bk=/206x305/v2/https://flxt.tmsimg.com/assets/p10650773_p_v8_ab.jpg,Super Duper Alice Cooper,100,7,2014.0,Documentary,0 days 01:26:00.000000000,-17
30,9,https://resizing.flixster.com/T3FuxJnOwpaTq7d9gaAeiRMFHEY=/206x305/v2/https://flxt.tmsimg.com/assets/p10671195_p_v10_ac.jpg,The Angriest Man in Brooklyn,2500,32,2014.0,Comedy/Drama,0 days 01:24:00.000000000,-21
55,57,https://resizing.flixster.com/2K1bkUWLiwumCKZV3ItSIxXnH7o=/206x305/v2/https://flxt.tmsimg.com/assets/p10658581_p_v8_aa.jpg,Road to Paloma,500,14,2014.0,Drama,0 days 01:31:00.000000000,2
67,20,https://resizing.flixster.com/EzltPvB5nvgDqxZuq36lZ3rceYo=/206x305/v2/https://flxt.tmsimg.com/assets/p10760032_p_v10_aa.jpg,The Odd Way Home,50,5,2013.0,Drama,0 days 01:27:00.000000000,-47
25,60,,Joy Ride 3: Roadkill,250,5,2014.0,Horror/Mystery and thriller,0 days 01:36:00.000000000,35
72,64,,Son of Batman,2500,11,2014.0,Animation/Action,0 days 01:14:00.000000000,-8
82,88,/assets/pizza-pie/images/poster_default.c8c896e70c3.gif,The Wipers Times,50,8,2013.0,,,6
71,78,,The Suspect,100,9,2013.0,Mystery and thriller/Action,0 days 02:17:00.000000000,7
86,99,,Finding Nemo,250000,268,2003.0,Animation/Comedy,0 days 01:40:00.000000000,13
90,96,https://resizing.flixster.com/_Amn5yvNGpi5b_EeHj8eyggwl20=/206x305/v2/https://resizing.flixster.com/YL2uY_OxeLWt2fgb9Pt740dkkLM=/ems.ZW1zLXByZC1hc3NldHMvbW92aWVzLzVmMjE2ODVkLTU3MGMtNGQxYS1hYTJjLWRmMTMyMDIyOTVlZi53ZWJw,"Monsters, Inc.",250000,197,2001.0,Comedy/Kids and family,0 days 01:32:00.000000000,6
64,88,,The Sterile Cuckoo,500,8,1969.0,Comedy/Drama,0 days 01:48:00.000000000,24
39,37,,Ishtar,5000,54,1987.0,Comedy,0 days 01:47:00.000000000,-2
22,29,,The Incubus,1000,7,1982.0,Horror,0 days 01:32:00.000000000,7
85,80,,Father Goose,5000,15,1964.0,Comedy,0 days 01:55:00.000000000,-5
85,94,,Long Day's Journey Into Night,2500,17,1962.0,Drama,0 days 02:54:00.000000000,9
64,88,,The Grass Is Greener,2500,8,1960.0,Comedy,0 days 01:45:00.000000000,24
70,88,,The Enforcer,1000,8,1951.0,Crime/Drama,0 days 01:27:00.000000000,18
42,80,https://resizing.flixster.com/JVtqyj-avcagGrd__b2HOY2rAAo=/206x305/v2/https://flxt.tmsimg.com/assets/p4789_p_v8_aa.jpg,Cloak and Dagger,1000,10,1946.0,Mystery and thriller,0 days 01:46:00.000000000,38
59,63,,Samson and Delilah,1000,8,1949.0,Drama,0 days 02:08:00.000000000,4
53,40,,Ninja III -- The Domination,1000,10,1984.0,Adventure/Sports and fitness,0 days 01:35:00.000000000,-13
52,40,,The Island,5000,5,1980.0,Adventure,0 days 01:54:00.000000000,-12
74,78,/assets/pizza-pie/images/poster_default.c8c896e70c3.gif,Ivans Xtc,500,32,2002.0,,,4
85,89,https://resizing.flixster.com/yHmsBqCbXsS8bGQMFnzKcL1-Naw=/206x305/v2/https://flxt.tmsimg.com/assets/p1165_p_v10_af.jpg,The Magnificent Ambersons,5000,44,1942.0,Drama,0 days 01:28:00.000000000,4
81,100,https://resizing.flixster.com/-kNauPEdkqXmLCTp5axXwKHN21E=/206x305/v2/https://flxt.tmsimg.com/assets/p36721_p_v13_ax.jpg,The Devil and Miss Jones,500,8,1941.0,Comedy,0 days 01:32:00.000000000,19
59,80,,Sinbad the Sailor,1000,5,1947.0,Adventure,0 days 01:57:00.000000000,21
86,100,https://resizing.flixster.com/a40_wbcoKpT389dLgpZRHnPdCT0=/206x305/v2/https://flxt.tmsimg.com/assets/p2836_p_v8_aa.jpg,Letter From an Unknown Woman,2500,23,1948.0,Romance,0 days 01:30:00.000000000,14
26,64,https://resizing.flixster.com/UZoLHcu1aRRZkeCu7GWOWy6kWcY=/206x305/v2/https://flxt.tmsimg.com/assets/p43977_p_v10_aa.jpg,Cavalcade,1000,33,1933.0,Drama,0 days 01:49:00.000000000,38
77,85,,Macbeth,2500,27,1948.0,Drama,0 days 01:46:00.000000000,8
80,100,,Le pont du nord,100,9,1981.0,Drama,0 days 02:09:00.000000000,20
78,100,,Red Dust,500,8,1932.0,Romance,0 days 01:23:00.000000000,22
74,93,https://resizing.flixster.com/sFAowo3LXKYkNmKCenAHBtP5AdE=/206x305/v2/https://flxt.tmsimg.com/assets/p104_p_v8_aa.jpg,Champion,500,14,1949.0,Romance/Drama,0 days 01:39:00.000000000,19
82,100,,The Devil's Envoys,500,6,1942.0,Fantasy/Romance,0 days 01:58:00.000000000,18
81,100,https://resizing.flixster.com/G72UsJ4W3JKiF4VHwYAUGDhMRwo=/206x305/v2/https://flxt.tmsimg.com/assets/p5245_p_v10_aa.jpg,Lili,500,7,1953.0,Romance/Musical,0 days 01:21:00.000000000,19
93,97,/assets/pizza-pie/images/poster_default.c8c896e70c3.gif,Safety Last,2500,35,1923.0,Comedy,0 days 01:14:00.000000000,4
76,100,,Gate of Hell,500,10,1953.0,Romance/Drama,0 days 01:30:00.000000000,24
56,74,,The Fourth Protocol,1000,19,1987.0,Mystery and thriller,0 days 01:58:00.000000000,18
75,83,https://resizing.flixster.com/PKGES3kvrKv9UCVlHLY_rqRDdc0=/206x305/v2/https://flxt.tmsimg.com/assets/p37452_p_v10_aa.jpg,Genevieve,500,6,1953.0,Comedy,0 days 01:26:00.000000000,8
36,56,https://resizing.flixster.com/fgpKZZz8g2m4GVxvpUIkkFLKU0g=/206x305/v2/https://flxt.tmsimg.com/assets/p49735_p_v8_aa.jpg,In Old Arizona,250,9,1929.0,Western,0 days 01:37:00.000000000,20
34,40,,Prison,500,5,1987.0,Horror,0 days 01:42:00.000000000,6
71,43,,House of Dark Shadows,500,7,1970.0,Horror,0 days 01:38:00.000000000,-28
65,70,,The Magic Flute,1000,23,2006.0,Romance/Music,0 days 02:15:00.000000000,5
43,33,,The Lady Vanishes,500,6,1979.0,Comedy/Mystery and thriller,0 days 01:39:00.000000000,-10
69,50,https://resizing.flixster.com/gnE03GJBh_Mqs9EAjapljOCpS5k=/206x305/v2/https://flxt.tmsimg.com/assets/p691_p_v8_aa.jpg,Goodbye Charlie,250,8,1964.0,Comedy,0 days 01:57:00.000000000,-19
71,77,,The Life and Times of Allen Ginsberg,500,13,1993.0,Documentary,0 days 01:22:00.000000000,6
35,40,,Staircase,100,5,1969.0,Drama,0 days 01:40:00.000000000,5
84,86,,Life of Pi,100000,253,2012.0,Drama/Adventure,0 days 02:05:00.000000000,2
16,9,https://resizing.flixster.com/OX5lRe1x-6FUeT0s_-SeDXWK4mw=/206x305/v2/https://flxt.tmsimg.com/assets/p197044_p_v10_aa.jpg,Reverb,250,11,2008.0,Horror,0 days 01:28:00.000000000,-7
6,20,,First Family,100,5,1980.0,Comedy,0 days 01:44:00.000000000,14
20,12,,Jack and Diane,2500,26,2012.0,Romance/Gay and lesbian,0 days 01:33:00.000000000,-8
83,64,,The Hobbit: An Unexpected Journey,250000,305,2012.0,Fantasy/Adventure,0 days 02:49:00.000000000,-19
83,96,,Outback,2500,56,1971.0,Drama/Mystery and thriller,0 days 01:39:00.000000000,13
28,14,https://resizing.flixster.com/jMlqm59sk6Kqnk4sTBRadnRn5p8=/206x305/v2/https://flxt.tmsimg.com/assets/p2624_p_v8_ab.jpg,Deadly Blessing,500,7,1981.0,Horror,0 days 01:42:00.000000000,-14
87,100,,Marketa Lazarová,500,12,1968.0,Drama,0 days 03:00:00.000000000,13
29,80,,The Face of Fu Manchu,100,5,1965.0,Horror,0 days 01:34:00.000000000,51
86,92,https://resizing.flixster.com/DXkn83oZ-1e279NUTLcB6N8YcmU=/206x305/v2/https://flxt.tmsimg.com/assets/p8919177_p_v13_bg.jpg,Skyfall,250000,379,2012.0,Mystery and thriller/Action,0 days 02:23:00.000000000,6
81,89,,Lincoln,100000,284,2012.0,Drama/History,0 days 02:29:00.000000000,8
49,66,,Solomon Kane,25000,50,2009.0,Fantasy/Adventure,0 days 01:44:00.000000000,17
83,100,https://resizing.flixster.com/5jw8HxYlH63FE9Pr6z4wj0wSdw8=/206x305/v2/https://flxt.tmsimg.com/assets/p2773_p_v8_aa.jpg,Wild River,500,12,1960.0,Drama,0 days 01:50:00.000000000,17
28,29,,A New Life,100,7,1988.0,Comedy,0 days 01:44:00.000000000,1
47,67,https://resizing.flixster.com/KgKXt5J1ygq1mny-qO6P1dQVqz4=/206x305/v2/https://flxt.tmsimg.com/assets/p50222_p_v10_aa.jpg,Villain,100,12,1971.0,Crime/Drama,0 days 01:38:00.000000000,20
23,33,,The Human Factor,100,6,1979.0,Mystery and thriller,0 days 01:55:00.000000000,10
37,45,https://resizing.flixster.com/Oaapoau4AAjyY8HVrlXORSz39o8=/206x305/v2/https://flxt.tmsimg.com/assets/p9820543_p_v8_aa.jpg,Down the Shore,250,11,2011.0,Drama/Mystery and thriller,0 days 01:33:00.000000000,8
91,91,https://resizing.flixster.com/4gLRk14vLrPzW2qLOjnEl5mRAkA=/206x305/v2/https://flxt.tmsimg.com/assets/p8815512_p_v10_ap.jpg,Marvel's the Avengers,250000,360,2012.0,Sci fi/Action,0 days 02:23:00.000000000,0
48,13,,The Night Visitor,100,8,1970.0,Mystery and thriller,0 days 01:42:00.000000000,-35
73,96,https://resizing.flixster.com/Cs9NOxrp6zo1tBRekur5rokOMyw=/206x305/v2/https://flxt.tmsimg.com/assets/p188822_p_v8_ae.jpg,The Pool,500,47,2007.0,Drama,0 days 01:44:00.000000000,23
77,72,,The Amazing Spider-Man,250000,334,2012.0,Mystery and thriller/Action,0 days 02:16:00.000000000,-5
38,4,https://resizing.flixster.com/HBxOJy8vAzzAr50U679Hwz5ZoFc=/206x305/v2/https://flxt.tmsimg.com/assets/p8915708_p_v10_bc.jpg,Scary Movie V,100000,52,2013.0,Comedy,0 days 01:25:00.000000000,-34
46,35,https://resizing.flixster.com/7Lpb7DfcKx5y4SAUyfDauV7Yf3Y=/206x305/v2/https://flxt.tmsimg.com/assets/p8915770_p_v10_aq.jpg,Dark Shadows,250000,258,2012.0,Comedy/Fantasy,0 days 01:52:00.000000000,-11
58,29,,The Athlete,1,7,2009.0,Drama/Biography,0 days 01:25:00.000000000,-29
74,92,https://resizing.flixster.com/ekZNB6xtZFa6jCPUlMf9Mu7rdio=/206x305/v2/https://flxt.tmsimg.com/assets/p7820886_p_v10_ad.jpg,The Cabin in the Woods,100000,286,2011.0,Horror/Comedy,0 days 01:35:00.000000000,18
64,71,,Guest of Cindy Sherman,1000,24,2008.0,Documentary,0 days 01:28:00.000000000,7
33,50,,Magic Town,100,6,1947.0,Comedy/Drama,0 days 01:43:00.000000000,17
72,45,,Hotel Transylvania,100000,145,2012.0,Fantasy/Comedy,0 days 01:35:00.000000000,-27
75,78,,Brave,250000,251,2012.0,Animation/Comedy,0 days 01:33:00.000000000,3
71,89,,In Search of Memory,50,9,2009.0,Documentary,0 days 01:35:00.000000000,18
65,93,https://resizing.flixster.com/gMWmKi449qiq_EPiYjV4HIr41QI=/206x305/v2/https://flxt.tmsimg.com/assets/p8615045_p_v8_aa.jpg,Last Ride,2500,28,2009.0,Drama,0 days 01:40:00.000000000,28
50,58,,The Revenant,1000,26,2009.0,Comedy/Horror,0 days 01:59:00.000000000,8
81,83,,I Killed My Mother,2500,23,2009.0,Drama/Biography,0 days 01:36:00.000000000,2
45,35,,Womb,1000,20,2010.0,Sci fi,0 days 01:51:00.000000000,-10
46,81,,The Hole,10000,36,2009.0,Horror/Mystery and thriller,0 days 01:32:00.000000000,35
51,59,https://resizing.flixster.com/6D0pxTXnq7D4HrlmjDdEAs2TZNg=/206x305/v2/https://flxt.tmsimg.com/assets/p8326076_p_v10_ab.jpg,Empire of Silver,250,17,2009.0,Romance/Drama,0 days 01:53:00.000000000,8
44,20,https://resizing.flixster.com/2fwITcn74tu4yebs7iBkd3qZG8U=/206x305/v2/https://flxt.tmsimg.com/assets/p9782092_p_v13_ab.jpg,K-11,1000,15,2012.0,Gay and lesbian/Drama,0 days 01:28:00.000000000,-24
90,80,/assets/pizza-pie/images/poster_default.c8c896e70c3.gif,Hipsters,500,25,2011.0,,,-10
73,98,,The Loved Ones,10000,58,2009.0,Horror/Mystery and thriller,0 days 01:24:00.000000000,25
34,90,https://resizing.flixster.com/NqBujuSLIAF8F85M9Ld54KjedII=/206x305/v2/https://flxt.tmsimg.com/assets/p9764016_p_v8_ac.jpg,Stoned Bros.,50,10,2009.0,Comedy,0 days 01:30:00.000000000,56
43,62,,Beyond the Pole,100,13,2009.0,Comedy/Drama,0 days 01:27:00.000000000,19
51,15,https://resizing.flixster.com/ZdVl5avevUQOuhILapR3C-YRI8s=/206x305/v2/https://flxt.tmsimg.com/assets/p8130799_p_v8_ae.jpg,Red Dawn,50000,143,2012.0,Action/Adventure,0 days 01:33:00.000000000,-36
45,84,,The Salt of Life,1000,51,2011.0,Comedy,0 days 01:30:00.000000000,39
63,86,,Easy Money,5000,69,2010.0,Crime/Drama,0 days 01:59:00.000000000,23
45,4,,6 Souls,10000,28,2010.0,Horror/Mystery and thriller,0 days 01:53:00.000000000,-41
73,72,https://resizing.flixster.com/Humr5pFbz5dALblaRdxS9IjHdzc=/206x305/v2/https://flxt.tmsimg.com/assets/p8396197_p_v10_aa.jpg,Loose Cannons,1000,18,2010.0,Romance/Comedy,0 days 01:50:00.000000000,-1
46,40,,Gerrymandering,50,20,2010.0,Documentary,0 days 01:21:00.000000000,-6
83,67,,"Fanny, Annie & Danny",1,9,2010.0,Drama,0 days 01:22:00.000000000,-16
67,14,https://resizing.flixster.com/rQF_ymyW9b9bcb__MrXv-6prZCk=/206x305/v2/https://flxt.tmsimg.com/assets/p8991665_p_v10_aa.jpg,Safe Haven,50000,147,2013.0,Drama/Mystery and thriller,0 days 01:55:00.000000000,-53
92,100,,Semper Fi: Always Faithful,100,11,2011.0,Documentary,0 days 01:15:00.000000000,8
51,20,https://resizing.flixster.com/jFOua9-veMj-DBOh3Cwo2snS_fI=/206x305/v2/https://flxt.tmsimg.com/assets/p8991538_p_v10_aa.jpg,That's My Boy,100000,115,2012.0,Comedy,0 days 01:56:00.000000000,-31
76,92,,Arthur Christmas,10000,169,2011.0,Other/Kids and family,0 days 01:40:00.000000000,16
45,100,,Murder Is My Beat,1,5,1955.0,Mystery and thriller,0 days 01:16:00.000000000,55
63,87,/assets/pizza-pie/images/poster_default.c8c896e70c3.gif,Our Beloved Month of August,100,15,2008.0,Romance,0 days 02:33:00.000000000,24
69,65,https://resizing.flixster.com/zVrz-grxFxow28W6M9yPOzadyLs=/206x305/v2/https://flxt.tmsimg.com/assets/p8273061_p_v10_ab.jpg,Dog Pound,1000,26,2010.0,Drama/Mystery and thriller,0 days 01:28:00.000000000,-4
24,3,,The Apparition,10000,62,2012.0,Horror,0 days 01:22:00.000000000,-21
70,68,,Men in Black 3,250000,251,2012.0,Action/Sci fi,0 days 01:44:00.000000000,-2
90,87,,The Dark Knight Rises,250000,369,2012.0,Mystery and thriller/Action,0 days 02:45:00.000000000,-3
62,37,,Ice Age: Continental Drift,100000,135,2012.0,Animation/Comedy,0 days 01:27:00.000000000,-25
34,45,,On the Road,10000,154,2012.0,Drama,0 days 02:19:00.000000000,11
23,23,https://resizing.flixster.com/0EPWZT2-kBEG4rIdT38zj4rF6IE=/206x305/v2/https://flxt.tmsimg.com/assets/p9293211_p_v8_aa.jpg,Drunkboat,50,13,2010.0,Drama,0 days 01:38:00.000000000,0
82,93,,Looper,100000,268,2012.0,Action/Sci fi,0 days 01:59:00.000000000,11
55,52,,Jack the Giant Slayer,50000,208,2013.0,Adventure/Fantasy,0 days 01:53:00.000000000,-3
47,31,,Total Recall,100000,235,2012.0,Action/Sci fi,0 days 01:57:00.000000000,-16
38,22,,6 Month Rule,1000,9,2011.0,Romance,0 days 01:39:00.000000000,-16
48,27,,Cost of a Soul,250,11,2010.0,Crime/Drama,0 days 01:30:00.000000000,-21
78,91,,Sleep Tight,5000,35,2011.0,Horror/Mystery and thriller,0 days 01:42:00.000000000,13
26,61,,Cherry Tree Lane,500,28,2010.0,Crime/Drama,0 days 01:17:00.000000000,35
70,49,,The Twilight Saga: Breaking Dawn Part 2,250000,196,2012.0,Romance/Fantasy,0 days 01:55:00.000000000,-21
64,68,https://resizing.flixster.com/K_yYHlYdb5BhKsdcwzOoy-HzvRM=/206x305/v2/https://flxt.tmsimg.com/assets/p51774_p_v10_aa.jpg,Miami Connection,500,19,1988.0,Drama/Sports and fitness,0 days 01:30:00.000000000,4
85,100,,Lost Angels: Skid Row Is My Home,250,7,2010.0,Documentary,0 days 01:17:00.000000000,15
71,64,,Parked,500,14,2011.0,Drama,0 days 01:34:00.000000000,-7
31,66,,The Good Doctor,2500,29,2011.0,Comedy/Drama,0 days 01:33:00.000000000,35
83,50,,Music From the Big House,50,12,2010.0,Documentary,0 days 01:26:00.000000000,-33
60,74,,Premium Rush,100000,162,2012.0,Action/Mystery and thriller,0 days 01:31:00.000000000,14
70,87,,Frankenweenie,50000,222,2012.0,Comedy/Kids and family,0 days 01:27:00.000000000,17
63,38,,Touchback,5000,13,2011.0,Drama,0 days 01:58:00.000000000,-25
27,42,,Rec 3: Genesis,5000,48,2012.0,Action/Horror,0 days 01:19:00.000000000,15
52,77,,Over Your Cities Grass Will Grow,2500,35,2010.0,Documentary,0 days 01:45:00.000000000,25
61,84,https://resizing.flixster.com/7ybQLchhnnc-9iGON-esHE0lMbU=/206x305/v2/https://flxt.tmsimg.com/assets/p9211021_p_v10_an.jpg,The Master,50000,255,2012.0,Drama,0 days 02:16:00.000000000,23
63,86,https://resizing.flixster.com/KJmhhzQiG8UDwMx2v8mV68Np1Vk=/206x305/v2/https://flxt.tmsimg.com/assets/p8562196_p_v10_aa.jpg,The Big Picture,1000,43,2010.0,Drama,0 days 01:54:00.000000000,23
72,78,,Madagascar 3: Europe's Most Wanted,250000,134,2012.0,Animation/Comedy,0 days 01:25:00.000000000,6
34,6,,The Tortured,1000,18,2010.0,Mystery and thriller,0 days 01:19:00.000000000,-28
72,79,https://resizing.flixster.com/HK_sko3WByEDm_uBTNnTCDORm9o=/206x305/v2/https://flxt.tmsimg.com/assets/p9128607_p_v8_ac.jpg,Dredd,100000,167,2012.0,Action/Sci fi,0 days 01:36:00.000000000,7
64,42,https://resizing.flixster.com/GAfqyKdPoZZ0b6ND_TBvx0giB2o=/206x305/v2/https://flxt.tmsimg.com/assets/p8627283_p_v13_ar.jpg,Little White Lies,2500,71,2010.0,Comedy/Drama,0 days 02:34:00.000000000,-22
46,36,,Yelling to the Sky,250,11,2011.0,Drama,0 days 01:34:00.000000000,-10
77,87,,Chico & Rita,5000,71,2010.0,Romance/Drama,0 days 01:33:00.000000000,10
77,88,,Happy People: A Year in the Taiga,1000,49,2010.0,Documentary,0 days 01:34:00.000000000,11
50,73,https://resizing.flixster.com/OhxH0ryxyI8wS0tkEEnq2x7bkRg=/206x305/v2/https://flxt.tmsimg.com/assets/p8277257_p_v13_aa.jpg,The Happy Poet,100,11,2010.0,Comedy/Drama,0 days 01:25:00.000000000,23
62,89,,Passion,250,38,2010.0,Documentary,0 days 01:30:00.000000000,27
23,77,,F,250,13,2010.0,Mystery and thriller,0 days 01:19:00.000000000,54
44,34,,Butter,10000,68,2011.0,Comedy,0 days 01:30:00.000000000,-10
76,96,https://resizing.flixster.com/hQcjkQWrCezvgIozxywoKxnaJy8=/206x305/v2/https://flxt.tmsimg.com/assets/p8351411_p_v10_ac.jpg,Silent Souls,500,47,2010.0,Drama,0 days 01:15:00.000000000,20
50,34,https://resizing.flixster.com/9bnG97497nydpwAfDt9lMuNhAZk=/206x305/v2/https://flxt.tmsimg.com/assets/p8815737_p_v10_aa.jpg,Abraham Lincoln: Vampire Hunter,100000,193,2012.0,Action/Horror,0 days 01:45:00.000000000,-16
61,79,https://resizing.flixster.com/AOJCHJrkdUXV_x75bNrUU81t_mk=/206x305/v2/https://flxt.tmsimg.com/assets/p9131668_p_v10_ab.jpg,Killer Joe,50000,170,2011.0,Crime/Drama,0 days 01:41:00.000000000,18
71,88,,The Silence,500,40,2010.0,Drama,0 days 02:00:00.000000000,17
56,57,https://resizing.flixster.com/ngwrnDTQ2yjF4xeM32kNwvVEsCY=/206x305/v2/https://flxt.tmsimg.com/assets/p9259612_p_v10_az.jpg,Oz the Great and Powerful,250000,272,2013.0,Fantasy/Kids and family,0 days 02:10:00.000000000,1
72,83,,A Cat in Paris,5000,64,2010.0,Drama/Crime,0 days 01:05:00.000000000,11
58,55,,The Bourne Legacy,250000,232,2012.0,Action/Mystery and thriller,0 days 02:15:00.000000000,-3
52,49,https://resizing.flixster.com/Rbwv4qKcZMglFXlGhz5XH4FvJkk=/206x305/v2/https://flxt.tmsimg.com/assets/p8687906_p_v10_aj.jpg,Snow White and the Huntsman,250000,238,2012.0,Fantasy/Adventure,0 days 02:07:00.000000000,-3
53,42,https://resizing.flixster.com/wG0RjCi66xBTHKGSs5aiO_BhsrE=/206x305/v2/https://flxt.tmsimg.com/assets/p8758400_p_v10_aa.jpg,Leonie!,250,12,2011.0,Drama,0 days 01:33:00.000000000,-11
48,39,,The Possession,50000,99,2012.0,Horror/Mystery and thriller,0 days 01:31:00.000000000,-9
36,30,https://resizing.flixster.com/cIdIcXWMflFKZUWXk3A4ed4QqlU=/206x305/v2/https://flxt.tmsimg.com/assets/p9199159_p_v8_ad.jpg,Red Lights,10000,94,2012.0,Mystery and thriller,0 days 01:58:00.000000000,-6
86,87,https://resizing.flixster.com/2yiSW3CWzYjt4wdKKwiy-y7t_n8=/206x305/v2/https://flxt.tmsimg.com/assets/p9248405_p_v13_am.jpg,Wreck-It Ralph,100000,189,2012.0,Animation/Comedy,0 days 01:41:00.000000000,1
48,60,https://resizing.flixster.com/EZDfnEZ0S3aweVaviCJwRZLmHpE=/206x305/v2/https://flxt.tmsimg.com/assets/p8792794_p_v8_aa.jpg,Wasted on the Young,500,20,2010.0,Drama/Mystery and thriller,0 days 01:37:00.000000000,12
24,4,https://resizing.flixster.com/sqwR8Mf5fzi1xNDDG8UOsn_JVlI=/206x305/v2/https://flxt.tmsimg.com/assets/p9370887_p_v10_aa.jpg,Movie 43,25000,89,2013.0,Comedy,0 days 01:34:00.000000000,-20
29,4,https://resizing.flixster.com/TA3tPBD7eYju14P-XdXCJuPuYpc=/206x305/v2/https://flxt.tmsimg.com/assets/p8886601_p_v7_ah.jpg,The Cold Light of Day,10000,47,2012.0,Mystery and thriller/Action,0 days 01:33:00.000000000,-25
68,65,https://resizing.flixster.com/UusQmFe37wPPRyMck0bzCY1E-OQ=/206x305/v2/https://flxt.tmsimg.com/assets/p8645631_p_v8_aa.jpg,Gun Hill Road,500,31,2011.0,Drama,0 days 01:28:00.000000000,-3
42,59,https://resizing.flixster.com/OZGRFGLpFzUhRUr7YSKwWMkgA20=/206x305/v2/https://flxt.tmsimg.com/assets/p9246056_p_v8_aa.jpg,Little Birds,1000,22,2011.0,Drama,0 days 01:36:00.000000000,17
67,84,/assets/pizza-pie/images/poster_default.c8c896e70c3.gif,Nobody Else but You,500,31,2011.0,Crime/Drama,0 days 01:43:00.000000000,17
65,89,https://resizing.flixster.com/77IUpkDvzsF4kJ8Nc2JNinawLv0=/206x305/v2/https://flxt.tmsimg.com/assets/p8340518_p_v13_aa.jpg,The Autobiography of Nicolae Ceausescu,100,18,2010.0,Documentary,0 days 03:00:00.000000000,24
66,75,https://resizing.flixster.com/ArRFtBUDZN-0bwPJEInypuPw_cA=/206x305/v2/https://flxt.tmsimg.com/assets/p9049677_p_v8_aa.jpg,Sound of My Voice,10000,110,2011.0,Drama,0 days 01:24:00.000000000,9
23,23,https://resizing.flixster.com/40ehaTxBgUf5fXxZClXF5sJIBPA=/206x305/v2/https://flxt.tmsimg.com/assets/p8642902_p_v10_ab.jpg,Salvation Boulevard,1000,35,2011.0,Drama/Comedy,0 days 01:36:00.000000000,0
34,46,https://resizing.flixster.com/MKDbbWS0VyE-QADfl6qtX_RfZyM=/206x305/v2/https://flxt.tmsimg.com/assets/p8477156_p_v10_ab.jpg,The Details,5000,35,2011.0,Comedy,0 days 01:36:00.000000000,12
53,16,https://resizing.flixster.com/ey2jawUcsQk6WeL_r0AIiNmbziE=/206x305/v2/https://flxt.tmsimg.com/assets/p8869378_p_v10_an.jpg,Hansel & Gretel: Witch Hunters,50000,144,2013.0,Horror/Action,0 days 01:28:00.000000000,-37
33,71,/assets/pizza-pie/images/poster_default.c8c896e70c3.gif,Lord Byron,1,7,2011.0,Comedy/Drama,0 days 01:35:00.000000000,38
44,73,,Killing Them Softly,100000,230,2012.0,Crime/Drama,0 days 01:37:00.000000000,29
31,65,https://resizing.flixster.com/WECC3w5-O_v_11wpISOZnl53e30=/206x305/v2/https://flxt.tmsimg.com/assets/p9269699_p_v10_am.jpg,Cosmopolis,25000,185,2012.0,Crime/Fantasy,0 days 01:48:00.000000000,34
50,51,,This Is 40,50000,221,2012.0,Romance,0 days 02:14:00.000000000,1
54,14,,Saving Grace B. Jones,100,7,2009.0,Drama/Mystery and thriller,0 days 01:55:00.000000000,-40
68,100,https://resizing.flixster.com/6-hN-Tt6icNsIiaDOuNSZ8ALMgo=/206x305/v2/https://flxt.tmsimg.com/assets/p8680682_p_v8_aa.jpg,Sholem Aleichem: Laughing in the Darkness,500,43,2011.0,Documentary,0 days 01:33:00.000000000,32
40,51,https://resizing.flixster.com/nVw7hjxNMJUt7enq8NeRSnlqtjA=/206x305/v2/https://flxt.tmsimg.com/assets/p9371058_p_v10_ae.jpg,The Man With the Iron Fists,25000,86,2012.0,Action/Adventure,0 days 01:35:00.000000000,11
49,6,,So Undercover,5000,16,2012.0,Action/Comedy,0 days 01:34:00.000000000,-43
26,45,https://resizing.flixster.com/rUsaj467Fc87qHR0vQ0F080C9zY=/206x305/v2/https://flxt.tmsimg.com/assets/p8690856_p_v10_aa.jpg,Restless City,100,11,2011.0,Drama,0 days 01:20:00.000000000,19
68,73,https://resizing.flixster.com/Xe1PMwWdBRel1hseq8gQCJQkGgY=/206x305/v2/https://flxt.tmsimg.com/NowShowing/109821/109821_aa.jpg,Prometheus,250000,306,2012.0,Horror/Mystery and thriller,0 days 02:03:00.000000000,5
46,22,https://resizing.flixster.com/4ymDXiQqOXOP_JuQz7d_UZz-kKM=/206x305/v2/https://flxt.tmsimg.com/assets/p8733908_p_v12_ak.jpg,The Raven,100000,141,2012.0,Mystery and thriller,0 days 01:51:00.000000000,-24
47,68,https://resizing.flixster.com/6uo21BfBU0hcfJyMiptPu4qVa_w=/206x305/v2/https://flxt.tmsimg.com/assets/p8833318_p_v10_ab.jpg,Wuthering Heights,5000,114,2011.0,Romance/Drama,0 days 02:08:00.000000000,21
47,11,,Alex Cross,25000,126,2012.0,Action/Mystery and thriller,0 days 01:41:00.000000000,-36
80,75,https://resizing.flixster.com/2nh-rQ3XY480YvJJcF_X_8zS-9Y=/206x305/v2/https://flxt.tmsimg.com/NowShowing/114481/114481_ab.jpg,Rise of the Guardians,100000,161,2012.0,Fantasy/Kids and family,0 days 01:37:00.000000000,-5
89,85,,The Perks of Being a Wallflower,100000,168,2012.0,Romance/Comedy,0 days 01:43:00.000000000,-4
39,9,https://resizing.flixster.com/97BFo55UtngvlTJ3uqCNWbyegNM=/206x305/v2/https://flxt.tmsimg.com/assets/p8768154_p_v10_ab.jpg,Horrid Henry: The Movie,2500,22,2011.0,Comedy/Kids and family,0 days 01:33:00.000000000,-30
81,95,,Pina,5000,106,2011.0,Documentary,0 days 01:44:00.000000000,14
54,22,,The Baytown Outlaws,2500,27,2012.0,Action/Comedy,0 days 01:38:00.000000000,-32
65,41,,Here Comes the Boom,50000,97,2012.0,Comedy/Action,0 days 01:44:00.000000000,-24
74,88,https://resizing.flixster.com/yHT2jOZM0ai3lLoTb3AkaZRwWf0=/206x305/v2/https://flxt.tmsimg.com/assets/p8965514_p_v8_aa.jpg,The Well Digger's Daughter,2500,41,2011.0,Romance,0 days 01:47:00.000000000,14
65,87,https://resizing.flixster.com/D-bKpGw7dHrP6q4lEVovbMM8IlY=/206x305/v2/https://flxt.tmsimg.com/assets/p8833360_p_v10_aa.jpg,A Monster in Paris,5000,23,2011.0,Animation/Comedy,0 days 01:29:00.000000000,22
51,28,,Resident Evil: Retribution,100000,74,2012.0,Action/Horror,0 days 01:35:00.000000000,-23
41,13,https://resizing.flixster.com/-9cBlzbG5kw8nclW67lBpUCV8-s=/206x305/v2/https://flxt.tmsimg.com/assets/p9244640_p_v10_aa.jpg,Charlie Casanova,50,8,2010.0,Crime/Drama,0 days 01:34:00.000000000,-28
51,11,https://resizing.flixster.com/b3b3f3_4jTSqphGaxCdrAc7av9k=/206x305/v2/https://flxt.tmsimg.com/assets/p9106451_p_v10_an.jpg,Black Gold,1000,27,2011.0,Drama,0 days 02:10:00.000000000,-40
65,76,/assets/pizza-pie/images/poster_default.c8c896e70c3.gif,Free Men,500,34,2011.0,Drama/War,0 days 01:39:00.000000000,11
82,54,,Brother,250,13,2010.0,Drama,0 days 01:36:00.000000000,-28
93,75,https://resizing.flixster.com/JPcIVygm4Z3liwvvRgVoDQl0Zkg=/206x305/v2/https://flxt.tmsimg.com/assets/p9096998_p_v13_bh.jpg,The Intouchables,25000,129,2011.0,Comedy/Drama,0 days 01:50:00.000000000,-18
62,36,https://resizing.flixster.com/AzJaCGuhox6vtyFYRrAqENb8X5g=/206x305/v2/https://flxt.tmsimg.com/assets/p8948115_p_v10_aa.jpg,The Lady,5000,72,2011.0,Drama/Biography,0 days 02:07:00.000000000,-26
75,94,,The Rabbi's Cat,1000,16,2011.0,Animation/Adventure,0 days 01:40:00.000000000,19
52,15,,Special Forces,1000,13,2011.0,Action/Drama,0 days 01:49:00.000000000,-37
61,83,,Goodbye First Love,5000,53,2011.0,Romance/Drama,0 days 01:48:00.000000000,22
73,69,https://resizing.flixster.com/m73BNXScO1i7yLtaAwQARu8at8k=/206x305/v2/https://flxt.tmsimg.com/NowShowing/114482/114482_ab.jpg,Ted,250000,221,2012.0,Fantasy/Comedy,0 days 01:46:00.000000000,-4
55,43,https://resizing.flixster.com/gJOGQMJxDsxqsEl7zNaGKmsAnDI=/206x305/v2/https://flxt.tmsimg.com/assets/p8957709_p_v10_aa.jpg,Rock of Ages,100000,231,2012.0,Musical,0 days 01:58:00.000000000,-12
84,84,https://resizing.flixster.com/ozaakOgi-1-VUGNXo3IN2QcM9Jo=/206x305/v2/https://flxt.tmsimg.com/assets/p8902144_p_v10_ad.jpg,Klitschko,500,19,2011.0,Documentary/Biography,0 days 01:56:00.000000000,0
78,88,/assets/pizza-pie/images/poster_default.c8c896e70c3.gif,Shakespeare High,100,16,2011.0,Documentary,0 days 01:20:00.000000000,10
16,45,https://resizing.flixster.com/j7Tltwho8m8u30p8aEhyZ9-pnAA=/206x305/v2/https://flxt.tmsimg.com/assets/p9487711_p_v8_ah.jpg,In Their Skin,500,11,2012.0,Horror/Mystery and thriller,0 days 01:36:00.000000000,29
91,100,https://resizing.flixster.com/j9mesVRSIJhXG3k7mHqf_ZuV2T8=/206x305/v2/https://flxt.tmsimg.com/assets/p8718726_p_v10_aa.jpg,Give Up Tomorrow,100,5,2011.0,Crime/Documentary,0 days 01:35:00.000000000,9
80,82,https://resizing.flixster.com/VPGTLUJVdl_9G5wVsORovuu1OuA=/206x305/v2/https://flxt.tmsimg.com/assets/p9069620_p_v8_aa.jpg,Splinters,500,11,2011.0,Documentary,0 days 01:34:00.000000000,2
69,93,,"Turn Me On, Dammit!",2500,45,2011.0,Comedy,0 days 01:16:00.000000000,24
53,67,https://resizing.flixster.com/mMvGgp0f19QLaaM_YeVKwbjZTBo=/206x305/v2/https://flxt.tmsimg.com/assets/p8653356_p_v7_ac.jpg,The Ballad of Genesis and Lady Jaye,500,27,2011.0,Documentary,0 days 01:12:00.000000000,14
100,100,,The Miners' Hymns,100,10,2010.0,Documentary/Drama,0 days 00:52:00.000000000,0
55,7,/assets/pizza-pie/images/poster_default.c8c896e70c3.gif,Losing Control,100,14,2011.0,Romance,0 days 01:31:00.000000000,-48
73,81,,Warm Bodies,100000,209,2013.0,Romance/Horror,0 days 01:38:00.000000000,8
67,67,,The Expendables 2,250000,132,2012.0,Action/Adventure,0 days 01:43:00.000000000,0
25,32,,The Victim,1000,19,2011.0,Mystery and thriller,0 days 01:23:00.000000000,7
33,0,https://resizing.flixster.com/UQniJw1QS77rfdQ5InGwSC7Rh4Q=/206x305/v2/https://flxt.tmsimg.com/assets/p9283270_p_v8_ah.jpg,You May Not Kiss the Bride,500,9,2011.0,Romance/Action,0 days 01:40:00.000000000,-33
74,57,,Detachment,5000,72,2011.0,Drama,0 days 01:37:00.000000000,-17
52,47,https://resizing.flixster.com/XNzGhH0UjAgulOeaW5g9sYJuux8=/206x305/v2/https://flxt.tmsimg.com/assets/p8869807_p_v10_aa.jpg,The Last Ride,1000,19,2012.0,Drama/History,0 days 01:42:00.000000000,-5
78,85,https://resizing.flixster.com/celAo-rLwgcBHgC21IDYQO2slYA=/206x305/v2/https://flxt.tmsimg.com/assets/p8725693_p_v8_ae.jpg,Bully,25000,142,2011.0,Documentary,0 days 01:39:00.000000000,7
35,44,,Late Bloomers,250,16,2011.0,Romance/Comedy,0 days 01:29:00.000000000,9
58,67,,Norman,500,15,2010.0,Comedy/Drama,0 days 01:37:00.000000000,9
40,46,,To Rome With Love,25000,181,2012.0,Romance,0 days 01:51:00.000000000,6
85,100,https://resizing.flixster.com/bpVQPZ9MkHXVVljsOxyLQ1vvuoI=/206x305/v2/https://flxt.tmsimg.com/assets/p9008173_p_v10_ab.jpg,The Loving Story,500,19,2011.0,Documentary,0 days 01:17:00.000000000,15
48,40,https://resizing.flixster.com/i7oknDNh3onAgOiRdnbLyr-bt7Y=/206x305/v2/https://flxt.tmsimg.com/assets/p9337533_p_v10_au.jpg,Parker,25000,109,2013.0,Crime/Action,0 days 01:58:00.000000000,-8
67,48,https://resizing.flixster.com/sssuUrQdefy7yryHq30OgjNiTu8=/206x305/v2/https://flxt.tmsimg.com/NowShowing/118961/118961_aa.jpg,The Great Gatsby,100000,301,2013.0,Drama,0 days 02:22:00.000000000,-19
43,76,,The Bay,10000,84,2012.0,Sci fi/Horror,0 days 01:24:00.000000000,33
58,67,,This Must Be the Place,5000,87,2011.0,Drama,0 days 01:58:00.000000000,9
41,13,https://resizing.flixster.com/W7M4mHHng0nMfCbBhYDK5js2nHI=/206x305/v2/https://flxt.tmsimg.com/assets/p8890173_p_v8_ab.jpg,House at the End of the Street,50000,67,2012.0,Horror/Mystery and thriller,0 days 01:41:00.000000000,-28
74,79,,Battle for Brooklyn,250,19,2010.0,Drama,0 days 01:33:00.000000000,5
82,60,,Kumaré,1000,25,2011.0,Documentary,0 days 01:24:00.000000000,-22
86,88,https://resizing.flixster.com/9fKA2DDhil3HA19NqBE2shg2mRU=/206x305/v2/https://flxt.tmsimg.com/assets/p8836612_p_v8_aa.jpg,Somewhere Between,250,24,2011.0,Documentary,0 days 01:34:00.000000000,2
72,85,,You've Been Trumped,1000,34,2011.0,Documentary,0 days 01:35:00.000000000,13
28,36,,Screwed,250,14,2011.0,Drama,0 days 01:50:00.000000000,8
54,50,,Savages,100000,195,2012.0,Crime/Drama,0 days 02:10:00.000000000,-4
75,76,,Hara-Kiri: Death of a Samurai,2500,42,2011.0,Drama/History,0 days 02:06:00.000000000,1
72,100,https://resizing.flixster.com/j8xer8oaGGIIUsZ2w58FqyHGBmE=/206x305/v2/https://flxt.tmsimg.com/assets/p8646547_p_v10_aa.jpg,They Call It Myanmar: Lifting the Curtain,250,13,2012.0,Documentary,0 days 01:10:00.000000000,28
48,28,,G.I. Joe: Retaliation,100000,179,2013.0,Action/Adventure,0 days 01:50:00.000000000,-20
84,81,,"Wild Horse, Wild Ride",250,16,2011.0,Western/Documentary,0 days 01:46:00.000000000,-3
60,79,,Magic Mike,100000,214,2012.0,Comedy/Drama,0 days 01:50:00.000000000,19
86,93,https://resizing.flixster.com/WE6eEuZEs5xiSTbpT98_HogFtuE=/206x305/v2/https://flxt.tmsimg.com/assets/p9005688_p_v10_aa.jpg,Moonrise Kingdom,100000,263,2012.0,Romance/Comedy,0 days 01:34:00.000000000,7
72,89,,ParaNorman,50000,185,2012.0,Comedy/Kids and family,0 days 01:36:00.000000000,17
62,68,https://resizing.flixster.com/T6KwFH0Wv0i0Lg5tFuc-acEUc3I=/206x305/v2/https://flxt.tmsimg.com/assets/p9632817_p_v13_af.jpg,Trance,10000,187,2013.0,Crime/Drama,0 days 01:41:00.000000000,6
31,37,,Hyde Park on Hudson,10000,178,2012.0,Drama/History,0 days 01:34:00.000000000,6
68,91,,The Day He Arrives,250,22,2011.0,Drama,0 days 01:19:00.000000000,23
82,97,,"Oslo, August 31st",5000,71,2011.0,Drama,0 days 01:35:00.000000000,15
76,96,,The Kid with a Bike,25000,133,2011.0,Drama,0 days 01:27:00.000000000,20
60,84,,Beauty (Skoonheid),250,19,2011.0,,,24
74,85,/assets/pizza-pie/images/poster_default.c8c896e70c3.gif,Wu Xia,5000,27,2011.0,Crime/Action,0 days 01:55:00.000000000,11
55,65,https://resizing.flixster.com/4EAXbJkZwJ0gAQtpmQKzqo5FV98=/206x305/v2/https://flxt.tmsimg.com/assets/p8833894_p_v8_aa.jpg,We Have a Pope,5000,81,2011.0,Comedy/Drama,0 days 01:41:00.000000000,10
71,90,,Khodorkovsky,500,29,2011.0,Documentary/Drama,0 days 01:51:00.000000000,19
46,60,https://resizing.flixster.com/SZz7Ob3hFO8jRjveQ2ozTM8ZKNA=/206x305/v2/https://flxt.tmsimg.com/assets/p8980462_p_v10_ab.jpg,The Eye of the Storm,5000,55,2011.0,Drama,0 days 01:59:00.000000000,14
45,56,https://resizing.flixster.com/jaUMAXhUJ6eztU4ol3PQPnvc5_0=/206x305/v2/https://flxt.tmsimg.com/assets/p9245151_p_v10_ac.jpg,Beloved,500,45,2011.0,Romance/Drama,0 days 02:13:00.000000000,11
69,97,https://resizing.flixster.com/cOMQwusCl-OkJs1yidJJ-zbH4Dc=/206x305/v2/https://flxt.tmsimg.com/assets/p8829986_p_v10_ac.jpg,This Is Not a Film,5000,102,2010.0,Documentary,0 days 01:15:00.000000000,28
80,65,,Starbuck,2500,71,2011.0,Romance/Comedy,0 days 01:48:00.000000000,-15
80,83,,Red Dog,2500,36,2011.0,Comedy/Kids and family,0 days 01:32:00.000000000,3
73,94,https://resizing.flixster.com/Muc_ny3xQkJeO8R8af4CU_Dfnow=/206x305/v2/https://flxt.tmsimg.com/assets/p8822327_p_v10_aa.jpg,Elena,2500,65,2011.0,Drama,0 days 01:49:00.000000000,21
44,83,,Corpo Celeste,1000,18,2011.0,Drama,0 days 01:40:00.000000000,39
62,85,,The Giants,250,20,2011.0,Drama,0 days 01:24:00.000000000,23
35,77,/assets/pizza-pie/images/poster_default.c8c896e70c3.gif,Unforgivable,1000,35,2011.0,Drama,0 days 01:52:00.000000000,42
56,70,https://resizing.flixster.com/_HWO6u7JVDHANdb76Dg8SG40Hr8=/206x305/v2/https://flxt.tmsimg.com/assets/p8701375_p_v10_aa.jpg,The Pill,1000,10,2011.0,Romance/Comedy,0 days 01:23:00.000000000,14
30,23,https://resizing.flixster.com/i0OoIqQyJrMJ4KfNeCCjBbkQIwg=/206x305/v2/https://resizing.flixster.com/2R7m0Pz2CnsY5xZMCw4mE-cx3xI=/ems.ZW1zLXByZC1hc3NldHMvbW92aWVzLzQxMGU3ODc5LWUwNzctNGM5NC05NjIyLWVmMDZiZjY1MGRjNS53ZWJw,Lucky,500,13,2011.0,Drama,0 days 01:40:00.000000000,-7
50,74,,Alps,1000,47,2011.0,Drama,0 days 01:33:00.000000000,24
40,60,https://resizing.flixster.com/Aefssn2kcg6NQrKC_wP9VJuJB_E=/206x305/v2/https://flxt.tmsimg.com/assets/p8967072_p_v10_aa.jpg,10 Years,10000,58,2011.0,Comedy,0 days 01:40:00.000000000,20
41,4,https://resizing.flixster.com/i3Z1XBXVWH6Ew-0tsiHpmvH7KZM=/206x305/v2/https://flxt.tmsimg.com/assets/p8869442_p_v13_an.jpg,Playing for Keeps,10000,91,2012.0,Romance,0 days 01:45:00.000000000,-37
68,74,https://resizing.flixster.com/dHrYUA823j82uk7A7Y2h5Eg5C14=/206x305/v2/https://flxt.tmsimg.com/assets/p9030126_p_v10_aa.jpg,Natural Selection,1000,35,2011.0,Comedy,0 days 01:30:00.000000000,6
72,84,https://resizing.flixster.com/750M7EdpVVujV2XM1xpzNqtL6V4=/206x305/v2/https://flxt.tmsimg.com/assets/p8833706_p_v8_aa.jpg,The Forgiveness of Blood,1000,70,2011.0,Drama,0 days 01:49:00.000000000,12
85,92,https://resizing.flixster.com/gfxqCa8pxiJT9ln3gXkdvxZ75vE=/206x305/v2/https://flxt.tmsimg.com/assets/p8849548_p_v10_aa.jpg,Wish Me Away,100,13,2011.0,Documentary/Gay and lesbian,0 days 01:36:00.000000000,7
91,87,,Django Unchained,250000,291,2012.0,Western/Action,0 days 02:45:00.000000000,-4
61,53,,Oblivion,100000,256,2013.0,Action/Sci fi,0 days 02:05:00.000000000,-8
84,94,,I Wish,1000,77,2011.0,Comedy/Drama,0 days 02:08:00.000000000,10
78,87,https://resizing.flixster.com/Maypz4ZN_FNFaIikNxh-H4lutqI=/206x305/v2/https://flxt.tmsimg.com/assets/p9119889_p_v13_ao.jpg,Polisse,5000,84,2011.0,Crime/Drama,0 days 02:07:00.000000000,9
49,10,https://resizing.flixster.com/Vh5hYb7-n8wn6I3uqnCGKxYCgcI=/206x305/v2/https://flxt.tmsimg.com/assets/p9170652_p_v10_ab.jpg,The Host,50000,133,2013.0,Romance/Sci fi,0 days 02:05:00.000000000,-39
40,19,https://resizing.flixster.com/-HoxSVb1uTgY76KcYHu_TpsLhqM=/206x305/v2/https://flxt.tmsimg.com/assets/p9337381_p_v8_ad.jpg,Texas Chainsaw,100000,79,2013.0,Horror,0 days 01:32:00.000000000,-21
84,83,https://resizing.flixster.com/83bbMblTroe_yzVLK2-Cj7XsmBs=/206x305/v2/https://flxt.tmsimg.com/assets/p8743214_p_v10_aa.jpg,The Whale,1000,23,2011.0,Documentary,0 days 01:25:00.000000000,-1
64,77,,Burning Man,2500,26,2011.0,Drama,0 days 01:49:00.000000000,13
28,67,,My Worst Nightmare,500,12,2011.0,Romance,0 days 01:39:00.000000000,39
33,56,https://resizing.flixster.com/UcNNH1H_UztLmzDM0Yl77OhRSWQ=/206x305/v2/https://flxt.tmsimg.com/assets/p9431628_p_v10_al.jpg,Vamps,5000,18,2012.0,Comedy/Horror,0 days 01:33:00.000000000,23
33,45,https://resizing.flixster.com/fGWqTUzGWMzI6kl1c_JK8ofUd_4=/206x305/v2/https://flxt.tmsimg.com/assets/p9273759_p_v10_ae.jpg,The Paperboy,10000,146,2012.0,Crime/Drama,0 days 01:47:00.000000000,12
46,36,,Connected,250,14,2011.0,Documentary,0 days 01:22:00.000000000,-10
48,68,,Flying Swords of Dragon Gate,2500,28,2011.0,Action/Adventure,0 days 02:02:00.000000000,20
88,81,https://resizing.flixster.com/I6yWDpRRaPQxoKo9_bsCKbIndYM=/206x305/v2/https://flxt.tmsimg.com/assets/p8932421_p_v8_aa.jpg,Last Call at the Oasis,250,26,2011.0,Documentary,0 days 01:45:00.000000000,-7
45,54,,The Company You Keep,10000,123,2012.0,Mystery and thriller,0 days 02:01:00.000000000,9
89,96,https://resizing.flixster.com/rCCwGDUro38nqGQb4Uu_ZulXdqo=/206x305/v2/https://flxt.tmsimg.com/assets/p8830065_p_v10_ay.jpg,Undefeated,5000,102,2011.0,Documentary,0 days 01:53:00.000000000,7
73,89,,Gerhard Richter Painting,250,28,2011.0,Documentary,0 days 01:37:00.000000000,16
22,55,https://resizing.flixster.com/7aFw7q4crxhiZInsrv-YLeE6H9c=/206x305/v2/https://flxt.tmsimg.com/assets/p9277229_p_v13_ac.jpg,A Burning Hot Summer,1000,11,2011.0,Drama,0 days 01:35:00.000000000,33
47,25,,Fun Size,25000,73,2012.0,Other/Comedy,0 days 01:26:00.000000000,-22
67,64,https://resizing.flixster.com/dfdO2U_R4z-jrBRM3jsR8_REe4E=/206x305/v2/https://flxt.tmsimg.com/assets/p9286627_p_v10_ae.jpg,Jack Reacher,100000,182,2012.0,Action/Mystery and thriller,0 days 02:10:00.000000000,-3
80,91,,Zero Dark Thirty,100000,300,2012.0,Drama/Mystery and thriller,0 days 02:37:00.000000000,11
61,84,https://resizing.flixster.com/fDAxaYE34sN1KuvJ0YoatF0x_pk=/206x305/v2/https://flxt.tmsimg.com/assets/p9245056_p_v10_aa.jpg,Fat Kid Rules the World,2500,25,2012.0,Comedy,0 days 01:34:00.000000000,23
58,79,https://resizing.flixster.com/iGoUtJj50gWW5QKS4Df571negmc=/206x305/v2/https://flxt.tmsimg.com/assets/p8925087_p_v10_av.jpg,Take This Waltz,10000,141,2011.0,Drama,0 days 01:56:00.000000000,21
53,61,https://resizing.flixster.com/zrOYRxgxBilwWWIzTvF10ljKeGE=/206x305/v2/https://flxt.tmsimg.com/assets/p9337470_p_v8_ac.jpg,The Last Stand,25000,167,2013.0,Action,0 days 01:46:00.000000000,8
80,94,https://resizing.flixster.com/EMwR-h70IN8aFlfvETzbWL_GoeM=/206x305/v2/https://flxt.tmsimg.com/assets/p9029313_p_v10_aa.jpg,Tatsumi,250,18,2011.0,Drama/Animation,0 days 01:36:00.000000000,14
39,75,https://resizing.flixster.com/QBB1VU6HPbRmo7FaPq6XtGajEVw=/206x305/v2/https://flxt.tmsimg.com/assets/p8926761_p_v10_aa.jpg,Damsels in Distress,10000,143,2011.0,Comedy,0 days 01:39:00.000000000,36
39,16,https://resizing.flixster.com/7JwxMyte7ee5PWWnn6v8uNNnmHs=/206x305/v2/https://flxt.tmsimg.com/assets/p9046508_p_v10_aq.jpg,The Watch,50000,165,2012.0,Comedy/Sci fi,0 days 01:41:00.000000000,-23
51,62,,The Awakening,5000,74,2011.0,Horror,0 days 01:47:00.000000000,11
41,70,https://resizing.flixster.com/ubQgH_IQiaJyvVz1Ixs0iDLtn4c=/206x305/v2/https://flxt.tmsimg.com/assets/p9259393_p_v10_aa.jpg,Dark Horse,2500,79,2011.0,Drama,0 days 01:25:00.000000000,29
50,63,https://resizing.flixster.com/sTOvhGOdotyJgvVfsQDspUZX2LQ=/206x305/v2/https://flxt.tmsimg.com/assets/p9248601_p_v10_ae.jpg,Anna Karenina,50000,192,2012.0,Romance/History,0 days 02:09:00.000000000,13
67,36,https://resizing.flixster.com/3fmNZIkAHHUpbMROhjOybfJFXuo=/206x305/v2/https://flxt.tmsimg.com/assets/p8797072_p_v10_aa.jpg,The Odd Life of Timothy Green,100000,132,2012.0,Fantasy/Comedy,0 days 01:44:00.000000000,-31
40,28,,Broken City,25000,153,2013.0,Crime/Drama,0 days 01:48:00.000000000,-12
63,90,https://resizing.flixster.com/k8BY3NcJTgFCq_u8OvfGCuVA0Pw=/206x305/v2/https://flxt.tmsimg.com/assets/p9235511_p_v8_aa.jpg,Keep the Lights On,2500,67,2012.0,Gay and lesbian/Drama,0 days 01:43:00.000000000,27
34,67,https://resizing.flixster.com/bVPb_1Un39MmclKyGE6ZF1TVcLo=/206x305/v2/https://flxt.tmsimg.com/assets/p8904996_p_v10_aa.jpg,Cargo,100,6,2011.0,Drama,0 days 01:26:00.000000000,33
66,83,,Your Sister's Sister,10000,145,2011.0,Romance/Comedy,0 days 01:30:00.000000000,17
71,74,https://resizing.flixster.com/4nQukXXLxkJTjxMQs5mQVy0Deiw=/206x305/v2/https://flxt.tmsimg.com/assets/p8843315_p_v8_ab.jpg,Chicken With Plums,1000,69,2011.0,Comedy/Drama,0 days 01:31:00.000000000,3
63,52,https://resizing.flixster.com/lhCOQZM1pofoi2KX8uCh4JFIcqE=/206x305/v2/https://flxt.tmsimg.com/assets/p9047877_p_v10_ao.jpg,Diary of a Wimpy Kid: Dog Days,50000,75,2012.0,Comedy/Kids and family,0 days 01:34:00.000000000,-11
55,92,,Girl Model,2500,36,2011.0,Documentary/Mystery and thriller,0 days 01:17:00.000000000,37
39,45,,Bullet to the Head,25000,145,2012.0,Action/Mystery and thriller,0 days 01:31:00.000000000,6
67,70,https://resizing.flixster.com/azANGSWnN4WBO_OOdoCtMBJrNBM=/206x305/v2/https://flxt.tmsimg.com/assets/p8833386_p_v8_aa.jpg,Barrymore,1000,23,2011.0,Drama,0 days 01:23:00.000000000,3
49,27,https://resizing.flixster.com/cNRzKx5SegjFVnuDD0WCPFUki2U=/206x305/v2/https://flxt.tmsimg.com/assets/p8920726_p_v10_ae.jpg,The Sorcerer and the White Snake,5000,15,2011.0,Action/Fantasy,0 days 01:40:00.000000000,-22
54,59,https://resizing.flixster.com/yYvUleyLnWhfsytpPeL7TJpW4eU=/206x305/v2/https://flxt.tmsimg.com/assets/p8871964_p_v10_an.jpg,Hysteria,10000,134,2011.0,Comedy,0 days 01:39:00.000000000,5
31,74,,The Loneliest Planet,5000,65,2011.0,Drama/Mystery and thriller,0 days 01:53:00.000000000,43
32,31,,The Oranges,5000,78,2011.0,Comedy/Drama,0 days 01:32:00.000000000,-1
42,27,https://resizing.flixster.com/oMYssbTenimA-d-N-WhPVqoDnkY=/206x305/v2/https://flxt.tmsimg.com/assets/p9069449_p_v8_aa.jpg,33 Postcards,250,15,2011.0,Drama,0 days 01:37:00.000000000,-15
40,33,https://resizing.flixster.com/kpsYP3pNWn50IaT44YFhC7GpmYk=/206x305/v2/https://flxt.tmsimg.com/assets/p9138556_p_v10_aa.jpg,A Man's Story,250,18,2010.0,Documentary,0 days 01:38:00.000000000,-7
78,78,,The Best Exotic Marigold Hotel,50000,168,2011.0,Comedy/Drama,0 days 02:04:00.000000000,0
61,35,,Won't Back Down,10000,106,2012.0,Drama,0 days 02:01:00.000000000,-26
91,91,https://resizing.flixster.com/U53p0fcliM3olm863qHR-JVUcyA=/206x305/v2/https://flxt.tmsimg.com/assets/p8602083_p_v10_aa.jpg,Face to Face,250,11,2010.0,Drama,0 days 01:27:00.000000000,0
74,88,,Whores' Glory,500,24,2011.0,Documentary,0 days 01:50:00.000000000,14
65,100,,The Wise Kids,250,12,2011.0,Gay and lesbian/Drama,0 days 01:35:00.000000000,35
55,46,https://resizing.flixster.com/e6NeaIF0nWJU5OfBynM0TDcqNl4=/206x305/v2/https://flxt.tmsimg.com/assets/p8833639_p_v10_am.jpg,Heleno,100,13,2011.0,Biography,0 days 01:57:00.000000000,-9
77,98,,The Island President,2500,49,2011.0,Documentary,0 days 01:41:00.000000000,21
86,94,https://resizing.flixster.com/TgjN_x99Vjk0dWHoHPYfigWgxPc=/206x305/v2/https://flxt.tmsimg.com/assets/p8833760_p_v10_ak.jpg,A Simple Life,1000,31,2011.0,Drama,0 days 01:57:00.000000000,8
80,73,,Surviving Progress,2500,37,2011.0,Documentary,0 days 01:26:00.000000000,-7
32,20,,360,2500,75,2011.0,Drama,0 days 01:53:00.000000000,-12
52,63,,Trishna,2500,93,2011.0,Romance/Drama,0 days 01:57:00.000000000,11
75,97,,In the Family,1000,29,2011.0,Drama,0 days 02:49:00.000000000,22
84,93,,First Position,10000,76,2011.0,Documentary,0 days 01:30:00.000000000,9
77,89,https://resizing.flixster.com/oNB9ZARKXiVHxc6gPtETY1NF__4=/206x305/v2/https://flxt.tmsimg.com/assets/p9060433_p_v8_aa.jpg,"Pink Ribbons, Inc.",1000,37,2011.0,Documentary,0 days 01:37:00.000000000,12
22,59,,The Woman in the Fifth,2500,58,2011.0,Mystery and thriller,0 days 01:23:00.000000000,37
60,88,https://resizing.flixster.com/sKYE0cURlnRM11q3WKehJ3Par7Y=/206x305/v2/https://flxt.tmsimg.com/assets/p8889363_p_v8_ab.jpg,Neil Young Journeys,1000,64,2011.0,Documentary,0 days 01:27:00.000000000,28
72,97,,Sleepless Night,1000,32,2011.0,Crime/Action,0 days 01:42:00.000000000,25
90,80,/assets/pizza-pie/images/poster_default.c8c896e70c3.gif,The Story Of Film: An Odyssey,100,5,2011.0,,,-10
27,50,https://resizing.flixster.com/kvMKNIVe_E-HrEgNJoRGvt6niYY=/206x305/v2/https://flxt.tmsimg.com/assets/p9098766_p_v8_aa.jpg,Americano,1000,16,2011.0,Drama,0 days 01:45:00.000000000,23
55,75,https://resizing.flixster.com/vjrQAR5Uhj_XNehKXVulUJEsX4o=/206x305/v2/https://flxt.tmsimg.com/assets/p9076083_p_v10_ba.jpg,Hope Springs,25000,174,2012.0,Drama/Comedy,0 days 01:40:00.000000000,20
35,66,,Union Square,250,29,2011.0,Drama,0 days 01:20:00.000000000,31
68,41,,Step Up Revolution,50000,98,2012.0,Romance/Drama,0 days 01:38:00.000000000,-27
86,92,,Silver Linings Playbook,250000,260,2012.0,Drama/Comedy,0 days 02:02:00.000000000,6
46,28,,The Cup,2500,25,2011.0,Drama,0 days 01:36:00.000000000,-18
79,70,,Les Misérables,250000,256,2012.0,History/Musical,0 days 02:38:00.000000000,-9
81,90,,The Last Gladiators,250,10,2011.0,Documentary,0 days 01:34:00.000000000,9
87,76,,Samsara,10000,79,2011.0,Documentary/Music,0 days 01:42:00.000000000,-11
57,67,,Hollywood to Dollywood,50,6,2010.0,Documentary,0 days 01:21:00.000000000,10
39,37,,The Guilt Trip,25000,128,2012.0,Comedy,0 days 01:35:00.000000000,-2
46,0,https://resizing.flixster.com/bTM5tEq_Fqebat7-JUTskw3v-3A=/206x305/v2/https://flxt.tmsimg.com/assets/p8921357_p_v10_aa.jpg,Will,100,5,2011.0,Drama,0 days 01:42:00.000000000,-46
16,22,,Strippers vs Werewolves,100,9,2012.0,Comedy/Horror,0 days 01:33:00.000000000,6
77,100,https://resizing.flixster.com/EjbQkj9cIwHo_rsUmZSVql9YKtI=/206x305/v2/https://flxt.tmsimg.com/assets/p9118327_p_v10_aa.jpg,Cloudburst,250,9,2011.0,Comedy/Drama,0 days 01:33:00.000000000,23
24,43,,The Wedding Party,50,7,2010.0,Comedy/Drama,0 days 01:38:00.000000000,19
80,91,,The Sessions,10000,203,2012.0,Comedy/Drama,0 days 01:35:00.000000000,11
90,96,https://resizing.flixster.com/Ac5mfOAapSXRP4snhS6aG4ynDrg=/206x305/v2/https://flxt.tmsimg.com/assets/p9128357_p_v10_an.jpg,Argo,100000,358,2012.0,Drama/Mystery and thriller,0 days 02:00:00.000000000,6
57,31,https://resizing.flixster.com/DFGP2ZUYW08DvGvBAgBMzl5pJZ4=/206x305/v2/https://flxt.tmsimg.com/assets/p9171240_p_v10_al.jpg,Gangster Squad,100000,208,2013.0,Crime/Action,0 days 01:50:00.000000000,-26
54,60,,John Dies at the End,10000,89,2012.0,Sci fi/Horror,0 days 01:39:00.000000000,6
44,33,,Donovan's Echo,100,9,2011.0,Fantasy/Drama,0 days 01:35:00.000000000,-11
24,15,https://resizing.flixster.com/qNt1lVH5dPpNt74JTUXOxyORCsE=/206x305/v2/https://flxt.tmsimg.com/assets/p9203491_p_v10_aa.jpg,Irvine Welsh's Ecstasy,1000,20,2011.0,Romance/Drama,0 days 01:39:00.000000000,-9
62,33,,The Brooklyn Brothers Beat the Best,1000,21,2011.0,Comedy,0 days 01:37:00.000000000,-29
68,90,https://resizing.flixster.com/355w0YguVQAkrTNTJx2A8MSQX3g=/206x305/v2/https://flxt.tmsimg.com/assets/p9078174_p_v10_aa.jpg,Patience (After Sebald),250,21,2012.0,Documentary,0 days 01:30:00.000000000,22
48,54,,Hunky Dory,500,46,2011.0,Musical,0 days 01:50:00.000000000,6
34,38,https://resizing.flixster.com/EskcQ7d7m5GuJK-WHm_Vriqwdik=/206x305/v2/https://flxt.tmsimg.com/assets/p9148638_p_v8_aa.jpg,Let My People Go!,100,16,2011.0,Comedy,0 days 01:25:00.000000000,4
74,66,,Lawless,100000,218,2012.0,Crime/Drama,0 days 01:55:00.000000000,-8
39,68,https://resizing.flixster.com/ExKQIJHPSZpcYZm4alildQsXLSU=/206x305/v2/https://flxt.tmsimg.com/assets/p9082904_p_v8_aa.jpg,17 Girls,2500,22,2011.0,Drama,0 days 01:30:00.000000000,29
65,77,,Dreams of a Life,2500,30,2011.0,Drama,0 days 01:35:00.000000000,12
90,100,,Vito,50,6,2011.0,Drama/Documentary,0 days 01:33:00.000000000,10
40,14,,A Good Day to Die Hard,100000,230,2013.0,Action/Mystery and thriller,0 days 01:38:00.000000000,-26
70,32,,Chasing Mavericks,10000,81,2012.0,Drama/Adventure,0 days 01:55:00.000000000,-38
86,87,,Boy,5000,71,2010.0,Comedy/Drama,0 days 01:28:00.000000000,1
79,95,,Li and the Poet,100,19,2011.0,Drama,0 days 01:32:00.000000000,16
86,86,,Barfi!,2500,14,2012.0,Comedy/Drama,0 days 02:30:00.000000000,0
82,100,https://resizing.flixster.com/OAS7vflVj1CH8Ql0eleQQWhy1uo=/206x305/v2/https://flxt.tmsimg.com/assets/p9145288_p_v10_aa.jpg,Wild Bill,5000,26,2011.0,Drama,0 days 01:38:00.000000000,18
66,100,https://resizing.flixster.com/AZRxSjLUnxQuKJ8oKUDGk3cWTXE=/206x305/v2/https://flxt.tmsimg.com/assets/p8941503_p_v10_aa.jpg,Black Pond,100,7,2011.0,Comedy/Drama,0 days 01:23:00.000000000,34
57,88,,Manborg,250,8,2011.0,Comedy/Sci fi,0 days 01:10:00.000000000,31
19,63,https://resizing.flixster.com/V9yti-OHwHYf-xjtP_W7WcS-LTo=/206x305/v2/https://flxt.tmsimg.com/assets/p9424605_p_v10_ab.jpg,Crawl,100,8,2011.0,Crime/Drama,0 days 01:20:00.000000000,44
73,69,https://resizing.flixster.com/_JeNoIM4NVlzHKaHrL-EQqxj1HE=/206x305/v2/https://flxt.tmsimg.com/assets/p9023706_p_v10_ab.jpg,A Bottle in the Gaza Sea,250,13,2011.0,Drama,0 days 01:39:00.000000000,-4
51,66,,The Campaign,100000,208,2012.0,Comedy,0 days 01:25:00.000000000,15
61,63,https://resizing.flixster.com/1XsI74HaXszca_5f8OiURATGwr0=/206x305/v2/https://flxt.tmsimg.com/assets/p9086074_p_v13_ag.jpg,Sinister,50000,154,2012.0,Horror/Mystery and thriller,0 days 01:49:00.000000000,2
29,10,https://resizing.flixster.com/XPnbiWob77hCgQhsnlCIvjWQgy8=/206x305/v2/https://flxt.tmsimg.com/assets/p9796350_p_v10_ad.jpg,Killing Season,5000,20,2013.0,Action/Mystery and thriller,0 days 01:30:00.000000000,-19
79,94,,Diana Vreeland: The Eye Has to Travel,1000,71,2011.0,Documentary/Biography,0 days 01:17:00.000000000,15
84,100,,Steve Jobs: The Lost Interview,1000,7,2011.0,Documentary,0 days 01:10:00.000000000,16
61,44,/assets/pizza-pie/images/poster_default.c8c896e70c3.gif,Walk Away Renee,100,9,2011.0,Drama,0 days 01:30:00.000000000,-17
69,11,https://resizing.flixster.com/p6Mxi8UU_eAJOmjIzFEEeGkOAqE=/206x305/v2/https://flxt.tmsimg.com/assets/p9056127_p_v8_aa.jpg,"After Fall, Winter",500,9,2011.0,Romance/Drama,0 days 02:11:00.000000000,-58
44,56,https://resizing.flixster.com/t3l3ZJ5yF-49LemwQU6BIwAEojE=/206x305/v2/https://flxt.tmsimg.com/assets/p9067095_p_v8_ab.jpg,Sparkle,500,94,2012.0,Drama/Musical,0 days 01:52:00.000000000,12
50,50,,"Small, Beautifully Moving Parts",50,12,2011.0,Comedy/Drama,0 days 01:12:00.000000000,0
87,95,,West of Memphis,5000,117,2012.0,Crime/Documentary,0 days 02:30:00.000000000,8
63,63,,Evil Dead,50000,203,2013.0,Horror/Mystery and thriller,0 days 01:31:00.000000000,0
53,55,https://resizing.flixster.com/7WkoC7x2ilCiLqNumDpQ8pCWSvs=/206x305/v2/https://flxt.tmsimg.com/assets/p9005655_p_v10_ac.jpg,Seeking a Friend for the End of the World,50000,174,2012.0,Romance/Comedy,0 days 01:41:00.000000000,2
49,48,https://resizing.flixster.com/Fp4srK2wgGeZkh7bG7xJunjJCiI=/206x305/v2/https://flxt.tmsimg.com/assets/p9151384_p_v10_aa.jpg,Hit & Run,25000,137,2012.0,Comedy/Action,0 days 01:35:00.000000000,-1
75,86,,Robot & Frank,25000,139,2012.0,Sci fi/Comedy,0 days 01:30:00.000000000,11
66,17,,Temptation,25000,36,0.0,Drama,0 days 02:00:00.000000000,-49
24,53,https://resizing.flixster.com/13kBs-xsxr3jiWgT26kYPOQxd9k=/206x305/v2/https://flxt.tmsimg.com/assets/p9336088_p_v10_ac.jpg,Black Rock,2500,59,2012.0,Mystery and thriller,0 days 01:20:00.000000000,29
65,47,,The First Time,5000,19,2012.0,Romance,0 days 01:40:00.000000000,-18
19,18,,Lay the Favorite,1000,51,2012.0,Comedy/Drama,0 days 01:34:00.000000000,-1
52,84,https://resizing.flixster.com/UhJq2WaOh7csQlnGusfZJ1V_J74=/206x305/v2/https://flxt.tmsimg.com/assets/p9028690_p_v10_ac.jpg,Shadow Dancer,5000,91,2012.0,Drama/Mystery and thriller,0 days 01:42:00.000000000,32
85,94,,The House I Live In,5000,66,2012.0,Documentary,0 days 01:48:00.000000000,9
78,95,,The Imposter,50000,116,2012.0,Documentary,0 days 01:35:00.000000000,17
84,99,https://resizing.flixster.com/zGdkP5IH2WGOxUHoxknw0yUHDvg=/206x305/v2/https://flxt.tmsimg.com/assets/p9026998_p_v8_aa.jpg,The Invisible War,10000,72,2011.0,Crime/Documentary,0 days 01:35:00.000000000,15
54,65,,Wrong,2500,43,2012.0,Comedy/Drama,0 days 01:34:00.000000000,11
60,71,https://resizing.flixster.com/bkH5k4X-Qs5-BbCS1QdAatC-zIo=/206x305/v2/https://flxt.tmsimg.com/assets/p9253625_p_v10_ak.jpg,Liberal Arts,5000,115,2012.0,Romance/Comedy,0 days 01:37:00.000000000,11
61,34,https://resizing.flixster.com/8caPC1zlPPkSUvk7Z46GdCvUb9A=/206x305/v2/https://flxt.tmsimg.com/assets/p9217110_p_v10_aa.jpg,Luv,1000,41,2012.0,Drama,0 days 01:34:00.000000000,-27
49,24,https://resizing.flixster.com/9uHtDsvdfZXMOiB4txj5MfX_jyU=/206x305/v2/https://flxt.tmsimg.com/assets/p9151681_p_v10_ab.jpg,The Words,25000,128,2012.0,Romance/Drama,0 days 01:36:00.000000000,-25
23,41,https://resizing.flixster.com/SpbvMartXvsJ_jEAq3fgJ5kAXpY=/206x305/v2/https://flxt.tmsimg.com/assets/p9028450_p_v8_ab.jpg,Nobody Walks,2500,41,2012.0,Drama,0 days 01:23:00.000000000,18
30,64,,Price Check,2500,22,2012.0,Comedy/Drama,0 days 01:33:00.000000000,34
73,95,,The Queen of Versailles,10000,119,2012.0,Documentary,0 days 01:40:00.000000000,22
34,58,,Red Hook Summer,1000,66,2012.0,Drama,0 days 02:01:00.000000000,24
41,57,https://resizing.flixster.com/F-IS8ZtsAlziDt8jxnZTbQF5t5c=/206x305/v2/https://flxt.tmsimg.com/assets/p9099113_p_v10_ae.jpg,VHS,10000,104,2012.0,Horror/Mystery and thriller,0 days 01:55:00.000000000,16
62,87,,Arbitrage,50000,171,2012.0,Drama/Mystery and thriller,0 days 01:40:00.000000000,25
55,68,,California Solo,250,25,2012.0,Drama,0 days 01:34:00.000000000,13
77,86,https://resizing.flixster.com/tcJ7tFcYLQi5QfuO6p79rvhv9_4=/206x305/v2/https://flxt.tmsimg.com/assets/p9028735_p_v10_aa.jpg,Something From Nothing: The Art of Rap,5000,28,2012.0,Documentary/Music,0 days 01:50:00.000000000,9
68,83,https://resizing.flixster.com/jCbctvKKZEiMJSY0PPm1GeEEnbA=/206x305/v2/https://flxt.tmsimg.com/assets/p9081174_p_v8_ak.jpg,Smashed,10000,107,2012.0,Drama,0 days 01:21:00.000000000,15
84,85,,Shut Up and Play the Hits,500,27,2012.0,Documentary/Music,0 days 01:45:00.000000000,1
80,91,,Safety Not Guaranteed,25000,150,2012.0,Comedy,0 days 01:24:00.000000000,11
42,66,,2 Days in New York,5000,109,2012.0,Comedy,0 days 01:35:00.000000000,24
74,71,,The Ambassador,500,38,2011.0,Documentary,0 days 01:33:00.000000000,-3
34,56,,Bachelorette,10000,101,2012.0,Comedy,0 days 01:33:00.000000000,22
91,77,,Bones Brigade: An Autobiography,500,13,2012.0,Documentary,0 days 01:51:00.000000000,-14
62,71,,Celeste and Jesse Forever,10000,143,2012.0,Romance,0 days 01:30:00.000000000,9
55,47,https://resizing.flixster.com/TjAFmEIQX829w_3mYic1xTA0IGE=/206x305/v2/https://flxt.tmsimg.com/assets/p9311620_p_v10_aa.jpg,The Comedy,2500,34,2012.0,Drama,0 days 01:30:00.000000000,-8
47,59,,The End of Love,500,17,2012.0,Drama,0 days 01:30:00.000000000,12
37,67,,For Ellen,1000,36,2012.0,Drama,0 days 01:33:00.000000000,30
64,56,https://resizing.flixster.com/3GVo32D6B8qWFG5InhejhzQiLBk=/206x305/v2/https://flxt.tmsimg.com/assets/p9455339_p_v10_aa.jpg,Now Is Good,2500,27,2012.0,Romance/Drama,0 days 01:43:00.000000000,-8
36,48,https://resizing.flixster.com/Zb7So2qVWh8uafcNr_vPBT07JMU=/206x305/v2/https://flxt.tmsimg.com/assets/p9744085_p_v10_aa.jpg,Welcome to the Punch,5000,56,2013.0,Crime/Action,0 days 01:39:00.000000000,12
41,67,,The Pact,10000,42,2012.0,Horror/Mystery and thriller,0 days 01:29:00.000000000,26
76,50,https://resizing.flixster.com/xsVsv_umPAR9JmXgdh1F0kMXhZc=/206x305/v2/https://flxt.tmsimg.com/assets/p9021221_p_v8_aa.jpg,Follow Me: The Yoni Netanyahu Story,100,14,2012.0,Documentary,0 days 01:27:00.000000000,-26
34,23,https://resizing.flixster.com/sV4lYSMA0P_22598q6qfS3J9UmQ=/206x305/v2/https://flxt.tmsimg.com/assets/p9024369_p_v10_ai.jpg,Paranormal Activity 4,100000,112,2012.0,Horror/Mystery and thriller,0 days 01:27:00.000000000,-11
42,28,https://resizing.flixster.com/QVtVBPX5-oQnwGRY_kl_-jv9zuM=/206x305/v2/https://flxt.tmsimg.com/assets/p9721598_p_v10_aa.jpg,Upside Down,10000,54,2012.0,Fantasy/Romance,0 days 01:47:00.000000000,-14
53,57,,"For a Good Time, Call ...",50000,109,2012.0,Comedy,0 days 01:26:00.000000000,4
55,75,https://resizing.flixster.com/uwLd3rQekH8gFgr-n7_mhhjOlaI=/206x305/v2/https://flxt.tmsimg.com/assets/p9141583_p_v10_aa.jpg,Hello I Must Be Going,2500,52,2012.0,Comedy/Drama,0 days 01:34:00.000000000,20
92,95,,Searching for Sugar Man,10000,132,2011.0,Documentary,0 days 01:26:00.000000000,3
61,84,,Excision,1000,25,2012.0,Horror,0 days 01:21:00.000000000,23
88,96,,5 Broken Cameras,1000,48,2011.0,Documentary/War,0 days 01:30:00.000000000,8
87,98,,Ai Weiwei: Never Sorry,5000,83,2012.0,Documentary,0 days 01:31:00.000000000,11
76,86,,Beasts of the Southern Wild,25000,206,2012.0,Fantasy/Drama,0 days 01:33:00.000000000,10
80,78,https://resizing.flixster.com/ulR4Y4JOVa1TYK4eR7DRF-73uR4=/206x305/v2/https://flxt.tmsimg.com/assets/p9027007_p_v10_aa.jpg,Big Boys Gone Bananas!,100,23,2011.0,Documentary/Drama,0 days 01:30:00.000000000,-2
60,82,,China Heavyweight,1000,22,2012.0,Documentary,0 days 01:34:00.000000000,22
60,89,,Compliance,10000,144,2012.0,Mystery and thriller,0 days 01:30:00.000000000,29
63,86,,Detropia,1000,42,2012.0,Documentary,0 days 01:30:00.000000000,23
92,78,,Escape Fire: The Fight to Rescue American Healthcare,500,23,2012.0,Documentary,0 days 01:39:00.000000000,-14
72,42,,Filly Brown,2500,12,2012.0,Drama,0 days 01:39:00.000000000,-30
73,90,,A Place at the Table,5000,62,2012.0,Documentary,0 days 01:24:00.000000000,17
82,98,https://resizing.flixster.com/34RXygYvAQ_5zNw-Y4aNYZX5dms=/206x305/v2/https://flxt.tmsimg.com/NowShowing/116670/116670_aa.jpg,How to Survive a Plague,5000,80,2012.0,Documentary/Drama,0 days 01:50:00.000000000,16
91,94,https://resizing.flixster.com/c166p77xqY38fxKXSEB4hRrMAIk=/206x305/v2/https://flxt.tmsimg.com/assets/p9027233_p_v8_aa.jpg,Indie Game: The Movie,2500,31,2011.0,Documentary/Drama,0 days 01:34:00.000000000,3
79,88,,The Law in These Parts,100,16,2011.0,Documentary/Drama,0 days 01:41:00.000000000,9
100,57,,Love Free or Die: How the Bishop of New Hampshire Is Changing the World,1,7,2012.0,Documentary/Gay and lesbian,0 days 01:22:00.000000000,-43
60,89,,"Madrid, 1987",100,9,2011.0,Drama,0 days 01:45:00.000000000,29
88,96,https://resizing.flixster.com/vNIz80u2rR9YC3ftMbIftQ-k9YA=/206x305/v2/https://flxt.tmsimg.com/assets/p9028241_p_v10_ab.jpg,Marina Abramovic: The Artist Is Present,2500,47,2012.0,Documentary/Drama,0 days 01:46:00.000000000,8
70,87,https://resizing.flixster.com/B-NjJ30ekhogV_o3SNkubL2EKAc=/206x305/v2/https://flxt.tmsimg.com/assets/p9028303_p_v10_aa.jpg,Mosquita y Mari,250,15,2011.0,Gay and lesbian/Drama,0 days 01:25:00.000000000,17
88,88,,The Other Dream Team,1000,32,2012.0,Documentary,0 days 01:28:00.000000000,0
61,81,https://resizing.flixster.com/hmb_lawNEEfxqXiFwAzd9-Onyy0=/206x305/v2/https://flxt.tmsimg.com/assets/p9043825_p_v8_aa.jpg,Putin's Kiss,250,16,2011.0,Documentary,0 days 01:24:00.000000000,20
36,47,,Save the Date,2500,30,2012.0,Romance/Drama,0 days 01:38:00.000000000,11
71,84,,Sleepwalk With Me,10000,117,2012.0,Comedy/Drama,0 days 01:30:00.000000000,13
80,94,https://resizing.flixster.com/biOGsWHoaT53jwjnT2cYNbof1-o=/206x305/v2/https://flxt.tmsimg.com/assets/p9035870_p_v10_aa.jpg,Teddy Bear,1000,16,2012.0,Drama,0 days 01:32:00.000000000,14
31,8,,That's What She Said,250,12,2012.0,Comedy,0 days 01:24:00.000000000,-23
38,47,https://resizing.flixster.com/4sXvzrGTen5Dwg1QCGB8gRJa2OI=/206x305/v2/https://flxt.tmsimg.com/assets/p9028747_p_v10_aa.jpg,28 Hotel Rooms,1000,15,2012.0,Drama,0 days 01:22:00.000000000,9
78,75,https://resizing.flixster.com/x9rgM63D3TEFPstXYWKKejtF3Og=/206x305/v2/https://flxt.tmsimg.com/assets/p9029277_p_v8_aa.jpg,I Am Bruce Lee,1000,12,2012.0,Documentary/Biography,0 days 01:30:00.000000000,-3
51,13,,If I Were You,500,15,2012.0,Comedy/Drama,0 days 01:55:00.000000000,-38
67,94,,Meet the Fokkens,1000,17,2011.0,Documentary/Biography,0 days 01:20:00.000000000,27
24,56,,388 Arletta Avenue,100,9,2011.0,Mystery and thriller,0 days 01:26:00.000000000,32
45,67,,Step Up to the Plate,250,27,2012.0,Documentary,0 days 01:26:00.000000000,22
15,5,https://resizing.flixster.com/44eHbbfDQEAHc3z8aN5jAsXVSeE=/206x305/v2/https://flxt.tmsimg.com/assets/p9097885_p_v8_ab.jpg,30 Beats,1000,22,2012.0,Romance,0 days 01:28:00.000000000,-10
56,93,,"Farewell, My Queen",10000,84,2012.0,Drama,0 days 01:40:00.000000000,37
54,35,https://resizing.flixster.com/lhnKLzAkgrzUWCWHCQhnQTvzo0U=/206x305/v2/https://flxt.tmsimg.com/assets/p9416734_p_v10_af.jpg,Escape From Planet Earth,25000,43,2013.0,Comedy/Sci fi,0 days 01:29:00.000000000,-19
30,50,https://resizing.flixster.com/ygkdw5KSED-AQjdGml2n8t8fq6Y=/206x305/v2/https://flxt.tmsimg.com/assets/p9100218_p_v10_aa.jpg,Transit,500,8,2012.0,Crime/Drama,0 days 01:27:00.000000000,20
86,93,,Side by Side,10000,68,2012.0,Documentary,0 days 01:38:00.000000000,7
66,64,,To the Arctic,10000,28,2012.0,Documentary,0 days 00:40:00.000000000,-2
53,7,,Battlefield America,2500,14,2012.0,Drama,0 days 01:46:00.000000000,-46
54,76,https://resizing.flixster.com/0-aIWCOyGp_7HHw0VyQeI0HRKDs=/206x305/v2/https://flxt.tmsimg.com/assets/p9140210_p_v8_ab.jpg,The Do-Deca-Pentathlon,1000,41,2012.0,Comedy,0 days 01:16:00.000000000,22
66,19,,Tyler Perry's Madea's Witness Protection,100000,37,2012.0,Comedy,0 days 01:54:00.000000000,-47
76,93,https://resizing.flixster.com/_KalmBLZr3_eqflMTgOJOjjumAg=/206x305/v2/https://flxt.tmsimg.com/assets/p9161118_p_v8_ae.jpg,Neighboring Sounds,500,41,2012.0,Drama/Mystery and thriller,0 days 02:11:00.000000000,17
28,33,,The Trouble With Bliss,1000,18,2011.0,Romance/Drama,0 days 01:37:00.000000000,5
46,36,,Stand Up Guys,10000,108,2012.0,Comedy/Drama,0 days 01:35:00.000000000,-10
37,40,https://resizing.flixster.com/a7cTCEPMLYAVUS0nH8Is3ts-quA=/206x305/v2/https://flxt.tmsimg.com/assets/p9257449_p_v10_ag.jpg,Iron Sky,10000,43,2012.0,Comedy/Sci fi,0 days 01:33:00.000000000,3
70,100,,Resident Evil: Damnation,1000,5,2012.0,Sci fi/Animation,0 days 01:40:00.000000000,30
77,100,,Vivan las Antipodas!,100,9,2011.0,Documentary,0 days 01:48:00.000000000,23
23,37,,The ABCs of Death,10000,68,2012.0,Horror,0 days 02:03:00.000000000,14
73,100,https://resizing.flixster.com/eF-Wszp0n_Vd6mLnbnRZLo4w4LU=/206x305/v2/https://flxt.tmsimg.com/assets/p9321276_p_v8_aa.jpg,Planet of Snail,1000,29,2011.0,Documentary/Drama,0 days 01:27:00.000000000,27
68,74,/assets/pizza-pie/images/poster_default.c8c896e70c3.gif,Clown,1000,53,2010.0,Comedy,0 days 01:31:00.000000000,6
28,19,,Chernobyl Diaries,100000,89,2012.0,Horror/Mystery and thriller,0 days 01:26:00.000000000,-9
40,26,https://resizing.flixster.com/SgSElAhKw8rzEsZVk9UlvXZLVj8=/206x305/v2/https://flxt.tmsimg.com/assets/p9101654_p_v10_aa.jpg,The Samaritan,5000,35,2012.0,Crime/Drama,0 days 01:33:00.000000000,-14
33,8,,A Thousand Kisses Deep,50,13,2011.0,Romance/Sci fi,0 days 01:24:00.000000000,-25
66,80,https://resizing.flixster.com/gDQ-tjUqYlKJ0sPyhNk8E1DLnrM=/206x305/v2/https://flxt.tmsimg.com/assets/p9447567_p_v13_ag.jpg,Quartet,10000,146,2012.0,Comedy/Drama,0 days 01:39:00.000000000,14
68,87,https://resizing.flixster.com/lZ-jzsrbR6C-UXsple2gWPVtW44=/206x305/v2/https://flxt.tmsimg.com/assets/p9336280_p_v10_as.jpg,Starlet,2500,45,2012.0,Drama,0 days 01:47:00.000000000,19
86,86,/assets/pizza-pie/images/poster_default.c8c896e70c3.gif,Heist: Who Stole the American Dream?,100,7,2011.0,Documentary,0 days 01:30:00.000000000,0
89,91,,Beauty Is Embarrassing,500,32,2012.0,Documentary/Comedy,0 days 01:28:00.000000000,2
87,98,,Beware of Mr. Baker,2500,53,2012.0,Documentary,0 days 01:32:00.000000000,11
32,56,,Citadel,2500,45,2012.0,Horror,0 days 01:25:00.000000000,24
41,45,https://resizing.flixster.com/BRdku1u5RS3XdajvdJuQBDVAoCE=/206x305/v2/https://flxt.tmsimg.com/assets/p9363019_p_v13_ac.jpg,"3, 2, 1... Frankie Go Boom",1000,22,2012.0,Comedy,0 days 01:29:00.000000000,4
62,90,https://resizing.flixster.com/d1NzXzIuXEcdH-0cyHWbJp7Ww3Q=/206x305/v2/https://resizing.flixster.com/CNPQloPekwjrhNEb-xfDFu1lkIY=/ems.ZW1zLXByZC1hc3NldHMvbW92aWVzLzY2OTczMDQwLTg5ZWEtNGRlNy05NDA1LTJlN2UxMWY3NTFlNS53ZWJw,Funeral Kings,1000,10,2012.0,Comedy/Drama,0 days 01:25:00.000000000,28
68,83,,Tchoupitoulas,250,18,2012.0,Documentary,0 days 01:20:00.000000000,15
36,9,,Someday This Pain Will Be Useful to You,250,11,2011.0,Drama,0 days 01:35:00.000000000,-27
95,45,https://resizing.flixster.com/gHaEYSrRW3myVoFr7lGEuL2OutM=/206x305/v2/https://flxt.tmsimg.com/assets/p9286976_p_v8_ad.jpg,Cirque du Soleil: Worlds Away,1000,47,2012.0,Fantasy/Adventure,0 days 01:27:00.000000000,-50
69,43,,Mariachi gringo,100,7,2012.0,Romance,0 days 01:47:00.000000000,-26
27,0,/assets/pizza-pie/images/poster_default.c8c896e70c3.gif,Sexual Chronicles of a French Family,250,5,2012.0,Comedy,0 days 01:17:00.000000000,-27
63,73,,Sushi: The Global Catch,100,11,2011.0,Documentary,0 days 01:15:00.000000000,10
71,77,https://resizing.flixster.com/4ceYY6jyPEVaNhOlL9_ZFRe4yVM=/206x305/v2/https://flxt.tmsimg.com/assets/p9924390_p_v10_aa.jpg,The Source Family,250,22,2012.0,Documentary/Music,0 days 01:38:00.000000000,6
53,19,,Identity Thief,100000,178,2013.0,Comedy,0 days 01:46:00.000000000,-34
22,8,https://resizing.flixster.com/jHmRHB7fPWkUFQwpKWZjigr5v5A=/206x305/v2/https://flxt.tmsimg.com/assets/p9133139_p_v10_aa.jpg,The Babymakers,2500,51,2012.0,Comedy,0 days 01:38:00.000000000,-14
44,86,/assets/pizza-pie/images/poster_default.c8c896e70c3.gif,Bestiaire,100,21,2012.0,Documentary,0 days 01:12:00.000000000,42
68,85,https://resizing.flixster.com/MDMZswSlpK5hzwTHsZ80sA7I-e8=/206x305/v2/https://flxt.tmsimg.com/assets/p9304250_p_v10_ac.jpg,Eden,2500,40,2012.0,Crime/Drama,0 days 01:38:00.000000000,17
55,90,https://resizing.flixster.com/QfvOxj3yPCyLkPFQCtkwn5e_yQ0=/206x305/v2/https://flxt.tmsimg.com/assets/p9131879_p_v8_aa.jpg,Gayby,2500,20,2012.0,Comedy/Drama,0 days 01:29:00.000000000,35
80,94,,Gregory Crewdson: Brief Encounters,500,18,2012.0,Documentary,0 days 01:17:00.000000000,14
17,5,,Nature Calls,1000,22,2012.0,Comedy,0 days 01:20:00.000000000,-12
41,30,,Small Apartments,500,10,2012.0,Crime/Comedy,0 days 01:37:00.000000000,-11
33,55,,Thale,1000,11,2012.0,Fantasy/Comedy,0 days 01:17:00.000000000,22
72,45,https://resizing.flixster.com/Nv0LL7L4A8GDiAA6xq6hapomUQk=/206x305/v2/https://flxt.tmsimg.com/assets/p9131608_p_v10_aa.jpg,Waiting for Lightning,250,22,2012.0,Documentary,0 days 01:36:00.000000000,-27
86,85,https://resizing.flixster.com/vF0qvaYxC2lxFrrQEfh1tZLmCvo=/206x305/v2/https://flxt.tmsimg.com/assets/p9139569_p_v10_aa.jpg,End of Watch,50000,180,2012.0,Crime/Action,0 days 01:49:00.000000000,-1
76,67,,Game Change,1000,42,2012.0,Drama,0 days 01:58:00.000000000,-9
52,32,,Struck by Lightning,5000,34,2012.0,Comedy,0 days 01:24:00.000000000,-20
30,60,https://resizing.flixster.com/ApkTB19BFDus3smj_ftJONQOBKI=/206x305/v2/https://resizing.flixster.com/2S_z9e3D3NB8efBfqgSVrqZAnAI=/ems.ZW1zLXByZC1hc3NldHMvbW92aWVzLzc4ZWY0MGNjLWM5MWMtNDU2OC05Y2RhLWNmOWQ1YWM5ZWZlMy53ZWJw,Stella Days,100,10,2011.0,Drama,0 days 01:27:00.000000000,30
71,83,https://resizing.flixster.com/GP3JekK2cpgKFrudg0GvHV8hFzg=/206x305/v2/https://flxt.tmsimg.com/assets/p9172146_p_v13_aa.jpg,North Sea Texas,1000,29,2011.0,Gay and lesbian/Drama,0 days 01:34:00.000000000,12
46,43,,Off-White Lies,50,7,2011.0,Drama,0 days 01:26:00.000000000,-3
82,90,,A Royal Affair,10000,110,2012.0,Drama/Romance,0 days 02:17:00.000000000,8
67,50,https://resizing.flixster.com/OQXgcXVz5TXNCfJBnj99SWAoSFI=/206x305/v2/https://flxt.tmsimg.com/assets/p9198325_p_v8_aa.jpg,Bert Stern: Original Mad Man,100,20,2011.0,Documentary,0 days 01:32:00.000000000,-17
71,83,,Seven Psychopaths,100000,219,2012.0,Comedy,0 days 01:51:00.000000000,12
62,53,https://resizing.flixster.com/cRzmQhn29fOvBN8mNijm7hdbwUE=/206x305/v2/https://flxt.tmsimg.com/assets/p9099032_p_v8_ae.jpg,People Like Us,25000,120,2012.0,Drama,0 days 01:55:00.000000000,-9
71,85,,Graceland,500,26,2012.0,Crime/Drama,0 days 01:24:00.000000000,14
51,21,,Dorfman in Love,250,14,2011.0,Romance,0 days 01:35:00.000000000,-30
75,78,,The Place Beyond the Pines,50000,224,2012.0,Crime/Drama,0 days 02:20:00.000000000,3
75,79,https://resizing.flixster.com/2PzOyaCO10LqHSiGu1T7Iw_F4_o=/206x305/v2/https://flxt.tmsimg.com/assets/p9165539_p_v13_ae.jpg,Ruby Sparks,25000,181,2012.0,Romance/Fantasy,0 days 01:44:00.000000000,4
55,54,https://resizing.flixster.com/gN6ew6stjzTNoClD4NagWW1hnsI=/206x305/v2/https://flxt.tmsimg.com/assets/p9563766_p_v8_ab.jpg,The Playroom,250,24,2012.0,Drama,0 days 01:23:00.000000000,-1
34,38,,Comes a Bright Day,100,8,2012.0,Romance,0 days 01:35:00.000000000,4
77,97,,Paul Williams Still Alive,500,32,2011.0,Documentary/Comedy,0 days 01:24:00.000000000,20
59,55,https://resizing.flixster.com/6LYlpf_yU5d95XKo59SmRr2lv88=/206x305/v2/https://flxt.tmsimg.com/assets/p9503710_p_v7_aa.jpg,Decoding Deepak,100,11,2012.0,Documentary,0 days 01:23:00.000000000,-4
62,29,,The Magic of Belle Isle,2500,34,2012.0,Drama/Comedy,0 days 01:49:00.000000000,-33
78,62,/assets/pizza-pie/images/poster_default.c8c896e70c3.gif,Secret of the Wings,1000,21,2012.0,,,-16
65,70,,The Giant Mechanical Man,1000,23,2012.0,Romance,0 days 01:34:00.000000000,5
36,59,https://resizing.flixster.com/vSQsvM1AXyxCqTI4FBr0s_ELG0o=/206x305/v2/https://flxt.tmsimg.com/assets/p9712918_p_v8_aa.jpg,Would You Rather,2500,22,2012.0,Horror/Mystery and thriller,0 days 01:33:00.000000000,23
80,82,,Rust and Bone,10000,165,2012.0,Romance/Drama,0 days 02:02:00.000000000,2
52,58,,Eddie: The Sleepwalking Cannibal,250,19,2012.0,Comedy/Horror,0 days 01:23:00.000000000,6
85,100,https://resizing.flixster.com/0sBxOEggktdLmJiqxYLksGn7R9s=/206x305/v2/https://flxt.tmsimg.com/assets/p9178130_p_v10_aa.jpg,Booker's Place: A Mississippi Story,100,17,2012.0,Documentary/Drama,0 days 01:30:00.000000000,15
72,76,,Katy Perry: Part of Me,25000,90,2012.0,Documentary,0 days 01:34:00.000000000,4
59,83,https://resizing.flixster.com/3BMyoBQfQvr6QCSBUVEiz9z3Bxk=/206x305/v2/https://flxt.tmsimg.com/assets/p9295317_p_v10_aa.jpg,Fast Girls,1000,23,2012.0,Drama,0 days 01:31:00.000000000,24
44,46,https://resizing.flixster.com/2c7XOvYNHUeNOjBNp7CjmHRQaFw=/206x305/v2/https://flxt.tmsimg.com/assets/p9451406_p_v10_ac.jpg,The Sweeney,5000,65,2012.0,Crime/Action,0 days 01:52:00.000000000,2
23,25,,Mansome,1000,36,2012.0,Documentary,0 days 01:24:00.000000000,2
15,0,https://resizing.flixster.com/wy5Sku-QLblCkjvngOfz3-5s-Zg=/206x305/v2/https://flxt.tmsimg.com/assets/p9209842_p_v13_ad.jpg,Elfie Hopkins,100,16,2012.0,Horror/Mystery and thriller,0 days 01:29:00.000000000,-15
76,79,https://resizing.flixster.com/eLerOt3syQ2gwiDYk4RI2Vl1ayo=/206x305/v2/https://flxt.tmsimg.com/assets/p9303992_p_v10_ab.jpg,Any Day Now,5000,67,2012.0,Drama/Gay and lesbian,0 days 01:40:00.000000000,3
72,64,/assets/pizza-pie/images/poster_default.c8c896e70c3.gif,Don't Stop Believin': Everyman's Journey,500,45,2013.0,Documentary,0 days 01:45:00.000000000,-8
46,27,,21 and Over,50000,109,2013.0,Comedy,0 days 01:33:00.000000000,-19
62,41,https://resizing.flixster.com/0qROkFyNW1sWBdfMpBEur1fTqLA=/206x305/v2/https://flxt.tmsimg.com/assets/p9196201_p_v10_ab.jpg,Crooked Arrows,10000,27,2012.0,Drama,0 days 01:45:00.000000000,-21
78,78,,An Affair of the Heart,100,9,2012.0,Documentary,0 days 01:34:00.000000000,0
34,47,,Pusher,2500,49,2012.0,Crime/Drama,0 days 01:29:00.000000000,13
71,18,https://resizing.flixster.com/HX3bAFsrAlDnhOyd_xivLWoPCcA=/206x305/v2/https://flxt.tmsimg.com/assets/p9212149_p_v10_aa.jpg,Just 45 Minutes From Broadway,100,11,2012.0,Drama,0 days 01:52:00.000000000,-53
27,37,,Cheerful Weather for the Wedding,250,30,2012.0,Comedy/Drama,0 days 01:32:00.000000000,10
21,40,,Storage 24,2500,35,2012.0,Sci fi/Horror,0 days 01:27:00.000000000,19
70,81,,Side Effects,50000,223,2013.0,Drama/Mystery and thriller,0 days 01:45:00.000000000,11
35,10,,Silent Hill: Revelation,25000,60,2012.0,Fantasy/Horror,0 days 01:35:00.000000000,-25
78,60,,Speak,50,5,2011.0,Documentary/Drama,0 days 01:29:00.000000000,-18
37,34,,Deadfall,5000,82,2012.0,Crime/Drama,0 days 01:35:00.000000000,-3
85,81,,42,100000,195,2013.0,Drama/History,0 days 02:08:00.000000000,-4
72,82,,Herman's House,250,17,2011.0,Documentary,0 days 01:20:00.000000000,10
88,83,,Jason Becker: Not Dead Yet,250,24,2012.0,Documentary,0 days 01:27:00.000000000,-5
60,81,,Only the Young,250,16,2012.0,Romance/Documentary,0 days 01:08:00.000000000,21
75,92,,The Revisionaries,1000,13,2012.0,Documentary,0 days 01:24:00.000000000,17
71,92,,Holy Motors,10000,194,2012.0,Drama/Fantasy,0 days 01:56:00.000000000,21
79,100,,The World Before Her,250,7,2012.0,Documentary,0 days 01:30:00.000000000,21
53,88,,Not Suitable for Children,2500,17,2012.0,Romance,0 days 01:37:00.000000000,35
32,39,,Admission,25000,158,2013.0,Comedy/Drama,0 days 01:57:00.000000000,7
48,71,,Headshot,1000,14,2011.0,Crime/Drama,0 days 01:45:00.000000000,23
71,81,https://resizing.flixster.com/fEU2th5Uid94P3bVNobXJececxY=/206x305/v2/https://flxt.tmsimg.com/assets/p9502326_p_v10_aa.jpg,Hitler's Children,5000,16,2012.0,Documentary,0 days 01:20:00.000000000,10
46,25,,Dinotasia,500,8,2012.0,Documentary,0 days 01:23:00.000000000,-21
68,78,,Paradise: Love,500,46,2012.0,Drama,0 days 02:00:00.000000000,10
34,17,,Bringing Up Bobby,250,12,2009.0,Comedy,0 days 01:33:00.000000000,-17
9,14,https://resizing.flixster.com/aFCABGKX4pCJT2rG4VEuNIHjwuI=/206x305/v2/https://flxt.tmsimg.com/assets/p9312460_p_v8_aa.jpg,Soldiers of Fortune,2500,7,2012.0,Action/Mystery and thriller,0 days 01:34:00.000000000,5
44,50,,Grassroots,1000,30,2012.0,Comedy/Drama,0 days 01:40:00.000000000,6
37,45,,Tortoise in Love,50,11,2010.0,Comedy,0 days 01:30:00.000000000,8
38,67,,Spring Breakers,50000,195,2012.0,Crime/Comedy,0 days 01:34:00.000000000,29
33,20,https://resizing.flixster.com/nZS7elq5PsnPKWdiBA3OaWkoe9c=/206x305/v2/https://flxt.tmsimg.com/assets/p9733952_p_v8_ar.jpg,Sammy 2,250,10,2013.0,Animation/Comedy,0 days 01:28:00.000000000,-13
24,9,,Branded,2500,11,2012.0,Sci fi/Mystery and thriller,0 days 01:46:00.000000000,-15
75,77,https://resizing.flixster.com/XOnNgqWtyQertufpfXELA9O1sZM=/206x305/v2/https://flxt.tmsimg.com/assets/p9253979_p_v10_aq.jpg,Flight,100000,238,2012.0,Drama/Mystery and thriller,0 days 02:18:00.000000000,2
69,40,,Clandestine Childhood,250,10,2011.0,Drama,0 days 01:48:00.000000000,-29
40,66,https://resizing.flixster.com/8Slcs5Cc6icDqnnGccQ1_GUUxYI=/206x305/v2/https://flxt.tmsimg.com/assets/p9514347_p_v10_ab.jpg,Antiviral,5000,93,2012.0,Sci fi/Horror,0 days 01:48:00.000000000,26
86,92,https://resizing.flixster.com/ArjgO6EsHi4g-yiF6jfxBg4Pqrk=/206x305/v2/https://flxt.tmsimg.com/assets/p9451016_p_v10_aa.jpg,The Central Park Five,5000,77,2012.0,Crime/Documentary,0 days 01:59:00.000000000,6
54,68,https://resizing.flixster.com/0VwtSMxFLNVTDugbmiR9c36S5tk=/206x305/v2/https://flxt.tmsimg.com/NowShowing/122991/122991_aa.jpg,Dangerous Liaisons,500,19,2012.0,Romance/Drama,0 days 01:45:00.000000000,14
48,83,https://resizing.flixster.com/oKhnsnmnXBitk7WloP12jebOxwI=/206x305/v2/https://flxt.tmsimg.com/assets/p9452882_p_v8_aa.jpg,In Another Country,1000,29,2012.0,Drama,0 days 01:29:00.000000000,35
57,95,,Night Across the Street,250,19,2012.0,Drama,0 days 01:50:00.000000000,38
79,67,/assets/pizza-pie/images/poster_default.c8c896e70c3.gif,Method to the Madness of Jerry Lewis,50,12,2012.0,,,-12
80,93,https://resizing.flixster.com/_egn_uDOsYYubYCOFIZmzNMMSPg=/206x305/v2/https://flxt.tmsimg.com/assets/p9488602_p_v10_aa.jpg,No,10000,132,2012.0,Drama/History,0 days 01:56:00.000000000,13
49,54,https://resizing.flixster.com/0xZFs6_hNYB83nuQhbCeyUNMf5c=/206x305/v2/https://flxt.tmsimg.com/assets/p9452832_p_v13_ab.jpg,Post Tenebras Lux,1000,59,2012.0,Drama,0 days 02:00:00.000000000,5
76,91,https://resizing.flixster.com/q7acjpRg5PQoh3fqxEqIoHxJ8kY=/206x305/v2/https://flxt.tmsimg.com/assets/p9294543_p_v10_aa.jpg,The Sapphires,10000,138,2012.0,Comedy/Musical,0 days 01:43:00.000000000,15
80,97,https://resizing.flixster.com/0yux2KEuxlF-SXMuFibt8HfO4Gw=/206x305/v2/https://resizing.flixster.com/wDU0oUuFpuJiPfazdZCYdeeHrjw=/ems.ZW1zLXByZC1hc3NldHMvbW92aWVzLzdhNzA3Y2ZkLWZiMDgtNDAxMi05YzFkLTBlZWYwMDg0NTBmYi53ZWJw,Mud,50000,182,2013.0,Drama/Adventure,0 days 02:10:00.000000000,17
69,80,https://resizing.flixster.com/YXIzhYROkZK8Ym3vptkO7V75Jb8=/206x305/v2/https://flxt.tmsimg.com/assets/p9452764_p_v10_aa.jpg,Reality,1000,79,2012.0,Comedy/Drama,0 days 01:55:00.000000000,11
73,26,,2016: Obama's America,25000,34,2012.0,Documentary,0 days 01:27:00.000000000,-47
41,49,,Hemingway & Gellhorn,1000,49,2012.0,Romance/Drama,0 days 02:30:00.000000000,8
59,50,,Foreverland,50,6,2011.0,Drama,0 days 01:33:00.000000000,-9
77,87,,Trashed,250,15,2012.0,Documentary,0 days 01:38:00.000000000,10
76,94,https://resizing.flixster.com/t4F0FmgS4ePJHrz7kdRGfBpN7qY=/206x305/v2/https://flxt.tmsimg.com/assets/p9463227_p_v10_af.jpg,Lore,5000,115,2012.0,Drama/War,0 days 01:49:00.000000000,18
83,81,https://resizing.flixster.com/N8J4a34j7ZsH8ukw6RCY19s9Seo=/206x305/v2/https://flxt.tmsimg.com/assets/p9276475_p_v13_ak.jpg,Pitch Perfect,100000,154,2012.0,Romance/Comedy,0 days 01:52:00.000000000,-2
51,36,https://resizing.flixster.com/tHFkh323dHZllgPv3nhGuNH05f4=/206x305/v2/https://flxt.tmsimg.com/assets/p9738072_p_v8_aa.jpg,Family Weekend,500,22,2012.0,Comedy,0 days 01:36:00.000000000,-15
24,57,https://resizing.flixster.com/j0zPILt9nNflhwhPIJHf3PO1Bng=/206x305/v2/https://flxt.tmsimg.com/assets/p9541290_p_v10_ab.jpg,Detention of the Dead,500,7,2012.0,Comedy/Horror,0 days 01:27:00.000000000,33
83,80,,English Vinglish,2500,5,2012.0,Drama,0 days 02:13:00.000000000,-3
70,85,https://resizing.flixster.com/MDq3OVHJvoYktHFm8kGtlJ1hs28=/206x305/v2/https://flxt.tmsimg.com/assets/p9353714_p_v10_aa.jpg,The Flat,2500,33,2011.0,Documentary,0 days 01:37:00.000000000,15
76,99,https://resizing.flixster.com/rG3R5927Cr2X-wL3Rb-pYQTLDCI=/206x305/v2/https://flxt.tmsimg.com/assets/p9513003_p_v8_aa.jpg,56 Up,5000,69,2012.0,Documentary,0 days 02:23:00.000000000,23
84,94,https://resizing.flixster.com/FJKLMryVKP-u92NywpXU8pU7yGI=/206x305/v2/https://flxt.tmsimg.com/assets/p9462450_p_v10_aa.jpg,Knuckleball!,500,17,2012.0,Documentary,0 days 01:34:00.000000000,10
16,14,,Cherry,2500,21,2012.0,Drama,0 days 01:42:00.000000000,-2
74,100,https://resizing.flixster.com/OyGfF9KgrHuR_UQ-6ipOzGRcsk0=/206x305/v2/https://flxt.tmsimg.com/assets/p9296334_p_v8_aa.jpg,High Ground,250,8,2012.0,Documentary,0 days 01:31:00.000000000,26
28,25,https://resizing.flixster.com/saqw8yLPO85M9g7WxfgqinF21ZQ=/206x305/v2/https://flxt.tmsimg.com/assets/p9297766_p_v10_aa.jpg,Why Stop Now?,2500,20,2012.0,Comedy/Drama,0 days 01:27:00.000000000,-3
55,80,,Bidder 70,100,10,2012.0,Documentary,0 days 01:13:00.000000000,25
19,33,/assets/pizza-pie/images/poster_default.c8c896e70c3.gif,Liz,250,6,1979.0,Other/Drama,0 days 01:20:00.000000000,14
34,20,https://resizing.flixster.com/YEoWvTRO-yDv1vCVMpIYXA152lw=/206x305/v2/https://flxt.tmsimg.com/assets/p9431798_p_v10_av.jpg,Stolen,10000,20,2012.0,Action/Mystery and thriller,0 days 01:36:00.000000000,-14
72,94,https://resizing.flixster.com/2y7wda8bA7rfpr-Uns8TM2R_N6o=/206x305/v2/https://flxt.tmsimg.com/assets/p9304748_p_v10_aa.jpg,The Bitter Buddha,250,16,2012.0,Documentary/Comedy,0 days 01:30:00.000000000,22
63,89,,The Unspeakable Act,100,9,2012.0,Drama,0 days 01:31:00.000000000,26
36,7,,Fire With Fire,1000,15,2012.0,Crime/Action,0 days 01:37:00.000000000,-29
54,80,https://resizing.flixster.com/G0uNJs6Xls2BgquaUZ9I2BxT_Bo=/206x305/v2/https://resizing.flixster.com/f1sAmFPukE1KM6qk3m70s2PW5xs=/ems.ZW1zLXByZC1hc3NldHMvbW92aWVzLzdlZDJjMGQ3LTUwMzYtNDE4OS04ODQ4LWViYjQ4ZTkxODZkYi53ZWJw,Doomsday Book,250,5,2012.0,Drama,0 days 01:55:00.000000000,26
7,71,,Fred Won't Move Out,100,7,2012.0,Drama,0 days 01:14:00.000000000,64
66,66,,Cloud Atlas,100000,284,2012.0,Sci fi/Drama,0 days 02:52:00.000000000,0
47,41,https://resizing.flixster.com/WOKwmkVPOuz858LoN_mjxbOi8eQ=/206x305/v2/https://flxt.tmsimg.com/assets/p9512762_p_v10_ab.jpg,Dead Man Down,10000,106,2013.0,Crime/Drama,0 days 01:58:00.000000000,-6
72,38,https://resizing.flixster.com/Ev3Ua6sQTts8ZbW0zc2bF_3ulw4=/206x305/v2/https://flxt.tmsimg.com/assets/p9337129_p_v10_aa.jpg,Death by China,250,13,2012.0,Documentary,0 days 01:19:00.000000000,-34
62,6,https://resizing.flixster.com/k5mKsiuETi8h-LOZ29AFL7VtxB0=/206x305/v2/https://flxt.tmsimg.com/assets/p9359443_p_v10_ac.jpg,Nitro Circus: The Movie,5000,18,2012.0,Comedy,0 days 01:25:00.000000000,-56
38,0,,General Education,250,15,2012.0,Comedy,0 days 01:25:00.000000000,-38
70,27,,Thunderstruck,5000,11,2012.0,Fantasy/Comedy,0 days 01:33:00.000000000,-43
60,4,,Atlas Shrugged: Part 2,10000,23,2012.0,Drama,0 days 01:52:00.000000000,-56
28,47,,Bait,1000,34,2012.0,Action/Horror,0 days 01:30:00.000000000,19
64,33,https://resizing.flixster.com/g0v0zWianc9fX9ZUiZebJaMP0ig=/206x305/v2/https://flxt.tmsimg.com/assets/p9350046_p_v8_aa.jpg,Craigslist Joe,2500,6,2012.0,Documentary/Adventure,0 days 01:30:00.000000000,-31
30,17,https://resizing.flixster.com/zSpZKW2em3sLU9syXOCsu68VRMg=/206x305/v2/https://flxt.tmsimg.com/assets/p9439662_p_v8_aa.jpg,Smiley,5000,23,2012.0,Horror/Mystery and thriller,0 days 01:35:00.000000000,-13
56,83,,Painted Skin: The Resurrection,500,6,2012.0,Mystery and thriller,0 days 02:11:00.000000000,27
27,20,https://resizing.flixster.com/YCuLzT8q1eGM2KnqZEmHIJIRG_I=/206x305/v2/https://flxt.tmsimg.com/assets/p9487804_p_v10_av.jpg,Grave Encounters 2,2500,10,2012.0,Horror/Mystery and thriller,0 days 01:39:00.000000000,-7
35,44,,Bad Kids Go to Hell,2500,9,2012.0,Comedy/Mystery and thriller,0 days 01:31:00.000000000,9
87,36,,Least Among Saints,250,11,2012.0,Drama,0 days 01:45:00.000000000,-51
52,28,https://resizing.flixster.com/OUQJLe0nglEZvxqRMJgK_t7S-GU=/206x305/v2/https://flxt.tmsimg.com/assets/p9354169_p_v10_aa.jpg,Backwards,250,18,2012.0,Drama,0 days 01:29:00.000000000,-24
49,36,,The Collection,10000,50,2012.0,Horror/Mystery and thriller,0 days 01:22:00.000000000,-13
40,39,https://resizing.flixster.com/AecGaxHLGCJGdE2haj2taXpkPEc=/206x305/v2/https://flxt.tmsimg.com/assets/p9531167_p_v10_aa.jpg,Stitches,1000,23,2012.0,Comedy/Horror,0 days 01:26:00.000000000,-1
20,29,,The Dinosaur Project,500,14,2012.0,Adventure/Sci fi,0 days 01:23:00.000000000,9
60,70,https://resizing.flixster.com/mn7YYCnB5eJjNNJy-bX0RmQcyK0=/206x305/v2/https://flxt.tmsimg.com/assets/p9370815_p_v13_ae.jpg,Stoker,10000,204,2013.0,Horror/Mystery and thriller,0 days 01:38:00.000000000,10
84,81,,The Impossible,25000,202,2012.0,Drama,0 days 01:54:00.000000000,-3
70,89,https://resizing.flixster.com/OlPWHAkmxYrW_NcPawcTfAmmBRI=/206x305/v2/https://flxt.tmsimg.com/assets/p9384742_p_v10_aa.jpg,Yossi,500,45,2012.0,Gay and lesbian/Drama,0 days 01:23:00.000000000,19
60,60,,"Joshua Tree, 1951: A Portrait of James Dean",100,5,2012.0,Gay and lesbian/Drama,0 days 01:33:00.000000000,0
37,40,,Werewolf: The Beast Among Us,500,5,2012.0,Horror/Mystery and thriller,0 days 01:33:00.000000000,3
53,68,,Chained,1000,19,2012.0,Mystery and thriller,0 days 01:34:00.000000000,15
42,69,,Not Fade Away,2500,91,2012.0,Drama,0 days 01:52:00.000000000,27
14,40,,Under the Bed,500,10,2012.0,Horror,0 days 01:28:00.000000000,26
82,89,,London: The Modern Babylon,100,9,2012.0,Documentary,0 days 02:05:00.000000000,7
41,75,,Errors of the Human Body,500,12,2012.0,Drama/Mystery and thriller,0 days 01:41:00.000000000,34
29,57,https://resizing.flixster.com/XakjRK2A6HUortlhzG2idpQDpAM=/206x305/v2/https://flxt.tmsimg.com/assets/p9504063_p_v8_ai.jpg,Bigfoot: The Lost Coast Tapes,250,7,2012.0,Horror/Mystery and thriller,0 days 01:27:00.000000000,28
93,100,https://resizing.flixster.com/SkwA4J3dZuDqpnErmfPtiTKfNNU=/206x305/v2/https://flxt.tmsimg.com/assets/p9410706_p_v10_ac.jpg,"Batman: The Dark Knight Returns, Part 1",5000,5,2012.0,Action/Animation,0 days 01:16:00.000000000,7
70,86,,Storm Surfers,500,21,2012.0,Documentary,0 days 01:35:00.000000000,16
40,7,https://resizing.flixster.com/X4lMeytvz9ccEZkzyevC01I1PBA=/206x305/v2/https://flxt.tmsimg.com/assets/p9211166_p_v10_aa.jpg,The Big Wedding,25000,112,2013.0,Romance,0 days 01:30:00.000000000,-33
41,70,https://resizing.flixster.com/18AwXMT9XB6bIrvDaTFFtExYwvA=/206x305/v2/https://flxt.tmsimg.com/assets/p9298472_p_v8_ab.jpg,The Girl,500,44,2012.0,Drama/Biography,0 days 01:31:00.000000000,29
26,17,,Inescapable,250,23,2012.0,Mystery and thriller,0 days 01:33:00.000000000,-9
15,14,https://resizing.flixster.com/kM6Ol5ZW1gRO3LooGxu5NsUMWIc=/206x305/v2/https://flxt.tmsimg.com/assets/p9393536_p_v10_aa.jpg,Excuse Me for Living,100,7,2012.0,Romance,0 days 01:47:00.000000000,-1
80,73,/assets/pizza-pie/images/poster_default.c8c896e70c3.gif,Toys in the Attic,500,15,2009.0,Fantasy/Animation,0 days 01:16:00.000000000,-7
55,63,,Mama,100000,166,2013.0,Horror/Mystery and thriller,0 days 01:40:00.000000000,8
82,100,,A Whisper to a Roar,100,5,2012.0,Documentary,0 days 01:34:00.000000000,18
52,60,,Tai Chi Zero,2500,30,2012.0,Action/Sports and fitness,0 days 01:40:00.000000000,8
34,56,,Universal Soldier: Day of Reckoning,5000,52,2012.0,Action/Sci fi,0 days 01:53:00.000000000,22
78,79,,The Other Son,5000,52,2012.0,Drama,0 days 01:45:00.000000000,1
15,20,,Outpost: Black Sun,100,5,2011.0,Action/Horror,0 days 01:38:00.000000000,5
52,60,,American Mary,2500,50,2012.0,Horror/Mystery and thriller,0 days 01:43:00.000000000,8
52,100,,Dead Sushi,100,7,2012.0,Comedy/Horror,0 days 01:31:00.000000000,48
37,47,,Tower Block,250,17,2012.0,Mystery and thriller,0 days 01:30:00.000000000,10
71,76,https://resizing.flixster.com/_lI45ZsEMqSKVzjyCRD0-KB55gU=/206x305/v2/https://flxt.tmsimg.com/assets/p9452007_p_v13_an.jpg,A Late Quartet,5000,113,2012.0,Drama,0 days 01:45:00.000000000,5
43,25,,Zambezia,500,8,2012.0,Animation/Comedy,0 days 01:23:00.000000000,-18
71,67,,The Thieves,1000,12,2012.0,Crime/Action,0 days 02:16:00.000000000,-4
30,22,,Truth or Die,250,9,2012.0,Horror/Mystery and thriller,0 days 01:32:00.000000000,-8
27,25,https://resizing.flixster.com/oQT46dJob8TJVR3mzJ6bLXtXUEw=/206x305/v2/https://flxt.tmsimg.com/assets/p8890194_p_v10_aw.jpg,The Kill Hole,50,8,2012.0,Action/Mystery and thriller,0 days 01:31:00.000000000,-2
46,53,,Promised Land,10000,154,2012.0,Drama,0 days 01:46:00.000000000,7
67,89,/assets/pizza-pie/images/poster_default.c8c896e70c3.gif,As Long As I Live,5000,18,2012.0,Romance/Drama,0 days 02:56:00.000000000,22
36,8,,A Dark Truth,1000,13,2012.0,Mystery and thriller,0 days 01:46:00.000000000,-28
55,44,https://resizing.flixster.com/oHLPunTWSJZ7DmeNamcnso3X97s=/206x305/v2/https://flxt.tmsimg.com/assets/p9586912_p_v10_aa.jpg,Mental,1000,55,2012.0,Comedy/Drama,0 days 01:56:00.000000000,-11
51,31,,The Brass Teapot,2500,32,2012.0,Fantasy/Comedy,0 days 01:41:00.000000000,-20
50,78,https://resizing.flixster.com/_If8FDBxrxISyK13UJXbuOXNHCI=/206x305/v2/https://flxt.tmsimg.com/assets/p9462753_p_v10_ac.jpg,Ginger & Rosa,5000,114,2012.0,Gay and lesbian/Drama,0 days 01:30:00.000000000,28
77,81,,Kon-Tiki,10000,80,2012.0,Drama/Adventure,0 days 01:58:00.000000000,4
72,73,https://resizing.flixster.com/-p4NM0whgnaI21E8HmQHMQCnI9w=/206x305/v2/https://flxt.tmsimg.com/assets/p9521748_p_v8_am.jpg,Pieta,2500,56,2012.0,Drama/Mystery and thriller,0 days 01:43:00.000000000,1
63,86,,Supporting Characters,500,7,2012.0,Comedy,0 days 01:27:00.000000000,23
52,60,,Vanishing Waves,250,10,2012.0,Romance/Sci fi,0 days 02:04:00.000000000,8
78,75,/assets/pizza-pie/images/poster_default.c8c896e70c3.gif,Hellbound?,250,8,2012.0,Documentary,0 days 01:25:00.000000000,-3
83,93,https://resizing.flixster.com/BZHA2HwudVv4bI4tEF3WgTOhC20=/206x305/v2/https://flxt.tmsimg.com/assets/p9812708_p_v8_ab.jpg,Free Angela and All Political Prisoners,250,15,2012.0,Documentary,0 days 01:41:00.000000000,10
64,64,https://resizing.flixster.com/YikN5xlk9DO7p1v-uU7dLYDeLDs=/206x305/v2/https://flxt.tmsimg.com/assets/p10004413_p_v10_aa.jpg,Iceberg Slim: Portrait of a Pimp,100,14,2012.0,Documentary/Biography,0 days 01:29:00.000000000,0
84,100,,A Werewolf Boy,2500,5,2012.0,Romance/Sci fi,0 days 02:02:00.000000000,16
79,94,https://resizing.flixster.com/E0j5341ZntVTMdfMjuJk9pYTLKQ=/206x305/v2/https://flxt.tmsimg.com/assets/p9402654_p_v13_ar.jpg,The Gatekeepers,10000,112,2012.0,Documentary,0 days 01:36:00.000000000,15
58,50,,The Lesser Blessed,50,6,2012.0,Drama,0 days 01:26:00.000000000,-8
53,71,,My Awkward Sexual Adventure,500,7,2012.0,Comedy,0 days 01:39:00.000000000,18
46,44,https://resizing.flixster.com/-vYs_xYJWKwRn8Jbd5nybHILJPQ=/206x305/v2/https://flxt.tmsimg.com/assets/p9451064_p_v8_ab.jpg,A Liar's Autobiography - The Untrue Story of Monty Python's Graham Chapman,250,50,2012.0,Comedy/Animation,0 days 01:25:00.000000000,-2
24,39,https://resizing.flixster.com/MVJd1YWxswadRe3L5mskzcUzrg8=/206x305/v2/https://flxt.tmsimg.com/assets/p9891233_p_v13_ad.jpg,Aftershock,5000,56,2012.0,Horror/Mystery and thriller,0 days 01:29:00.000000000,15
35,28,,The Expatriate,10000,46,2012.0,Action/Mystery and thriller,0 days 01:44:00.000000000,-7
62,80,,Picture Day,100,5,2012.0,Comedy/Drama,0 days 01:33:00.000000000,18
41,28,,Reincarnated,250,29,2012.0,Documentary/Music,0 days 01:36:00.000000000,-13
61,57,,The Reluctant Fundamentalist,5000,99,2012.0,Drama,0 days 02:08:00.000000000,-4
44,50,https://resizing.flixster.com/1p6sQjDbyKZcmeCmsEd-GUrledA=/206x305/v2/https://flxt.tmsimg.com/assets/p9522594_p_v10_aa.jpg,Sushi Girl,500,6,2012.0,Crime/Drama,0 days 01:38:00.000000000,6
80,87,https://resizing.flixster.com/W4rgNB3xvcWtdnk5gNijCyiFbug=/206x305/v2/https://flxt.tmsimg.com/assets/p9449010_p_v13_ac.jpg,What Maisie Knew,10000,112,2012.0,Drama,0 days 01:38:00.000000000,7
51,46,https://resizing.flixster.com/Sd9aCuC338z4wuXWrkDedfLlC54=/206x305/v2/https://flxt.tmsimg.com/assets/p9451162_p_v13_ae.jpg,Zaytoun,250,39,2012.0,Drama,0 days 01:47:00.000000000,-5
69,75,https://resizing.flixster.com/2gs1A8pKQS4vgqrTwXY4B82Ftlc=/206x305/v2/https://flxt.tmsimg.com/assets/p9777387_p_v10_aa.jpg,Venus and Serena,1000,32,2012.0,Documentary/Biography,0 days 01:40:00.000000000,6
37,47,https://resizing.flixster.com/6pDvgteHbQH0IHqDWGezdlM_nSs=/206x305/v2/https://flxt.tmsimg.com/assets/p9463230_p_v10_ab.jpg,To the Wonder,5000,177,2012.0,Romance/Drama,0 days 01:52:00.000000000,10
31,51,,At Any Price,5000,104,2012.0,Drama,0 days 01:45:00.000000000,20
23,48,,Come Out and Play,500,21,2012.0,Horror,0 days 01:26:00.000000000,25
42,48,,No One Lives,2500,40,2012.0,Horror/Mystery and thriller,0 days 01:26:00.000000000,6
72,80,https://resizing.flixster.com/TNK2rIHMxtDr_BSsmlr1YRV5z_Q=/206x305/v2/https://flxt.tmsimg.com/assets/p9665305_p_v10_aa.jpg,No Place on Earth,500,41,2012.0,Documentary,0 days 01:24:00.000000000,8
63,94,,The Deep,250,31,2012.0,Drama,0 days 01:33:00.000000000,31
46,32,,Emperor,5000,91,2012.0,Drama/History,0 days 01:46:00.000000000,-14
22,0,https://resizing.flixster.com/in4myIH8gsudqV5EkW08eFWDkTc=/206x305/v2/https://flxt.tmsimg.com/assets/p9836870_p_v10_ab.jpg,Generation Um...,500,15,2012.0,Drama,0 days 01:36:00.000000000,-22
67,45,,Into the White,1000,11,2012.0,Action/Drama,0 days 01:40:00.000000000,-22
89,100,,Masquerade,1000,9,2012.0,Drama/History,0 days 02:11:00.000000000,11
33,25,,Phantom,5000,56,2013.0,Mystery and thriller,0 days 01:38:00.000000000,-8
44,0,,Gottfried Helnwein & the Dreaming Child,1000,6,2011.0,Documentary,0 days 01:10:00.000000000,-44
25,50,,Gut,100,10,2012.0,Horror/Mystery and thriller,0 days 01:30:00.000000000,25
61,57,,Snitch,50000,150,2013.0,Drama/Crime,0 days 01:52:00.000000000,-4
60,60,,Hitchcock,25000,217,2012.0,Drama/History,0 days 01:38:00.000000000,0
51,9,,A Haunted House,50000,53,2013.0,Comedy/Horror,0 days 01:26:00.000000000,-42
70,80,,Orchestra of Exiles,250,10,2012.0,Documentary,0 days 01:25:00.000000000,10
78,100,,The Central Park Effect,250,11,2012.0,Documentary,0 days 01:00:00.000000000,22
26,16,,A Glimpse Inside the Mind of Charles Swan III,2500,56,2012.0,Comedy/Drama,0 days 01:25:00.000000000,-10
49,41,,Dark Skies,25000,93,2013.0,Horror/Sci fi,0 days 01:37:00.000000000,-8
49,74,https://resizing.flixster.com/XoBbMwU_ULZyP_KdXnqoXCnPA3A=/206x305/v2/https://flxt.tmsimg.com/assets/p9497997_p_v10_aa.jpg,Dead Man's Burden,250,19,2012.0,Western,0 days 01:33:00.000000000,25
61,45,,Little Red Wagon,100,11,2012.0,Drama,0 days 01:44:00.000000000,-16
57,27,,Craptastic!,100,11,2011.0,Documentary,0 days 01:29:00.000000000,-30
70,67,,The Zen of Bennett,100,9,2012.0,Documentary,0 days 01:27:00.000000000,-3
85,89,,Crossfire Hurricane,250,27,2012.0,Documentary/Music,0 days 01:51:00.000000000,4
39,70,,My Amityville Horror,1000,27,2012.0,Documentary/Horror,0 days 01:29:00.000000000,31
33,38,,The Incredible Burt Wonderstone,50000,196,2013.0,Comedy,0 days 01:40:00.000000000,5
43,60,,Arcadia,50,5,2012.0,Drama,0 days 01:30:00.000000000,17
85,94,,A Band Called Death,5000,52,2012.0,Documentary/Music,0 days 01:38:00.000000000,9
38,60,,Kiss of the Damned,2500,35,2012.0,Horror,0 days 01:36:00.000000000,22
78,83,,The Story of Luke,500,6,2012.0,Comedy/Drama,0 days 01:35:00.000000000,5
36,20,,Delhi Safari,250,15,2012.0,Animation/Comedy,0 days 01:36:00.000000000,-16
27,36,/assets/pizza-pie/images/poster_default.c8c896e70c3.gif,Code Name: Geronimo,100,11,2012.0,,,9
92,0,/assets/pizza-pie/images/poster_default.c8c896e70c3.gif,Hating Breitbart,500,9,2012.0,Documentary,0 days 01:25:00.000000000,-92
41,29,,Allegiance,250,14,2012.0,Drama/Mystery and thriller,0 days 01:31:00.000000000,-12
55,93,,Future Weather,250,14,2012.0,Drama,0 days 01:40:00.000000000,38
45,50,,SEAL Team Six: The Raid on Osama bin Laden,500,6,2012.0,Action/Drama,0 days 01:30:00.000000000,5
32,64,,Silent Night,1000,11,2012.0,Horror/Mystery and thriller,0 days 01:34:00.000000000,32
64,81,,Talaash: The Answer Lies Within,1000,21,2012.0,Mystery and thriller,0 days 02:19:00.000000000,17
48,45,https://resizing.flixster.com/oCXq7pvrwUNzIOarSqaK6oCFCfw=/206x305/v2/https://flxt.tmsimg.com/assets/p9880473_p_v10_al.jpg,Tai Chi Hero,500,11,2012.0,Action/Adventure,0 days 01:43:00.000000000,-3
66,49,,Olympus Has Fallen,100000,198,2013.0,Action/Mystery and thriller,0 days 02:00:00.000000000,-17
93,80,,Honor Flight,100,5,2012.0,War/Documentary,0 days 01:22:00.000000000,-13
68,100,,The Fruit Hunters,100,7,2012.0,Documentary,0 days 01:35:00.000000000,32
39,57,https://resizing.flixster.com/M6reF8KBQalFH66ggUGg1rXZ8bk=/206x305/v2/https://flxt.tmsimg.com/assets/p9987049_p_v8_aa.jpg,Hatchet III,1000,23,2013.0,Horror,0 days 01:21:00.000000000,18
68,40,https://resizing.flixster.com/zUPuo5Wli5fNCTOOXux9P6MtGBM=/206x305/v2/https://flxt.tmsimg.com/assets/p9357497_p_v8_aa.jpg,The Man Who Shook the Hand of Vicente Fernandez,100,5,2012.0,Comedy/Drama,0 days 01:39:00.000000000,-28
76,50,,Between Us,1,10,2012.0,Comedy/Drama,0 days 01:30:00.000000000,-26
35,61,,The Liability,250,18,2012.0,Action/Mystery and thriller,0 days 01:22:00.000000000,26
45,50,https://resizing.flixster.com/Xv5kL3Ifks2BoOtUzbl1pVm4Ers=/206x305/v2/https://flxt.tmsimg.com/assets/p9620132_p_v10_aa.jpg,Death Race 3: Inferno,1000,6,2012.0,Action/Mystery and thriller,0 days 01:45:00.000000000,5
89,50,,Mumia: Long Distance Revolutionary,250,18,2012.0,Documentary/Drama,0 days 02:00:00.000000000,-39
26,15,,The Last Exorcism Part II,10000,72,2013.0,Horror/Mystery and thriller,0 days 01:29:00.000000000,-11
30,68,,Magic Magic,2500,41,2013.0,Mystery and thriller,0 days 01:37:00.000000000,38
62,36,,Back to 1942,500,11,2012.0,Drama/History,0 days 02:26:00.000000000,-26
44,33,https://resizing.flixster.com/VL6r7jBd-I61hs5-1XsTK5_LZJE=/206x305/v2/https://flxt.tmsimg.com/assets/p9598351_p_v8_ab.jpg,Matru Ki Bijlee Ka Mandola,250,9,2013.0,Romance,0 days 02:27:00.000000000,-11
36,18,/assets/pizza-pie/images/poster_default.c8c896e70c3.gif,Hustlers,1000,17,2013.0,,,-18
69,86,,Upstream Color,10000,148,2013.0,Drama,0 days 01:36:00.000000000,17
16,14,,The Guillotines,250,14,2012.0,Action/Drama,0 days 01:52:00.000000000,-2
76,90,,Koch,250,42,2012.0,Documentary/Biography,0 days 01:38:00.000000000,14
73,75,https://resizing.flixster.com/mctbXiEoTFUm_c9Pj6u_YWv6f5I=/206x305/v2/https://flxt.tmsimg.com/assets/p9786711_p_v10_aa.jpg,Andre Gregory: Before and After Dinner,100,24,2013.0,Documentary,0 days 01:48:00.000000000,2
58,29,,The Tower,250,7,2012.0,Action/Mystery and thriller,0 days 02:01:00.000000000,-29
44,19,,The Haunting in Connecticut 2: Ghosts of Georgia,10000,16,2013.0,Horror,0 days 01:41:00.000000000,-25
26,28,https://resizing.flixster.com/QIXZfVKyy1yt5pqHTKrvV0xD6t4=/206x305/v2/https://flxt.tmsimg.com/assets/p9488233_p_v13_ad.jpg,Knife Fight,250,18,2012.0,Drama,0 days 01:39:00.000000000,2
39,13,,Love and Honor,2500,15,2012.0,Drama,0 days 01:36:00.000000000,-26
4,7,https://resizing.flixster.com/08SHv3j-QJZHxxjYAyZrWpRxv68=/206x305/v2/https://flxt.tmsimg.com/assets/p9793351_p_v10_aa.jpg,Tomorrow You're Gone,100,14,2012.0,Mystery and thriller,0 days 01:31:00.000000000,3
69,71,https://resizing.flixster.com/v7HWoy801FD5UCgVsSpZ7MZzW3s=/206x305/v2/https://flxt.tmsimg.com/assets/p9732633_p_v8_aa.jpg,Hansel & Gretel Get Baked,1000,7,2013.0,Comedy/Horror,0 days 01:27:00.000000000,2
31,30,https://resizing.flixster.com/jjzP1srmPKIpk5RaKZj2_ynqpE0=/206x305/v2/https://flxt.tmsimg.com/assets/p9692872_p_v10_aa.jpg,The Numbers Station,5000,27,2013.0,Action/Mystery and thriller,0 days 01:29:00.000000000,-1
65,44,,The Call,50000,133,2013.0,Mystery and thriller,0 days 01:36:00.000000000,-21
35,33,,The Rambler,100,12,2013.0,Horror/Comedy,0 days 01:39:00.000000000,-2
38,50,,The Power of Few,500,8,2013.0,Crime/Drama,0 days 01:35:00.000000000,12
48,15,https://resizing.flixster.com/YGlwsifvbCJQ6DNqhXXyL_e8brE=/206x305/v2/https://flxt.tmsimg.com/assets/p9901788_p_v13_ae.jpg,Baggage Claim,10000,84,2013.0,Romance,0 days 01:36:00.000000000,-33
64,0,,The Condemned,100,9,2012.0,Mystery and thriller,0 days 01:44:00.000000000,-64
11,11,,Spiders,250,9,2013.0,Horror/Mystery and thriller,0 days 01:29:00.000000000,0
43,53,https://resizing.flixster.com/WAAdTJEfZDItLBFZ8sfXBqmM8Eg=/206x305/v2/https://flxt.tmsimg.com/assets/p9575468_p_v10_aa.jpg,The Girl,250,19,2012.0,Drama,0 days 01:35:00.000000000,10
86,63,,New World,1000,16,2013.0,Mystery and thriller,0 days 02:14:00.000000000,-23
84,50,,Not Today,500,6,2012.0,Drama,0 days 01:58:00.000000000,-34
31,23,,Vehicle 19,5000,26,2013.0,Action/Mystery and thriller,0 days 01:25:00.000000000,-8
31,41,,The English Teacher,2500,37,2013.0,Comedy/Drama,0 days 01:31:00.000000000,10
42,49,,Scatter My Ashes at Bergdorf's,500,47,2013.0,Documentary,0 days 01:33:00.000000000,7
33,31,https://resizing.flixster.com/uMaA7lC7K52gI-PFvJ9UsS0OKFU=/206x305/v2/https://flxt.tmsimg.com/assets/p9907125_p_v10_ab.jpg,Aroused,500,13,2013.0,Documentary,0 days 01:13:00.000000000,-2
18,0,https://resizing.flixster.com/iR4uTx92uOlhCA1OUxKBom4oRjE=/206x305/v2/https://flxt.tmsimg.com/assets/p9932791_p_v10_aa.jpg,Once Upon a Time in Brooklyn,100,6,2013.0,Crime/Drama,0 days 01:56:00.000000000,-18
9,0,https://resizing.flixster.com/sxsyePcYXbVQKIitzSFzP8DkcuY=/206x305/v2/https://flxt.tmsimg.com/assets/p9966413_p_v10_bb.jpg,Stranded,1000,15,2013.0,Sci fi/Horror,0 days 01:25:00.000000000,-9
64,57,https://resizing.flixster.com/3twNrfhYU7HIp7rUHGbn0TDb02E=/206x305/v2/https://flxt.tmsimg.com/assets/p9992744_p_v10_ac.jpg,Yeh Jawaani Hai Deewani,2500,7,2013.0,Romance,0 days 02:40:00.000000000,-7
75,100,,Superman: Unbound,2500,5,2013.0,Animation/Action,0 days 01:15:00.000000000,25
62,0,,How Sweet It Is,1,6,2013.0,Musical,0 days 01:44:00.000000000,-62
64,26,https://resizing.flixster.com/FbC2JSIJN7O6wrmsqTe3rCMpock=/206x305/v2/https://flxt.tmsimg.com/assets/p9903034_p_v10_aa.jpg,Rushlights,250,19,2012.0,Crime/Romance,0 days 01:36:00.000000000,-38
34,36,,The Hot Flashes,500,25,2013.0,Comedy,0 days 01:39:00.000000000,2
28,6,,Evidence,500,17,2013.0,Mystery and thriller,0 days 01:33:00.000000000,-22
42,25,,Assault on Wall Street,1000,8,2012.0,Action/Mystery and thriller,0 days 01:37:00.000000000,-17
31,80,https://resizing.flixster.com/4_5DM8omby-J3mvocWNb-Cp5a3M=/206x305/v2/https://flxt.tmsimg.com/assets/p9917558_p_v10_ab.jpg,Ek Thi Daayan,250,5,2013.0,Romance/Horror,0 days 02:13:00.000000000,49
69,60,https://resizing.flixster.com/zSHdavX-rd1WuFxswpmVkRcresY=/206x305/v2/https://flxt.tmsimg.com/assets/p9976883_p_v13_aa.jpg,War on Whistleblowers: Free Press and the National Security State,1,5,2013.0,Documentary,0 days 01:07:00.000000000,-9
29,24,,Rapture-Palooza,1000,21,2013.0,Comedy/Fantasy,0 days 01:24:00.000000000,-5
85,89,https://resizing.flixster.com/OywtQvcQ-2NAGsuE4b8RXu7BPaU=/206x305/v2/https://flxt.tmsimg.com/assets/p10102199_p_v10_af.jpg,Blue Is the Warmest Color,10000,198,2013.0,Romance/Gay and lesbian,0 days 02:55:00.000000000,4
82,80,,From the Head,50,5,2012.0,Drama,0 days 01:35:00.000000000,-2
42,33,,Ring of Fire,50,9,2013.0,Romance/Drama,0 days 01:30:00.000000000,-9
72,86,https://resizing.flixster.com/va-x1xMDRLRP0CEPKznPrvlT3Fo=/206x305/v2/https://flxt.tmsimg.com/assets/p9835045_p_v8_ab.jpg,Teen Beach Movie,2500,7,2013.0,Romance/Comedy,0 days 01:30:00.000000000,14
29,22,,Absence,100,9,2013.0,Mystery and thriller,0 days 01:22:00.000000000,-7
93,100,,Justice League: The Flashpoint Paradox,5000,5,2013.0,Animation/Action,0 days 01:15:00.000000000,7
20,29,,Ghost Shark,100,7,2013.0,Horror/Mystery and thriller,0 days 01:30:00.000000000,9
80,93,,Lady and the Tramp,250000,42,1955.0,Fantasy/Kids and family,0 days 01:15:00.000000000,13
84,95,/assets/pizza-pie/images/poster_default.c8c896e70c3.gif,Yellow Submarine,25000,60,1968.0,Animation/Comedy,0 days 01:25:00.000000000,11
70,38,,Amazing Grace and Chuck,1000,8,1987.0,Drama,0 days 01:56:00.000000000,-32
81,80,,Forbidden Zone,5000,10,1980.0,Comedy,0 days 01:16:00.000000000,-1
49,11,,Dead Heat,5000,9,1988.0,Action/Horror,0 days 01:28:00.000000000,-38
89,93,,A Better Tomorrow,10000,14,1986.0,Crime/Drama,0 days 01:31:00.000000000,4
79,93,https://resizing.flixster.com/EZdr-99xi8wPcaMAoIW7ySftIFM=/206x305/v2/https://flxt.tmsimg.com/assets/p5240_p_v10_aa.jpg,Wings,2500,59,1927.0,History/War,0 days 02:19:00.000000000,14
69,89,,Titanic,250000,193,1997.0,Romance/Drama,0 days 03:15:00.000000000,20
34,38,,Godzilla vs. Megalon,5000,8,1976.0,Sci fi,0 days 01:20:00.000000000,4
89,88,https://resizing.flixster.com/CxReZqifxePqJ-6-7i5dOWx177g=/206x305/v2/https://flxt.tmsimg.com/NowShowing/26615/26615_aa.jpg,Battle Royale,50000,48,2000.0,Action/Mystery and thriller,0 days 01:54:00.000000000,-1
60,36,,95 Miles to Go,1000,22,2004.0,Documentary/Comedy,0 days 01:17:00.000000000,-24
45,63,,Track 29,1000,8,1988.0,Comedy,0 days 01:26:00.000000000,18
92,78,,The Moment of Truth,250,9,1965.0,Drama,0 days 01:50:00.000000000,-14
60,60,,Big Shots,1000,5,1987.0,Adventure,0 days 01:28:00.000000000,0
88,83,,Hamilton,250,6,2006.0,Drama,0 days 01:05:00.000000000,-5
90,100,,The Phantom Carriage,1000,15,1921.0,Horror,0 days 01:33:00.000000000,10
87,90,,Show People,500,10,1928.0,Comedy,0 days 01:22:00.000000000,3
39,40,,No Blade of Grass,250,5,1970.0,Sci fi,0 days 01:37:00.000000000,1
88,100,,Maytime,250,5,1937.0,Musical,0 days 02:12:00.000000000,12
74,80,,Twilight's Last Gleaming,500,10,1977.0,Mystery and thriller,0 days 02:26:00.000000000,6
81,81,,Quill: The Life of a Guide Dog,2500,21,2004.0,Drama,0 days 01:40:00.000000000,0
52,50,https://resizing.flixster.com/dZ58u6ifVu-dfwRFsukWTl36TkI=/206x305/v2/https://flxt.tmsimg.com/assets/p36635_p_v8_aa.jpg,Fanny by Gaslight,250,6,1944.0,Drama,0 days 01:48:00.000000000,-2
88,96,,On the Bowery,250,24,1956.0,Documentary,0 days 01:05:00.000000000,8
78,92,/assets/pizza-pie/images/poster_default.c8c896e70c3.gif,"I'm a Cyborg, but That's OK",10000,12,2006.0,Romance/Comedy,0 days 01:45:00.000000000,14
59,30,https://resizing.flixster.com/NKii0bQx_78Ff3lZQL0WJwI4xmk=/206x305/v2/https://flxt.tmsimg.com/assets/p60_p_v8_aa.jpg,The Brothers Karamazov,500,10,1958.0,Drama,0 days 02:26:00.000000000,-29
62,86,https://resizing.flixster.com/GBZM0DHBgfnvrFiKRp1tut5CYpo=/206x305/v2/https://flxt.tmsimg.com/assets/p5709_p_v10_aa.jpg,Dangerous,500,7,1935.0,Drama,0 days 01:18:00.000000000,24
70,100,,The Sky Turns,250,13,2004.0,Documentary,0 days 01:55:00.000000000,30
82,69,,Lonesome,250,13,1928.0,Romance/Comedy,0 days 01:09:00.000000000,-13
80,83,https://resizing.flixster.com/p6xO2qa0--KUzfQNuTTIjoIDMgM=/206x305/v2/https://flxt.tmsimg.com/assets/p176436_p_v8_aa.jpg,All in This Tea,250,12,2007.0,Documentary,0 days 01:10:00.000000000,3
23,62,,"Drive, He Said",100,13,1971.0,Drama,0 days 01:30:00.000000000,39
72,100,https://resizing.flixster.com/fjipdeD9uuA7vlYPbu4NU4avilg=/206x305/v2/https://flxt.tmsimg.com/assets/p4584_p_v8_aa.jpg,The Spy in Black,250,13,1939.0,War,0 days 01:22:00.000000000,28
68,100,,Northwest Passage,500,6,1940.0,Adventure,0 days 02:06:00.000000000,32
61,86,https://resizing.flixster.com/vQiubuDTPFOR1ZUHazjHkTWOecM=/206x305/v2/https://flxt.tmsimg.com/assets/p12205_p_v10_aa.jpg,The Fugitive,500,7,1947.0,Drama,0 days 01:44:00.000000000,25
45,20,,Lost Horizon,250,5,1973.0,Musical,0 days 02:23:00.000000000,-25
44,21,,The Smurfs,50000,119,2011.0,Fantasy/Comedy,0 days 01:42:00.000000000,-23
53,64,https://resizing.flixster.com/Y3wPPKfI5iu79LHDiStUswozSbQ=/206x305/v2/https://flxt.tmsimg.com/assets/p3582_p_v8_aa.jpg,PT 109,250,11,1963.0,Biography,0 days 02:20:00.000000000,11
85,95,,Kuroneko,500,22,1968.0,Fantasy/Horror,0 days 01:39:00.000000000,10
22,0,,The Awakening,250,5,1980.0,Horror,0 days 01:42:00.000000000,-22
69,57,,Simon,100,7,1980.0,Comedy,0 days 01:37:00.000000000,-12
75,100,,Handsome Serge,500,9,1958.0,Drama,0 days 01:33:00.000000000,25
45,26,https://resizing.flixster.com/7BdTftWR8AwDfg4CPS1L6LWZNwQ=/206x305/v2/https://flxt.tmsimg.com/assets/p8176346_p_v10_ag.jpg,Green Lantern,100000,246,2011.0,Fantasy/Action,0 days 01:54:00.000000000,-19
49,53,https://resizing.flixster.com/Duu0AvoYbQOUJUZW9whJMyvyaMo=/206x305/v2/https://flxt.tmsimg.com/assets/p7991536_p_v8_aa.jpg,Largo Winch,2500,19,2008.0,Mystery and thriller/Adventure,0 days 01:48:00.000000000,4
75,79,,Beautiful Darling,250,14,2010.0,Documentary,0 days 01:25:00.000000000,4
73,83,,Rose Marie,250,6,1936.0,Musical,0 days 01:50:00.000000000,10
58,67,,Never Apologize,100,12,2007.0,Documentary,0 days 01:51:00.000000000,9
43,100,,Elephant Boy,100,11,1937.0,Drama/Adventure,0 days 01:20:00.000000000,57
43,40,,The Last Run,100,5,1971.0,Crime/Drama,0 days 01:40:00.000000000,-3
61,68,https://resizing.flixster.com/wi7lavvxyFlHZ71zR9DnE9mgQAc=/206x305/v2/https://flxt.tmsimg.com/assets/p7963627_p_v10_al.jpg,Footloose,50000,174,2011.0,Comedy/Drama,0 days 01:53:00.000000000,7
89,94,,The Pinochet Case,100,17,2001.0,Documentary,0 days 01:54:00.000000000,5
75,78,https://resizing.flixster.com/PQ1vTPNedRRZn7Y7Mwfahxw0iSY=/206x305/v2/https://flxt.tmsimg.com/assets/p3533408_p_v10_ab.jpg,Severe Clear,250,9,2009.0,Documentary,0 days 01:33:00.000000000,3
27,0,/assets/pizza-pie/images/poster_default.c8c896e70c3.gif,The Nutcracker in 3D,2500,32,2013.0,,,-27
45,22,https://resizing.flixster.com/J-Per1PVZzS43bYuFYYAEcNV9k8=/206x305/v2/https://flxt.tmsimg.com/assets/p194005_p_v8_aa.jpg,Fireflies in the Garden,25000,54,2008.0,Drama,0 days 01:38:00.000000000,-23
33,56,,Thirteen Women,100,9,1932.0,Mystery and thriller,0 days 01:14:00.000000000,23
74,74,,The Adventures of Tintin,50000,233,2011.0,Animation/Kids and family,0 days 01:47:00.000000000,0
25,43,,My Son John,50,7,1952.0,Drama,0 days 02:02:00.000000000,18
31,71,,Lassiter,250,7,1984.0,Adventure,0 days 01:40:00.000000000,40
34,8,,13,5000,13,2010.0,Action/Mystery and thriller,0 days 01:37:00.000000000,-26
10,27,,The Wicker Tree,1000,15,2010.0,Horror/Mystery and thriller,0 days 01:36:00.000000000,17
89,96,https://resizing.flixster.com/3FH1MZ04DgTiMfzjHX_U-fWG1z8=/206x305/v2/https://flxt.tmsimg.com/NowShowing/87176/87176_aa.jpg,Harry Potter and the Deathly Hallows: Part 2,250000,331,2011.0,Fantasy/Adventure,0 days 02:11:00.000000000,7
34,67,,The Shrine,1000,6,2010.0,Horror,0 days 01:25:00.000000000,33
100,60,,Where the River Runs Black,50,5,1986.0,Adventure,0 days 01:37:00.000000000,-40
54,36,,Firstborn,1000,14,1984.0,Drama,0 days 01:43:00.000000000,-18
74,80,,Captain America: The First Avenger,100000,272,2011.0,Fantasy/Adventure,0 days 02:04:00.000000000,6
75,76,,Chimpanzee,50000,98,2012.0,Documentary,0 days 01:18:00.000000000,1
36,51,,The Rum Diary,25000,169,2011.0,Comedy/Drama,0 days 01:59:00.000000000,15
33,33,,A Previous Engagement,100,21,2008.0,Romance,0 days 01:58:00.000000000,0
67,71,,Sleep Furiously,250,28,2008.0,Documentary,0 days 01:34:00.000000000,4
30,25,,Conan the Barbarian,25000,152,2011.0,Action/Fantasy,0 days 01:53:00.000000000,-5
76,77,,Thor,100000,289,2011.0,Action/Fantasy,0 days 01:53:00.000000000,1
24,14,https://resizing.flixster.com/9oZ-0rnou3is4kCy6Vvm-KRTerQ=/206x305/v2/https://flxt.tmsimg.com/assets/p8723103_p_v13_ab.jpg,Stay Cool,1000,7,2009.0,Comedy,0 days 01:34:00.000000000,-10
58,96,https://resizing.flixster.com/GM68HUY50EnN_LZXF8h2kZVzP78=/206x305/v2/https://flxt.tmsimg.com/assets/p9023417_p_v10_aa.jpg,Midnight Son,1000,23,2011.0,Horror,0 days 01:28:00.000000000,38
68,87,/assets/pizza-pie/images/poster_default.c8c896e70c3.gif,Night and Day (Bam gua nat),250,15,2009.0,,,19
49,17,https://resizing.flixster.com/JbkLt2xOZ0EcwKFQmxnb7QNYG9U=/206x305/v2/https://flxt.tmsimg.com/assets/p8617232_p_v10_ae.jpg,Bunraku,2500,23,2010.0,Action/Fantasy,0 days 02:01:00.000000000,-32
43,100,,Safe in Hell,50,6,1931.0,Drama,0 days 01:05:00.000000000,57
63,93,https://resizing.flixster.com/eQ2GXso6ie_qEYdVedd3P5ocQFg=/206x305/v2/https://flxt.tmsimg.com/assets/p7916292_p_v10_aa.jpg,United Red Army,1000,14,2007.0,Drama,0 days 03:10:00.000000000,30
83,67,https://resizing.flixster.com/G0CPxijEClBDEZg7W45R71E7qjU=/206x305/v2/https://flxt.tmsimg.com/assets/p8782681_p_v8_aa.jpg,Sidewalls,1000,9,2011.0,Drama,0 days 01:35:00.000000000,-16
60,84,,The Tree of Life,50000,289,2011.0,Drama,0 days 02:18:00.000000000,24
89,54,https://resizing.flixster.com/Y9VFzYL1bkgwI_z0XmTkrM78aI0=/206x305/v2/https://flxt.tmsimg.com/assets/p190333_p_v8_aa.jpg,Kassim the Dream,250,13,2008.0,Documentary,0 days 01:27:00.000000000,-35
64,38,https://resizing.flixster.com/YRYQlXUkN7Sq9IkGTujs2MuPEX0=/206x305/v2/https://flxt.tmsimg.com/assets/p196921_p_v8_ac.jpg,Mia and the Migoo,1000,16,2008.0,Fantasy/Kids and family,0 days 01:32:00.000000000,-26
67,100,https://resizing.flixster.com/lDP7yE65PluutFNJBNX4yymHWS8=/206x305/v2/https://flxt.tmsimg.com/assets/p191636_p_v7_aa.jpg,Boogie,250,10,2008.0,Comedy/Drama,0 days 01:42:00.000000000,33
47,51,https://resizing.flixster.com/SUSbWtmeTi6h5T93eIuNtVVp1Ng=/206x305/v2/https://flxt.tmsimg.com/assets/p8850873_p_v10_ag.jpg,The Three Stooges,100000,150,2012.0,Comedy,0 days 01:32:00.000000000,4
33,0,https://resizing.flixster.com/BV6NK7AzmX69KYAHZcibfiaYYDI=/206x305/v2/https://flxt.tmsimg.com/assets/p8589176_p_v8_aa.jpg,An Invisible Sign,1000,15,2010.0,Drama,0 days 01:36:00.000000000,-33
44,53,https://resizing.flixster.com/35YTaRZ0FDeozn6mcE0rSMVu31I=/206x305/v2/https://flxt.tmsimg.com/assets/p8339774_p_v8_ac.jpg,Mr. Nice,2500,45,2010.0,Drama/Biography,0 days 02:01:00.000000000,9
88,91,,Love Exposure,2500,22,2008.0,Romance/Comedy,0 days 03:57:00.000000000,3
60,52,,John Carter,100000,238,2012.0,Adventure/Sci fi,0 days 02:12:00.000000000,-8
83,100,https://resizing.flixster.com/GTBSZ3pWltqyGdigmDN1Kjz3Gsc=/206x305/v2/https://flxt.tmsimg.com/assets/p42798_p_v8_aa.jpg,Remember the Night,250,10,1940.0,Romance/Other,0 days 01:34:00.000000000,17
41,100,,The Juche Idea,50,6,2008.0,Documentary/Comedy,0 days 01:02:00.000000000,59
67,91,https://resizing.flixster.com/11fvzkr0PRVW5mSJ-Cgjobc2W6k=/206x305/v2/https://flxt.tmsimg.com/assets/p7883447_p_v13_ab.jpg,London River,10000,33,2009.0,Drama,0 days 01:27:00.000000000,24
75,68,https://resizing.flixster.com/9v2cpwFe4f9g70WHH_PUK96BfmY=/206x305/v2/https://flxt.tmsimg.com/assets/p8075135_p_v8_aa.jpg,Bride Flight,1000,40,2008.0,Drama,0 days 02:10:00.000000000,-7
28,30,https://resizing.flixster.com/DEAPnjVvrtLwhwot6wIJ4e9rUs8=/206x305/v2/https://flxt.tmsimg.com/assets/p8227865_p_v8_ab.jpg,The Tempest,10000,89,2010.0,Fantasy/Drama,0 days 01:49:00.000000000,2
30,38,,London Boulevard,10000,48,2010.0,Crime/Romance,0 days 01:43:00.000000000,8
73,83,/assets/pizza-pie/images/poster_default.c8c896e70c3.gif,A Necessary Death,100,12,2008.0,Documentary,0 days 01:41:00.000000000,10
41,14,,Zookeeper,25000,133,2011.0,Comedy/Fantasy,0 days 01:41:00.000000000,-27
74,81,,Kung Fu Panda 2,100000,182,2011.0,Animation/Comedy,0 days 01:30:00.000000000,7
49,40,https://resizing.flixster.com/ko7EJHzOqChmgFtaubBVAvCgC7c=/206x305/v2/https://flxt.tmsimg.com/NowShowing/100272/100272_ab.jpg,Cars 2,100000,219,2011.0,Animation/Comedy,0 days 01:47:00.000000000,-9
63,58,,The Shock Doctrine,250,12,2009.0,Documentary,0 days 01:25:00.000000000,-5
62,80,,Detective Dee and the Mystery of the Phantom Flame,2500,55,2010.0,Action/Drama,0 days 02:03:00.000000000,18
53,75,,True Adolescents,250,8,2009.0,Comedy,0 days 01:28:00.000000000,22
67,80,,Melancholia,25000,207,2011.0,Sci fi/Drama,0 days 02:15:00.000000000,13
69,79,,Telstar,500,28,2008.0,Drama/Music,0 days 01:59:00.000000000,10
87,73,,NoBody's Perfect,50,11,2008.0,Documentary,0 days 01:24:00.000000000,-14
97,100,,American Harmony,100,5,2009.0,Documentary,0 days 01:25:00.000000000,3
55,60,,Scream 4,50000,186,2011.0,Comedy/Horror,0 days 01:52:00.000000000,5
49,64,,General Orders No. 9,500,14,2009.0,Documentary,0 days 01:12:00.000000000,15
54,17,https://resizing.flixster.com/nmSUrGb3XvT3Pl5YTbBhnaLYOko=/206x305/v2/https://flxt.tmsimg.com/assets/p8889840_p_v10_an.jpg,A Warrior's Heart,1000,12,2011.0,Romance/Drama,0 days 01:38:00.000000000,-37
41,35,,A Good Old Fashioned Orgy,5000,65,2011.0,Comedy,0 days 01:35:00.000000000,-6
100,88,,Mary Pickford: The Muse of the Movies,1,8,2008.0,Documentary,0 days 01:42:00.000000000,-12
91,89,,The Topp Twins: Untouchable Girls,250,28,2009.0,Documentary/Music,0 days 01:24:00.000000000,-2
58,40,https://resizing.flixster.com/AKAdiRYhp9DCcu9R4BJdPoy5sU8=/206x305/v2/https://flxt.tmsimg.com/assets/p8780438_p_v10_aa.jpg,Red Tails,25000,135,2012.0,War/Drama,0 days 02:05:00.000000000,-18
48,28,https://resizing.flixster.com/DwU29YHPxKPkziTeBDzR0m_XtGU=/206x305/v2/https://flxt.tmsimg.com/assets/p9195241_p_v10_am.jpg,High School,5000,54,2010.0,Comedy,0 days 01:39:00.000000000,-20
68,85,,The Time That Remains,5000,47,2009.0,Drama/History,0 days 01:49:00.000000000,17
11,13,,Main Street,1000,8,2010.0,Drama,0 days 01:32:00.000000000,2
44,77,,Zero Bridge,500,13,2008.0,Drama,0 days 01:36:00.000000000,33
67,86,https://resizing.flixster.com/WFzHgpD8YDKyRDw_Yyv11CX886E=/206x305/v2/https://flxt.tmsimg.com/NowShowing/105384/105384_aa.jpg,Puss in Boots,50000,155,2011.0,Animation/Comedy,0 days 01:30:00.000000000,19
14,67,,The Agent,100,12,2009.0,Comedy/Drama,0 days 01:21:00.000000000,53
47,0,,A Thousand Words,50000,59,2012.0,Comedy,0 days 01:31:00.000000000,-47
86,93,https://resizing.flixster.com/8fsb3KoyfXV1ZaBOvFKPJJiXZrc=/206x305/v2/https://flxt.tmsimg.com/assets/p8030779_p_v8_ac.jpg,City of Life and Death,2500,54,2009.0,War/History,0 days 02:13:00.000000000,7
62,57,,The 5th Quarter,1000,7,2010.0,Drama,0 days 01:38:00.000000000,-5
88,100,,Fish Story,500,12,2009.0,Comedy,0 days 01:52:00.000000000,12
93,100,https://resizing.flixster.com/YzOwNffWpdS4GDWj4jfKf1c5B1A=/206x305/v2/https://flxt.tmsimg.com/assets/p8876451_p_v10_aa.jpg,Paradise Lost 3: Purgatory,1000,17,2011.0,Documentary,0 days 02:01:00.000000000,7
82,100,,Henri-George Clouzot's Inferno,500,32,2009.0,Documentary,0 days 01:42:00.000000000,18
84,85,,Tucker & Dale vs Evil,25000,115,2010.0,Comedy/Horror,0 days 01:29:00.000000000,1
49,74,https://resizing.flixster.com/hPzFphpY9JXyyhD6gQiHaKL0Ovc=/206x305/v2/https://flxt.tmsimg.com/assets/p8547951_p_v13_ac.jpg,Norwegian Wood,5000,66,2010.0,Romance/Drama,0 days 02:13:00.000000000,25
72,85,,A Matter of Size,250,13,2009.0,Comedy/Drama,0 days 01:32:00.000000000,13
78,95,,Making the Boys,500,19,2009.0,Documentary/Gay and lesbian,0 days 01:30:00.000000000,17
52,56,,Bran Nue Dae,2500,62,2009.0,Comedy/Musical,0 days 01:28:00.000000000,4
61,55,,Hesher,10000,78,2010.0,Drama,0 days 01:40:00.000000000,-6
60,43,,From Time to Time,500,7,2009.0,Comedy/Fantasy,0 days 01:35:00.000000000,-17
88,73,/assets/pizza-pie/images/poster_default.c8c896e70c3.gif,Saint Misbehavin': The Wavy Gravy Movie,500,15,2009.0,Documentary,0 days 01:27:00.000000000,-15
78,91,https://resizing.flixster.com/Ag5wJD4MGxxRg7KfUPSu9lT6il8=/206x305/v2/https://flxt.tmsimg.com/assets/p7906798_p_v10_ac.jpg,Tales From the Golden Age,1000,33,2009.0,Comedy,0 days 02:35:00.000000000,13
66,77,,The Debt,25000,185,2010.0,Drama/Mystery and thriller,0 days 01:52:00.000000000,11
77,71,,Turtle: The Incredible Journey,1000,17,2009.0,Documentary,0 days 01:21:00.000000000,-6
30,41,,A Little Help,2500,44,2010.0,Comedy/Drama,0 days 01:49:00.000000000,11
85,88,,Reel Injun,1000,17,2009.0,Documentary,0 days 01:26:00.000000000,3
44,56,/assets/pizza-pie/images/poster_default.c8c896e70c3.gif,Making Plans for Lena,250,9,2009.0,Drama,0 days 01:45:00.000000000,12
52,42,,Mother's Day,10000,45,2010.0,Crime/Horror,0 days 01:52:00.000000000,-10
68,82,,The Double Hour,1000,67,2009.0,Drama/Mystery and thriller,0 days 01:35:00.000000000,14
72,81,https://resizing.flixster.com/LBTXt0L3dYmabuQ-Y4pzA2DKhYo=/206x305/v2/https://flxt.tmsimg.com/assets/p8329959_p_v8_aa.jpg,Today's Special,1000,31,2009.0,Comedy,0 days 01:39:00.000000000,9
19,0,,Monsignor,50,7,1982.0,Drama,0 days 02:02:00.000000000,-19
42,66,,Great Directors,500,38,2009.0,Documentary,0 days 01:26:00.000000000,24
27,0,https://resizing.flixster.com/B3_BicHbcuQHTAWZKTtmnlEzK24=/206x305/v2/https://flxt.tmsimg.com/assets/p8803331_p_v10_al.jpg,Father of Invention,1000,16,2010.0,Comedy,0 days 01:34:00.000000000,-27
26,16,https://resizing.flixster.com/-Dbyy-qHiCYzTg9MSrLmJk66XAo=/206x305/v2/https://flxt.tmsimg.com/assets/p8746582_p_v10_aa.jpg,Tanner Hall,1000,19,2009.0,Drama,0 days 01:35:00.000000000,-10
70,82,,Nothing Personal,1000,11,2009.0,Drama,0 days 01:25:00.000000000,12
69,63,,Protektor,250,8,2009.0,Drama/History,0 days 01:43:00.000000000,-6
10,25,/assets/pizza-pie/images/poster_default.c8c896e70c3.gif,Splintered,100,8,2008.0,Horror/Mystery and thriller,0 days 01:31:00.000000000,15
81,77,,Inside Hana's Suitcase,2500,13,2009.0,Documentary,0 days 01:28:00.000000000,-4
76,93,/assets/pizza-pie/images/poster_default.c8c896e70c3.gif,Tibet in Song,50,14,2009.0,Documentary,0 days 01:26:00.000000000,17
73,82,,Blank City,500,44,2009.0,Documentary,0 days 01:39:00.000000000,9
41,45,https://resizing.flixster.com/mT6quETS7hW-0n_fkTiX5s2yTTQ=/206x305/v2/https://flxt.tmsimg.com/assets/p8976630_p_v10_ab.jpg,All In: The Poker Movie,500,11,2012.0,Documentary,0 days 01:40:00.000000000,4
82,92,/assets/pizza-pie/images/poster_default.c8c896e70c3.gif,9500 Liberty,100,12,2009.0,Documentary,0 days 01:20:00.000000000,10
66,97,https://resizing.flixster.com/H4lAzJGd-ydAWz60RiiwwBRokLI=/206x305/v2/https://flxt.tmsimg.com/assets/p8159350_p_v10_aa.jpg,Rapt,500,35,2009.0,Drama,0 days 02:05:00.000000000,31
54,33,,Pirates of the Caribbean: On Stranger Tides,100000,278,2011.0,Action/Fantasy,0 days 02:16:00.000000000,-21
85,100,,Enemies of the People,500,33,2009.0,Documentary,0 days 01:33:00.000000000,15
73,80,https://resizing.flixster.com/xs-iBC4cqtzCQmTNI17E7M4yh2c=/206x305/v2/https://flxt.tmsimg.com/assets/p8009337_p_v10_aa.jpg,Grown Up Movie Star,100,5,2009.0,Gay and lesbian/Drama,0 days 01:34:00.000000000,7
78,92,https://resizing.flixster.com/Fg4Q0caY3YYiDApgNapD2eMjZSk=/206x305/v2/https://flxt.tmsimg.com/assets/p8062246_p_v8_aa.jpg,My Perestroika,1000,26,2010.0,Documentary,0 days 01:27:00.000000000,14
77,93,,Abel,500,15,2010.0,Comedy/Drama,0 days 01:24:00.000000000,16
83,87,https://resizing.flixster.com/7BUCefC0fa7NPwhK9J3IjS_MCmc=/206x305/v2/https://flxt.tmsimg.com/assets/p8046987_p_v10_ad.jpg,The Hedgehog,5000,71,2009.0,Comedy/Drama,0 days 01:40:00.000000000,4
62,67,,Snowmen,250,9,2010.0,Adventure,0 days 01:26:00.000000000,5
56,89,,Life 2.0,250,9,2010.0,Documentary,0 days 01:40:00.000000000,33
70,82,https://resizing.flixster.com/e2xABXdJ1RlZVJjKdsK40EOHAv0=/206x305/v2/https://flxt.tmsimg.com/assets/p8144633_p_v13_ab.jpg,The First Beautiful Thing,500,17,2010.0,Drama,0 days 02:02:00.000000000,12
92,83,https://resizing.flixster.com/d6Wi9F1UGym2k76Nxm-bDf86WQU=/206x305/v2/https://flxt.tmsimg.com/assets/p8063104_p_v10_ak.jpg,Warrior,50000,191,2011.0,Action/Drama,0 days 02:19:00.000000000,-9
53,24,https://resizing.flixster.com/28l92KW9JQmIsfdn1cpAG3LCIfE=/206x305/v2/https://flxt.tmsimg.com/NowShowing/101043/101043_aa.jpg,Hop,100000,139,2011.0,Other/Kids and family,0 days 01:35:00.000000000,-29
34,43,,Straw Dogs,10000,127,2011.0,Drama/Mystery and thriller,0 days 01:50:00.000000000,9
54,34,https://resizing.flixster.com/VUbGKInh_A4rAKLRFGApQyxkPhk=/206x305/v2/https://flxt.tmsimg.com/assets/p8777089_p_v10_an.jpg,Battleship,250000,225,2012.0,Adventure/Action,0 days 02:11:00.000000000,-20
60,45,,Happy Feet Two,50000,121,2011.0,Comedy/Kids and family,0 days 01:40:00.000000000,-15
73,60,,Real Steel,100000,233,2011.0,Sci fi/Action,0 days 02:07:00.000000000,-13
68,73,https://resizing.flixster.com/8AxosvEAKhE-INi3wZFvs_susjg=/206x305/v2/https://flxt.tmsimg.com/assets/p8073441_p_v10_af.jpg,Gainsbourg,10000,82,2010.0,Drama/Music,0 days 02:10:00.000000000,5
40,0,,Fading of the Cries,500,7,2011.0,Fantasy/Action,0 days 01:29:00.000000000,-40
74,63,,The Red Chapel,2500,8,2009.0,Documentary/Comedy,0 days 01:28:00.000000000,-11
46,74,https://resizing.flixster.com/lBABuGFi144ZQKAVdWmRhihBCFo=/206x305/v2/https://flxt.tmsimg.com/assets/p3596037_p_v10_aa.jpg,The Dead,1000,23,2010.0,Horror/Mystery and thriller,0 days 01:48:00.000000000,28
44,29,,Kaavalan,1000,7,2011.0,Romance,0 days 02:40:00.000000000,-15
76,93,https://resizing.flixster.com/nTxLQAFQY-nQHTsZvrqWMGXx4f4=/206x305/v2/https://flxt.tmsimg.com/NowShowing/102595/102595_aa.jpg,Mission: Impossible -- Ghost Protocol,250000,251,2011.0,Mystery and thriller/Action,0 days 02:13:00.000000000,17
43,44,,Cowboys & Aliens,100000,257,2011.0,Western/Action,0 days 01:58:00.000000000,1
82,84,https://resizing.flixster.com/OAtSSnsz8wJNYPYY5iCuYSEeR-g=/206x305/v2/https://flxt.tmsimg.com/NowShowing/111056/111056_ab.jpg,21 Jump Street,250000,225,2012.0,Comedy/Action,0 days 01:50:00.000000000,2
62,26,https://resizing.flixster.com/yLhvDnhjWuGyb3qKUVVlyeFj1Yc=/206x305/v2/https://flxt.tmsimg.com/assets/p8761312_p_v10_az.jpg,Underworld: Awakening,50000,76,2012.0,Horror/Action,0 days 01:29:00.000000000,-36
60,86,/assets/pizza-pie/images/poster_default.c8c896e70c3.gif,The Pirates! Band of Misfits,50000,153,2012.0,,,26
77,100,,Alambrista,50,6,1978.0,Drama,0 days 01:50:00.000000000,23
69,72,,The People vs. George Lucas,1000,25,2010.0,Documentary/Comedy,0 days 01:33:00.000000000,3
53,74,,Putty Hill,250,34,2010.0,Drama,0 days 01:27:00.000000000,21
85,100,https://resizing.flixster.com/COGCcbNiPw7wbVjI07E8Z80DkZI=/206x305/v2/https://flxt.tmsimg.com/assets/p8063040_p_v8_aa.jpg,Thunder Soul,500,29,2010.0,Documentary,0 days 01:28:00.000000000,15
54,80,,Tiny Furniture,10000,98,2010.0,Comedy/Drama,0 days 01:39:00.000000000,26
54,12,https://resizing.flixster.com/8DhGxcxOngDX9PZxJVjN1L1NaRs=/206x305/v2/https://flxt.tmsimg.com/assets/p8510749_p_v10_as.jpg,There Be Dragons,1000,41,2011.0,Drama,0 days 02:00:00.000000000,-42
33,51,,Brighton Rock,5000,95,2010.0,Crime/Drama,0 days 01:51:00.000000000,18
27,60,/assets/pizza-pie/images/poster_default.c8c896e70c3.gif,The Fields,250,5,2011.0,,,33
53,85,,Caterpillar,1000,13,2010.0,War/Drama,0 days 01:25:00.000000000,32
51,81,,The Myth of the American Sleepover,1000,48,2010.0,Comedy/Drama,0 days 01:33:00.000000000,30
48,50,,House of Boys,100,8,2009.0,Romance/Gay and lesbian,0 days 01:53:00.000000000,2
71,91,,And Everything Is Going Fine,1000,34,2010.0,Documentary,0 days 01:29:00.000000000,20
83,77,https://resizing.flixster.com/L0FgZiWzbOFBV7YyBUBzE1zWOtU=/206x305/v2/https://flxt.tmsimg.com/assets/p8338313_p_v10_bb.jpg,Fast Five,100000,202,2011.0,Action,0 days 02:10:00.000000000,-6
42,63,/assets/pizza-pie/images/poster_default.c8c896e70c3.gif,Mammuth,500,24,2010.0,Comedy,0 days 01:32:00.000000000,21
48,33,,A Beginner's Guide to Endings,100,6,2010.0,Comedy/Drama,0 days 01:36:00.000000000,-15
82,88,https://resizing.flixster.com/xmUBcJx4dKw3IzFxksGIHILntlk=/206x305/v2/https://flxt.tmsimg.com/assets/p8433121_p_v13_ab.jpg,Submarine,25000,156,2010.0,Comedy/Drama,0 days 01:37:00.000000000,6
8,9,,Age of the Dragons,1000,11,2011.0,Fantasy/Adventure,0 days 01:31:00.000000000,1
34,60,https://resizing.flixster.com/RtAcbxIJd_kbXuTI4bvk2C1beG4=/206x305/v2/https://flxt.tmsimg.com/assets/p8084095_p_v10_ac.jpg,Don't Be Afraid of the Dark,25000,176,2010.0,Fantasy/Mystery and thriller,0 days 01:39:00.000000000,26
39,28,,Justice,5000,79,2011.0,Action/Drama,0 days 01:45:00.000000000,-11
19,40,,Easy Living,1,5,1949.0,Drama,0 days 01:17:00.000000000,21
62,38,,Night Watch,50,8,1973.0,Mystery and thriller,0 days 01:45:00.000000000,-24
42,7,,All's Faire in Love,500,15,2009.0,Romance,0 days 01:55:00.000000000,-35
35,33,https://resizing.flixster.com/lZZhMnTwdlkaClMMIHKuflW5-CE=/206x305/v2/https://flxt.tmsimg.com/assets/p8361777_p_v10_ad.jpg,Burke & Hare,10000,58,2010.0,Comedy/Mystery and thriller,0 days 01:31:00.000000000,-2
76,89,,The Turin Horse,2500,63,2011.0,Drama,0 days 02:26:00.000000000,13
59,72,,Fright Night,50000,180,2011.0,Comedy/Horror,0 days 01:46:00.000000000,13
19,17,,The Howling: Reborn,250,6,2011.0,Horror,0 days 01:32:00.000000000,-2
58,76,,Rejoice & Shout,100,38,2010.0,Documentary,0 days 01:55:00.000000000,18
36,45,https://resizing.flixster.com/hOEv5Qw0rwHzGiyP4-vndClby2c=/206x305/v2/https://flxt.tmsimg.com/assets/p8395421_p_v10_ah.jpg,Bad Teacher,50000,191,2011.0,Comedy,0 days 01:32:00.000000000,9
48,46,https://resizing.flixster.com/giwUSXZBuJ8Bj839BTQ0AIwwy30=/206x305/v2/https://flxt.tmsimg.com/assets/p8615831_p_v8_af.jpg,Immortals,50000,132,2011.0,Action/Fantasy,0 days 01:50:00.000000000,-2
69,12,,Atlas Shrugged: Part 1,10000,52,2011.0,Drama,0 days 01:42:00.000000000,-57
64,54,https://resizing.flixster.com/EBReu-ECB37q4rGyYpHNLr74c_I=/206x305/v2/https://flxt.tmsimg.com/assets/p8477173_p_v10_ah.jpg,The Devil's Double,10000,102,2011.0,Biography/Drama,0 days 01:49:00.000000000,-10
49,43,,Berlin 36,100,7,2009.0,History/Drama,0 days 01:43:00.000000000,-6
44,56,/assets/pizza-pie/images/poster_default.c8c896e70c3.gif,The Kreutzer Sonata,50,18,2008.0,Drama,0 days 01:39:00.000000000,12
85,67,,Fresh,100,9,2009.0,Documentary,0 days 01:10:00.000000000,-18
79,85,,My Afternoons with Margueritte,5000,61,2010.0,Drama,0 days 01:22:00.000000000,6
74,95,,The Woodmans,500,19,2010.0,Documentary/Biography,0 days 01:22:00.000000000,21
47,44,https://resizing.flixster.com/inj1RXwIcEOcQHRSrjk_e06Il0M=/206x305/v2/https://flxt.tmsimg.com/assets/p8365592_p_v13_aa.jpg,Beware the Gonzo,250,9,2010.0,Comedy,0 days 01:34:00.000000000,-3
71,82,https://resizing.flixster.com/pJoRVhP64u1UXr7IzHv7pEc5gFw=/206x305/v2/https://flxt.tmsimg.com/assets/p8098882_p_v8_aa.jpg,Littlerock,500,28,2010.0,Drama,0 days 01:23:00.000000000,11
77,73,,African Cats,10000,79,2011.0,Documentary,0 days 01:30:00.000000000,-4
37,22,,Spy Kids: All the Time in the World in 4D,25000,60,2011.0,Fantasy/Action,0 days 01:29:00.000000000,-15
42,37,https://resizing.flixster.com/65ZApxFVtx1fvoCNqjJp9qshivI=/206x305/v2/https://flxt.tmsimg.com/assets/p8136759_p_v10_aa.jpg,4.3.2.1.,2500,30,2010.0,Crime/Drama,0 days 01:57:00.000000000,-5
76,90,https://resizing.flixster.com/hJEvBaJasdXhaw5mATOIPxvRo60=/206x305/v2/https://flxt.tmsimg.com/NowShowing/101380/101380_ab.jpg,Bridesmaids,100000,289,2011.0,Comedy,0 days 02:05:00.000000000,14
76,40,https://resizing.flixster.com/vJnditBN4CS9UP6gvjKj9FFhjEA=/206x305/v2/https://flxt.tmsimg.com/assets/p8089082_p_v10_aa.jpg,Carbon Nation,500,15,2010.0,Documentary,0 days 01:22:00.000000000,-36
83,93,https://resizing.flixster.com/dHrOm83gONCP6RbhAMw1NjisdoM=/206x305/v2/https://flxt.tmsimg.com/NowShowing/103248/103248_aa.jpg,Midnight in Paris,50000,224,2011.0,Romance/Fantasy,0 days 01:34:00.000000000,10
60,25,https://resizing.flixster.com/C1UTeP1rJBSvdeO1IKExCf9MOug=/206x305/v2/https://flxt.tmsimg.com/assets/p8500932_p_v10_aa.jpg,The Twilight Saga: Breaking Dawn Part 1,100000,210,2011.0,Romance/Fantasy,0 days 01:57:00.000000000,-35
57,77,https://resizing.flixster.com/SDbtC2NHfZHVUpWrvWnMn6DsTNc=/206x305/v2/https://flxt.tmsimg.com/assets/p8575761_p_v8_aa.jpg,Aurora,500,30,2010.0,Drama,0 days 03:01:00.000000000,20
55,75,https://resizing.flixster.com/PJRlb947jOWjR8SbOTJMyP6PLck=/206x305/v2/https://flxt.tmsimg.com/assets/p8344006_p_v8_aa.jpg,October,100,16,2010.0,Drama,0 days 01:23:00.000000000,20
68,74,https://resizing.flixster.com/ryR1WvJkK6-301-V3WigeNM-Bz8=/206x305/v2/https://flxt.tmsimg.com/assets/p8329451_p_v10_aa.jpg,"Tuesday, After Christmas",500,23,2010.0,Drama,0 days 01:40:00.000000000,6
84,70,/assets/pizza-pie/images/poster_default.c8c896e70c3.gif,Redline,50,10,2009.0,Action/Sci fi,0 days 01:42:00.000000000,-14
56,93,,Leap Year,2500,27,2010.0,Drama,0 days 01:34:00.000000000,37
82,93,,Benda Bilili!,250,28,2010.0,Documentary/Music,0 days 01:25:00.000000000,11
75,93,,The Four Times,1000,54,2010.0,Drama,0 days 01:28:00.000000000,18
66,90,,My Joy,500,20,2010.0,Drama,0 days 02:07:00.000000000,24
37,68,,The Silent House,2500,28,2010.0,Horror/Mystery and thriller,0 days 01:19:00.000000000,31
78,92,,Sound of Noise,1000,24,2010.0,Crime/Comedy,0 days 01:42:00.000000000,14
75,81,,Super 8,100000,291,2011.0,Sci fi/Mystery and thriller,0 days 01:52:00.000000000,6
59,68,https://resizing.flixster.com/3_e5eGtF1sKdlH6ggipP5Wfpphw=/206x305/v2/https://flxt.tmsimg.com/assets/p8718205_p_v10_aa.jpg,A Very Harold & Kumar Christmas,25000,131,2011.0,Other/Comedy,0 days 01:30:00.000000000,9
87,86,,X-Men: First Class,100000,297,2011.0,Sci fi/Action,0 days 02:06:00.000000000,-1
77,82,https://resizing.flixster.com/1w9BNwuIlcLgNfzfJc416PFbf-4=/206x305/v2/https://flxt.tmsimg.com/assets/p8338079_p_v10_ae.jpg,Rise of the Planet of the Apes,250000,271,2011.0,Adventure/Action,0 days 01:45:00.000000000,5
80,91,,Winnie the Pooh,25000,130,2011.0,Animation/Kids and family,0 days 01:09:00.000000000,11
70,69,,Horrible Bosses,100000,223,2011.0,Comedy,0 days 01:38:00.000000000,-1
47,25,,The Change-Up,25000,157,2011.0,Comedy,0 days 01:52:00.000000000,-22
40,45,,30 Minutes or Less,25000,165,2011.0,Comedy/Action,0 days 01:23:00.000000000,5
63,85,https://resizing.flixster.com/9bkDsLXt8ur443URXJdkRCGk6jY=/206x305/v2/https://flxt.tmsimg.com/assets/p8640396_p_v8_ad.jpg,Contagion,50000,275,2011.0,Drama/Mystery and thriller,0 days 01:46:00.000000000,22
78,93,,Hugo,50000,228,2011.0,Fantasy/Adventure,0 days 02:06:00.000000000,15
74,74,,War Horse,50000,238,2011.0,War/Drama,0 days 02:26:00.000000000,0
70,89,https://resizing.flixster.com/W_B6Xk4KULB8EtrAGvHfsZzr6xE=/206x305/v2/https://flxt.tmsimg.com/assets/p8280818_p_v10_ap.jpg,Certified Copy,5000,135,2010.0,Romance/Drama,0 days 01:46:00.000000000,19
59,45,,Journey 2: The Mysterious Island,100000,132,2012.0,Adventure/Kids and family,0 days 01:34:00.000000000,-14
78,100,https://resizing.flixster.com/Abw4Yn26R6fzess6H95Yqyjrbd0=/206x305/v2/https://flxt.tmsimg.com/assets/p8830498_p_v10_aa.jpg,Kinyarwanda,500,14,2011.0,Romance/Drama,0 days 01:40:00.000000000,22
54,73,,Mozart's Sister,1000,63,2010.0,Drama,0 days 02:00:00.000000000,19
66,71,https://resizing.flixster.com/Odc4dkgsTin0kx49SdcCRqkvREA=/206x305/v2/https://flxt.tmsimg.com/assets/p8395508_p_v13_aq.jpg,Hanna,50000,235,2011.0,Action/Mystery and thriller,0 days 01:51:00.000000000,5
39,26,,The Three Musketeers,25000,96,2011.0,Action/Drama,0 days 01:50:00.000000000,-13
52,33,https://resizing.flixster.com/dXE86FgE5xoRv6UaQVrGHabcbVY=/206x305/v2/https://flxt.tmsimg.com/assets/p8418274_p_v10_ay.jpg,The Hangover Part II,100000,248,2011.0,Comedy,0 days 01:42:00.000000000,-19
45,7,https://resizing.flixster.com/J3N4bllZHf_v-xIhpe63Ma1WYSU=/206x305/v2/https://flxt.tmsimg.com/assets/p8718286_p_v8_af.jpg,New Year's Eve,50000,142,2011.0,Romance/Other,0 days 01:57:00.000000000,-38
84,42,,Burzynski: the Movie,250,12,2010.0,,,-42
77,21,https://resizing.flixster.com/4_w4MOFn4yR_R94XsFCR1YYR-Pw=/206x305/v2/https://flxt.tmsimg.com/assets/p9144094_p_v8_aa.jpg,My Way,500,19,2011.0,War/Drama,0 days 02:22:00.000000000,-56
48,74,,Margaret,5000,100,2011.0,Drama,0 days 02:29:00.000000000,26
84,81,,The Skin I Live In,25000,176,2011.0,Drama/Mystery and thriller,0 days 02:00:00.000000000,-3
79,85,https://resizing.flixster.com/soJGod52Y97mkkAHPwS_vmewKAE=/206x305/v2/https://flxt.tmsimg.com/assets/p8564254_p_v8_ab.jpg,A Better Life,10000,108,2011.0,Crime/Drama,0 days 01:38:00.000000000,6
48,44,https://resizing.flixster.com/5aOSA3Hr0SNqwQfa4sdrBhx-_OE=/206x305/v2/https://flxt.tmsimg.com/assets/p8546454_p_v13_af.jpg,A Turtle's Tale: Sammy's Adventures,2500,18,2010.0,Animation/Kids and family,0 days 01:28:00.000000000,-4
86,94,,Moneyball,50000,267,2011.0,Drama,0 days 02:13:00.000000000,8
81,84,https://resizing.flixster.com/wlmIV6X5aZH5RQ3rU466MIeSuSo=/206x305/v2/https://flxt.tmsimg.com/assets/p8648012_p_v10_ab.jpg,The Hunger Games,250000,312,2012.0,Action/Sci fi,0 days 02:22:00.000000000,3
92,92,https://resizing.flixster.com/uZtIB3JEhKir1pEkJb3zdJ6k_Aw=/206x305/v2/https://flxt.tmsimg.com/assets/p8306864_p_v13_ae.jpg,Incendies,10000,122,2010.0,Drama,0 days 02:10:00.000000000,0
41,37,,Larry Crowne,25000,202,2011.0,Romance,0 days 01:38:00.000000000,-4
84,100,/assets/pizza-pie/images/poster_default.c8c896e70c3.gif,Nostalgia for the Light,2500,48,2010.0,Documentary,0 days 01:30:00.000000000,16
82,82,,"Life, Above All",1000,74,2010.0,Drama,0 days 01:42:00.000000000,0
53,10,https://resizing.flixster.com/gUUVsCubzvbfRvmeEJZHFJXe7wc=/206x305/v2/https://flxt.tmsimg.com/assets/p8705531_p_v10_aq.jpg,Honey 2,2500,21,2011.0,Drama,0 days 01:51:00.000000000,-43
70,90,https://resizing.flixster.com/yf7rsXK8H-NxfmkmWkiwpogsdUQ=/206x305/v2/https://flxt.tmsimg.com/assets/p8336137_p_v10_ad.jpg,Rare Exports: A Christmas Tale,10000,105,2010.0,Other/Horror,0 days 01:17:00.000000000,20
31,18,,Ghost Rider: Spirit of Vengeance,100000,114,2011.0,Action/Fantasy,0 days 01:36:00.000000000,-13
76,85,,Honey,500,27,2010.0,Drama,0 days 01:43:00.000000000,9
53,77,https://resizing.flixster.com/NpePZihZTz8aw9h_eYSTRaPmijo=/206x305/v2/https://flxt.tmsimg.com/assets/p8562939_p_v10_au.jpg,Chalet Girl,5000,43,2011.0,Comedy,0 days 01:36:00.000000000,24
77,59,https://resizing.flixster.com/Q8rwwL4Qs7b0YOmvxCppqXAiwWI=/206x305/v2/https://flxt.tmsimg.com/assets/p8418474_p_v8_ai.jpg,Sherlock Holmes: A Game of Shadows,100000,228,2011.0,Mystery and thriller/Action,0 days 02:09:00.000000000,-18
76,83,,Sons of Perdition,100,6,2010.0,Documentary,0 days 01:25:00.000000000,7
53,72,https://resizing.flixster.com/dgYeDlng7DXfe8bL7T7tLBvgHzA=/206x305/v2/https://flxt.tmsimg.com/assets/p8663035_p_v10_ad.jpg,The Tree,5000,67,2010.0,Romance/Drama,0 days 01:40:00.000000000,19
86,87,https://resizing.flixster.com/TfTwEvDJhvuCGGUa3E_DcYb9-tQ=/206x305/v2/https://flxt.tmsimg.com/assets/p8702416_p_v10_aa.jpg,The Girl With the Dragon Tattoo,100000,253,2011.0,Drama/Mystery and thriller,0 days 02:38:00.000000000,1
61,28,,Project X,50000,138,2012.0,Comedy,0 days 01:28:00.000000000,-33
52,62,https://resizing.flixster.com/tQ_-Gel97TbFFsqCi9iK6MRjn4U=/206x305/v2/https://flxt.tmsimg.com/assets/p8609535_p_v10_ap.jpg,Final Destination 5,50000,137,2011.0,Horror/Mystery and thriller,0 days 01:32:00.000000000,10
56,60,https://resizing.flixster.com/O49UT7hiJ5GtI3FlQlbDeDBNTKU=/206x305/v2/https://flxt.tmsimg.com/assets/p8393784_p_v8_aa.jpg,Vidal Sassoon: The Movie,1000,35,2010.0,Documentary,0 days 01:30:00.000000000,4
48,38,https://resizing.flixster.com/3fRU6kbQD6dfWep8I_HH6kBw440=/206x305/v2/https://flxt.tmsimg.com/assets/p8175530_p_v10_ag.jpg,Restless,5000,112,2011.0,Drama,0 days 01:33:00.000000000,-10
41,80,,Haywire,25000,198,2011.0,Mystery and thriller/Action,0 days 01:32:00.000000000,39
49,40,,Monte Carlo,25000,93,2011.0,Romance,0 days 01:48:00.000000000,-9
42,34,https://resizing.flixster.com/flEBDYoszT7MgHFfH2sD5i7bkZ8=/206x305/v2/https://flxt.tmsimg.com/assets/p176084_p_v10_ab.jpg,The Thing,25000,173,2011.0,Sci fi/Horror,0 days 01:43:00.000000000,-8
71,64,,We Bought a Zoo,100000,171,2011.0,Comedy/Kids and family,0 days 02:04:00.000000000,-7
29,27,,Bel Ami,5000,95,2012.0,Drama/History,0 days 01:42:00.000000000,-2
78,79,https://resizing.flixster.com/sqvncxV54blqa_rUbPhXUG8B4Nw=/206x305/v2/https://flxt.tmsimg.com/assets/p8410544_p_v10_aa.jpg,"Crazy, Stupid, Love.",100000,236,2011.0,Romance,0 days 01:58:00.000000000,1
44,23,https://resizing.flixster.com/QCT95aCWUrtvJkGZ14l_rosZbUY=/206x305/v2/https://flxt.tmsimg.com/assets/p8481287_p_v10_ab.jpg,What's Your Number?,25000,115,2011.0,Romance,0 days 01:46:00.000000000,-21
50,78,,A Dangerous Method,25000,190,2011.0,Drama/Mystery and thriller,0 days 01:39:00.000000000,28
34,44,https://resizing.flixster.com/JI2OJsEzOgbzaaqA2TSe6phazEE=/206x305/v2/https://flxt.tmsimg.com/assets/p8835567_p_v8_aa.jpg,5 Star Day,500,18,2010.0,Drama,0 days 01:37:00.000000000,10
75,90,,Attack the Block,25000,181,2011.0,Action/Sci fi,0 days 01:28:00.000000000,15
43,47,https://resizing.flixster.com/1xUq6YJSAwUtDgzebiaTnMROEyg=/206x305/v2/https://flxt.tmsimg.com/assets/p8308959_p_v10_ac.jpg,A Serbian Film,5000,32,2010.0,Mystery and thriller,0 days 01:44:00.000000000,4
42,80,https://resizing.flixster.com/01DbarAhYilC29gxgCKldza7ie4=/206x305/v2/https://flxt.tmsimg.com/assets/p8254289_p_v10_aa.jpg,Dead Hooker in a Trunk,250,5,2009.0,Action,0 days 01:32:00.000000000,38
81,100,https://resizing.flixster.com/3SHbpYhXylfqDZczUlK8ke-ZSbM=/206x305/v2/https://flxt.tmsimg.com/assets/p8226835_p_v10_aa.jpg,Louder Than a Bomb,1000,26,2010.0,Documentary,0 days 01:40:00.000000000,19
70,60,,Water for Elephants,50000,197,2011.0,Romance/Drama,0 days 02:01:00.000000000,-10
80,95,,The Muppets,50000,228,2011.0,Comedy/Kids and family,0 days 01:38:00.000000000,15
39,58,https://resizing.flixster.com/MSSw22-pg5bYPTfb1Hf5r-FfzHo=/206x305/v2/https://flxt.tmsimg.com/assets/p8340470_p_v8_aa.jpg,Film Socialisme,1000,60,2010.0,Drama,0 days 01:41:00.000000000,19
36,6,,Dream House,25000,88,2011.0,Mystery and thriller,0 days 01:32:00.000000000,-30
39,22,https://resizing.flixster.com/BG5Je7kGgaS2XLidViknyj2dOM8=/206x305/v2/https://flxt.tmsimg.com/assets/p8507153_p_v10_aj.jpg,The Sitter,25000,112,2011.0,Comedy,0 days 01:21:00.000000000,-17
25,12,,The Darkest Hour,25000,59,2011.0,Action/Sci fi,0 days 01:29:00.000000000,-13
47,56,https://resizing.flixster.com/Z9J2PtM9EKg3pTMhMr3JhfnJN6c=/206x305/v2/https://flxt.tmsimg.com/assets/p8805507_p_v10_an.jpg,Albert Nobbs,5000,159,2011.0,Romance/Drama,0 days 01:53:00.000000000,9
58,92,,Coriolanus,10000,156,2011.0,Drama/War,0 days 02:02:00.000000000,34
52,56,https://resizing.flixster.com/Ty0XELaMPXBWbCLmk9xc-7SEe9U=/206x305/v2/https://flxt.tmsimg.com/assets/p8854112_p_v10_ag.jpg,Janie Jones,1000,32,2010.0,Drama,0 days 01:54:00.000000000,4
54,85,,The Princess of Montpensier,5000,66,2010.0,Romance/Action,0 days 02:19:00.000000000,31
44,85,,The Strange Case of Angelica,5000,27,2010.0,Fantasy/Drama,0 days 01:37:00.000000000,41
71,75,,The Whistleblower,10000,119,2010.0,Drama,0 days 01:52:00.000000000,4
47,22,,Snow Flower and the Secret Fan,5000,91,2011.0,Drama/History,0 days 01:43:00.000000000,-25
53,73,https://resizing.flixster.com/QMIQsHAEv3m9LxymMRXGfcBC6jo=/206x305/v2/https://flxt.tmsimg.com/assets/p8380428_p_v10_av.jpg,Everything Must Go,10000,134,2010.0,Comedy/Drama,0 days 01:37:00.000000000,20
92,99,,Bill Cunningham New York,2500,74,2010.0,Documentary/Drama,0 days 01:24:00.000000000,7
23,29,,The Human Centipede II (Full Sequence),10000,82,2011.0,Horror,0 days 01:28:00.000000000,6
94,100,,How to Die in Oregon,500,11,2011.0,Documentary,0 days 01:47:00.000000000,6
42,2,,One for the Money,25000,55,2012.0,Action/Comedy,0 days 01:31:00.000000000,-40
67,27,,Colombiana,100000,103,2011.0,Action/Mystery and thriller,0 days 01:47:00.000000000,-40
80,82,,Dolphin Tale,25000,114,2011.0,Kids and family/Adventure,0 days 01:53:00.000000000,2
36,3,https://resizing.flixster.com/AqWqUcI3k-DFXRv_u1vzXb97iu0=/206x305/v2/https://flxt.tmsimg.com/assets/p8718215_p_v8_af.jpg,Jack and Jill,50000,116,2011.0,Comedy,0 days 01:30:00.000000000,-33
35,42,/assets/pizza-pie/images/poster_default.c8c896e70c3.gif,House of My Father,50000,113,2012.0,Comedy,0 days 01:24:00.000000000,7
89,76,https://resizing.flixster.com/V3ckju2Kd04dx3Arc6UPcB78sCk=/206x305/v2/https://flxt.tmsimg.com/assets/p8554431_p_v10_av.jpg,The Help,100000,230,2011.0,Drama,0 days 02:26:00.000000000,-13
73,88,,Bernie,25000,167,2011.0,Crime/Comedy,0 days 01:44:00.000000000,15
60,84,/assets/pizza-pie/images/poster_default.c8c896e70c3.gif,Women Art Revolution,100,25,2010.0,Documentary,0 days 01:23:00.000000000,24
34,0,,In/Sight,250,5,2011.0,Mystery and thriller,0 days 01:32:00.000000000,-34
86,100,,We Were Here,2500,46,2011.0,Drama/Documentary,0 days 01:30:00.000000000,14
81,89,https://resizing.flixster.com/R-f7WtwOy7O69sbZxpWYF8IKfeU=/206x305/v2/https://flxt.tmsimg.com/assets/p8320743_p_v10_aa.jpg,Armadillo,2500,54,2010.0,Documentary/War,0 days 01:40:00.000000000,8
72,100,,Raw Faith,100,7,2010.0,Documentary,0 days 01:34:00.000000000,28
49,36,https://resizing.flixster.com/MhH7_eGO5SyvNuxsW9ilaGjU9ts=/206x305/v2/https://flxt.tmsimg.com/assets/p8486587_p_v13_aj.jpg,One Day,25000,145,2011.0,Romance,0 days 01:48:00.000000000,-13
33,21,https://resizing.flixster.com/XqNh3ZtIGcvrhxUtvvYrn4ypI7c=/206x305/v2/https://flxt.tmsimg.com/assets/p8828435_p_v8_aa.jpg,The Double,5000,52,2011.0,Action/Mystery and thriller,0 days 01:38:00.000000000,-12
24,10,https://resizing.flixster.com/WWSdyKUVUn2ggVk3XLAybb_FOv8=/206x305/v2/https://flxt.tmsimg.com/assets/p8146116_p_v8_aa.jpg,The Family Tree,500,21,2010.0,Comedy/Drama,0 days 01:35:00.000000000,-14
56,26,https://resizing.flixster.com/JlbPlOYn91iAyniaV5s9WsQTP2o=/206x305/v2/https://flxt.tmsimg.com/assets/p8787579_p_v10_ae.jpg,This Means War,50000,183,2012.0,Action/Comedy,0 days 01:37:00.000000000,-30
47,64,https://resizing.flixster.com/FncU0asKHtW35mz0x_xWm0wfhnY=/206x305/v2/https://flxt.tmsimg.com/assets/p8418445_p_v10_ag.jpg,Love Crime,1000,81,2010.0,Mystery and thriller,0 days 01:46:00.000000000,17
82,100,,Bag It,100,5,2010.0,Documentary/Drama,0 days 01:19:00.000000000,18
17,60,,Wound,1,5,2010.0,Horror/Fantasy,0 days 01:16:00.000000000,43
53,45,,Anonymous,10000,176,2011.0,Drama/History,0 days 02:10:00.000000000,-8
64,75,,Big Miracle,25000,105,2012.0,Adventure/Drama,0 days 01:47:00.000000000,11
65,68,https://resizing.flixster.com/s8BnY0xP6GCJwyPvytvwHMwLjt0=/206x305/v2/https://flxt.tmsimg.com/assets/p8405003_p_v13_au.jpg,Friends With Benefits,50000,170,2011.0,Romance,0 days 01:49:00.000000000,3
63,63,/assets/pizza-pie/images/poster_default.c8c896e70c3.gif,Stuck Between Stations,500,8,2011.0,Romance,0 days 01:25:00.000000000,0
22,11,https://resizing.flixster.com/ERlb1EKO3L2zVXWn4pwF_L-4wcU=/206x305/v2/https://flxt.tmsimg.com/assets/p8799979_p_v10_ae.jpg,Trespass,5000,76,2011.0,Mystery and thriller,0 days 01:30:00.000000000,-11
56,93,/assets/pizza-pie/images/poster_default.c8c896e70c3.gif,Nine Nation Animation,50,14,2010.0,,,37
49,26,,Wrath of the Titans,100000,174,2012.0,Action/Fantasy,0 days 01:39:00.000000000,-23
86,84,,Force of Nature: The David Suzuki Movie,100,19,2010.0,Documentary,0 days 01:33:00.000000000,-2
22,18,https://resizing.flixster.com/N6RJS3dqkfUotuwkvhCn1Xl_CHE=/206x305/v2/https://flxt.tmsimg.com/assets/p8611174_p_v10_aq.jpg,Shark Night,25000,71,2011.0,Horror/Mystery and thriller,0 days 01:31:00.000000000,-4
76,62,,The First Grader,1000,78,2010.0,Drama/Biography,0 days 01:39:00.000000000,-14
72,92,,Tabloid,10000,121,2010.0,Documentary,0 days 01:28:00.000000000,20
86,63,,The Afterlight,1,8,2009.0,Drama,0 days 01:27:00.000000000,-23
64,77,https://resizing.flixster.com/SqKsH442b-Ir2lh8Zn55C6tgsRc=/206x305/v2/https://flxt.tmsimg.com/assets/p8436826_p_v8_aa.jpg,The Last Circus,5000,35,2010.0,Comedy/Drama,0 days 01:47:00.000000000,13
71,86,,Mysteries of Lisbon,1000,57,2010.0,Drama/History,0 days 04:26:00.000000000,15
56,70,,Beautiful Boy,5000,67,2010.0,Drama,0 days 01:40:00.000000000,14
73,96,,Cave of Forgotten Dreams,10000,137,2010.0,Documentary,0 days 01:30:00.000000000,23
46,77,,Essential Killing,2500,52,2010.0,Mystery and thriller/War,0 days 01:24:00.000000000,31
77,85,,Beginners,25000,161,2010.0,Gay and lesbian/Drama,0 days 01:45:00.000000000,8
35,67,https://resizing.flixster.com/JgEd5oquMDjkIbpNdzRBWPsw8AM=/206x305/v2/https://flxt.tmsimg.com/assets/p8384075_p_v10_at.jpg,Good Neighbours,2500,30,2010.0,Crime/Drama,0 days 01:38:00.000000000,32
56,62,,"Yves Saint Laurent 5, Avenue Marceau 75116 Paris",500,50,2002.0,Documentary,0 days 01:25:00.000000000,6
82,72,,Sarah's Key,5000,117,2010.0,Drama,0 days 01:51:00.000000000,-10
44,72,,Windfall,500,18,2010.0,Documentary/Drama,0 days 01:21:00.000000000,28
33,39,,Special Treatment,100,18,2010.0,Comedy/Drama,0 days 01:35:00.000000000,6
85,100,/assets/pizza-pie/images/poster_default.c8c896e70c3.gif,Everyday Sunshine: The Story of Fishbone,1000,47,2010.0,Documentary/Music,0 days 01:47:00.000000000,15
83,94,https://resizing.flixster.com/MnyG3hjNsOeLeeiNVHfkf49T6Qw=/206x305/v2/https://flxt.tmsimg.com/assets/p8137379_p_v10_aa.jpg,Queen of the Sun: What Are the Bees Telling Us?,500,33,2010.0,Documentary/Drama,0 days 01:22:00.000000000,11
68,90,,Julia's Eyes,5000,40,2010.0,Horror/Mystery and thriller,0 days 01:52:00.000000000,22
64,88,,Trigger,100,8,2010.0,Drama,0 days 01:23:00.000000000,24
35,60,,A Horrible Way to Die,500,10,2010.0,Horror/Mystery and thriller,0 days 01:25:00.000000000,25
55,47,https://resizing.flixster.com/YJCENDVtoyTYDFhkIhf_82rppuA=/206x305/v2/https://flxt.tmsimg.com/assets/p8636011_p_v8_ak.jpg,3,500,32,2010.0,Comedy/Drama,0 days 01:44:00.000000000,-8
55,60,,Herschell Gordon Lewis: The Godfather of Gore,1,5,2010.0,Documentary,0 days 01:46:00.000000000,5
39,55,https://resizing.flixster.com/LcnpZZIJgib7PCjSty3pmOJErZ8=/206x305/v2/https://flxt.tmsimg.com/assets/p8331552_p_v13_aa.jpg,Zenith,500,11,2010.0,Sci fi/Mystery and thriller,0 days 01:33:00.000000000,16
42,56,,Seducing Charlie Barker,50,9,2010.0,Comedy,0 days 01:33:00.000000000,14
65,32,https://resizing.flixster.com/CD45Ez5Os1mFqixdJYLEArWoCpA=/206x305/v2/https://flxt.tmsimg.com/assets/p8786072_p_v8_aq.jpg,Joyful Noise,25000,129,2012.0,Comedy/Drama,0 days 01:57:00.000000000,-33
29,21,,Darling Companion,10000,91,2012.0,Comedy/Drama,0 days 01:43:00.000000000,-8
27,25,https://resizing.flixster.com/2I_tXGZrtzMqLCN1uPtH7_vlZa8=/206x305/v2/https://flxt.tmsimg.com/assets/p8447949_p_v10_ak.jpg,Animals United,2500,8,2010.0,Animation/Comedy,0 days 01:33:00.000000000,-2
36,50,/assets/pizza-pie/images/poster_default.c8c896e70c3.gif,Some Days Are Better Than Others,100,12,2010.0,Drama,0 days 01:33:00.000000000,14
84,83,https://resizing.flixster.com/iV8LsatyhIbmsinr7m1js100fGQ=/206x305/v2/https://flxt.tmsimg.com/assets/p8237067_p_v10_aa.jpg,The Elephant in the Living Room,500,23,2010.0,Documentary,0 days 01:36:00.000000000,-1
42,5,,Abduction,25000,108,2011.0,Action/Mystery and thriller,0 days 01:46:00.000000000,-37
64,80,,Outrage,2500,46,2010.0,Crime/Action,0 days 01:49:00.000000000,16
74,96,,The Arbor,1000,46,2010.0,Drama,0 days 01:34:00.000000000,22
41,20,,From Prada to Nada,10000,20,2011.0,Romance/Comedy,0 days 01:47:00.000000000,-21
60,0,https://resizing.flixster.com/I9c3GaLviP5nw5wLK3-FLc3iLmc=/206x305/v2/https://flxt.tmsimg.com/assets/p183410_p_v10_aa.jpg,The Lion of Judah,2500,6,2011.0,Other/Kids and family,0 days 01:27:00.000000000,-60
48,68,,Tower Heist,50000,200,2011.0,Comedy/Adventure,0 days 01:45:00.000000000,20
47,56,,Killing Bono,5000,43,2011.0,Comedy,0 days 01:54:00.000000000,9
59,73,/assets/pizza-pie/images/poster_default.c8c896e70c3.gif,Hello Lonesome,250,15,2010.0,Comedy/Drama,0 days 01:31:00.000000000,14
67,100,,Foreign Parts,1,5,2010.0,Documentary/Drama,0 days 01:20:00.000000000,33
52,63,,Griff the Invisible,2500,57,2010.0,Romance/Comedy,0 days 01:33:00.000000000,11
51,87,https://resizing.flixster.com/JcSNzn8EEDr0lreG-h-xUc43e6U=/206x305/v2/https://flxt.tmsimg.com/assets/p8534750_p_v10_aa.jpg,Viva Riva!,500,60,2010.0,Drama,0 days 01:36:00.000000000,36
77,33,,Habermann,100,6,2010.0,Romance/Drama,0 days 01:44:00.000000000,-44
66,79,,The Robber,500,33,2010.0,Crime/Drama,0 days 01:30:00.000000000,13
87,91,,Fire in Babylon,500,23,2010.0,Documentary,0 days 01:23:00.000000000,4
49,80,,Young Adult,25000,195,2011.0,Romance/Comedy,0 days 01:34:00.000000000,31
25,3,https://resizing.flixster.com/c7eKEqXC__J8S8rZWqcmbHtAoG0=/206x305/v2/https://flxt.tmsimg.com/assets/p8045330_p_v10_ak.jpg,Bucky Larson: Born to Be a Star,10000,36,2011.0,Comedy,0 days 01:36:00.000000000,-22
39,59,,Wanderlust,25000,146,2012.0,Comedy,0 days 01:38:00.000000000,20
0,33,,Satan Hates You,250,6,2010.0,Horror,0 days 01:34:00.000000000,33
91,93,,Elite Squad 2,5000,45,2010.0,Crime/Action,0 days 01:56:00.000000000,2
72,55,,Spork,500,11,2010.0,Comedy/Musical,0 days 01:26:00.000000000,-17
12,22,,Spiderhole,1000,9,2009.0,Horror,0 days 01:22:00.000000000,10
17,17,,Twelve Thirty,100,12,2010.0,Drama,0 days 02:00:00.000000000,0
53,47,,Mr. Popper's Penguins,50000,145,2011.0,Kids and family/Comedy,0 days 01:34:00.000000000,-6
65,64,,Goethe!,500,36,2010.0,Drama,0 days 01:40:00.000000000,-1
49,67,/assets/pizza-pie/images/poster_default.c8c896e70c3.gif,Friends With Kids,25000,153,2011.0,Romance,0 days 01:40:00.000000000,18
76,91,https://resizing.flixster.com/P21dlkTVsvHLCyNIBY0C4O6cpos=/206x305/v2/https://flxt.tmsimg.com/assets/p8592851_p_v8_aa.jpg,Point Blank,5000,79,2010.0,Crime/Action,0 days 01:24:00.000000000,15
60,33,,Amador,100,6,2010.0,Drama,0 days 01:52:00.000000000,-27
79,42,https://resizing.flixster.com/q21b8SRWsgPmbg8nwqY4Hsf7tqQ=/206x305/v2/https://flxt.tmsimg.com/assets/p8382666_p_v7_af.jpg,Jane's Journey,250,12,2010.0,Documentary,0 days 01:46:00.000000000,-37
52,63,https://resizing.flixster.com/vH__S7P1I6v-IIub8a7qVIgVHRQ=/206x305/v2/https://flxt.tmsimg.com/assets/p8649824_p_v8_aa.jpg,We Are the Night,5000,16,2010.0,Horror,0 days 01:40:00.000000000,11
71,81,,Goon,10000,106,2011.0,Comedy/Biography,0 days 01:31:00.000000000,10
63,53,,Safe House,100000,193,2012.0,Action/Mystery and thriller,0 days 01:55:00.000000000,-10
63,31,https://resizing.flixster.com/aUUDF-bIz4uegLl5KdjkcwWvX9I=/206x305/v2/https://flxt.tmsimg.com/assets/p8786369_p_v10_au.jpg,The Vow,100000,135,2012.0,Romance/Drama,0 days 01:44:00.000000000,-32
74,85,,Make Believe,1000,20,2010.0,Documentary,0 days 01:29:00.000000000,11
37,17,https://resizing.flixster.com/9BxPQgtDh7r0inC4D743eczNY-0=/206x305/v2/https://flxt.tmsimg.com/assets/p8867141_p_v8_aa.jpg,Breakaway,500,6,2011.0,Comedy,0 days 01:41:00.000000000,-20
62,75,,The Human Resources Manager,250,32,2010.0,Drama,0 days 01:43:00.000000000,13
73,86,/assets/pizza-pie/images/poster_default.c8c896e70c3.gif,Romantics Anonymous,2500,35,2010.0,Romance,0 days 01:20:00.000000000,13
86,92,,Zindagi Na Milegi Dobara,2500,13,2011.0,Comedy/Drama,0 days 02:35:00.000000000,6
51,12,https://resizing.flixster.com/0Bkem-0ZA4kx38HsEI_YuNYXrnQ=/206x305/v2/https://flxt.tmsimg.com/assets/p8718307_p_v10_aa.jpg,Alvin and the Chipmunks: Chipwrecked,50000,82,2011.0,Kids and family/Adventure,0 days 01:27:00.000000000,-39
71,83,,My Week With Marilyn,25000,187,2011.0,Drama,0 days 01:41:00.000000000,12
23,23,https://resizing.flixster.com/KQYGibPHsbH1TNjwqA8WcIZZ9QU=/206x305/v2/https://flxt.tmsimg.com/assets/p8401072_p_v10_ax.jpg,Apollo 18,25000,74,2011.0,Sci fi/Mystery and thriller,0 days 01:26:00.000000000,0
95,93,,Senna,10000,122,2010.0,Documentary,0 days 01:44:00.000000000,-2
44,57,https://resizing.flixster.com/X7pyB8ReIoIGxfK_cBDrdQCagKI=/206x305/v2/https://flxt.tmsimg.com/assets/p8915813_p_v8_am.jpg,The Dictator,100000,221,2012.0,Comedy,0 days 01:23:00.000000000,13
78,72,,The Names of Love,1000,53,2010.0,Romance,0 days 01:24:00.000000000,-6
29,55,https://resizing.flixster.com/6fpfVMlkaumVWr1ImNFMaEmlpQ0=/206x305/v2/https://flxt.tmsimg.com/assets/p8815408_p_v10_ac.jpg,Saint,250,11,2010.0,Comedy/Horror,0 days 01:26:00.000000000,26
51,66,,Paranormal Activity 3,50000,125,2011.0,Horror/Mystery and thriller,0 days 01:21:00.000000000,15
84,98,https://resizing.flixster.com/-6L3qfWmrTHuxV7k16ZzwwH6kAU=/206x305/v2/https://flxt.tmsimg.com/assets/p8395259_p_v13_ah.jpg,Born to Be Wild,10000,50,2011.0,Documentary,0 days 00:40:00.000000000,14
45,38,https://resizing.flixster.com/NIAYEoXnemeeJRZcdenkUaNzOOU=/206x305/v2/https://flxt.tmsimg.com/assets/p8419061_p_v10_ad.jpg,Johnny English Reborn,25000,92,2011.0,Comedy/Action,0 days 01:42:00.000000000,-7
42,79,,The Innkeepers,50000,121,2011.0,Horror/Mystery and thriller,0 days 01:41:00.000000000,37
72,76,,Let the Bullets Fly,2500,33,2010.0,Western/Comedy,0 days 02:12:00.000000000,4
54,67,https://resizing.flixster.com/1baHstyBE0SwL20mnhu96ZXdQUY=/206x305/v2/https://flxt.tmsimg.com/assets/p8694014_p_v13_al.jpg,The Woman in Black,50000,194,2012.0,Horror/Mystery and thriller,0 days 01:35:00.000000000,13
85,95,https://resizing.flixster.com/YmPEWasDT2cOnQ_TaaHg4Xkv71U=/206x305/v2/https://flxt.tmsimg.com/NowShowing/109188/109188_aa.jpg,The Secret World of Arrietty,10000,151,2010.0,Fantasy/Kids and family,0 days 01:35:00.000000000,10
22,13,https://resizing.flixster.com/7YzgTBzDKD7P5ijBWVnkblbhbq0=/206x305/v2/https://flxt.tmsimg.com/assets/p8720061_p_v8_ah.jpg,Piranha 3DD,10000,53,2012.0,Horror,0 days 01:23:00.000000000,-9
51,36,,In Time,50000,173,2011.0,Action/Sci fi,0 days 01:49:00.000000000,-15
53,78,,Attenberg,1000,46,2010.0,Drama,0 days 01:35:00.000000000,25
55,35,https://resizing.flixster.com/JMa_FeEMYV_uyUd6KQ01nazbtxE=/206x305/v2/https://flxt.tmsimg.com/assets/p8176375_p_v10_aw.jpg,Transformers: Dark of the Moon,250000,263,2011.0,Action/Sci fi,0 days 02:34:00.000000000,-20
40,46,https://resizing.flixster.com/buBVCvUxlSd5IQHMfl7SaCEk25E=/206x305/v2/https://flxt.tmsimg.com/assets/p8576320_p_v8_aa.jpg,"The Butcher, the Chef, and the Swordsman",500,13,2010.0,Action/Sports and fitness,0 days 01:35:00.000000000,6
65,83,,Tinker Tailor Soldier Spy,50000,229,2011.0,Mystery and thriller,0 days 02:07:00.000000000,18
23,32,,Intruders,5000,73,2011.0,Horror/Mystery and thriller,0 days 01:39:00.000000000,9
51,14,,LOL,10000,7,2012.0,Comedy/Drama,0 days 01:37:00.000000000,-37
44,43,,J. Edgar,25000,247,2011.0,Drama/History,0 days 02:17:00.000000000,-1
17,7,,11-11-11,2500,14,2011.0,Horror/Mystery and thriller,0 days 01:22:00.000000000,-10
87,95,https://resizing.flixster.com/urUHtCGmMLO3RaZro9efmkomTq4=/206x305/v2/https://flxt.tmsimg.com/assets/p8717762_p_v8_aa.jpg,Being Elmo: A Puppeteer's Journey,10000,78,2011.0,Documentary,0 days 01:25:00.000000000,8
66,66,,Another Earth,10000,135,2011.0,Sci fi/Drama,0 days 01:32:00.000000000,0
62,82,https://resizing.flixster.com/LYpQ592QPQIFIMHOqVyfDg__vts=/206x305/v2/https://flxt.tmsimg.com/assets/p8628101_p_v8_ab.jpg,Higher Ground,2500,93,2011.0,Drama,0 days 01:54:00.000000000,20
48,14,,The Ledge,2500,29,2011.0,Drama/Mystery and thriller,0 days 01:41:00.000000000,-34
61,72,,Like Crazy,10000,155,2011.0,Romance/Drama,0 days 01:29:00.000000000,11
71,90,https://resizing.flixster.com/pTu1ECabjXYxydsNXXrHeteMLB0=/206x305/v2/https://resizing.flixster.com/kS5SGk9TCRDrtNbkJzwf8xjb8ug=/ems.ZW1zLXByZC1hc3NldHMvbW92aWVzLzEwMTdkMGE0LTRlOTItNGJmMC04ZGM5LWViMzY5ZjM1ZTJhOS5qcGc=,Martha Marcy May Marlene,10000,211,2011.0,Drama/Mystery and thriller,0 days 01:41:00.000000000,19
62,67,https://resizing.flixster.com/RxMeDOc0IlPQg6VcV0FMEQzOfNU=/206x305/v2/https://resizing.flixster.com/nH2KJV7e-BM2HTsiN8QNd4UviVI=/ems.ZW1zLXByZC1hc3NldHMvbW92aWVzL2IyNjUzNzE4LTZmNWQtNDhjYy05NDc4LTA0ZTJkMWFlNzkzMy5qcGc=,On the Ice,500,15,2011.0,Drama/Mystery and thriller,0 days 01:36:00.000000000,5
81,92,,Take Shelter,25000,166,2011.0,Drama/Mystery and thriller,0 days 02:04:00.000000000,11
89,90,,Buck,2500,105,2011.0,Documentary,0 days 01:28:00.000000000,1
62,68,,Shut Up Little Man! An Audio Misadventure,500,31,2011.0,Comedy/Drama,0 days 01:25:00.000000000,6
85,83,https://resizing.flixster.com/V_7imJL8ZR35L63DKrSKppgIzDE=/206x305/v2/https://flxt.tmsimg.com/assets/p8477240_p_v8_aa.jpg,Tyrannosaur,5000,86,2011.0,Drama,0 days 01:31:00.000000000,-2
84,97,https://resizing.flixster.com/X6CA_KvHjCKlhhZyZPftTly9SF4=/206x305/v2/https://flxt.tmsimg.com/assets/p8601597_p_v13_aa.jpg,Project Nim,10000,146,2011.0,Documentary,0 days 01:39:00.000000000,13
79,95,,Sing Your Song,1000,40,2011.0,Documentary/Music,0 days 01:43:00.000000000,16
81,65,,Resurrect Dead: The Mystery of the Toynbee Tiles,500,20,2011.0,Documentary,0 days 01:26:00.000000000,-16
75,79,https://resizing.flixster.com/-izwVXnDn6slbt4i5RdjDhQ0khE=/206x305/v2/https://flxt.tmsimg.com/assets/p8667505_p_v10_ab.jpg,Page One: Inside The New York Times,1000,112,2011.0,Documentary,0 days 01:28:00.000000000,4
83,81,,The Last Mountain,500,42,2011.0,Documentary,0 days 01:35:00.000000000,-2
79,92,https://resizing.flixster.com/Zl1Bl_lKTEDP8fBbjT_MaA8UWIo=/206x305/v2/https://resizing.flixster.com/xQQsLC7IJypTxyRXeOvnPwdEWwE=/ems.ZW1zLXByZC1hc3NldHMvbW92aWVzLzE0ZWFjM2Y1LTYzNTYtNGIwNS1iNGU2LTk0NTA2MGQ3NjY3NC53ZWJw,Drive,100000,266,2011.0,Drama/Action,0 days 01:40:00.000000000,13
57,51,https://resizing.flixster.com/CQwRCuvPn2o9mPhAzZbV7DFtRHs=/206x305/v2/https://flxt.tmsimg.com/assets/p8780575_p_v10_aa.jpg,Contraband,50000,165,2012.0,Action/Mystery and thriller,0 days 01:50:00.000000000,-6
73,41,https://resizing.flixster.com/rh8mYW9w8QRLddNyWhlDaoNmgoo=/206x305/v2/https://flxt.tmsimg.com/assets/p8933604_p_v10_aa.jpg,The Flowers of War,5000,58,2011.0,War/Drama,0 days 02:21:00.000000000,-32
58,67,,ReGeneration,100,6,2010.0,Documentary,0 days 01:21:00.000000000,9
52,4,,A Little Bit of Heaven,10000,55,2011.0,Romance/Comedy,0 days 01:46:00.000000000,-48
55,73,,The Woman,2500,51,2011.0,Horror,0 days 01:42:00.000000000,18
85,75,,These Amazing Shadows,500,12,2011.0,Documentary,0 days 01:26:00.000000000,-10
71,74,,Shaolin,5000,27,2011.0,Action/Drama,0 days 02:11:00.000000000,3
51,70,,Our Idiot Brother,25000,143,2011.0,Comedy,0 days 01:36:00.000000000,19
43,56,,Septien,100,16,2011.0,Drama,0 days 01:19:00.000000000,13
44,46,,Another Happy Day,1000,35,2011.0,Comedy/Drama,0 days 01:55:00.000000000,2
74,87,,Margin Call,10000,172,2011.0,Drama/Mystery and thriller,0 days 01:49:00.000000000,13
61,88,https://resizing.flixster.com/POSqEl951xmDWI6C82IiK17qRt8=/206x305/v2/https://flxt.tmsimg.com/assets/p8838888_p_v8_aa.jpg,Post Mortem,2500,34,2010.0,Drama,0 days 01:36:00.000000000,27
63,73,,Bellflower,5000,94,2011.0,Romance/Drama,0 days 01:45:00.000000000,10
88,87,https://resizing.flixster.com/CyEDrYc-4wpazLcNpKzgnMbqKEc=/206x305/v2/https://flxt.tmsimg.com/assets/p8390242_p_v10_aa.jpg,The Last Lions,1000,38,2011.0,Documentary,0 days 01:28:00.000000000,-1
67,67,https://resizing.flixster.com/0OTWZxQxhRnHUkc7_dSp-Ti9cy8=/206x305/v2/https://flxt.tmsimg.com/assets/p8697821_p_v8_aa.jpg,Service Entrance,1000,67,2010.0,Comedy,0 days 01:44:00.000000000,0
29,0,,What Women Want,250,5,2011.0,Romance/Comedy,0 days 01:56:00.000000000,-29
23,40,,Age of Heroes,1000,5,2011.0,Drama/War,0 days 01:30:00.000000000,17
78,75,,We Need to Talk About Kevin,25000,210,2011.0,Drama,0 days 01:51:00.000000000,-3
82,91,,Crime After Crime,500,34,2011.0,Crime/Documentary,0 days 01:35:00.000000000,9
60,58,,Perfect Sense,5000,64,2011.0,Romance/Drama,0 days 01:32:00.000000000,-2
22,15,https://resizing.flixster.com/O3VltCYhWLDlZwvcLntT-NGfvhA=/206x305/v2/https://flxt.tmsimg.com/assets/p8765895_p_v10_af.jpg,The Son of No One,5000,39,2011.0,Crime/Drama,0 days 01:35:00.000000000,-7
60,87,https://resizing.flixster.com/FBL1KBQ59MebcGaXGiFXkco4WmM=/206x305/v2/https://flxt.tmsimg.com/assets/p8611150_p_v8_aa.jpg,Terri,5000,98,2011.0,Comedy/Drama,0 days 01:45:00.000000000,27
42,16,https://resizing.flixster.com/u8sVCQJlh-7-g3u5UOKcb6tm_q4=/206x305/v2/https://flxt.tmsimg.com/assets/p8691594_p_v8_af.jpg,Flypaper,2500,19,2011.0,Crime/Comedy,0 days 01:24:00.000000000,-26
54,72,https://resizing.flixster.com/niSex1OvCbAHBSUYX-smjjpSQLs=/206x305/v2/https://flxt.tmsimg.com/assets/p8601690_p_v8_aa.jpg,The Future,2500,111,2011.0,Drama,0 days 01:31:00.000000000,18
81,94,,The Guard,25000,137,2011.0,Comedy/Mystery and thriller,0 days 01:35:00.000000000,13
49,71,,Here,2500,14,2011.0,Romance/Drama,0 days 02:06:00.000000000,22
46,19,,The Art of Getting By,10000,113,2011.0,Comedy/Drama,0 days 01:24:00.000000000,-27
43,16,,I Melt With You,1000,45,2011.0,Mystery and thriller,0 days 02:09:00.000000000,-27
79,80,,Life in a Day,10000,76,2011.0,Documentary,0 days 01:35:00.000000000,1
64,79,https://resizing.flixster.com/kSnKU-8yjMN0tLiUegEoryyjK4M=/206x305/v2/https://flxt.tmsimg.com/assets/p8680672_p_v10_ab.jpg,The Mill and the Cross,500,42,2011.0,Drama/History,0 days 01:35:00.000000000,15
86,88,,Bobby Fischer Against the World,1000,51,2011.0,Documentary,0 days 01:32:00.000000000,2
43,47,,The Catechism Cataclysm,100,19,2011.0,Comedy,0 days 01:21:00.000000000,4
67,93,https://resizing.flixster.com/veRlSdeEN2cCX0wKpEWCyB3SPT8=/206x305/v2/https://flxt.tmsimg.com/assets/p8778360_p_v8_aa.jpg,Knuckle,2500,44,2011.0,Documentary/Drama,0 days 01:33:00.000000000,26
48,74,https://resizing.flixster.com/YGZEfFQtogi3b_euDOAEAol6M6k=/206x305/v2/https://flxt.tmsimg.com/assets/p8820372_p_v8_ab.jpg,The Lie,500,19,2011.0,Comedy/Drama,0 days 01:22:00.000000000,26
82,95,,Pariah,5000,119,2011.0,Gay and lesbian/Drama,0 days 01:26:00.000000000,13
30,43,,Silent House,25000,135,2011.0,Horror/Mystery and thriller,0 days 01:28:00.000000000,13
59,85,,"Happy, Happy",500,48,2010.0,Comedy/Drama,0 days 01:28:00.000000000,26
68,86,https://resizing.flixster.com/ruyX78b2uGjk8Fp7EaX71SS3cTQ=/206x305/v2/https://flxt.tmsimg.com/assets/p8590695_p_v10_av.jpg,Circumstance,5000,79,2011.0,Gay and lesbian/Drama,0 days 01:45:00.000000000,18
84,92,,Corman's World: Exploits of a Hollywood Rebel,1000,51,2011.0,Documentary,0 days 01:35:00.000000000,8
69,83,,The Flaw,100,12,2011.0,Documentary/Drama,0 days 01:22:00.000000000,14
69,100,,Hell and Back Again,2500,31,2011.0,Documentary,0 days 01:28:00.000000000,31
68,80,,Jess & Moss,100,5,2011.0,Drama,0 days 01:23:00.000000000,12
73,100,/assets/pizza-pie/images/poster_default.c8c896e70c3.gif,The Colors of the Mountain,250,8,2010.0,Drama,0 days 01:30:00.000000000,27
34,50,,My Piece of the Pie,250,14,2011.0,Comedy/Drama,0 days 01:49:00.000000000,16
36,46,https://resizing.flixster.com/mfvGNuZuPZFyqQCG74NsYIfymLk=/206x305/v2/https://flxt.tmsimg.com/assets/p8883625_p_v8_aa.jpg,A Year in Mooring,100,13,2011.0,Drama,0 days 01:28:00.000000000,10
32,17,https://resizing.flixster.com/0o8sdv_dgdjuMXTGdQ1SLEHo64w=/206x305/v2/https://flxt.tmsimg.com/assets/p8632649_p_v8_ad.jpg,I Don't Know How She Does It,10000,113,2011.0,Comedy,0 days 01:31:00.000000000,-15
48,52,https://resizing.flixster.com/g-qEUZMAr1q8ol5wWzClgI9eTVY=/206x305/v2/https://flxt.tmsimg.com/assets/p8571283_p_v8_aj.jpg,Vallanzasca,250,25,2010.0,Crime/Drama,0 days 02:05:00.000000000,4
33,20,,Cat Run,1000,15,2011.0,Action/Comedy,0 days 01:42:00.000000000,-13
88,94,https://resizing.flixster.com/cfdUa0xzl1_JRBrZNJQJBpL09es=/206x305/v2/https://flxt.tmsimg.com/assets/p8635546_p_v10_ad.jpg,King of Devil's Island,2500,49,2010.0,Drama/History,0 days 01:52:00.000000000,6
44,50,,Mirror Mirror,100000,198,2012.0,Fantasy/Comedy,0 days 01:46:00.000000000,6
80,68,,The Sunset Limited,1000,28,2011.0,Drama,0 days 01:31:00.000000000,-12
52,62,https://resizing.flixster.com/MMEm2s4jI6BeEpuYdYR0pfue-V4=/206x305/v2/https://flxt.tmsimg.com/assets/p8447466_p_v10_ab.jpg,Toast,1000,34,2010.0,Comedy/Drama,0 days 01:36:00.000000000,10
80,92,https://resizing.flixster.com/8KazDja_1MkmgeSCCCW_AiUefZc=/206x305/v2/https://flxt.tmsimg.com/assets/p8547182_p_v8_aa.jpg,Circo,500,26,2010.0,Documentary,0 days 01:15:00.000000000,12
41,21,,Judy Moody and the NOT Bummer Summer,10000,82,2011.0,Comedy/Kids and family,0 days 01:27:00.000000000,-20
68,82,https://resizing.flixster.com/APJuzMW5vOjPJVv3k8ahGRr4ELI=/206x305/v2/https://flxt.tmsimg.com/assets/p9134074_p_v10_aa.jpg,Get the Gringo,5000,56,2012.0,Action/Mystery and thriller,0 days 01:36:00.000000000,14
46,38,,Lockout,100000,138,2012.0,Action/Sci fi,0 days 01:35:00.000000000,-8
40,33,https://resizing.flixster.com/1_PmQV_0Q8g6MCwBLCjfC8n0hgw=/206x305/v2/https://flxt.tmsimg.com/assets/p8596687_p_v8_aa.jpg,Meeting Spencer,50,12,2011.0,Comedy,0 days 01:26:00.000000000,-7
70,89,,The Trip,5000,108,2010.0,Comedy,0 days 01:49:00.000000000,19
62,72,/assets/pizza-pie/images/poster_default.c8c896e70c3.gif,Magic Trip: Ken Kesey's Search for a Kool Place,2500,61,2011.0,Documentary,0 days 01:30:00.000000000,10
82,99,https://resizing.flixster.com/gdcFWpg04S-XUhaW2Ug2vrQLsiU=/206x305/v2/https://flxt.tmsimg.com/assets/p8566531_p_v8_aa.jpg,The Interrupters,5000,93,2011.0,Crime/Documentary,0 days 02:05:00.000000000,17
20,0,https://resizing.flixster.com/EzGXWR0E9PDY6fRfOezqgDuywmQ=/206x305/v2/https://flxt.tmsimg.com/assets/p8715191_p_v10_ag.jpg,Swinging With the Finkels,500,19,2010.0,Romance/Comedy,0 days 01:25:00.000000000,-20
79,92,,Rebirth,100,13,2011.0,Documentary,0 days 01:44:00.000000000,13
60,39,https://resizing.flixster.com/I7cQqI4bviGGNuhQC4s9nkIm9To=/206x305/v2/https://flxt.tmsimg.com/assets/p8843244_p_v8_aa.jpg,You Instead,2500,46,2011.0,Romance,0 days 01:20:00.000000000,-21
70,53,https://resizing.flixster.com/J6PpDcGvYRmtkroBkMhTOW9COmY=/206x305/v2/https://flxt.tmsimg.com/assets/p8792070_p_v10_af.jpg,The Inbetweeners Movie,10000,51,2011.0,Comedy,0 days 01:37:00.000000000,-17
43,50,https://resizing.flixster.com/1aoHZesJ7Bldzd-MSg7t6fzsqw8=/206x305/v2/https://flxt.tmsimg.com/assets/p8550931_p_v10_aa.jpg,Dum Maaro Dum,500,6,2011.0,Mystery and thriller,,7
86,92,,The Black Power Mixtape 1967-1975,1000,53,2011.0,Documentary/Drama,0 days 01:40:00.000000000,6
54,85,,Under the Boardwalk: The Monopoly Story,100,13,2010.0,Documentary,0 days 01:28:00.000000000,31
61,75,https://resizing.flixster.com/et64KaiM11UCO0McbQbqeQts63U=/206x305/v2/https://flxt.tmsimg.com/assets/p8767827_p_v10_as.jpg,Blackthorn,1000,75,2011.0,Western/Action,0 days 01:38:00.000000000,14
88,93,https://resizing.flixster.com/inho9g2D7c2mbBGqTtjmT1_hUK4=/206x305/v2/https://flxt.tmsimg.com/assets/p8559465_p_v10_aa.jpg,50/50,50000,200,2011.0,Comedy/Drama,0 days 01:39:00.000000000,5
73,83,https://resizing.flixster.com/lIXcXyUIr5FM1-Wov24NLruOCJY=/206x305/v2/https://flxt.tmsimg.com/assets/p8578508_p_v13_ak.jpg,The Ides of March,50000,247,2011.0,Drama,0 days 01:40:00.000000000,10
41,51,,Being Flynn,2500,84,2012.0,Drama/Comedy,0 days 01:42:00.000000000,10
53,33,https://resizing.flixster.com/R9F0R_VjM8jTTOifZrkB5V5sxfs=/206x305/v2/https://flxt.tmsimg.com/assets/p8581516_p_v10_af.jpg,Dirty Girl,5000,40,2010.0,Comedy/Drama,0 days 01:46:00.000000000,-20
50,71,,My Sucky Teen Romance,50,7,2011.0,Comedy,0 days 01:17:00.000000000,21
51,60,,How to Live Forever,250,20,2009.0,Documentary,0 days 01:32:00.000000000,9
52,62,https://resizing.flixster.com/M3OdfmMtTHj4rl0R_jqkwnO0jIQ=/206x305/v2/https://flxt.tmsimg.com/assets/p8637190_p_v10_aa.jpg,The Dish & the Spoon,100,13,2011.0,Comedy/Drama,0 days 01:32:00.000000000,10
86,95,https://resizing.flixster.com/2kN1_NNNpvhlOFN6TrW9zGME3Nw=/206x305/v2/https://flxt.tmsimg.com/assets/p8773646_p_v13_af.jpg,Weekend,5000,85,2011.0,Romance/Gay and lesbian,0 days 01:36:00.000000000,9
50,78,,The Conquest,500,32,2011.0,Biography,0 days 01:50:00.000000000,28
41,13,,When Harry Tries to Marry,1000,8,2011.0,Romance,0 days 01:33:00.000000000,-28
55,80,https://resizing.flixster.com/FUH0sMeQqkEzE_8J7zL1jSeXXoU=/206x305/v2/https://flxt.tmsimg.com/assets/p8608429_p_v13_aa.jpg,35 & Ticking,1000,5,2011.0,Romance,0 days 01:30:00.000000000,25
68,82,https://resizing.flixster.com/wbmmEzl9x7fw0D2OB7-yL8GXBoU=/206x305/v2/https://flxt.tmsimg.com/assets/p8605006_p_v8_aa.jpg,Conan O'Brien Can't Stop,10000,77,2011.0,Documentary,0 days 01:29:00.000000000,14
78,100,https://resizing.flixster.com/Denmxq_1UUnQ3vWl6gRmBKhZy8Q=/206x305/v2/https://flxt.tmsimg.com/assets/p8637176_p_v8_aa.jpg,Better This World,100,10,2011.0,Documentary,0 days 01:22:00.000000000,22
42,75,,Cold Sweat,100,12,2010.0,Horror/Mystery and thriller,0 days 01:30:00.000000000,33
54,50,,The FP,500,24,2011.0,Comedy,0 days 01:22:00.000000000,-4
46,41,,Detention,10000,44,2011.0,Comedy/Horror,0 days 01:29:00.000000000,-5
72,66,https://resizing.flixster.com/EOM4yLwgBwe5gktB0inHVKj6vC0=/206x305/v2/https://flxt.tmsimg.com/assets/p8594038_p_v8_aa.jpg,Hit So Hard,250,38,2011.0,Documentary/Biography,0 days 01:43:00.000000000,-6
79,87,,The Descendants,50000,267,2011.0,Comedy/Drama,0 days 01:55:00.000000000,8
66,62,,A Bag of Hammers,250,21,2011.0,Comedy/Drama,0 days 01:25:00.000000000,-4
58,78,,Kill List,5000,95,2011.0,Horror/Mystery and thriller,0 days 01:34:00.000000000,20
92,99,,A Separation,10000,179,2011.0,Drama,0 days 02:03:00.000000000,7
87,90,,Carol Channing: Larger Than Life,250,31,2011.0,Documentary,0 days 01:23:00.000000000,3
64,67,,Limelight,250,21,2011.0,Documentary,0 days 01:32:00.000000000,3
36,50,,The Perfect Family,2500,34,2011.0,Comedy/Drama,0 days 01:24:00.000000000,14
54,52,,Puncture,2500,42,2011.0,Drama/History,0 days 01:40:00.000000000,-2
70,69,https://resizing.flixster.com/0pJW0U9vg6jvwX7-6KGfY_Sta8s=/206x305/v2/https://flxt.tmsimg.com/assets/p8727152_p_v10_aa.jpg,Revenge of the Electric Car,1000,42,2011.0,Documentary,0 days 01:30:00.000000000,-1
25,40,,The Bleeding House,250,5,2010.0,Horror/Mystery and thriller,0 days 01:35:00.000000000,15
62,69,,Black Butterflies,500,13,2011.0,Drama,0 days 01:40:00.000000000,7
47,22,https://resizing.flixster.com/QOBRy1y1a3Fb1RlkdZKEmwjkbyI=/206x305/v2/https://flxt.tmsimg.com/assets/p9159887_p_v10_av.jpg,Jesus Henry Christ,2500,23,2011.0,Comedy,0 days 01:32:00.000000000,-25
91,99,https://resizing.flixster.com/VYkl5AsluUyECbs6oliD0huZvAk=/206x305/v2/https://flxt.tmsimg.com/NowShowing/108019/108019_aa.jpg,Jiro Dreams of Sushi,25000,95,2011.0,Documentary,0 days 01:21:00.000000000,8
45,50,,96 Minutes,2500,18,2011.0,Drama/Mystery and thriller,0 days 01:33:00.000000000,5
39,70,https://resizing.flixster.com/QxpkETeL_FFY7AE4ABvx9CpT-Xc=/206x305/v2/https://flxt.tmsimg.com/assets/p8701459_p_v10_aa.jpg,Turkey Bowl,50,10,2011.0,Comedy,0 days 01:04:00.000000000,31
80,67,https://resizing.flixster.com/e4oXdQTymrtOJq_y4tRGICdliw0=/206x305/v2/https://flxt.tmsimg.com/assets/p8773418_p_v10_aa.jpg,God Bless Ozzy Osbourne,250,6,2010.0,Documentary,0 days 01:31:00.000000000,-13
31,68,,Roadie,500,28,2011.0,Drama,0 days 01:35:00.000000000,37
49,67,https://resizing.flixster.com/X77OBnVNfZpqkkyll3E0Zp2iC0M=/206x305/v2/https://flxt.tmsimg.com/assets/p8755034_p_v10_ag.jpg,Grave Encounters,5000,15,2010.0,Horror/Mystery and thriller,0 days 01:32:00.000000000,18
65,74,,The Last Rites of Joe May,1000,19,2011.0,Drama,0 days 01:42:00.000000000,9
76,80,/assets/pizza-pie/images/poster_default.c8c896e70c3.gif,Becoming Santa,500,5,2010.0,Other/Documentary,0 days 01:37:00.000000000,4
66,84,,The Snowtown Murders,5000,73,2011.0,Crime/Drama,0 days 02:00:00.000000000,18
62,28,,Machine Gun Preacher,10000,116,2011.0,Drama/Biography,0 days 02:07:00.000000000,-34
62,57,,Boy Wonder,1000,7,2010.0,Crime/Action,0 days 01:33:00.000000000,-5
71,40,,Planeat,100,5,2010.0,Documentary,0 days 01:27:00.000000000,-31
64,40,,Falling Overnight,250,5,2011.0,Drama,0 days 01:28:00.000000000,-24
49,44,,Kidnapped,5000,25,2010.0,Horror/Mystery and thriller,0 days 01:25:00.000000000,-5
78,64,,Vincent Wants to Sea,250,22,2010.0,Drama,0 days 01:36:00.000000000,-14
82,96,,Tomboy,5000,70,2011.0,Drama,0 days 01:24:00.000000000,14
67,61,,Fightville,250,18,2011.0,Documentary,0 days 01:25:00.000000000,-6
82,86,,The Pruitt-Igoe Myth,250,22,2011.0,Documentary,0 days 01:23:00.000000000,4
38,60,https://resizing.flixster.com/TXY0qAGsSdBEk66U7Y7oVP-mgkA=/206x305/v2/https://flxt.tmsimg.com/assets/p8647989_p_v10_aa.jpg,The Veteran,500,20,2011.0,Action/Mystery and thriller,0 days 01:38:00.000000000,22
29,56,https://resizing.flixster.com/Ek8vOgAG6_UMH1E4UTMztrjasiE=/206x305/v2/https://flxt.tmsimg.com/assets/p8615768_p_v10_aa.jpg,Atrocious,1000,18,2010.0,Horror/Mystery and thriller,0 days 01:15:00.000000000,27
40,57,,It's About You,100,14,2012.0,Documentary,0 days 01:20:00.000000000,17
49,60,,El Bulli: Cooking in Progress,500,47,2010.0,Documentary,0 days 01:48:00.000000000,11
53,73,,Newlyweds,500,11,2011.0,Comedy/Drama,0 days 01:35:00.000000000,20
48,82,,Rabies,250,11,2010.0,Horror,0 days 01:30:00.000000000,34
71,85,https://resizing.flixster.com/fU9GWytWr71P_vuyK7-izAZfUsE=/206x305/v2/https://flxt.tmsimg.com/assets/p8786283_p_v13_ai.jpg,Chronicle,100000,185,2012.0,Sci fi/Drama,0 days 01:24:00.000000000,14
18,0,https://resizing.flixster.com/-t16KQqgDhPos8XEnvfeDksYu9g=/206x305/v2/https://flxt.tmsimg.com/assets/p8666007_p_v7_ag.jpg,World of the Dead: The Zombie Diaries 2,1000,7,2011.0,Horror,0 days 01:28:00.000000000,-18
68,57,https://resizing.flixster.com/0zvKxp4bYgKKHFsHiBrTJm9uhXs=/206x305/v2/https://flxt.tmsimg.com/assets/p8725080_p_v8_aa.jpg,Talihina Sky: The Story of Kings of Leon,250,7,2011.0,Documentary,0 days 01:27:00.000000000,-11
32,48,https://resizing.flixster.com/O50H9Hted0OGOUr4t4uIulaRNus=/206x305/v2/https://flxt.tmsimg.com/assets/p8845545_p_v8_ac.jpg,Sleeping Beauty,50000,97,2010.0,Drama,0 days 01:41:00.000000000,16
73,96,,One Lucky Elephant,500,27,2009.0,Documentary,0 days 01:24:00.000000000,23
36,5,,Hick,5000,22,2011.0,Drama/Mystery and thriller,0 days 01:42:00.000000000,-31
90,69,https://resizing.flixster.com/DIAAh1ZLiyl-5j3ezR8mi2-5-qk=/206x305/v2/https://flxt.tmsimg.com/assets/p8587490_p_v13_aa.jpg,The Sons of Tennessee Williams,250,13,2010.0,Documentary/Drama,0 days 01:20:00.000000000,-21
28,0,,"Love, Wedding, Marriage",2500,19,2011.0,Comedy,0 days 01:30:00.000000000,-28
71,63,https://resizing.flixster.com/nCRAhcdXor_VBjhgC5YP9QM_3F4=/206x305/v2/https://flxt.tmsimg.com/assets/p8654231_p_v10_aa.jpg,Jig,500,41,2011.0,Documentary,0 days 01:33:00.000000000,-8
44,40,/assets/pizza-pie/images/poster_default.c8c896e70c3.gif,The Warring States,100,5,2011.0,War/Drama,0 days 02:05:00.000000000,-4
74,92,,Once Upon A Time in Anatolia,5000,79,2011.0,Drama,0 days 02:37:00.000000000,18
38,22,https://resizing.flixster.com/aj9DDTOar2FaKkptI7z4_KfIiKk=/206x305/v2/https://flxt.tmsimg.com/assets/p8881734_p_v8_aa.jpg,Angels Crest,500,23,2011.0,Drama,0 days 01:33:00.000000000,-16
39,67,,Ek Main Aur Ekk Tu,1000,9,2012.0,Romance,0 days 01:50:00.000000000,28
36,86,,Caught Inside,100,7,2010.0,Mystery and thriller/Action,0 days 01:33:00.000000000,50
60,61,https://resizing.flixster.com/hnMTaCP_KVNXb8PbMGOqtUn-g5s=/206x305/v2/https://flxt.tmsimg.com/assets/p8553870_p_v10_ac.jpg,Cinema Verite,500,41,2011.0,Drama,0 days 01:30:00.000000000,1
66,70,,Carnage,10000,198,2011.0,Comedy/Drama,0 days 01:19:00.000000000,4
22,6,https://resizing.flixster.com/R-CIfPmLTYaHTpmAGg409m9KsMc=/206x305/v2/https://flxt.tmsimg.com/assets/p8787642_p_v10_ak.jpg,The Devil Inside,25000,90,2012.0,Horror/Mystery and thriller,0 days 01:23:00.000000000,-16
50,0,https://resizing.flixster.com/OEkd4ZoDVHCLAIDdSa7ynXGEleI=/206x305/v2/https://flxt.tmsimg.com/assets/p8678074_p_v8_aa.jpg,The Perfect Age of Rock 'n' Roll,500,14,2009.0,Drama,0 days 01:32:00.000000000,-50
90,86,,Last Days Here,250,21,2011.0,Documentary/Music,0 days 01:31:00.000000000,-4
87,95,https://resizing.flixster.com/2TTCt4MuxsxZYUK26WeCN1FPIM4=/206x305/v2/https://flxt.tmsimg.com/assets/p8725913_p_v13_aj.jpg,The Artist,50000,319,2011.0,Drama/Romance,0 days 01:40:00.000000000,8
59,85,,Bonsai,500,26,2011.0,Drama,0 days 01:35:00.000000000,26
52,32,,Man on a Ledge,25000,160,2012.0,Crime/Drama,0 days 01:42:00.000000000,-20
63,45,,American Reunion,250000,184,2012.0,Comedy,0 days 01:52:00.000000000,-18
79,54,,Think Like a Man,100000,102,2012.0,Romance,0 days 02:02:00.000000000,-25
51,52,,The Iron Lady,50000,235,2011.0,Drama/History,0 days 01:45:00.000000000,1
43,46,,Chasing Madoff,250,41,2011.0,Documentary,0 days 01:31:00.000000000,3
64,60,,Glee the Concert Movie,10000,90,2011.0,Documentary/Musical,0 days 01:24:00.000000000,-4
9,14,/assets/pizza-pie/images/poster_default.c8c896e70c3.gif,Hard Breakers,250,7,2010.0,Comedy,0 days 01:38:00.000000000,5
59,59,,Safe,100000,111,2012.0,Mystery and thriller/Action,0 days 01:35:00.000000000,0
42,12,,Gone,25000,69,2012.0,Mystery and thriller,0 days 01:35:00.000000000,-30
71,89,https://resizing.flixster.com/q3Z3-hbBQ1bNx7n2DIAjlSfipCk=/206x305/v2/https://flxt.tmsimg.com/assets/p8833601_p_v10_ad.jpg,Footnote,10000,90,2011.0,Comedy/Drama,0 days 01:46:00.000000000,18
63,83,https://resizing.flixster.com/zu5OgL0OhhMGyssJShXz4oFP2Zo=/206x305/v2/https://flxt.tmsimg.com/assets/p8903495_p_v13_ab.jpg,House of Tolerance,1000,29,2011.0,Drama,0 days 02:02:00.000000000,20
75,99,,Le Havre,5000,96,2011.0,Comedy/Drama,0 days 01:43:00.000000000,24
63,87,,Miss Bala,2500,69,2011.0,Action/Drama,0 days 01:53:00.000000000,24
64,86,,The Whisperer in Darkness,100,7,2011.0,Sci fi/Mystery and thriller,0 days 01:44:00.000000000,22
47,23,,What to Expect When You're Expecting,100000,136,2012.0,Romance/Comedy,0 days 01:50:00.000000000,-24
62,80,,Father's Day,250,10,2011.0,Action/Horror,0 days 01:39:00.000000000,18
50,53,,Good for Nothing,100,17,2012.0,Western/Comedy,0 days 01:32:00.000000000,3
51,64,https://resizing.flixster.com/ZXIqNfItVK_g-a7KJkGU4cNukIA=/206x305/v2/https://flxt.tmsimg.com/assets/p8889912_p_v10_aa.jpg,The Five-Year Engagement,250000,179,2012.0,Romance,0 days 01:59:00.000000000,13
36,34,https://resizing.flixster.com/87bTQnubxQnTMzdKUCc_MAGncyE=/206x305/v2/https://flxt.tmsimg.com/assets/p8704900_p_v10_ae.jpg,5 Days of War,2500,35,2011.0,Drama/War,0 days 01:52:00.000000000,-2
46,30,,Ready,1000,10,2011.0,Action/Drama,0 days 02:25:00.000000000,-16
78,88,https://resizing.flixster.com/ocwyOKFDi74TqtWNSV-OSKvE7os=/206x305/v2/https://flxt.tmsimg.com/assets/p8741380_p_v13_ac.jpg,The Yellow Sea,1000,25,2010.0,Drama/Mystery and thriller,0 days 02:19:00.000000000,10
35,56,,The Devil's Rock,250,9,2011.0,Drama/Fantasy,0 days 01:26:00.000000000,21
47,57,https://resizing.flixster.com/WaYGLh5ombT8qg2S9Jl0SqoJsgU=/206x305/v2/https://flxt.tmsimg.com/assets/p8703511_p_v10_aa.jpg,In the Land of Blood and Honey,5000,82,2011.0,Romance/Drama,0 days 02:07:00.000000000,10
56,90,,The Fairy,2500,40,2011.0,Romance/Comedy,0 days 01:34:00.000000000,34
60,67,https://resizing.flixster.com/DPiicFlNeVzmTnu9r2sRmaLSEdg=/206x305/v2/https://flxt.tmsimg.com/assets/p8874339_p_v10_af.jpg,Guilty of Romance,250,18,2011.0,Drama,0 days 02:24:00.000000000,7
76,36,,Tyler Perry's Good Deeds,50000,36,2012.0,Romance/Drama,0 days 01:51:00.000000000,-40
67,80,,Michael,1000,40,2011.0,Drama,0 days 01:38:00.000000000,13
73,53,,Where Do We Go Now?,2500,76,2011.0,Comedy/Drama,0 days 01:40:00.000000000,-20
17,10,,Creature,1000,29,2011.0,Horror,0 days 01:35:00.000000000,-7
68,70,https://resizing.flixster.com/KVU1pk95tziYssFqXq1rX0KVAYM=/206x305/v2/https://flxt.tmsimg.com/assets/p8849438_p_v10_ab.jpg,Leave It on the Floor,100,10,2011.0,Romance/Gay and lesbian,0 days 01:46:00.000000000,2
42,28,,Killer Elite,25000,127,2011.0,Action/Mystery and thriller,0 days 01:57:00.000000000,-14
81,57,,Farmageddon,250,14,2011.0,Documentary,0 days 01:30:00.000000000,-24
33,20,https://resizing.flixster.com/tln5KA6gSrE1Un8Bip8EPam5nO8=/206x305/v2/https://flxt.tmsimg.com/assets/p8833859_p_v10_aa.jpg,Mausam,500,5,2011.0,Romance/Drama,0 days 02:40:00.000000000,-13
78,77,,Bombay Beach,250,39,2011.0,Drama/Musical,0 days 01:20:00.000000000,-1
64,93,,Page Eight,1000,15,2011.0,Drama,0 days 01:40:00.000000000,29
63,91,https://resizing.flixster.com/UMivbTdhoQ0frZ5mC3j5iiAtTvo=/206x305/v2/https://flxt.tmsimg.com/assets/p8714321_p_v8_aa.jpg,Daylight,500,11,2010.0,Mystery and thriller,0 days 01:15:00.000000000,28
72,27,,Act of Valor,50000,142,2012.0,Action/Mystery and thriller,0 days 01:49:00.000000000,-45
16,0,https://resizing.flixster.com/ftC1XH4ENBQBZ4YBY7hY2ZlGiec=/206x305/v2/https://flxt.tmsimg.com/assets/p9052169_p_v10_aa.jpg,Dark Tide,1000,20,2012.0,Mystery and thriller/Drama,0 days 01:54:00.000000000,-16
30,26,https://resizing.flixster.com/IqsGPusPGqAQqydAC1awAQWJtyU=/206x305/v2/https://flxt.tmsimg.com/assets/p9050571_p_v10_af.jpg,Life Happens,1000,31,2011.0,Comedy,0 days 01:40:00.000000000,-4
30,8,https://resizing.flixster.com/Ry3LK5fhQkx03b82sZ9sU9Czsf4=/206x305/v2/https://flxt.tmsimg.com/assets/p8830140_p_v10_aa.jpg,1911,1000,24,2011.0,War/Action,0 days 02:05:00.000000000,-22
38,0,,The Undefeated,1000,15,2011.0,Documentary,0 days 01:50:00.000000000,-38
90,71,https://resizing.flixster.com/tjhtXi5XYWarqypsXNFQHH8XgD8=/206x305/v2/https://flxt.tmsimg.com/assets/p8943410_p_v8_aa.jpg,Never Stand Still,100,7,2011.0,Documentary,0 days 01:18:00.000000000,-19
64,47,,The Mighty Macs,2500,51,2009.0,Drama,0 days 01:38:00.000000000,-17
74,50,,Girlfriend,250,10,2010.0,Drama,0 days 01:34:00.000000000,-24
36,77,https://resizing.flixster.com/GxUyTZXZt2dzgCUZ67NIn93EthE=/206x305/v2/https://flxt.tmsimg.com/assets/p8761747_p_v13_aa.jpg,Just Do It: A Tale of Modern-Day Outlaws,50,13,2011.0,Documentary,0 days 01:28:00.000000000,41
76,0,,Playback,1000,6,2011.0,Horror,0 days 01:38:00.000000000,-76
18,20,https://resizing.flixster.com/ToqNi4fFmBetXeJ2sgxscwOqPas=/206x305/v2/https://flxt.tmsimg.com/assets/p9000001_p_v10_aa.jpg,The Broken Tower,2500,10,2011.0,Gay and lesbian/Drama,0 days 01:48:00.000000000,2
49,80,,Phase 7,500,10,2011.0,Comedy/Horror,0 days 01:35:00.000000000,31
59,57,,"Black, White and Blues",500,7,2010.0,Drama,0 days 01:31:00.000000000,-2
70,86,,Declaration of War,1000,43,2011.0,Drama,0 days 01:40:00.000000000,16
49,10,,One Fall,100,10,2011.0,Fantasy/Drama,0 days 01:30:00.000000000,-39
27,37,https://resizing.flixster.com/TIZke8hMMGxyGIY2Vh9jM0Kvyo0=/206x305/v2/https://flxt.tmsimg.com/assets/p8729214_p_v10_aa.jpg,Texas Killing Fields,5000,46,2011.0,Crime/Drama,0 days 01:45:00.000000000,10
67,21,,Seven Days in Utopia,1000,56,2011.0,Drama,0 days 01:36:00.000000000,-46
34,0,,Faces in the Crowd,1000,5,2011.0,Horror/Mystery and thriller,0 days 01:42:00.000000000,-34
52,84,,Charlotte Rampling: The Look,100,19,2011.0,Documentary,0 days 01:38:00.000000000,32
42,83,https://resizing.flixster.com/mgMKkP0XdvBylipQZPsmpNsedhM=/206x305/v2/https://flxt.tmsimg.com/assets/p8989297_p_v10_aa.jpg,Return,1000,41,2011.0,Drama,0 days 01:41:00.000000000,41
61,45,https://resizing.flixster.com/62gHjlSJCGp_TIsT6sObh7HUg10=/206x305/v2/https://flxt.tmsimg.com/assets/p8743169_p_v8_an.jpg,Extremely Loud & Incredibly Close,50000,190,2011.0,Drama,0 days 02:09:00.000000000,-16
48,12,,W.E.,5000,113,2011.0,Romance/Drama,0 days 01:59:00.000000000,-36
84,71,https://resizing.flixster.com/OLEUABgSKGD7TehTm33N7PwVtD0=/206x305/v2/https://flxt.tmsimg.com/assets/p8817572_p_v8_ab.jpg,Kevin Hart: Laugh at My Pain,5000,7,2011.0,Comedy,0 days 01:28:00.000000000,-13
58,95,https://resizing.flixster.com/-YWRAiCOMJfJEIyoOIycjdknfz0=/206x305/v2/https://flxt.tmsimg.com/assets/p8772391_p_v8_aa.jpg,Paul Goodman Changed My Life,250,20,2011.0,Documentary/Drama,0 days 01:29:00.000000000,37
70,69,https://resizing.flixster.com/PyDd_waPhw3CQzNXiBQOMrV39G4=/206x305/v2/https://flxt.tmsimg.com/assets/p8763933_p_v8_aa.jpg,American Teacher,250,16,2011.0,Documentary,0 days 01:21:00.000000000,-1
22,25,https://resizing.flixster.com/JR0rHvjGDnCXhS69_EpiAcKh8KA=/206x305/v2/https://flxt.tmsimg.com/assets/p8788799_p_v10_ak.jpg,Inside Out,250,12,2011.0,Crime/Drama,0 days 01:34:00.000000000,3
58,30,,A Bird of the Air,100,10,2011.0,Romance,0 days 01:38:00.000000000,-28
82,78,,The Other F Word,1000,36,2011.0,Documentary,0 days 01:38:00.000000000,-4
39,54,,Albatross,1000,26,2011.0,Drama,0 days 01:30:00.000000000,15
62,77,https://resizing.flixster.com/vbaouKJxFIHezcnRAUN8WEs2vXs=/206x305/v2/https://flxt.tmsimg.com/assets/p8855648_p_v10_aq.jpg,"Jeff, Who Lives at Home",25000,143,2011.0,Comedy/Drama,0 days 01:23:00.000000000,15
84,86,,The Big Fix,100,7,2011.0,Documentary,0 days 01:48:00.000000000,2
89,68,https://resizing.flixster.com/tEbgtO4iWWO5cyBE0_L9D61pdI4=/206x305/v2/https://flxt.tmsimg.com/assets/p8768743_p_v10_aa.jpg,Pearl Jam Twenty,2500,28,2011.0,Documentary/Drama,0 days 01:59:00.000000000,-21
50,75,,A Lonely Place to Die,2500,32,2011.0,Action/Mystery and thriller,0 days 01:38:00.000000000,25
52,80,https://resizing.flixster.com/J9e-257_cLceirEsFK_I3RUHcpI=/206x305/v2/https://flxt.tmsimg.com/assets/p8833584_p_v10_aa.jpg,The Deep Blue Sea,10000,141,2011.0,Romance/Drama,0 days 01:38:00.000000000,28
62,72,,The Hunter,10000,95,2011.0,Mystery and thriller/Drama,0 days 01:40:00.000000000,10
38,50,https://resizing.flixster.com/wpaYNtm_hYCz6XJ4vVTtTnSEEuM=/206x305/v2/https://flxt.tmsimg.com/assets/p8784217_p_v10_aa.jpg,Patagonia Rising,50,10,2011.0,Western/Documentary,0 days 01:27:00.000000000,12
80,88,,In Darkness,10000,113,2011.0,Drama/History,0 days 02:25:00.000000000,8
62,84,,"The Man Nobody Knew: In Search of My Father, CIA Spymaster William Colby",250,25,2011.0,Documentary,0 days 01:44:00.000000000,22
36,9,,Answers to Nothing,1000,23,2011.0,Drama,0 days 02:04:00.000000000,-27
38,13,,The Greening of Whitney Brown,100,15,2011.0,Adventure,0 days 01:27:00.000000000,-25
61,79,,The Grey,100000,209,2012.0,Drama/Adventure,0 days 01:57:00.000000000,18
36,38,,The Theatre Bizarre,1000,8,2011.0,Horror,0 days 01:54:00.000000000,2
79,82,,Comic-Con Episode IV: A Fan's Hope,5000,56,2011.0,Documentary,0 days 01:26:00.000000000,3
75,79,,Shame,25000,226,2011.0,Drama,0 days 01:39:00.000000000,4
23,13,,The Moth Diaries,5000,46,2011.0,Horror,0 days 01:23:00.000000000,-10
61,90,,Dragonslayer,250,21,2011.0,Documentary,0 days 01:13:00.000000000,29
33,8,,The Reunion,500,12,2011.0,Action/Drama,0 days 01:36:00.000000000,-25
67,20,,The Lucky One,100000,148,2012.0,Romance/Drama,0 days 01:41:00.000000000,-47
93,86,,George Harrison: Living in the Material World,1000,37,2011.0,Documentary/Music,0 days 03:28:00.000000000,-7
58,82,https://resizing.flixster.com/OXo5DTyCnPpLD0PwghmcEau5Grs=/206x305/v2/https://flxt.tmsimg.com/assets/p8953539_p_v10_aa.jpg,The Love We Make,250,11,2011.0,Documentary,0 days 01:34:00.000000000,24
85,93,,Carlos,5000,69,2010.0,Drama/Biography,0 days 02:30:00.000000000,8
86,97,,Monsieur Lazhar,25000,119,2011.0,Drama,0 days 01:34:00.000000000,11
66,83,,Rockstar,1000,6,2011.0,Romance/Drama,0 days 02:40:00.000000000,17
80,87,,Bullhead,2500,75,2011.0,Crime/Drama,0 days 02:08:00.000000000,7
52,78,/assets/pizza-pie/images/poster_default.c8c896e70c3.gif,Scalene,100,9,2011.0,Drama/Mystery and thriller,0 days 01:36:00.000000000,26
68,66,,God Bless America,25000,114,2011.0,Comedy,0 days 01:47:00.000000000,-2
76,92,https://resizing.flixster.com/3xYPB7s34fUQuquYxUb-bbMqhgg=/206x305/v2/https://flxt.tmsimg.com/assets/p8895373_p_v8_aa.jpg,Into the Abyss,5000,116,2011.0,Crime/Documentary,0 days 01:47:00.000000000,16
85,100,,Urbanized,1000,14,2011.0,Documentary,0 days 01:22:00.000000000,15
35,74,https://resizing.flixster.com/DcjAJ1Rpf07hu5miNKhC1aBk9jo=/206x305/v2/https://flxt.tmsimg.com/assets/p8916202_p_v10_aa.jpg,Rampart,10000,149,2011.0,Crime/Drama,0 days 01:43:00.000000000,39
64,67,,Salmon Fishing in the Yemen,25000,151,2011.0,Romance/Comedy,0 days 01:51:00.000000000,3
32,44,,Lovely Molly,5000,39,2011.0,Horror/Mystery and thriller,0 days 01:40:00.000000000,12
87,86,https://resizing.flixster.com/zHcr30wwy5rXpI_2HgAmCqQI4SU=/206x305/v2/https://resizing.flixster.com/t6xg1LTbeE9hoq4UhInzdim_O5U=/ems.ZW1zLXByZC1hc3NldHMvbW92aWVzLzY2YTc3ZjJlLWFjNTktNGM4ZS05NjkxLTM4YzEyYWNlYTIxOS53ZWJw,The Raid: Redemption,50000,170,2011.0,Crime/Action,0 days 01:41:00.000000000,-1
41,62,,Retreat,2500,13,2011.0,Sci fi/Mystery and thriller,0 days 01:30:00.000000000,21
26,23,https://resizing.flixster.com/uNP8aF0PT-LIO-tzhEnz5F8niMg=/206x305/v2/https://flxt.tmsimg.com/assets/p8833498_p_v10_ab.jpg,Elles,2500,62,2011.0,Drama,0 days 01:39:00.000000000,-3
81,83,/assets/pizza-pie/images/poster_default.c8c896e70c3.gif,Fullmetal Alchemist: The Sacred Star of Milos,5000,12,2011.0,Sci fi/Adventure,0 days 01:50:00.000000000,2
64,83,,Juan of the Dead,1000,23,2011.0,Comedy/Horror,0 days 01:40:00.000000000,19
71,73,,My Reincarnation,250,15,2010.0,Documentary,0 days 01:40:00.000000000,2
85,93,,Headhunters,25000,101,2011.0,Crime/Action,0 days 01:40:00.000000000,8
44,33,https://resizing.flixster.com/rkqW1zBjABMr_oI_Dh6ZKBOMPPw=/206x305/v2/https://flxt.tmsimg.com/assets/p8815127_p_v10_am.jpg,Chillerama,500,6,2011.0,Comedy/Fantasy,0 days 02:00:00.000000000,-11
72,80,https://resizing.flixster.com/zopzfNrJLZ2cdDL7pDuZdmnxCG0=/206x305/v2/https://flxt.tmsimg.com/assets/p9069371_p_v10_ac.jpg,The Hidden Face,500,5,2011.0,Mystery and thriller,0 days 01:43:00.000000000,8
39,0,https://resizing.flixster.com/6G0_6QJn2bXFAQKL0z_SHO5HnVs=/206x305/v2/https://flxt.tmsimg.com/assets/p8896282_p_v8_aa.jpg,Reuniting the Rubins,250,18,2010.0,Comedy/Drama,0 days 01:39:00.000000000,-39
82,88,,Eames: The Architect & the Painter,500,25,2011.0,Documentary/Biography,0 days 01:23:00.000000000,6
83,67,https://resizing.flixster.com/B_QxL6har3RG_DskGE0uNqwyfo8=/206x305/v2/https://flxt.tmsimg.com/assets/p8843458_p_v10_aa.jpg,Warriors of the Rainbow: Seediq Bale,1,15,2011.0,Drama/History,0 days 02:30:00.000000000,-16
26,20,https://resizing.flixster.com/s3d-dScGflzQPbhVSglbvt17-R0=/206x305/v2/https://flxt.tmsimg.com/assets/p8865028_p_v10_aa.jpg,Wrong Turn 4: Bloody Beginnings,1000,5,2011.0,Horror,0 days 01:33:00.000000000,-6
78,100,/assets/pizza-pie/images/poster_default.c8c896e70c3.gif,"Arrow, the Ultimate Weapon",500,5,2011.0,Action/Drama,0 days 02:02:00.000000000,22
51,23,,The Decoy Bride,1000,22,2011.0,Comedy/Drama,0 days 01:29:00.000000000,-28
24,0,,A Novel Romance,50,6,2011.0,Romance/Comedy,0 days 01:31:00.000000000,-24
34,22,https://resizing.flixster.com/ah_kFtxK0mEy0h4rAcYEukdxJsM=/206x305/v2/https://flxt.tmsimg.com/assets/p8895480_p_v13_al.jpg,Loosies,500,18,2011.0,Drama/Comedy,0 days 01:29:00.000000000,-12
15,4,,Beneath the Darkness,1000,24,2011.0,Mystery and thriller,0 days 01:37:00.000000000,-11
59,80,,Some Guy Who Kills People,500,10,2011.0,Comedy/Mystery and thriller,0 days 01:37:00.000000000,21
47,36,https://resizing.flixster.com/867jN4A0svTKJD8xTVJBPUq9uuU=/206x305/v2/https://flxt.tmsimg.com/assets/p8969195_p_v10_aa.jpg,Tim and Eric's Billion Dollar Movie,2500,74,2012.0,Comedy,0 days 01:32:00.000000000,-11
19,45,https://resizing.flixster.com/CdOSH5n16LoPNblLEtAIB0X_JXs=/206x305/v2/https://flxt.tmsimg.com/NowShowing/111235/111235_aa.jpg,4:44 Last Day on Earth,1000,31,2011.0,Fantasy/Sci fi,0 days 01:24:00.000000000,26
38,26,https://resizing.flixster.com/N6sYH9TR0SlyS7-z7KMmw6rtamg=/206x305/v2/https://flxt.tmsimg.com/assets/p8858510_p_v10_ab.jpg,The Divide,5000,58,2011.0,Sci fi/Mystery and thriller,0 days 01:50:00.000000000,-12
20,67,https://resizing.flixster.com/5mMYxX7sFzXjMmPFIDKSyImL_-M=/206x305/v2/https://flxt.tmsimg.com/assets/p8955467_p_v10_af.jpg,Hostel Part III,1000,6,2011.0,Horror,0 days 01:28:00.000000000,47
79,88,,Batman Year One,2500,8,2011.0,Animation/Action,0 days 01:04:00.000000000,9
66,55,,Private Romeo,500,11,2011.0,Gay and lesbian/Drama,0 days 01:38:00.000000000,-11
24,50,/assets/pizza-pie/images/poster_default.c8c896e70c3.gif,Sket,250,8,2011.0,Crime/Drama,0 days 01:23:00.000000000,26
79,25,https://resizing.flixster.com/1fAPB0chyMERnWofNG1hMRgXgrQ=/206x305/v2/https://flxt.tmsimg.com/assets/p8868815_p_v10_aa.jpg,October Baby,25000,40,2011.0,Drama,0 days 01:46:00.000000000,-54
57,60,,Surrogate Valentine,50,5,2011.0,Comedy,0 days 01:16:00.000000000,3
59,33,https://resizing.flixster.com/MyawamG2zgyweMRhTi5OlrC2nqA=/206x305/v2/https://flxt.tmsimg.com/assets/p8661812_p_v10_ab.jpg,Magic Beyond Words: The J.K. Rowling Story,100,6,2011.0,Drama/Biography,0 days 01:30:00.000000000,-26
36,75,https://resizing.flixster.com/KzVHNdHcSh50pa_sdzyEJkkFrdA=/206x305/v2/https://flxt.tmsimg.com/assets/p9174639_p_v10_aa.jpg,The Monitor,500,24,2011.0,Mystery and thriller,0 days 01:36:00.000000000,39
78,69,,Go-ji-jeon,250,16,2011.0,Drama/War,0 days 02:13:00.000000000,-9
72,71,https://resizing.flixster.com/xO7YAnlo5h-zXf6lcIFa37dvAdw=/206x305/v2/https://flxt.tmsimg.com/assets/p8934938_p_v10_ac.jpg,Don 2,2500,14,2011.0,Crime/Action,0 days 02:25:00.000000000,-1
53,59,https://resizing.flixster.com/-c0FdfdXY5oYwSKztjXEiiwMWqA=/206x305/v2/https://flxt.tmsimg.com/assets/p9043675_p_v10_aa.jpg,American Animal,100,17,2011.0,Comedy/Drama,0 days 01:35:00.000000000,6
54,73,/assets/pizza-pie/images/poster_default.c8c896e70c3.gif,Payback,100,15,2012.0,Documentary,0 days 01:26:00.000000000,19
39,67,,Extraterrestrial,1000,30,2011.0,Romance/Sci fi,0 days 01:33:00.000000000,28
54,56,https://resizing.flixster.com/GrKKM3r7_h9pYWpt5t_IbVtPhY0=/206x305/v2/https://flxt.tmsimg.com/assets/p9029839_p_v10_ab.jpg,The Viral Factor,500,16,2012.0,Action/Adventure,0 days 02:00:00.000000000,2
51,69,,Thin Ice,2500,61,2011.0,Crime/Comedy,0 days 01:34:00.000000000,18
39,68,https://resizing.flixster.com/ZBVbP35nzsn1IN2l9a6trwvxCQk=/206x305/v2/https://flxt.tmsimg.com/assets/p8833070_p_v8_ab.jpg,Keyhole,250,41,2011.0,Drama/Mystery and thriller,0 days 01:34:00.000000000,29
76,77,,Too Big to Fail,1000,30,2011.0,Drama,0 days 01:38:00.000000000,1
39,20,https://resizing.flixster.com/tGv78GkJinSYFMgV0bf7dr_v6Ss=/206x305/v2/https://flxt.tmsimg.com/assets/p9036460_p_v10_aa.jpg,Bad Ass,5000,5,2012.0,Action,0 days 01:45:00.000000000,-19
12,0,https://resizing.flixster.com/WZP4xb-8CIdm0xQdKK1WGv2L5CA=/206x305/v2/https://flxt.tmsimg.com/assets/p9051344_p_v13_ab.jpg,Mercenaries,100,7,2011.0,Action,0 days 01:37:00.000000000,-12
39,19,https://resizing.flixster.com/hQTyxpaY0KB0zNtqNkqOL59oKN8=/206x305/v2/https://flxt.tmsimg.com/assets/p9043824_p_v10_aa.jpg,Goats,1000,27,2012.0,Comedy,0 days 01:34:00.000000000,-20
49,87,,Absentia,1000,15,2011.0,Horror,0 days 01:31:00.000000000,38
53,33,,Girl in Progress,50000,46,2012.0,Comedy/Drama,0 days 01:32:00.000000000,-20
23,12,,ATM,10000,26,2012.0,Horror/Mystery and thriller,0 days 01:30:00.000000000,-11
65,53,https://resizing.flixster.com/YIkkCBElcKr-vlJ_8z9_lUjOzog=/206x305/v2/https://flxt.tmsimg.com/assets/p9130823_p_v10_aa.jpg,Cleanskin,1000,17,2012.0,Mystery and thriller,0 days 01:48:00.000000000,-12
90,90,https://resizing.flixster.com/WpX1S4TxVc43joanPAPY9h0G6kg=/206x305/v2/https://flxt.tmsimg.com/assets/p8598520_p_v10_aa.jpg,"Beats, Rhymes & Life: The Travels of A Tribe Called Quest",2500,60,2011.0,Documentary/Music,0 days 01:37:00.000000000,0
40,44,,Brake,1000,27,2012.0,Action/Mystery and thriller,0 days 01:32:00.000000000,4
53,0,,Deadline,100,9,2012.0,Mystery and thriller,0 days 01:35:00.000000000,-53
50,55,/assets/pizza-pie/images/poster_default.c8c896e70c3.gif,Joffrey: Mavericks of American Dance,50,11,2011.0,Documentary/Biography,0 days 01:30:00.000000000,5
38,50,,Best Laid Plans,100,6,2012.0,Drama,0 days 01:43:00.000000000,12
21,40,,The Girl From the Naked Eye,250,15,2012.0,Action/Mystery and thriller,0 days 01:24:00.000000000,19
71,100,https://resizing.flixster.com/cSZjNCWo8SrtuuWU-mM-ZnpvdFg=/206x305/v2/https://flxt.tmsimg.com/assets/p9063983_p_v8_aa.jpg,Art Is ... the Permanent Revolution,100,6,2011.0,Documentary,0 days 01:22:00.000000000,29
69,20,https://resizing.flixster.com/OVCBqZtI1oHMB1fNBBuuHI7yVK0=/206x305/v2/https://flxt.tmsimg.com/assets/p9084156_p_v8_aa.jpg,Woman Thou Art Loosed: On the 7th Day,10000,10,2012.0,Drama,0 days 01:41:00.000000000,-49
82,20,https://resizing.flixster.com/_VBQjQLDZsQIOugY5Vymbb-GCuc=/206x305/v2/https://flxt.tmsimg.com/assets/p10949357_p_v10_aa.jpg,My Way,500,15,2012.0,Documentary,0 days 02:00:00.000000000,-62
42,56,/assets/pizza-pie/images/poster_default.c8c896e70c3.gif,Treasure Island,100,9,2012.0,,,14
85,100,/assets/pizza-pie/images/poster_default.c8c896e70c3.gif,Patton Oswalt: Finest Hour,1,5,2012.0,,,15
63,47,https://resizing.flixster.com/BuNdZODkZYHEcUNhtS8JbSNpkXo=/206x305/v2/https://flxt.tmsimg.com/assets/p8984260_p_v10_ac.jpg,White Knight,100,15,2011.0,Comedy,0 days 01:26:00.000000000,-16
78,83,,Changing the Game,100,6,2012.0,Action,0 days 01:43:00.000000000,5
90,95,https://resizing.flixster.com/NubxmXqcEl7fcw76V1SxX4twbpI=/206x305/v2/https://flxt.tmsimg.com/assets/p9080803_p_v13_ab.jpg,Marley,25000,113,2012.0,Documentary/Music,0 days 02:24:00.000000000,5
63,39,,Blue Like Jazz,10000,41,2012.0,Drama,0 days 01:46:00.000000000,-24
67,28,https://resizing.flixster.com/U8cPYKUFl0zuUUg3m7Q2hAxnjZA=/206x305/v2/https://flxt.tmsimg.com/assets/p9089268_p_v8_aa.jpg,We the Party,2500,18,2012.0,Comedy/Drama,0 days 01:44:00.000000000,-39
65,44,https://resizing.flixster.com/MakGGOzeHGbgBdlETCmgnK396w0=/206x305/v2/https://flxt.tmsimg.com/assets/p9101413_p_v8_aa.jpg,The Beat Hotel,50,9,2012.0,Documentary/Drama,0 days 01:28:00.000000000,-21
88,86,,Pelotero,250,28,2011.0,Documentary,0 days 01:17:00.000000000,-2
52,59,,Beyond the Black Rainbow,2500,34,2011.0,Sci fi,0 days 01:49:00.000000000,7
88,100,https://resizing.flixster.com/zYkqi4_MTKV3UPdvWcAHa3wKP8M=/206x305/v2/https://flxt.tmsimg.com/assets/p9124174_p_v10_aa.jpg,Kahaani,1000,6,2012.0,Mystery and thriller,0 days 02:02:00.000000000,12
77,43,https://resizing.flixster.com/JEZuEYua9n_zoSX58kDS_wCISRQ=/206x305/v2/https://flxt.tmsimg.com/assets/p9128083_p_v8_aa.jpg,Patriocracy,100,7,2011.0,Documentary,0 days 01:28:00.000000000,-34
50,100,https://resizing.flixster.com/hVjSvPkKX7ddWfEDyHWL3gT2Jy4=/206x305/v2/https://flxt.tmsimg.com/assets/p9187220_p_v10_aa.jpg,The Aggression Scale,250,5,2012.0,Crime/Drama,0 days 01:25:00.000000000,50
31,22,,Meeting Evil,5000,9,2011.0,Drama/Mystery and thriller,0 days 01:29:00.000000000,-9
40,56,,Citizen Gangster,250,16,2011.0,Crime/Drama,0 days 01:45:00.000000000,16
51,80,https://resizing.flixster.com/T7oovA6FdCAPCy3_TylojyNm_-A=/206x305/v2/https://flxt.tmsimg.com/assets/p9268151_p_v10_aa.jpg,Nate & Margaret,1000,10,2012.0,Comedy/Drama,0 days 01:19:00.000000000,29
31,36,,Lola Versus,5000,84,2012.0,Romance,0 days 01:26:00.000000000,5
77,20,,For Greater Glory,25000,49,2012.0,Drama/History,0 days 02:23:00.000000000,-57
80,94,/assets/pizza-pie/images/poster_default.c8c896e70c3.gif,Wagner's Dream,250,16,2012.0,Documentary,0 days 01:55:00.000000000,14
88,90,,Woody Allen: A Documentary,1000,21,2012.0,Documentary,0 days 01:53:00.000000000,2
22,17,,Apartment 143,2500,6,2011.0,Horror,0 days 01:20:00.000000000,-5
45,0,,Jannat 2,250,6,2012.0,Romance/Mystery and thriller,0 days 03:00:00.000000000,-45
12,7,,Assassin's Bullet,250,15,2012.0,Action/Mystery and thriller,0 days 01:31:00.000000000,-5
31,20,,Dangerous Ishhq,100,5,2012.0,Mystery and thriller,,-11
75,80,,Superman vs. the Elite,1000,5,2012.0,Action/Animation,0 days 01:14:00.000000000,5
49,0,https://resizing.flixster.com/HV6EEPkRH-SY-MP2CZJ1Sz0g_5Y=/206x305/v2/https://flxt.tmsimg.com/assets/p9292551_p_v10_aa.jpg,For the Love of Money,1000,7,2012.0,Crime/Drama,0 days 01:33:00.000000000,-49
51,71,https://resizing.flixster.com/B8hczdBNlL_mSKRtJFjyy0nUakA=/206x305/v2/https://flxt.tmsimg.com/assets/p9282084_p_v8_aa.jpg,Bol Bachchan,2500,7,2012.0,Comedy/Drama,0 days 02:30:00.000000000,20
45,67,,Cocktail,2500,6,2012.0,Romance/Drama,0 days 02:26:00.000000000,22
83,100,,Monika,2500,15,1952.0,Drama,0 days 01:36:00.000000000,17
54,0,,Trade of Innocents,250,7,2012.0,Drama/Mystery and thriller,0 days 01:31:00.000000000,-54
50,33,https://resizing.flixster.com/1bDOhLAZk0ses-3Pq9cCx58_jQk=/206x305/v2/https://flxt.tmsimg.com/assets/p10578782_p_v8_aa.jpg,Refuge,100,9,2012.0,Drama,0 days 01:24:00.000000000,-17
78,81,https://resizing.flixster.com/czl63w765h6KaBb3vClXAkWkRkM=/206x305/v2/https://flxt.tmsimg.com/assets/p6646_p_v10_aa.jpg,Alice in Wonderland,250000,32,1951.0,Fantasy/Kids and family,0 days 01:15:00.000000000,3
90,97,,Limelight,5000,35,1952.0,Comedy/Drama,0 days 02:25:00.000000000,7
34,44,https://resizing.flixster.com/Li5_Zqh8lV32Cv5GmJmS5l88V6s=/206x305/v2/https://flxt.tmsimg.com/assets/p5755_p_v8_aa.jpg,Damnation Alley,1000,9,1977.0,Sci fi,0 days 01:31:00.000000000,10
84,73,,Jacob's Ladder,50000,66,1990.0,Horror/Mystery and thriller,0 days 01:53:00.000000000,-11
77,73,https://resizing.flixster.com/hlGzeXD7PJOwjMhSv6F7b0vQw3c=/206x305/v2/https://flxt.tmsimg.com/assets/p19429_p_v10_aa.jpg,Bent,5000,22,1997.0,Gay and lesbian/Drama,0 days 01:57:00.000000000,-4
95,100,,Modern Times,25000,61,1936.0,Comedy,0 days 01:29:00.000000000,5
50,75,https://resizing.flixster.com/8DJMZ8yAJSMGn2eGfIT2mp8smKo=/206x305/v2/https://flxt.tmsimg.com/assets/p176426_p_v10_az.jpg,Alien Autopsy,10000,8,2006.0,Sci fi/Comedy,0 days 01:35:00.000000000,25
44,0,https://resizing.flixster.com/B5EQnbBICbyAxWJXcV90k18rJH4=/206x305/v2/https://flxt.tmsimg.com/assets/p81933_p_v8_ab.jpg,Nola,500,13,2003.0,Romance,0 days 01:37:00.000000000,-44
56,67,https://resizing.flixster.com/nKl1aMgmp20HHcVo48IACC-twhw=/206x305/v2/https://flxt.tmsimg.com/assets/p4064_p_v10_aa.jpg,The Heroes of Telemark,1000,6,1965.0,Drama/War,0 days 02:11:00.000000000,11
92,100,https://resizing.flixster.com/Eg_Y681JnljYFtJPD9GfPCu87XM=/206x305/v2/https://flxt.tmsimg.com/assets/p39301_p_v8_aa.jpg,Shoeshine,1000,6,1946.0,Drama,0 days 01:33:00.000000000,8
91,100,https://resizing.flixster.com/pXFw4JQJXiu8RGwK9v2cENhC7CY=/206x305/v2/https://resizing.flixster.com/evjT93Jt-AsmPP8SKEDXlC9VnmY=/ems.ZW1zLXByZC1hc3NldHMvbW92aWVzL2FhOTU2NDJiLTljZjQtNDY3My1iNTEyLTYyZGQ1NmZiOTE1NC53ZWJw,Kes,5000,32,1969.0,Drama,0 days 01:49:00.000000000,9
79,83,https://resizing.flixster.com/I_vj3Y7RrZfuGkOqrJk-ocoaDmM=/206x305/v2/https://flxt.tmsimg.com/assets/p4776_p_v8_aa.jpg,Cul-de-Sac,2500,24,1966.0,Comedy,0 days 01:50:00.000000000,4
66,25,,Freebie and the Bean,1000,12,1974.0,Action,0 days 01:52:00.000000000,-41
59,57,,Feast,10000,56,2006.0,Comedy/Horror,0 days 01:26:00.000000000,-2
76,100,https://resizing.flixster.com/HuWOCczstJCD9bQg-O1tAgqNHfs=/206x305/v2/https://resizing.flixster.com/PAHN8bmVKH7t06CVdi7020w5N4Q=/ems.ZW1zLXByZC1hc3NldHMvbW92aWVzL2U3YTNhZWVjLTQxOWMtNDYzMC1hOTIyLTIzMTIyMDljYzk4ZS53ZWJw,The Clowns,1000,18,1970.0,Fantasy,0 days 01:31:00.000000000,24
25,17,,Destricted,1000,12,2006.0,Drama,0 days 01:56:00.000000000,-8
82,100,/assets/pizza-pie/images/poster_default.c8c896e70c3.gif,Docks of New York,500,16,1945.0,Comedy/Drama,0 days 01:03:00.000000000,18
90,100,/assets/pizza-pie/images/poster_default.c8c896e70c3.gif,The Last Command,500,19,1928.0,Romance/Drama,0 days 01:30:00.000000000,10
78,80,/assets/pizza-pie/images/poster_default.c8c896e70c3.gif,Me,500,5,1968.0,Drama,0 days 01:23:00.000000000,2
88,88,/assets/pizza-pie/images/poster_default.c8c896e70c3.gif,Underworld,1000,16,1927.0,Crime/Drama,0 days 01:20:00.000000000,0
55,82,/assets/pizza-pie/images/poster_default.c8c896e70c3.gif,S&Man,250,11,2010.0,,,27
22,17,,Poltergeist III,10000,18,1988.0,Horror,0 days 01:36:00.000000000,-5
50,60,/assets/pizza-pie/images/poster_default.c8c896e70c3.gif,Love Is the Drug,1000,5,2006.0,Drama,0 days 01:36:00.000000000,10
69,83,https://resizing.flixster.com/A-qFYUepB-88Lkf-igYQpkmOnbQ=/206x305/v2/https://flxt.tmsimg.com/assets/p4219_p_v10_aa.jpg,The Boy Friend,500,12,1971.0,Comedy/Musical,0 days 02:16:00.000000000,14
64,80,,Vampire Circus,1000,5,1972.0,Horror,0 days 01:27:00.000000000,16
70,94,,Cinévardaphoto,100,18,2004.0,Documentary,0 days 01:36:00.000000000,24
54,50,https://resizing.flixster.com/VOiPS-v4f35iH5cEdQn5fT1rOOA=/206x305/v2/https://flxt.tmsimg.com/assets/p93695_p_v8_aa.jpg,Black Moon,1000,10,1975.0,Fantasy,0 days 01:40:00.000000000,-4
80,90,,House,2500,31,1977.0,Comedy/Mystery and thriller,0 days 01:27:00.000000000,10
46,43,https://resizing.flixster.com/WAEwMBh-8jWxw1itc0jfjIaBBXg=/206x305/v2/https://flxt.tmsimg.com/NowShowing/92360/92360_aa.jpg,Tales From Earthsea,25000,40,2006.0,Fantasy/Adventure,0 days 01:55:00.000000000,-3
46,80,https://resizing.flixster.com/_tWj5AKQ_0UyPkRXlKjuBZCuLHg=/206x305/v2/https://flxt.tmsimg.com/assets/p5592_p_v10_aa.jpg,Yolanda and the Thief,250,5,1945.0,Musical,0 days 01:48:00.000000000,34
47,50,,Patty Hearst,500,10,1988.0,Drama,0 days 01:48:00.000000000,3
61,50,https://resizing.flixster.com/Z2X7aRQoq4glC1W2eusQQjT3cPI=/206x305/v2/https://flxt.tmsimg.com/assets/p6194_p_v8_aa.jpg,Greaser's Palace,500,6,1972.0,Comedy,0 days 01:31:00.000000000,-11
72,87,,The Wanton Contessa,500,23,1954.0,Drama,0 days 02:05:00.000000000,15
57,58,,Year of the Fish,250,24,2007.0,Romance/Fantasy,0 days 01:36:00.000000000,1
65,82,https://resizing.flixster.com/8YH8YlGcaEtw2prjBHsilXySVQM=/206x305/v2/https://flxt.tmsimg.com/assets/p9711_p_v8_aa.jpg,Trouble in Mind,500,11,1985.0,Crime/Drama,0 days 01:51:00.000000000,17
50,13,https://resizing.flixster.com/kqe4yobediF6nVQ7pHfSwz6y7E8=/206x305/v2/https://flxt.tmsimg.com/assets/p11072_p_v8_av.jpg,Far North,250,8,1988.0,Drama,0 days 01:30:00.000000000,-37
75,69,,9th Company,5000,16,2005.0,Drama/War,0 days 02:19:00.000000000,-6
72,82,https://resizing.flixster.com/22a4QuDVsvDnJEXPndXVITzqPIg=/206x305/v2/https://flxt.tmsimg.com/assets/p2133_p_v8_aa.jpg,Pursuit of the Graf Spee,500,11,1956.0,Adventure/War,0 days 01:59:00.000000000,10
60,89,,Bei yazi de nanhai (Taking Father Home),100,9,2006.0,,,29
52,100,,Dinosaurs: Giants of Patagonia,500,7,2007.0,Documentary,0 days 00:40:00.000000000,48
63,43,https://resizing.flixster.com/b7R3pcGBrH4gY0Xbbj45jP4u_ak=/206x305/v2/https://flxt.tmsimg.com/assets/p2671_p_v10_aa.jpg,Susan Slept Here,500,7,1954.0,Comedy,0 days 01:38:00.000000000,-20
77,56,,Naughty Marietta,500,9,1935.0,Comedy/Musical,0 days 01:46:00.000000000,-21
78,76,,Zazie in the Subway,1000,17,1960.0,Comedy,0 days 01:30:00.000000000,-2
92,100,,Jalsaghar,500,23,1960.0,Drama,0 days 01:40:00.000000000,8
50,63,https://resizing.flixster.com/QPQo9qDvCgPEPnZKvp5aKA8jRQw=/206x305/v2/https://flxt.tmsimg.com/assets/p6421_p_v10_aa.jpg,Still of the Night,500,8,1982.0,Crime/Drama,0 days 01:31:00.000000000,13
86,100,,Warrendale,100,5,1967.0,Documentary,0 days 01:40:00.000000000,14
63,91,https://resizing.flixster.com/sCW-IIyLjV-oBnIt3fkSF3NNZVY=/206x305/v2/https://flxt.tmsimg.com/assets/p4758_p_v10_aa.jpg,My Little Chickadee,500,11,1940.0,Western/Comedy,0 days 01:23:00.000000000,28
66,71,,Insignificance,500,14,1985.0,Comedy,0 days 01:50:00.000000000,5
58,50,,The Chronicles of Narnia: The Voyage of the Dawn Treader,100000,167,2010.0,Fantasy/Kids and family,0 days 01:52:00.000000000,-8
82,100,,There Was a Father,250,9,1942.0,Drama,0 days 01:34:00.000000000,18
62,75,/assets/pizza-pie/images/poster_default.c8c896e70c3.gif,The Vanquished,100,8,1953.0,Drama,0 days 01:50:00.000000000,13
85,100,,The Magician,1000,11,1958.0,Comedy/Drama,0 days 01:42:00.000000000,15
58,37,https://resizing.flixster.com/wFfJQGVGQyzch1H_94MCGTTYbM4=/206x305/v2/https://flxt.tmsimg.com/assets/p3546197_p_v10_av.jpg,Prince of Persia: The Sands of Time,250000,228,2010.0,Action/Fantasy,0 days 01:56:00.000000000,-21
89,90,https://resizing.flixster.com/qxd3pEXGNabytYO_93tmfvr0DC4=/206x305/v2/https://flxt.tmsimg.com/assets/p8175505_p_v10_ay.jpg,The Fighter,100000,252,2010.0,Drama/Biography,0 days 01:56:00.000000000,1
33,17,https://resizing.flixster.com/sC7T78Vi6pdoSJ3xEJeS6Si4adc=/206x305/v2/https://flxt.tmsimg.com/assets/p180706_p_v13_aj.jpg,The Oxford Murders,10000,12,2008.0,Crime/Drama,0 days 01:50:00.000000000,-16
90,98,https://resizing.flixster.com/cG1i3U5NH1znrOD_HtWxvhCHsxk=/206x305/v2/https://resizing.flixster.com/CaE_hITEMwMzdSnIKHc3nXgqRds=/ems.ZW1zLXByZC1hc3NldHMvbW92aWVzLzlhZDg3ZjU1LTk3ZTAtNDMzMC04MzliLTNiMzE5YmQ3ZDQ4OC53ZWJw,Toy Story 3,250000,308,2010.0,Comedy/Kids and family,0 days 01:42:00.000000000,8
63,72,,Machete,100000,195,2010.0,Action,0 days 01:44:00.000000000,9
82,100,https://resizing.flixster.com/EAjV2rF8PBcJXdMQ90oFDah7wu0=/206x305/v2/https://flxt.tmsimg.com/assets/p13893_p_v8_aa.jpg,Laws of Gravity,250,7,1992.0,Crime/Drama,0 days 01:40:00.000000000,18
85,96,,"Leon Morin, Priest",500,23,1961.0,Drama,0 days 02:10:00.000000000,11
85,77,,Harry Potter and the Deathly Hallows: Part 1,250000,287,2010.0,Fantasy/Adventure,0 days 02:26:00.000000000,-8
70,80,https://resizing.flixster.com/Anqmt86SxsptJCtgrtRzrzcyMWs=/206x305/v2/https://flxt.tmsimg.com/assets/p5668_p_v10_aa.jpg,The Human Comedy,250,5,1943.0,Comedy/Drama,0 days 01:58:00.000000000,10
60,80,,To Kill a Priest,250,5,1988.0,Mystery and thriller,0 days 01:56:00.000000000,20
77,100,https://resizing.flixster.com/_2JGx5f-qC7SwURfcNrfzzY95UI=/206x305/v2/https://flxt.tmsimg.com/assets/p90_p_v8_aa.jpg,Sunday in New York,500,7,1963.0,Romance,0 days 01:45:00.000000000,23
86,75,,The Hellstrom Chronicle,100,8,1971.0,Documentary,0 days 01:30:00.000000000,-11
77,95,https://resizing.flixster.com/tjR1H5aRjAINdk-eNw7ffWHR3XM=/206x305/v2/https://flxt.tmsimg.com/assets/p4310_p_v8_aa.jpg,Christmas in July,500,19,1940.0,Comedy,0 days 01:07:00.000000000,18
29,50,,Out of the Dark,250,6,1989.0,Comedy/Mystery and thriller,0 days 01:30:00.000000000,21
72,33,,Blossoms in the Dust,250,9,1941.0,Biography,0 days 01:40:00.000000000,-39
43,74,https://resizing.flixster.com/yRj_D9fgMPxvlHJBogjGszF6hhA=/206x305/v2/https://flxt.tmsimg.com/assets/p178157_p_v10_ap.jpg,Piranha,50000,130,2010.0,Horror/Mystery and thriller,0 days 01:28:00.000000000,31
79,94,,Secret Sunshine,2500,31,2007.0,Drama,0 days 02:22:00.000000000,15
88,55,,Shake Hands With the Devil,2500,11,2007.0,Drama,0 days 01:52:00.000000000,-33
71,78,,In the City of Sylvia,500,23,2007.0,Drama,0 days 01:24:00.000000000,7
78,83,/assets/pizza-pie/images/poster_default.c8c896e70c3.gif,The Dhamma Brothers,250,23,2008.0,Documentary,0 days 01:16:00.000000000,5
63,55,,The Sign of the Cross,250,11,1932.0,Drama/History,0 days 01:58:00.000000000,-8
86,95,,Hail the Conquering Hero,500,20,1944.0,Comedy,0 days 01:41:00.000000000,9
87,91,,Forbidden Lies,1000,34,2007.0,Drama,0 days 01:44:00.000000000,4
43,44,,The Green Hornet,100000,239,2011.0,Action/Adventure,0 days 01:59:00.000000000,1
87,89,,Tangled,100000,227,2010.0,Comedy/Kids and family,0 days 01:41:00.000000000,2
89,100,https://resizing.flixster.com/IKmqSYVOCIVobB-NvFdw-WHjdyA=/206x305/v2/https://flxt.tmsimg.com/assets/p179495_p_v10_aa.jpg,Spine Tingler! The William Castle Story,500,6,2007.0,Documentary/Biography,0 days 01:22:00.000000000,11
58,53,,Disney's A Christmas Carol,250000,202,2009.0,Kids and family/Other,0 days 01:35:00.000000000,-5
75,85,https://resizing.flixster.com/0sAcDw3oui26EK7jIk6X4c0HQqA=/206x305/v2/https://flxt.tmsimg.com/assets/p40137_p_v8_aa.jpg,Deep End,500,20,1970.0,Drama,0 days 01:30:00.000000000,10
58,100,,Highway Patrolman,100,6,1992.0,Drama,0 days 01:31:00.000000000,42
39,21,,Case 39,50000,76,2009.0,Horror/Mystery and thriller,0 days 01:49:00.000000000,-18
49,32,https://resizing.flixster.com/_qjvtGBHbdrJijiMiWnHMc1heUE=/206x305/v2/https://flxt.tmsimg.com/assets/p182469_p_v10_aa.jpg,Adventures of Power,1000,19,2008.0,Comedy/Adventure,0 days 01:36:00.000000000,-17
54,11,,Not as a Stranger,250,9,1955.0,Drama,0 days 02:15:00.000000000,-43
81,80,,Don't Let Me Drown,250,5,2009.0,Romance/Drama,0 days 01:42:00.000000000,-1
48,68,https://resizing.flixster.com/xMru6e_orpF-gdJhZ2c6p6C87mA=/206x305/v2/https://flxt.tmsimg.com/assets/p7880024_p_v13_ac.jpg,Life During Wartime,5000,104,2009.0,Comedy/Drama,0 days 01:38:00.000000000,20
84,82,,"The Good, the Bad, the Weird",10000,66,2008.0,Western/Action,0 days 02:07:00.000000000,-2
86,100,https://resizing.flixster.com/J6qiYKmTNDmO0M9Yi4uqzJtaeL8=/206x305/v2/https://flxt.tmsimg.com/assets/p36749_p_v10_aa.jpg,The Prowler,250,18,1951.0,Mystery and thriller,0 days 01:32:00.000000000,14
66,49,,The A-Team,100000,216,2010.0,Action/Adventure,0 days 01:58:00.000000000,-17
42,28,,Take Me Home Tonight,25000,114,2011.0,Romance/Drama,0 days 01:29:00.000000000,-14
37,75,,Splice,250000,196,2009.0,Horror/Sci fi,0 days 01:47:00.000000000,38
26,44,,Jackboots on Whitehall,500,18,2010.0,Comedy/Animation,,18
56,56,,A Complete History of My Sexual Failures,1000,9,2008.0,Documentary/Comedy,0 days 01:30:00.000000000,0
46,15,,Priest,50000,101,2011.0,Horror/Action,0 days 01:27:00.000000000,-31
60,75,,I Think We're Alone Now,500,8,2008.0,Documentary,0 days 01:10:00.000000000,15
78,54,https://resizing.flixster.com/irDMWuvcoFmvml5LgLW7d3skX5Q=/206x305/v2/https://flxt.tmsimg.com/assets/p8084155_p_v10_ab.jpg,Flipped,10000,76,2010.0,Romance,0 days 01:30:00.000000000,-24
78,100,/assets/pizza-pie/images/poster_default.c8c896e70c3.gif,People on Sunday,250,10,1930.0,Romance/Documentary,0 days 01:14:00.000000000,22
57,73,,Kings of the Evening,100,11,2007.0,Drama,0 days 01:40:00.000000000,16
33,29,/assets/pizza-pie/images/poster_default.c8c896e70c3.gif,Fade to Black,250,7,2006.0,Mystery and thriller,0 days 01:45:00.000000000,-4
5,0,,Fall Down Dead,100,7,2007.0,Mystery and thriller,0 days 01:33:00.000000000,-5
34,9,,Little Fockers,100000,151,2010.0,Comedy,0 days 01:37:00.000000000,-25
57,50,,French Film,250,18,2008.0,Romance,0 days 01:28:00.000000000,-7
74,72,,Micmacs,10000,144,2009.0,Crime/Comedy,0 days 01:45:00.000000000,-2
35,11,,Hoodwinked Too! Hood vs. Evil,25000,65,2011.0,Comedy/Kids and family,0 days 01:26:00.000000000,-24
82,81,,Mesrine: Part II - Public Enemy 1,10000,90,2008.0,Drama/Crime,0 days 02:10:00.000000000,-1
74,73,,Soul Kitchen,5000,60,2009.0,Comedy/Drama,0 days 01:39:00.000000000,-1
40,17,https://resizing.flixster.com/jUqjBwc7-VIyEkvhhij9L05KsNg=/206x305/v2/https://flxt.tmsimg.com/assets/p180569_p_v13_aa.jpg,Three and Out,1000,6,2008.0,Comedy,0 days 01:46:00.000000000,-23
77,86,,Blue Valentine,50000,211,2010.0,Romance/Drama,0 days 02:00:00.000000000,9
37,35,https://resizing.flixster.com/3zVuE56wYTgO_yOgKCL90_A7aqU=/206x305/v2/https://flxt.tmsimg.com/assets/p194409_p_v10_aa.jpg,All Good Things,25000,98,2010.0,Mystery and thriller,0 days 01:41:00.000000000,-2
26,22,,Hurry Sundown,100,9,1967.0,Drama,0 days 02:26:00.000000000,-4
76,100,,Hotel Terminus: The Life and Times of Klaus Barbie,100,7,1987.0,Documentary,0 days 04:28:00.000000000,24
26,38,https://resizing.flixster.com/cSi49VbvHoVp7IhqsuWf01oRWGI=/206x305/v2/https://flxt.tmsimg.com/assets/p192118_p_v8_aa.jpg,Eichmann,1000,8,2007.0,Drama/History,0 days 01:40:00.000000000,12
30,29,,Love Hurts,250,7,2009.0,Romance,0 days 01:35:00.000000000,-1
64,47,https://resizing.flixster.com/m5Xu5daqZmrTz6CEv-9X_pwAcH4=/206x305/v2/https://flxt.tmsimg.com/assets/p8073811_p_v10_aa.jpg,Step Up 3,100000,123,2010.0,Romance/Drama,0 days 01:46:00.000000000,-17
44,57,,Wild Rovers,100,14,1971.0,Western,0 days 02:16:00.000000000,13
37,44,,Used People,100,16,1992.0,Drama,0 days 01:55:00.000000000,7
84,85,,Black Swan,100000,313,2010.0,Drama/Mystery and thriller,0 days 01:48:00.000000000,1
43,88,https://resizing.flixster.com/OF__UQJF2UsMk-kk21BswGmt1S8=/206x305/v2/https://flxt.tmsimg.com/assets/p7866_p_v10_aa.jpg,Hearts of the West,100,8,1975.0,Comedy,0 days 01:42:00.000000000,45
31,0,https://resizing.flixster.com/e-WDDvlzuGiiv24OSim_JEmGrjA=/206x305/v2/https://flxt.tmsimg.com/assets/p8588937_p_v10_aa.jpg,Tekken,10000,6,2010.0,Sci fi/Action,0 days 01:32:00.000000000,-31
72,50,,Desert Flower,2500,18,2009.0,Drama/Biography,0 days 02:04:00.000000000,-22
60,86,/assets/pizza-pie/images/poster_default.c8c896e70c3.gif,The Gates,100,7,2005.0,Documentary,0 days 01:38:00.000000000,26
40,0,,Lucky Lady,100,5,1975.0,Comedy/Drama,0 days 01:58:00.000000000,-40
32,45,,Cactus,250,11,2008.0,Crime/Drama,,13
51,66,,Freakonomics,5000,64,2010.0,Documentary,0 days 01:26:00.000000000,15
56,60,,The Waiting Room,250,5,2007.0,Drama,0 days 01:50:00.000000000,4
44,71,https://resizing.flixster.com/SAqU7GhKYLTmGfAd4PAW0CQr6m0=/206x305/v2/https://flxt.tmsimg.com/assets/p3576702_p_v13_aa.jpg,Chelsea on the Rocks,500,28,2008.0,Documentary,0 days 01:28:00.000000000,27
70,57,,The Perfect Game,10000,44,2008.0,Kids and family/Drama,0 days 01:58:00.000000000,-13
88,84,https://resizing.flixster.com/4ANUINUT7xnul1zR3u1PqV7-YYI=/206x305/v2/https://flxt.tmsimg.com/assets/p196914_p_v10_aa.jpg,Prince of Broadway,500,19,2008.0,Drama,0 days 01:42:00.000000000,-4
74,43,,Highwater,500,14,2008.0,Documentary/Adventure,0 days 01:30:00.000000000,-31
73,60,,Loot,50,10,2008.0,Documentary,0 days 01:26:00.000000000,-13
71,72,,Enter the Void,10000,93,2009.0,Drama,0 days 02:42:00.000000000,1
47,78,,Heartless,10000,40,2009.0,Horror/Drama,0 days 01:49:00.000000000,31
61,71,https://resizing.flixster.com/Abxv6gLP29HzZTOGMcvJ1ho-sl8=/206x305/v2/https://flxt.tmsimg.com/assets/p3595211_p_v10_ag.jpg,I Love You Phillip Morris,50000,158,2009.0,Romance/Gay and lesbian,0 days 01:38:00.000000000,10
47,20,https://resizing.flixster.com/keovMeNl2j89V3agEICCUFoMmYE=/206x305/v2/https://flxt.tmsimg.com/assets/p8020481_p_v13_aa.jpg,The Lightkeepers,100,5,2009.0,Comedy,0 days 01:36:00.000000000,-27
91,99,https://resizing.flixster.com/GdX8AzWzv11iNyhcZHc1KWpXjBE=/206x305/v2/https://flxt.tmsimg.com/NowShowing/82448/82448_aa.jpg,How to Train Your Dragon,250000,211,2010.0,Comedy/Kids and family,0 days 01:38:00.000000000,8
65,67,https://resizing.flixster.com/XrDlMlvyBpbSsm3EHKy9NfXY5cw=/206x305/v2/https://resizing.flixster.com/l2TssJo7XqQbxeqt0gaxpy5wgWo=/ems.ZW1zLXByZC1hc3NldHMvbW92aWVzLzMwYWJlZmFiLTRlNjgtNDFjNy1hN2YzLWI2NmI4MjQ1NzI0ZS53ZWJw,Bunny and the Bull,2500,33,2009.0,Comedy,0 days 01:41:00.000000000,2
84,82,https://resizing.flixster.com/ikyHzosxukSrBvi6LOAiyJr12eU=/206x305/v2/https://flxt.tmsimg.com/NowShowing/89479/89479_aa.jpg,Scott Pilgrim vs. the World,100000,272,2010.0,Romance/Action,0 days 01:52:00.000000000,-2
37,33,,Who Killed Nancy?,100,21,2009.0,Documentary/Music,0 days 01:40:00.000000000,-4
45,22,https://resizing.flixster.com/8One6qAnWdgTFHEOm-i4c2HkhOw=/206x305/v2/https://flxt.tmsimg.com/assets/p188019_p_v10_ae.jpg,Daylight Robbery,250,9,2008.0,Crime/Drama,0 days 01:32:00.000000000,-23
60,68,https://resizing.flixster.com/7NcQAzYfoMVU_OviPcT9_qNlty4=/206x305/v2/https://flxt.tmsimg.com/assets/p8011713_p_v10_az.jpg,Ondine,10000,101,2009.0,Fantasy/Drama,0 days 01:50:00.000000000,8
63,51,,Tron: Legacy,100000,246,2010.0,Action/Sci fi,0 days 02:05:00.000000000,-12
43,15,,A Nightmare on Elm Street,100000,183,2010.0,Horror,0 days 01:36:00.000000000,-28
39,44,,Dorian Gray,25000,39,2009.0,Horror/Mystery and thriller,0 days 01:52:00.000000000,5
89,100,,Louie Bluie,100,6,1985.0,Documentary,0 days 01:00:00.000000000,11
62,70,https://resizing.flixster.com/UWz63Ps9fNHm4VMMutFIypSF5Cs=/206x305/v2/https://flxt.tmsimg.com/assets/p8371978_p_v10_aa.jpg,Paul,250000,206,2011.0,Comedy/Sci fi,0 days 01:44:00.000000000,8
45,23,,The Secret of Moonacre,2500,22,2009.0,Romance/Fantasy,0 days 01:43:00.000000000,-22
80,85,,Kisses,1000,53,2008.0,Drama,0 days 01:16:00.000000000,5
41,18,,Alpha and Omega,25000,57,2010.0,Animation/Comedy,0 days 01:28:00.000000000,-23
76,93,,Idiots and Angels,500,15,2008.0,Comedy/Drama,0 days 01:18:00.000000000,17
69,50,https://resizing.flixster.com/FZ4CyPP3VuzVIRUw5Un3LOOyBCE=/206x305/v2/https://flxt.tmsimg.com/assets/p7887593_p_v8_aa.jpg,The Scenesters,100,8,2009.0,Crime/Comedy,0 days 01:42:00.000000000,-19
49,94,,Liverpool,250,16,2008.0,Drama,0 days 01:24:00.000000000,45
49,61,,Leaves of Grass,10000,38,2009.0,Comedy/Drama,0 days 01:44:00.000000000,12
58,50,https://resizing.flixster.com/M7f9pAsszrpEZxYcE9FUeT4nYoY=/206x305/v2/https://resizing.flixster.com/9kRliOQjsHOYxAG1eooUPPTIz8c=/ems.ZW1zLXByZC1hc3NldHMvbW92aWVzLzdjYmYxNzI1LTJmMDgtNGYwMi05NDM5LTkyOTkzMzQ5ZDk2Mi53ZWJw,The Beautiful Person,1000,6,2008.0,Drama,0 days 01:35:00.000000000,-8
63,27,https://resizing.flixster.com/ynVVHiRNiE36msNPLCAk63Jlihs=/206x305/v2/https://flxt.tmsimg.com/assets/p189845_p_v13_ab.jpg,Clubbed,1000,11,2008.0,Crime/Drama,0 days 01:35:00.000000000,-36
36,47,https://resizing.flixster.com/GwfCp18dmzwirGEx_HgPlsmPF9E=/206x305/v2/https://flxt.tmsimg.com/assets/p8227644_p_v8_aa.jpg,Barry Munday,1000,15,2010.0,Comedy/Drama,0 days 01:38:00.000000000,11
59,71,https://resizing.flixster.com/JHlDgVAkfm2rktYvU6dLRUl6Vpw=/206x305/v2/https://flxt.tmsimg.com/assets/p3497581_p_v10_aa.jpg,Fear Me Not,250,7,2008.0,Drama,0 days 01:35:00.000000000,12
40,27,,The Loss of a Teardrop Diamond,50000,41,2008.0,Romance/Drama,0 days 01:42:00.000000000,-13
82,81,https://resizing.flixster.com/sKdjMw09wGbO2EIVKaIdOan7ujQ=/206x305/v2/https://flxt.tmsimg.com/assets/p197819_p_v10_av.jpg,Mesrine: Part II - Public Enemy 1,10000,90,2008.0,Drama/Crime,0 days 02:10:00.000000000,-1
72,50,https://resizing.flixster.com/bnlv2b7-m9uu80amIY_9kifZJCA=/206x305/v2/https://flxt.tmsimg.com/assets/p3533462_p_v13_ad.jpg,Touching Home,250,14,2008.0,Drama,0 days 01:54:00.000000000,-22
67,86,,The Windmill Movie,1000,21,2008.0,Documentary,0 days 01:22:00.000000000,19
79,84,https://resizing.flixster.com/3Ru7Tjz_tY1w3hg5iW58U1KkrPc=/206x305/v2/https://flxt.tmsimg.com/assets/p190834_p_v10_aq.jpg,Skin,1000,64,2008.0,Drama,0 days 01:47:00.000000000,5
58,63,,Howl,5000,109,2010.0,Drama/Biography,0 days 01:24:00.000000000,5
36,67,/assets/pizza-pie/images/poster_default.c8c896e70c3.gif,Helen,100,21,2008.0,Drama,0 days 01:19:00.000000000,31
75,73,https://resizing.flixster.com/PpCMk6boCvzmZod0n8FXvP4Zj5A=/206x305/v2/https://flxt.tmsimg.com/assets/p7919859_p_v8_aa.jpg,"Lovely, Still",1000,22,2008.0,Other/Drama,0 days 01:30:00.000000000,-2
86,65,,Who Does She Think She Is?,50,17,2008.0,Documentary,0 days 01:23:00.000000000,-21
78,76,/assets/pizza-pie/images/poster_default.c8c896e70c3.gif,Jerusalema,500,21,2008.0,Crime/Action,0 days 01:58:00.000000000,-2
70,88,,Pranzo di Ferragosto,2500,67,2008.0,Comedy/Drama,0 days 01:15:00.000000000,18
53,40,https://resizing.flixster.com/GcAmnLB88cRni9PcFLI2EWAfGf4=/206x305/v2/https://flxt.tmsimg.com/assets/p7947752_p_v10_ai.jpg,The Sorcerer's Apprentice,100000,173,2010.0,Comedy/Fantasy,0 days 01:48:00.000000000,-13
17,36,https://resizing.flixster.com/z5vTw3ahdg0XcIdqM4Gi68C6cWw=/206x305/v2/https://flxt.tmsimg.com/assets/p7992214_p_v10_aj.jpg,The Last New Yorker,50,11,2006.0,Drama,0 days 01:30:00.000000000,19
75,47,/assets/pizza-pie/images/poster_default.c8c896e70c3.gif,The Beautiful Truth,1000,15,2008.0,Documentary,0 days 01:32:00.000000000,-28
24,40,,Pig Hunt,500,5,2008.0,Action/Horror,0 days 01:41:00.000000000,16
37,50,,Hush,1000,8,2009.0,Mystery and thriller,0 days 01:31:00.000000000,13
33,22,https://resizing.flixster.com/hzBBaoKbuKiymnjYA5PjQU5QFqw=/206x305/v2/https://flxt.tmsimg.com/assets/p189805_p_v8_aa.jpg,Looking for Palladin,50,9,2008.0,Comedy/Drama,0 days 01:55:00.000000000,-11
63,54,https://resizing.flixster.com/53qrIEQkLXffINKDKR4CB5qTmWo=/206x305/v2/https://flxt.tmsimg.com/assets/p190401_p_v10_aa.jpg,Salt of This Sea,1000,13,2008.0,Romance/Drama,0 days 01:49:00.000000000,-9
76,78,https://resizing.flixster.com/hYUhN8bEImPxgP3uSiWEl0kCZOg=/206x305/v2/https://flxt.tmsimg.com/assets/p7996882_p_v10_ag.jpg,Mother and Child,5000,128,2009.0,Drama,0 days 02:06:00.000000000,2
48,45,,Cracks,5000,51,2009.0,Gay and lesbian/Drama,0 days 01:44:00.000000000,-3
58,43,https://resizing.flixster.com/PLTSLNKw-Rqrhh2RfpiKB0oH56A=/206x305/v2/https://flxt.tmsimg.com/assets/p7874392_p_v10_ae.jpg,Robin Hood,250000,251,2010.0,Action/Drama,0 days 02:19:00.000000000,-15
71,72,,Iron Man 2,250000,302,2010.0,Fantasy/Action,0 days 02:04:00.000000000,1
79,72,/assets/pizza-pie/images/poster_default.c8c896e70c3.gif,Theater of War,250,18,2008.0,Documentary,0 days 01:35:00.000000000,-7
83,79,,Max Manus,2500,34,2008.0,Drama/War,0 days 01:58:00.000000000,-4
71,89,https://resizing.flixster.com/DehOVCuLbqPQy3Gx19xtg5GuQvI=/206x305/v2/https://flxt.tmsimg.com/assets/p3564335_p_v13_aa.jpg,The Immaculate Conception of Little Dizzle,250,9,2009.0,Comedy,0 days 01:40:00.000000000,18
72,81,,White Lightnin',500,16,2009.0,Drama,0 days 01:24:00.000000000,9
78,74,https://resizing.flixster.com/rOiSiTFx00I7L4mqPlq-6OReNzA=/206x305/v2/https://flxt.tmsimg.com/assets/p7935905_p_v10_ad.jpg,Winter in Wartime,2500,66,2008.0,War/Drama,0 days 01:43:00.000000000,-4
40,86,/assets/pizza-pie/images/poster_default.c8c896e70c3.gif,Mock Up on Mu,50,7,2008.0,Comedy/Sci fi,0 days 01:54:00.000000000,46
55,50,https://resizing.flixster.com/olClHu10KEBK6um1esoaHtwoRSM=/206x305/v2/https://flxt.tmsimg.com/assets/p8187101_p_v8_aa.jpg,The Winning Season,1000,22,2009.0,Drama/Comedy,0 days 01:46:00.000000000,-5
64,42,https://resizing.flixster.com/200hcIM0UKWwUftzI-Ml_UhTZ8c=/206x305/v2/https://flxt.tmsimg.com/assets/p3546099_p_v10_ae.jpg,The Expendables,250000,208,2010.0,Action/Adventure,0 days 01:43:00.000000000,-22
80,88,/assets/pizza-pie/images/poster_default.c8c896e70c3.gif,Journey to Mecca in the Footsteps of Ibn Battuta,100,8,2008.0,Drama,0 days 00:40:00.000000000,8
93,100,,3 Idiots,10000,13,2009.0,Comedy,0 days 02:40:00.000000000,7
56,50,,Metropia,2500,6,2009.0,Sci fi/Animation,0 days 01:26:00.000000000,-6
35,40,https://resizing.flixster.com/2Rh8sx-QpAtOgmiLzsxhoRLA_0g=/206x305/v2/https://flxt.tmsimg.com/assets/p3546925_p_v8_aa.jpg,Rosencrantz and Guildenstern Are Undead,2500,15,2009.0,Comedy,0 days 01:25:00.000000000,5
65,53,https://resizing.flixster.com/BOMt3et9Ttulfgu_fMP2lbS6K6M=/206x305/v2/https://flxt.tmsimg.com/assets/p8040869_p_v10_ap.jpg,Agora,10000,92,2009.0,Romance/Drama,0 days 02:06:00.000000000,-12
69,65,,Jackass 3,50000,112,2010.0,Comedy,0 days 01:34:00.000000000,-4
65,60,,Barking Water,50,5,2009.0,Drama,0 days 01:20:00.000000000,-5
27,67,,Everything Strange and New,500,6,2009.0,Drama,0 days 01:24:00.000000000,40
39,33,,Sympathy for Delicious,1000,27,2010.0,Comedy/Drama,0 days 01:36:00.000000000,-6
56,33,https://resizing.flixster.com/x3y2GHJC6g12CgQ0I1k0MgSZafs=/206x305/v2/https://flxt.tmsimg.com/assets/p8153168_p_v8_ak.jpg,Wild Target,25000,55,2010.0,Action/Drama,0 days 01:36:00.000000000,-23
74,91,https://resizing.flixster.com/zVmatUdC9NUR3S7Kibtjmx6itiA=/206x305/v2/https://flxt.tmsimg.com/assets/p3549291_p_v13_aa.jpg,Big River Man,250,33,2009.0,Documentary,0 days 01:40:00.000000000,17
33,29,https://resizing.flixster.com/MByl1LOQ6wx17f_Y247cIz_vHqA=/206x305/v2/https://flxt.tmsimg.com/assets/p8225095_p_v10_ab.jpg,"Carmo, Hit the Road",500,7,2008.0,Drama/Adventure,0 days 01:40:00.000000000,-4
69,60,/assets/pizza-pie/images/poster_default.c8c896e70c3.gif,Kimjongilia,250,10,2009.0,Documentary/Drama,0 days 01:16:00.000000000,-9
69,76,/assets/pizza-pie/images/poster_default.c8c896e70c3.gif,Unmade Beds,500,29,2009.0,Comedy/Drama,0 days 01:32:00.000000000,7
64,64,https://resizing.flixster.com/EBIK9nl2GAri4sZUpyg4sZmxL6E=/206x305/v2/https://flxt.tmsimg.com/assets/p3587829_p_v10_aa.jpg,You Won't Miss Me,1000,11,2009.0,Comedy/Drama,0 days 01:21:00.000000000,0
79,80,/assets/pizza-pie/images/poster_default.c8c896e70c3.gif,Nurse.Fighter.Boy,500,5,2008.0,Drama,0 days 01:33:00.000000000,1
62,28,https://resizing.flixster.com/vZ44MrU5DxvJI8U5OLCaIpzk9I0=/206x305/v2/https://flxt.tmsimg.com/assets/p189063_p_v10_ak.jpg,Takers,100000,115,2010.0,Crime/Action,0 days 01:47:00.000000000,-34
36,63,,Ricky,1000,16,2009.0,Comedy/Drama,0 days 01:29:00.000000000,27
85,90,,The Secret of Kells,10000,83,2009.0,Fantasy/Kids and family,0 days 01:18:00.000000000,5
27,34,,The Resident,5000,32,2011.0,Drama/Mystery and thriller,0 days 01:31:00.000000000,7
85,80,,I Knew It Was You: Rediscovering John Cazale,500,5,2009.0,Documentary/Biography,0 days 00:39:00.000000000,-5
72,74,,The Way Back,25000,139,2010.0,Drama,0 days 02:13:00.000000000,2
57,60,,Breaking Upwards,1000,20,2009.0,Romance,0 days 01:28:00.000000000,3
82,81,https://resizing.flixster.com/q27eQ7iI1j9mFdqSujn9f3kJbFA=/206x305/v2/https://flxt.tmsimg.com/NowShowing/88104/88104_aa.jpg,Despicable Me,250000,202,2010.0,Comedy/Animation,0 days 01:35:00.000000000,-1
68,73,,The Age of Stupid,1000,15,2009.0,Documentary/Drama,0 days 01:29:00.000000000,5
38,13,,Cats & Dogs: The Revenge of Kitty Galore,50000,99,2010.0,Comedy/Kids and family,0 days 01:22:00.000000000,-25
76,88,,Let Me In,50000,237,2010.0,Horror,0 days 01:55:00.000000000,12
46,18,https://resizing.flixster.com/7WRKyXMlXXZqiIFjFo-kNhK49dM=/206x305/v2/https://flxt.tmsimg.com/assets/p7812551_p_v8_aa.jpg,The Back-up Plan,100000,148,2010.0,Romance,0 days 01:44:00.000000000,-28
71,70,,Ramona and Beezus,50000,91,2010.0,Comedy/Kids and family,0 days 01:43:00.000000000,-1
68,27,https://resizing.flixster.com/vuf9WYIsB780xUAh7V3StWY6SQo=/206x305/v2/https://flxt.tmsimg.com/assets/p7885587_p_v8_aa.jpg,Tyler Perry's Why Did I Get Married Too?,100000,49,2010.0,Romance/Comedy,0 days 02:01:00.000000000,-41
68,78,https://resizing.flixster.com/mmPHoeMRxjbeT30nt0LE3x_lqRA=/206x305/v2/https://flxt.tmsimg.com/assets/p3507344_p_v8_aa.jpg,The Milk of Sorrow,5000,41,2009.0,Drama,0 days 01:34:00.000000000,10
60,48,https://resizing.flixster.com/yW6VFwZ9KAm2ZEPDtCirqIsr5lg=/206x305/v2/https://flxt.tmsimg.com/assets/p3623663_p_v13_bc.jpg,The Twilight Saga: Eclipse,250000,246,2010.0,Romance/Fantasy,0 days 02:04:00.000000000,-12
30,5,,The Last Airbender,250000,192,2010.0,Fantasy/Adventure,0 days 01:43:00.000000000,-25
91,87,https://resizing.flixster.com/4MrL62heb7yBgBt8zllSeqNZxg4=/206x305/v2/https://flxt.tmsimg.com/assets/p7825626_p_v10_af.jpg,Inception,250000,359,2010.0,Action/Sci fi,0 days 02:28:00.000000000,-4
20,12,https://resizing.flixster.com/Epr6LSAwUDzcWW4GPNG5tZXsbVY=/206x305/v2/https://flxt.tmsimg.com/assets/p3624505_p_v10_as.jpg,Jonah Hex,100000,152,2010.0,Western/Fantasy,0 days 01:21:00.000000000,-8
47,22,,Sucker Punch,50000,220,2011.0,Action/Fantasy,0 days 01:50:00.000000000,-25
72,73,,Megamind,100000,182,2010.0,Animation/Comedy,0 days 01:36:00.000000000,1
69,88,https://resizing.flixster.com/VgdGAf1vgUyevKOaVazRZU4NpVs=/206x305/v2/https://flxt.tmsimg.com/assets/p8157012_p_v13_aq.jpg,Rango,100000,222,2011.0,Animation/Comedy,0 days 01:45:00.000000000,19
46,64,https://resizing.flixster.com/9MKggpnDOw6T7aGpNXzEr5-tFCs=/206x305/v2/https://flxt.tmsimg.com/assets/p8129057_p_v8_aa.jpg,The Dry Land,250,25,2010.0,Drama,0 days 01:32:00.000000000,18
59,62,,Salt,100000,247,2010.0,Action/Mystery and thriller,0 days 01:40:00.000000000,3
75,80,,Oceans,50000,81,2009.0,Documentary,0 days 01:42:00.000000000,5
43,48,,Jolene,2500,21,2008.0,Drama,0 days 01:50:00.000000000,5
58,78,/assets/pizza-pie/images/poster_default.c8c896e70c3.gif,Shirin,1000,9,2008.0,Drama,0 days 01:32:00.000000000,20
40,32,/assets/pizza-pie/images/poster_default.c8c896e70c3.gif,My Last Five Girlfriends,500,19,2009.0,Romance,0 days 01:27:00.000000000,-8
79,82,https://resizing.flixster.com/nI4wGnjjKvFqpJpuQUN5vXpZrZg=/206x305/v2/https://flxt.tmsimg.com/assets/p7995820_p_v8_an.jpg,City Island,25000,104,2009.0,Comedy,0 days 01:43:00.000000000,3
56,81,,Handsome Harry,250,26,2009.0,Drama,0 days 01:34:00.000000000,25
75,92,/assets/pizza-pie/images/poster_default.c8c896e70c3.gif,Only When I Dance,500,13,2009.0,Documentary,0 days 01:18:00.000000000,17
49,77,https://resizing.flixster.com/iNDRheJugkRpuDsxJOnnIQK76TM=/206x305/v2/https://flxt.tmsimg.com/assets/p8007052_p_v10_aa.jpg,Double Take,250,30,2009.0,Drama,0 days 01:20:00.000000000,28
50,78,,Eccentricities of a Blond Hair Girl,1000,23,2009.0,Drama,0 days 01:04:00.000000000,28
93,100,/assets/pizza-pie/images/poster_default.c8c896e70c3.gif,Still Bill,250,6,2009.0,Documentary/Music,0 days 01:18:00.000000000,7
46,80,,The Fish Child,250,5,2009.0,Drama,0 days 01:36:00.000000000,34
42,42,,Turning Green,50,12,2005.0,Comedy/Drama,0 days 01:25:00.000000000,0
33,69,https://resizing.flixster.com/RlaOThhzSM06b6oYZp8p3eyglZc=/206x305/v2/https://flxt.tmsimg.com/assets/p3557963_p_v10_aa.jpg,Tormented,5000,36,2009.0,Comedy/Horror,0 days 01:31:00.000000000,36
54,55,https://resizing.flixster.com/6gVxj35iiI3g8WJRtvS_EkFtnLA=/206x305/v2/https://flxt.tmsimg.com/assets/p8237996_p_v10_ax.jpg,Gnomeo & Juliet,100000,128,2011.0,Comedy/Kids and family,0 days 01:24:00.000000000,1
42,42,,Dinner for Schmucks,100000,191,2010.0,Comedy,0 days 01:54:00.000000000,0
32,3,,Twelve,10000,30,2010.0,Drama,0 days 01:34:00.000000000,-29
79,93,,Living in Emergency: Stories of Doctors Without Borders,250,27,2008.0,Documentary,0 days 01:33:00.000000000,14
76,56,,Mao's Last Dancer,5000,77,2009.0,Drama/Biography,0 days 01:57:00.000000000,-20
42,5,/assets/pizza-pie/images/poster_default.c8c896e70c3.gif,Waiting for Forever,10000,19,2010.0,Romance,0 days 01:34:00.000000000,-37
74,66,,Biutiful,10000,155,2010.0,Romance/Drama,0 days 02:27:00.000000000,-8
61,53,,The Sicilian Girl,500,32,2009.0,Drama,0 days 01:55:00.000000000,-8
52,56,https://resizing.flixster.com/OjoG9GOCK1R__4gnoaCpwzXK2eI=/206x305/v2/https://flxt.tmsimg.com/assets/p3499036_p_v8_aa.jpg,White Wedding,1000,27,2009.0,Romance,0 days 01:33:00.000000000,4
84,87,/assets/pizza-pie/images/poster_default.c8c896e70c3.gif,Punching the Clown,2500,15,2009.0,Comedy,0 days 01:31:00.000000000,3
48,32,,Paper Man,2500,31,2009.0,Comedy/Drama,0 days 01:50:00.000000000,-16
27,20,https://resizing.flixster.com/pJF6hE5_tE-bdDsOLWbJK_X8M6U=/206x305/v2/https://flxt.tmsimg.com/assets/p8149619_p_v13_an.jpg,Gulliver's Travels,50000,120,2010.0,Fantasy/Comedy,0 days 01:25:00.000000000,-7
84,94,,Best Worst Movie,2500,69,2009.0,Documentary,0 days 01:31:00.000000000,10
75,69,,Letters to Father Jacob,500,13,2009.0,Drama,0 days 01:15:00.000000000,-6
70,50,,A Shine of Rainbows,500,10,2009.0,Kids and family/Drama,0 days 01:41:00.000000000,-20
52,54,,Going the Distance,50000,167,2010.0,Romance,0 days 01:38:00.000000000,2
51,55,,Morning Glory,50000,180,2010.0,Romance,0 days 01:50:00.000000000,4
69,100,,The Makioka Sisters,500,9,1983.0,Drama,0 days 02:20:00.000000000,31
50,78,https://resizing.flixster.com/8GAJgpM1zWpCbR-VhcmTqQZXAjo=/206x305/v2/https://flxt.tmsimg.com/assets/p7976237_p_v10_ac.jpg,Solitary Man,10000,99,2009.0,Comedy/Drama,0 days 01:29:00.000000000,28
48,91,,Guy and Madeline on a Park Bench,1000,23,2009.0,Romance/Drama,0 days 01:22:00.000000000,43
47,31,,The Warrior's Way,25000,42,2010.0,Western/Action,0 days 01:40:00.000000000,-16
44,49,https://resizing.flixster.com/Tcbq3WDRW76oujZi8qNZy7NYP7Y=/206x305/v2/https://flxt.tmsimg.com/assets/p7958102_p_v10_ab.jpg,"My Son, My Son, What Have Ye Done",2500,41,2009.0,Horror/Drama,0 days 01:33:00.000000000,5
22,33,,Boogie Woogie,1000,24,2009.0,Comedy/Drama,0 days 01:30:00.000000000,11
76,94,,Samson & Delilah,5000,52,2009.0,Romance/Drama,0 days 01:41:00.000000000,18
87,90,https://resizing.flixster.com/RnTmp3v5UR_Ogp595vkQCHuAhNQ=/206x305/v2/https://flxt.tmsimg.com/assets/p3530673_p_v8_aa.jpg,The Boys: The Sherman Brothers' Story,2500,21,2009.0,Documentary,0 days 01:41:00.000000000,3
78,92,,The Girl,1000,12,2009.0,Drama,0 days 01:35:00.000000000,14
75,93,,Of Gods and Men,10000,120,2010.0,Drama,0 days 02:02:00.000000000,18
42,33,https://resizing.flixster.com/_7WNR6i88tIabYmQDln1AtAClHs=/206x305/v2/https://flxt.tmsimg.com/assets/p8145460_p_v10_ad.jpg,Don't Look Back,1000,6,2009.0,Drama/Mystery and thriller,0 days 01:50:00.000000000,-9
61,50,/assets/pizza-pie/images/poster_default.c8c896e70c3.gif,Jaffa,100,6,2009.0,Drama,0 days 01:46:00.000000000,-11
75,63,,Harry Brown,25000,127,2009.0,Crime/Drama,0 days 01:37:00.000000000,-12
75,85,,Get Low,10000,145,2009.0,Comedy/Drama,0 days 01:42:00.000000000,10
68,88,https://resizing.flixster.com/Prqn0VFrMBruP0fy3_UByLXA8kA=/206x305/v2/https://flxt.tmsimg.com/assets/p7845746_p_v13_ag.jpg,The Army of Crime,1000,33,2009.0,War/Drama,0 days 02:19:00.000000000,20
21,25,https://resizing.flixster.com/kJ9cCgf_Ik1pcDBz8KzFfLSG5ow=/206x305/v2/https://flxt.tmsimg.com/assets/p8036884_p_v8_ab.jpg,The Chameleon,500,8,2010.0,Mystery and thriller,0 days 01:46:00.000000000,4
43,53,https://resizing.flixster.com/Ee77UJjfX5i0S1oRgZmLzolMoeY=/206x305/v2/https://flxt.tmsimg.com/assets/p8006448_p_v10_av.jpg,Coco Chanel & Igor Stravinsky,10000,93,2009.0,Romance/Drama,0 days 02:00:00.000000000,10
24,0,,A Beautiful Life,100,12,2008.0,Romance/Drama,0 days 01:21:00.000000000,-24
62,71,,Adrift,2500,14,2009.0,Drama,0 days 01:37:00.000000000,9
18,21,https://resizing.flixster.com/dcp-83uLYjq8o41yX3LGn8UZijM=/206x305/v2/https://flxt.tmsimg.com/assets/p8013433_p_v8_aa.jpg,The Black Waters of Echo's Pond,1000,19,2009.0,Horror/Mystery and thriller,0 days 01:32:00.000000000,3
80,90,https://resizing.flixster.com/xj082ZZRDx8d9jPhnSKBcKS4bSM=/206x305/v2/https://flxt.tmsimg.com/assets/p3549304_p_v13_ac.jpg,Winnebago Man,10000,62,2009.0,Documentary/Comedy,0 days 01:27:00.000000000,10
56,40,https://resizing.flixster.com/u5jkwERoHyBvsix6ppRExeWWDbY=/206x305/v2/https://flxt.tmsimg.com/assets/p8088811_p_v10_ag.jpg,Middle Men,10000,53,2009.0,Crime/Drama,0 days 01:45:00.000000000,-16
76,95,,Nobody Knows About the Persian Cats,2500,61,2009.0,Drama,0 days 01:46:00.000000000,19
76,82,,Like Dandelion Dust,1000,17,2009.0,Drama,0 days 01:44:00.000000000,6
32,7,https://resizing.flixster.com/i-KpcEOQTfZbZ4WrRo61TmYtuiI=/206x305/v2/https://flxt.tmsimg.com/assets/p7876926_p_v8_ai.jpg,Furry Vengeance,50000,95,2010.0,Comedy/Kids and family,0 days 01:31:00.000000000,-25
62,11,,Grown Ups,250000,169,2010.0,Comedy,0 days 01:42:00.000000000,-51
49,29,,The Last International Playboy,1000,7,2008.0,Romance/Comedy,0 days 01:35:00.000000000,-20
63,75,https://resizing.flixster.com/BMWP6HvbhsPt1h4o6gfEPc4QbJE=/206x305/v2/https://flxt.tmsimg.com/assets/p3590867_p_v8_ah.jpg,OSS 117: Lost in Rio,2500,52,2009.0,Comedy/Adventure,0 days 01:41:00.000000000,12
48,21,https://resizing.flixster.com/-dtZPienmRPitF9rTPYjmes6YaE=/206x305/v2/https://flxt.tmsimg.com/assets/p8000512_p_v10_aa.jpg,Beastly,50000,97,2011.0,Romance/Fantasy,0 days 01:26:00.000000000,-27
43,61,,Centurion,25000,111,2010.0,Drama/Adventure,0 days 01:37:00.000000000,18
56,43,,Mercy,250,14,2009.0,Romance/Drama,0 days 01:27:00.000000000,-13
60,94,https://resizing.flixster.com/aKXOMOh84ivqiwYTZfd6DjkM6AE=/206x305/v2/https://flxt.tmsimg.com/assets/p7997109_p_v10_ab.jpg,Passenger Side,500,18,2009.0,Drama,,34
64,75,,Dear Lemon Lima,500,12,2009.0,Comedy,0 days 01:28:00.000000000,11
53,50,,Suck,1000,10,2009.0,Comedy/Horror,0 days 01:31:00.000000000,-3
74,75,,The Crimson Wing: Mystery of the Flamingos,250,20,2008.0,Documentary,0 days 01:17:00.000000000,1
93,100,,Racing Dreams,1000,27,2009.0,Documentary,0 days 01:37:00.000000000,7
41,10,,Killers,100000,109,2010.0,Comedy/Action,0 days 01:40:00.000000000,-31
65,79,,Fair Game,25000,177,2010.0,Drama/Mystery and thriller,0 days 01:47:00.000000000,14
33,13,,In My Sleep,250,16,2009.0,Drama/Mystery and thriller,0 days 01:30:00.000000000,-20
67,71,,The Adjustment Bureau,100000,261,2011.0,Romance/Mystery and thriller,0 days 01:45:00.000000000,4
56,63,https://resizing.flixster.com/yenLIElil_GusVGJ--SRYRArBKk=/206x305/v2/https://flxt.tmsimg.com/assets/p7979129_p_v13_aa.jpg,Exam,5000,30,2009.0,Mystery and thriller,0 days 01:41:00.000000000,7
49,73,,Valhalla Rising,10000,59,2009.0,Action/Adventure,0 days 01:40:00.000000000,24
32,60,https://resizing.flixster.com/5FbRddNT2KVJupMstGpPaXMlmqY=/206x305/v2/https://flxt.tmsimg.com/assets/p8186935_p_v10_aa.jpg,High Lane,500,5,2009.0,Adventure/Mystery and thriller,0 days 01:24:00.000000000,28
66,73,,Sex & Drugs & Rock & Roll,2500,51,2010.0,Drama/Biography,0 days 01:54:00.000000000,7
54,58,https://resizing.flixster.com/zw4G7WWO6HEyG4elWUrEfdVSj1s=/206x305/v2/https://flxt.tmsimg.com/NowShowing/80011/80011_ab.jpg,Shrek Forever After,250000,200,2010.0,Comedy/Kids and family,0 days 01:35:00.000000000,4
44,52,https://resizing.flixster.com/LTDu8N-T9uREWemvWgA-nEUdVtU=/206x305/v2/https://flxt.tmsimg.com/assets/p8045289_p_v10_ai.jpg,The Switch,50000,155,2010.0,Romance,0 days 01:41:00.000000000,8
60,48,,The Bang Bang Club,2500,48,2010.0,Drama,0 days 01:49:00.000000000,-12
19,24,https://resizing.flixster.com/ITfBR8dILRdFJsy25wtTZnHkopM=/206x305/v2/https://flxt.tmsimg.com/assets/p8504452_p_v8_aa.jpg,Elektra Luxx,2500,33,2010.0,Comedy,0 days 01:38:00.000000000,5
90,97,,Mugabe and the White African,500,35,2009.0,Documentary,0 days 01:30:00.000000000,7
92,100,/assets/pizza-pie/images/poster_default.c8c896e70c3.gif,Which Way Home,500,8,2009.0,Documentary,0 days 01:23:00.000000000,8
60,91,https://resizing.flixster.com/XunEz1YpqicFhlbUt_1R-hL5QsY=/206x305/v2/https://flxt.tmsimg.com/assets/p8090080_p_v8_ad.jpg,Vengeance,1000,23,2009.0,Crime/Action,0 days 01:48:00.000000000,31
72,87,,Rabbit Hole,25000,201,2010.0,Drama,0 days 01:31:00.000000000,15
71,43,,Sweethearts of the Prison Rodeo,1,7,2009.0,Documentary,0 days 01:29:00.000000000,-28
21,14,,The Romantics,10000,35,2010.0,Comedy/Drama,0 days 01:34:00.000000000,-7
63,55,,Cemetery Junction,10000,40,2010.0,Comedy,0 days 01:35:00.000000000,-8
77,71,,The Misfortunates,1000,21,2009.0,Drama,0 days 01:48:00.000000000,-6
81,97,https://resizing.flixster.com/ADdvG_AWNzN0pEukxaH7oAHzUHE=/206x305/v2/https://flxt.tmsimg.com/assets/p7923137_p_v8_aa.jpg,Ajami,5000,69,2009.0,Drama,0 days 02:00:00.000000000,16
22,25,,Peep World,5000,28,2010.0,Comedy,0 days 01:29:00.000000000,3
50,67,,"Road, Movie",250,9,2009.0,Comedy/Drama,0 days 01:35:00.000000000,17
41,45,https://resizing.flixster.com/B_QcfxD4a14637MNOfv5b7aJkXQ=/206x305/v2/https://flxt.tmsimg.com/assets/p7932431_p_v10_ae.jpg,The Horde,2500,20,2009.0,Action/Horror,0 days 01:30:00.000000000,4
89,78,https://resizing.flixster.com/gbBXTkyWssuYBIakDXQWeylb0K8=/206x305/v2/https://flxt.tmsimg.com/assets/p8058959_p_v8_aa.jpg,Evangelion: 2.0 You Can (Not) Advance,2500,9,2009.0,Sci fi/Action,0 days 01:53:00.000000000,-11
29,8,https://resizing.flixster.com/M0z6vrRDPo5X0JC8YqY7fxNAMgU=/206x305/v2/https://flxt.tmsimg.com/assets/p7846901_p_v8_aa.jpg,31 North 62 East,100,13,2009.0,Mystery and thriller,0 days 01:40:00.000000000,-21
74,75,,Hair High,100,20,2004.0,Comedy/Animation,0 days 01:18:00.000000000,1
57,46,,Until the Light Takes Us,500,24,2008.0,Documentary/Music,0 days 01:33:00.000000000,-11
68,69,https://resizing.flixster.com/GbiPckBFpc1DNgOmBTg3AW7fLXM=/206x305/v2/https://flxt.tmsimg.com/assets/p7989685_p_v10_ac.jpg,The Girl Who Played With Fire,25000,160,2009.0,Crime/Drama,0 days 02:09:00.000000000,1
35,38,https://resizing.flixster.com/_8q5SwdZAaeV5AqGeA3RgwNrt7w=/206x305/v2/https://flxt.tmsimg.com/assets/p8403601_p_v10_aa.jpg,Burning Palms,1000,8,2010.0,Comedy/Drama,0 days 01:52:00.000000000,3
50,67,,Picasso and Braque Go to the Movies,100,15,2007.0,Documentary,0 days 01:00:00.000000000,17
80,82,https://resizing.flixster.com/SZ8LwEM81-6UwnUQ1e1ku3JB7Rs=/206x305/v2/https://flxt.tmsimg.com/assets/p8063179_p_v10_af.jpg,Four Lions,10000,137,2009.0,Comedy/Drama,0 days 01:42:00.000000000,2
77,85,https://resizing.flixster.com/th1A8ZWctY_uQ7xICRyQ9YTzq8o=/206x305/v2/https://flxt.tmsimg.com/NowShowing/91955/91955_aa.jpg,Easy A,100000,191,2010.0,Comedy,0 days 01:33:00.000000000,8
46,53,https://resizing.flixster.com/vL_FrZ8_JQZ-MGtAvHfaeYAyq2E=/206x305/v2/https://flxt.tmsimg.com/assets/p7876880_p_v13_ao.jpg,Last Night,10000,68,2010.0,Romance/Drama,0 days 01:32:00.000000000,7
48,70,,Somewhere,25000,196,2010.0,Comedy/Drama,0 days 01:38:00.000000000,22
67,66,https://resizing.flixster.com/_pkaG72OtzL70X5uJXTn1HpRzTI=/206x305/v2/https://flxt.tmsimg.com/NowShowing/86614/86614_aa.jpg,The Karate Kid,250000,210,2010.0,Kids and family/Sports and fitness,0 days 02:20:00.000000000,-1
58,60,/assets/pizza-pie/images/poster_default.c8c896e70c3.gif,What's the Matter With Kansas?,100,15,2009.0,Documentary,0 days 01:30:00.000000000,2
64,84,https://resizing.flixster.com/YaoLicUlQTwO-1Y8tIsyLTbWx-8=/206x305/v2/https://flxt.tmsimg.com/assets/p8223917_p_v10_aa.jpg,Beautiful Kate,10000,31,2009.0,Drama,0 days 01:36:00.000000000,20
27,3,,The Roommate,25000,86,2011.0,Drama/Mystery and thriller,0 days 01:33:00.000000000,-24
62,42,https://resizing.flixster.com/AsKQpG5yblI_olHJ5yig5j8iCVU=/206x305/v2/https://flxt.tmsimg.com/assets/p7886534_p_v13_ax.jpg,Letters to Juliet,250000,159,2010.0,Romance/Drama,0 days 01:45:00.000000000,-20
61,50,https://resizing.flixster.com/U0dVajVom3q17b8lQgeo4g9911A=/206x305/v2/https://flxt.tmsimg.com/assets/p7809700_p_v10_aa.jpg,Broken Hill,250,6,2009.0,Drama/Music,0 days 01:42:00.000000000,-11
48,68,,Jack Goes Boating,2500,111,2010.0,Romance,0 days 01:30:00.000000000,20
48,68,/assets/pizza-pie/images/poster_default.c8c896e70c3.gif,Leaving,10000,65,2009.0,Romance/Drama,0 days 01:25:00.000000000,20
52,40,https://resizing.flixster.com/Wo1_rnLIF_eH9Vp2VZoiQbaa0rE=/206x305/v2/https://flxt.tmsimg.com/assets/p8129741_p_v10_am.jpg,Due Date,100000,194,2010.0,Comedy,0 days 01:35:00.000000000,-12
35,48,,MacGruber,100000,152,2010.0,Comedy/Action,0 days 01:30:00.000000000,13
42,9,,Marmaduke,50000,103,2010.0,Comedy/Kids and family,0 days 01:28:00.000000000,-33
85,92,,The Town,100000,234,2010.0,Crime/Drama,0 days 02:04:00.000000000,7
72,87,https://resizing.flixster.com/RIYQHwCLMOHIZQhDAlw-rYIl1Hw=/206x305/v2/https://flxt.tmsimg.com/assets/p8129775_p_v10_ai.jpg,Unstoppable,100000,194,2010.0,Action/Drama,0 days 01:34:00.000000000,15
44,55,,Wall Street: Money Never Sleeps,100000,237,2010.0,Drama,0 days 02:10:00.000000000,11
78,81,/assets/pizza-pie/images/poster_default.c8c896e70c3.gif,Soundtrack for a Revolution,100,16,2009.0,Documentary/Drama,0 days 01:22:00.000000000,3
43,59,,Walt & El Grupo,100,22,2008.0,Documentary,0 days 01:46:00.000000000,16
41,60,,Calvin Marshall,250,10,2010.0,Comedy/Drama,0 days 01:33:00.000000000,19
34,39,https://resizing.flixster.com/t6b9mn4SMVQS00qbzvDxoZRQhh8=/206x305/v2/https://flxt.tmsimg.com/assets/p8345713_p_v8_ad.jpg,Casino Jack,10000,99,2010.0,Drama/Biography,0 days 01:48:00.000000000,5
58,54,https://resizing.flixster.com/upTMJ4OxAAdaUmylHQUFC_l1E0I=/206x305/v2/https://flxt.tmsimg.com/assets/p7986553_p_v10_ap.jpg,Welcome to the Rileys,10000,83,2010.0,Drama,0 days 01:50:00.000000000,-4
65,64,https://resizing.flixster.com/UZlqB8WDnFIzM1AVHBh6ZWJs5YI=/206x305/v2/https://flxt.tmsimg.com/assets/p3536812_p_v8_aa.jpg,The Nature of Existence,250,22,2009.0,Documentary,0 days 01:34:00.000000000,-1
56,0,,Merah Putih,250,7,2009.0,Action/Drama,0 days 01:48:00.000000000,-56
93,89,https://resizing.flixster.com/EakF-lTZlSdi2iXkpdGWLm38by8=/206x305/v2/https://flxt.tmsimg.com/assets/p7936594_p_v8_ah.jpg,The Secret in Their Eyes,25000,140,2009.0,Crime/Drama,0 days 02:07:00.000000000,-4
48,36,https://resizing.flixster.com/MS_e95TkYoDH5wyca8T7cysnFKc=/206x305/v2/https://flxt.tmsimg.com/assets/p8288118_p_v10_aa.jpg,Battle: Los Angeles,50000,211,2011.0,Action/Sci fi,0 days 01:56:00.000000000,-12
34,27,https://resizing.flixster.com/L2CBkarHjzb1XXHCPmukLmQukR8=/206x305/v2/https://resizing.flixster.com/JmcL9PKlsE_ssqx3sIHA3A1zZE4=/ems.ZW1zLXByZC1hc3NldHMvbW92aWVzLzBhMmY5OWFlLTEwZjUtNDZjOS1iNjY2LTIyNTNkNjI3ODhjYS53ZWJw,Your Highness,50000,182,2011.0,Comedy/Adventure,0 days 01:42:00.000000000,-7
41,39,,The Eagle,25000,158,2011.0,Action/Drama,0 days 01:54:00.000000000,-2
62,88,,Everyone Else,500,42,2009.0,Romance/Drama,0 days 01:59:00.000000000,26
27,67,,"Leslie, My Name Is Evil",1000,9,2009.0,Crime/Fantasy,0 days 01:25:00.000000000,40
37,42,,The Extra Man,2500,72,2010.0,Comedy,0 days 01:48:00.000000000,5
39,50,,Provinces of Night,2500,8,2010.0,Drama,0 days 01:45:00.000000000,11
52,75,,The Waiting City,500,16,2009.0,Drama,0 days 01:49:00.000000000,23
29,71,,Shadow,250,7,2009.0,Horror/Mystery and thriller,0 days 01:30:00.000000000,42
44,60,,Trash Humpers,1000,40,2009.0,Horror,0 days 01:18:00.000000000,16
78,100,,"Nightmares in Red, White and Blue",1000,7,2009.0,Documentary,0 days 01:26:00.000000000,22
71,71,,Queen to Play,1000,41,2009.0,Drama,0 days 01:37:00.000000000,0
30,11,,Season of the Witch,50000,125,2011.0,Action/Fantasy,0 days 01:35:00.000000000,-19
60,78,,The Other Guys,100000,208,2010.0,Action/Comedy,0 days 01:47:00.000000000,18
48,22,,Resident Evil: Afterlife,100000,106,2010.0,Action/Horror,0 days 01:37:00.000000000,-26
52,42,,Faster,25000,131,2010.0,Action/Mystery and thriller,0 days 01:38:00.000000000,-10
39,67,,Videocracy,250,27,2009.0,Documentary,0 days 01:25:00.000000000,28
80,71,,Waking Sleeping Beauty,2500,51,2009.0,Documentary,0 days 01:26:00.000000000,-9
58,92,,Beetle Queen Conquers Tokyo,100,36,2009.0,Documentary,0 days 01:30:00.000000000,34
71,57,https://resizing.flixster.com/GwtGMOAPd_BqBBKx9hwRav1zBHw=/206x305/v2/https://flxt.tmsimg.com/assets/p8107488_p_v10_au.jpg,Bodyguards and Assassins,2500,7,2009.0,Action/Drama,0 days 02:19:00.000000000,-14
70,79,https://resizing.flixster.com/pb907sYlEWfrQf8OwRxU5eIpyWY=/206x305/v2/https://flxt.tmsimg.com/assets/p7997070_p_v8_ac.jpg,The Trotsky,1000,14,2009.0,Comedy,0 days 01:57:00.000000000,9
65,60,https://resizing.flixster.com/xHyDUgHhuA8KdBEaJmTC6d813nQ=/206x305/v2/https://flxt.tmsimg.com/assets/p7834779_p_v13_ab.jpg,The Wild and Wonderful Whites of West Virginia,1000,10,2009.0,Documentary,0 days 01:24:00.000000000,-5
92,94,https://resizing.flixster.com/cfm5tvDT4X6_0Ocd3bkMGhvIOVI=/206x305/v2/https://flxt.tmsimg.com/assets/p8073374_p_v8_ad.jpg,The King's Speech,100000,297,2010.0,Drama/History,0 days 01:58:00.000000000,2
73,91,,Ghost Bird,50,11,2009.0,Documentary,0 days 01:25:00.000000000,18
37,68,https://resizing.flixster.com/IVzBFMRHD5V804QEeNT0PM2xUvU=/206x305/v2/https://flxt.tmsimg.com/assets/p8006499_p_v8_aa.jpg,Wild Grass,1000,91,2009.0,Drama,0 days 01:44:00.000000000,31
76,93,https://resizing.flixster.com/pd_SxhvV3vnfuMWD5Zr70snOPgg=/206x305/v2/https://flxt.tmsimg.com/assets/p7915295_p_v10_ae.jpg,Dogtooth,10000,67,2009.0,Drama,0 days 01:34:00.000000000,17
54,79,,Amer,1000,29,2009.0,Horror/Mystery and thriller,0 days 01:30:00.000000000,25
25,49,https://resizing.flixster.com/_LnnaaR2vYfjjBvG1MtG5L8JRh8=/206x305/v2/https://flxt.tmsimg.com/assets/p7915218_p_v8_aa.jpg,The Human Centipede,10000,96,2009.0,Horror,0 days 01:30:00.000000000,24
42,44,https://resizing.flixster.com/OVR0QgclyoVhutZ1QAYR6h7h6SI=/206x305/v2/https://flxt.tmsimg.com/assets/p7914861_p_v10_aa.jpg,Glorious 39,1000,25,2009.0,Drama/History,0 days 02:09:00.000000000,2
76,86,,Farewell,5000,77,2009.0,Drama/Mystery and thriller,0 days 01:53:00.000000000,10
74,82,,The Wild Hunt,500,11,2009.0,Drama/Mystery and thriller,0 days 01:36:00.000000000,8
74,80,,Nowhere Boy,25000,148,2009.0,Drama/Biography,0 days 01:37:00.000000000,6
61,86,,Down Terrace,1000,35,2009.0,Crime/Comedy,0 days 01:33:00.000000000,25
52,73,,Women Without Men,500,41,2009.0,Drama,0 days 01:35:00.000000000,21
16,43,,Cooking With Stella,250,7,2009.0,Drama,0 days 01:44:00.000000000,27
64,86,,White Material,10000,91,2009.0,Drama,0 days 01:45:00.000000000,22
14,0,,Eulogy for a Vampire,50,6,2009.0,Horror,0 days 01:47:00.000000000,-14
69,90,https://resizing.flixster.com/PYHsbJk1yUzNGAKtn59v8QVTJ_k=/206x305/v2/https://flxt.tmsimg.com/assets/p8108121_p_v8_aa.jpg,My Dog Tulip,2500,60,2009.0,Drama/Animation,0 days 01:21:00.000000000,21
62,81,https://resizing.flixster.com/iC0k2ODdCzvPGhJwN4cGCjvfE2U=/206x305/v2/https://flxt.tmsimg.com/assets/p7869860_p_v10_aa.jpg,Cairo Time,2500,80,2009.0,Romance/Drama,0 days 01:28:00.000000000,19
67,81,https://resizing.flixster.com/8t8o9mOcYDjyBW8n93YXszEt5OI=/206x305/v2/https://flxt.tmsimg.com/assets/p8041499_p_v8_aa.jpg,The Disappearance of Alice Creed,25000,98,2009.0,Mystery and thriller,0 days 01:40:00.000000000,14
68,81,https://resizing.flixster.com/tWZsXdlgzvq8rEu4Haik44kbdes=/206x305/v2/https://flxt.tmsimg.com/assets/p7945465_p_v10_ad.jpg,I Am Love,10000,134,2009.0,Romance/Drama,0 days 01:59:00.000000000,13
52,65,https://resizing.flixster.com/eLKwWkNmUO6QVOlktXd0xtx_KwI=/206x305/v2/https://flxt.tmsimg.com/assets/p8000437_p_v10_ad.jpg,Predators,100000,203,2010.0,Mystery and thriller/Adventure,0 days 01:47:00.000000000,13
39,80,https://resizing.flixster.com/dvAcRRzCNn3ZUxrWsnA8sYTP2l4=/206x305/v2/https://flxt.tmsimg.com/assets/p8573161_p_v8_as.jpg,Wake Wood,1000,25,2011.0,Horror/Drama,0 days 01:30:00.000000000,41
30,9,/assets/pizza-pie/images/poster_default.c8c896e70c3.gif,Opa!,100,11,2005.0,Comedy,0 days 01:37:00.000000000,-21
73,44,/assets/pizza-pie/images/poster_default.c8c896e70c3.gif,The Butcher's Son,500,16,2009.0,Crime/Action,0 days 01:42:00.000000000,-29
38,45,,Confucius,250,11,2010.0,Drama/Biography,0 days 02:05:00.000000000,7
78,85,,Genius Within: The Inner Life of Glenn Gould,250,39,2009.0,Documentary/Music,0 days 01:49:00.000000000,7
68,50,,Taqwacore: The Birth of Punk Islam,50,6,2009.0,Documentary,0 days 01:20:00.000000000,-18
50,72,https://resizing.flixster.com/sPJh6HDxVlmO8zCRCZWGTmQH4ZM=/206x305/v2/https://flxt.tmsimg.com/assets/p8153908_p_v10_aa.jpg,Wah Do Dem,250,18,2009.0,Drama/Adventure,0 days 01:16:00.000000000,22
84,91,https://resizing.flixster.com/YUq8Msvs-HGj0JoEq4_a0QBuVFY=/206x305/v2/https://flxt.tmsimg.com/assets/p8103295_p_v8_aa.jpg,Alamar,1000,47,2009.0,Drama,0 days 01:13:00.000000000,7
67,95,https://resizing.flixster.com/sxWGUH3uzp7jXq_hsJt8gFte2OI=/206x305/v2/https://flxt.tmsimg.com/assets/p8034160_p_v10_aa.jpg,The Unloved,500,19,2009.0,Drama,0 days 01:46:00.000000000,28
77,86,,Eyes Wide Open,1000,35,2009.0,Drama,0 days 01:31:00.000000000,9
63,58,https://resizing.flixster.com/sQIohasUh-Lr_qlm3ar3xg4wHo4=/206x305/v2/https://flxt.tmsimg.com/assets/p8594780_p_v13_aa.jpg,Vanishing of the Bees,500,19,2009.0,Documentary,0 days 01:27:00.000000000,-5
29,7,,Dylan Dog: Dead of Night,10000,45,2011.0,Comedy/Horror,0 days 01:47:00.000000000,-22
68,83,,Mademoiselle Chambon,1000,53,2009.0,Drama,0 days 01:41:00.000000000,15
43,19,https://resizing.flixster.com/3O2fKeX1ypCx-T5v22xjHPLBJ8w=/206x305/v2/https://flxt.tmsimg.com/assets/p8077771_p_v10_aa.jpg,You Again,50000,96,2010.0,Romance,0 days 01:45:00.000000000,-24
83,94,,Animal Kingdom,25000,163,2010.0,Crime/Drama,0 days 01:52:00.000000000,11
67,88,,October Country,100,32,2009.0,Documentary,0 days 01:20:00.000000000,21
52,85,,Nénette,100,34,2010.0,Documentary,0 days 01:10:00.000000000,33
68,75,/assets/pizza-pie/images/poster_default.c8c896e70c3.gif,Freedom,500,8,2009.0,Drama,0 days 01:51:00.000000000,7
61,91,https://resizing.flixster.com/1GMjLDqedS52NxUOvTn5vBMPuR0=/206x305/v2/https://flxt.tmsimg.com/assets/p7900136_p_v10_aa.jpg,Cropsey,2500,45,2009.0,Drama/Crime,0 days 01:24:00.000000000,30
72,90,https://resizing.flixster.com/W1wgbdscHEvTHnzEXE2wM4TLfWo=/206x305/v2/https://flxt.tmsimg.com/assets/p8006465_p_v10_ag.jpg,Lebanon,5000,110,2009.0,Drama/War,0 days 01:33:00.000000000,18
30,26,,The Best and the Brightest,1000,19,2010.0,Comedy,0 days 01:33:00.000000000,-4
74,92,https://resizing.flixster.com/HjHhpm6YYGwUnfwe_BocAr5-AdU=/206x305/v2/https://flxt.tmsimg.com/assets/p8020470_p_v10_ae.jpg,The Kids Are All Right,50000,225,2010.0,Comedy/Drama,0 days 01:44:00.000000000,18
60,42,,Happythankyoumoreplease,5000,53,2010.0,Comedy/Drama,0 days 01:40:00.000000000,-18
76,63,https://resizing.flixster.com/X-ug0s2cA3F0_TE0kXJVpDgPO90=/206x305/v2/https://flxt.tmsimg.com/assets/p8078196_p_v8_ah.jpg,Secretariat,25000,156,2010.0,Drama/Biography,0 days 02:03:00.000000000,-13
65,87,https://resizing.flixster.com/XbULC4EMNDG_BRESw9W313Gcje4=/206x305/v2/https://flxt.tmsimg.com/assets/p8006445_p_v10_ae.jpg,Buried,50000,157,2010.0,Drama/Mystery and thriller,0 days 01:34:00.000000000,22
83,83,,You Don't Know Jack,2500,24,2010.0,Drama/Biography,0 days 02:10:00.000000000,0
91,88,,Araya,50,25,1959.0,Documentary,0 days 01:30:00.000000000,-3
49,52,https://resizing.flixster.com/akULH_Ba64CD2LokImuJly6ST8A=/206x305/v2/https://flxt.tmsimg.com/assets/p7963670_p_v10_ae.jpg,Knight and Day,100000,231,2010.0,Comedy/Action,0 days 01:49:00.000000000,3
69,52,https://resizing.flixster.com/AJKMo-OZaKk0_8u_BY1oUc5fGGQ=/206x305/v2/https://flxt.tmsimg.com/assets/p8073348_p_v8_aa.jpg,South of the Border,2500,56,2009.0,Documentary,0 days 01:18:00.000000000,-17
55,67,https://resizing.flixster.com/mOI6fGqCJGA5ZHui9ImxTQbojAU=/206x305/v2/https://flxt.tmsimg.com/assets/p7971241_p_v10_ar.jpg,The Company Men,25000,170,2010.0,Drama,0 days 01:55:00.000000000,12
88,95,,13 Assassins,10000,131,2010.0,Action/Drama,0 days 02:06:00.000000000,7
85,83,https://resizing.flixster.com/B_8nxHaa831aTUqdikLZMyF8JXc=/206x305/v2/https://flxt.tmsimg.com/assets/p8063206_p_v10_ab.jpg,American: The Bill Hicks Story,2500,60,2010.0,Documentary,0 days 01:46:00.000000000,-2
89,56,,Daniel and Ana,1,9,2009.0,Drama/Mystery and thriller,0 days 01:30:00.000000000,-33
55,50,/assets/pizza-pie/images/poster_default.c8c896e70c3.gif,Spring Fever,100,16,2009.0,Romance/Drama,0 days 01:56:00.000000000,-5
69,79,https://resizing.flixster.com/um1lltJ66mZG_MHt8EpYenZ0teI=/206x305/v2/https://flxt.tmsimg.com/assets/p8170728_p_v10_ap.jpg,Little Big Soldier,2500,14,2010.0,Action/Adventure,0 days 01:36:00.000000000,10
85,100,,Con Artist,50,8,2009.0,Documentary,0 days 01:24:00.000000000,15
61,55,https://resizing.flixster.com/o_yjZjS_HG202FGN44i4UrAnFmA=/206x305/v2/https://flxt.tmsimg.com/assets/p8191605_p_v10_aa.jpg,Picture Me,250,11,2009.0,Documentary,0 days 01:22:00.000000000,-6
94,100,,Teenage Paparazzo,2500,6,2010.0,Documentary,0 days 01:34:00.000000000,6
56,86,,Orgasm Inc.,1000,22,2009.0,Documentary,0 days 01:13:00.000000000,30
70,57,https://resizing.flixster.com/Pg-qkEe25KpqTfaRKVL1pema6A4=/206x305/v2/https://flxt.tmsimg.com/assets/p3564299_p_v8_aa.jpg,Dancing Across Borders,100,21,2009.0,Documentary,0 days 01:28:00.000000000,-13
78,61,,The Concert,10000,66,2009.0,Comedy/Drama,0 days 01:47:00.000000000,-17
79,86,,Me Too,2500,7,2009.0,Drama,0 days 01:43:00.000000000,7
42,10,,Saw: The Final Chapter,50000,80,2010.0,Horror,0 days 01:31:00.000000000,-32
86,100,/assets/pizza-pie/images/poster_default.c8c896e70c3.gif,Rio Breaks,100,11,2009.0,Documentary,0 days 01:25:00.000000000,14
88,98,https://resizing.flixster.com/tHsNjtSqd0Fzk8aeuLO435AlF8I=/206x305/v2/https://flxt.tmsimg.com/assets/p7950923_p_v13_ae.jpg,Cell 211,5000,44,2009.0,Action/Drama,0 days 01:50:00.000000000,10
45,86,https://resizing.flixster.com/6nYcf6KbGBEvO3cK7AL2AocanhM=/206x305/v2/https://flxt.tmsimg.com/assets/p8034854_p_v8_aa.jpg,Harlan: In the Shadow of Jew Süss,100,28,2008.0,Documentary,0 days 01:39:00.000000000,41
87,78,,Summer Wars,2500,23,2009.0,Sci fi/Adventure,0 days 01:54:00.000000000,-9
67,54,,The Girl Who Kicked the Hornet's Nest,25000,134,2009.0,Mystery and thriller,0 days 02:26:00.000000000,-13
68,67,/assets/pizza-pie/images/poster_default.c8c896e70c3.gif,Ward No. 6,100,6,2009.0,Drama,0 days 01:23:00.000000000,-1
66,58,https://resizing.flixster.com/7UqOabX71WHZjMsYFwq-S7vTI9U=/206x305/v2/https://flxt.tmsimg.com/assets/p8119294_p_v10_ab.jpg,It's Kind of a Funny Story,25000,137,2010.0,Comedy/Drama,0 days 01:40:00.000000000,-8
63,58,,Plastic Planet,500,12,2009.0,Documentary,0 days 01:35:00.000000000,-5
91,88,,Budrus,100,24,2009.0,Documentary/Action,0 days 01:18:00.000000000,-3
58,86,https://resizing.flixster.com/TElE1McflH6kOE6cxKQZWxpOa5A=/206x305/v2/https://flxt.tmsimg.com/assets/p8191645_p_v8_aa.jpg,The Refuge,10000,37,2009.0,Gay and lesbian/Drama,0 days 01:28:00.000000000,28
67,62,https://resizing.flixster.com/uPsdW1gWgC6cQwxMiMR9nqrSpDE=/206x305/v2/https://flxt.tmsimg.com/assets/p8247601_p_v8_ad.jpg,Kill the Irishman,5000,53,2011.0,Crime/Drama,0 days 01:46:00.000000000,-5
27,33,https://resizing.flixster.com/c7MUYdfuWRV7LUs-ArujyEgVc5M=/206x305/v2/https://flxt.tmsimg.com/assets/p8489151_p_v10_bb.jpg,The Ward,10000,72,2010.0,Horror/Mystery and thriller,0 days 01:28:00.000000000,6
53,49,,Love & Other Drugs,50000,168,2010.0,Romance/Drama,0 days 01:52:00.000000000,-4
33,52,https://resizing.flixster.com/p2WeYgp5GgeBQ76M_ASQy5hWRW8=/206x305/v2/https://flxt.tmsimg.com/assets/p8046944_p_v8_aa.jpg,Holy Rollers,2500,90,2010.0,Crime/Drama,0 days 01:29:00.000000000,19
66,81,https://resizing.flixster.com/bo0M3usrmq_y0jaZI38xoayEaME=/206x305/v2/https://flxt.tmsimg.com/assets/p8070336_p_v8_aa.jpg,Night Catches Us,1000,57,2010.0,Drama,0 days 01:30:00.000000000,15
85,98,https://resizing.flixster.com/lGfHs7V9S3iK15Fh08qAiNcDoe4=/206x305/v2/https://flxt.tmsimg.com/assets/p8083207_p_v10_ab.jpg,GasLand,5000,41,2010.0,Documentary,0 days 01:45:00.000000000,13
55,45,,The Perfect Host,5000,33,2010.0,Mystery and thriller,0 days 01:34:00.000000000,-10
72,86,,Peepli Live,2500,28,2010.0,Comedy,0 days 01:45:00.000000000,14
53,80,,Cyrus,25000,157,2010.0,Romance/Comedy,0 days 01:31:00.000000000,27
84,90,,Waiting for Superman,10000,119,2010.0,Documentary,0 days 01:42:00.000000000,6
77,88,,A Small Act,100,17,2010.0,Documentary,0 days 01:28:00.000000000,11
79,88,/assets/pizza-pie/images/poster_default.c8c896e70c3.gif,The Oath,250,24,2010.0,Documentary,0 days 01:30:00.000000000,9
76,94,https://resizing.flixster.com/_e_vgj7U0YztcDYMIwVJCnNaSAg=/206x305/v2/https://flxt.tmsimg.com/NowShowing/89066/89066_aa.jpg,Winter's Bone,50000,175,2010.0,Drama,0 days 01:39:00.000000000,18
36,47,,Skateland,5000,30,2010.0,Drama,0 days 01:36:00.000000000,11
49,41,,The Taqwacores,2500,27,2010.0,Drama,0 days 01:23:00.000000000,-8
90,100,https://resizing.flixster.com/1xmwrxti8yypfLaPQV0nvSD30XU=/206x305/v2/https://flxt.tmsimg.com/assets/p8361167_p_v8_aa.jpg,Waste Land,5000,71,2010.0,Documentary,0 days 01:38:00.000000000,10
76,90,https://resizing.flixster.com/CLM_VpbqWlmjK_ZBo67KcHHQFWw=/206x305/v2/https://flxt.tmsimg.com/assets/p8044227_p_v8_aa.jpg,The Temptation of St. Tony,250,10,2009.0,Fantasy/Drama,0 days 01:50:00.000000000,14
88,96,,Restrepo,10000,118,2010.0,Drama/Documentary,0 days 01:33:00.000000000,8
64,87,https://resizing.flixster.com/zH0-jLpCh7Ex5eR0ZIcv88EKEeM=/206x305/v2/https://flxt.tmsimg.com/assets/p7996868_p_v10_aa.jpg,Please Give,10000,143,2010.0,Comedy/Drama,0 days 01:30:00.000000000,23
78,78,,Barney's Version,10000,138,2010.0,Comedy/Drama,0 days 02:12:00.000000000,0
68,80,/assets/pizza-pie/images/poster_default.c8c896e70c3.gif,7 Days,1000,15,2010.0,Crime/Horror,0 days 01:45:00.000000000,12
30,76,,3 Backyards,1000,17,2010.0,Drama,0 days 01:27:00.000000000,46
72,79,,Countdown to Zero,1000,87,2010.0,Documentary,0 days 01:30:00.000000000,7
71,80,https://resizing.flixster.com/nc7KUHGe2rk_qTTuQwxgM817VGM=/206x305/v2/https://flxt.tmsimg.com/assets/p8108064_p_v10_aa.jpg,Catfish,25000,154,2010.0,Documentary/Drama,0 days 01:28:00.000000000,9
46,63,https://resizing.flixster.com/9I8UY1UncxqKclVERRA0guOQpy4=/206x305/v2/https://flxt.tmsimg.com/assets/p8007536_p_v10_an.jpg,Frozen,10000,97,2010.0,Mystery and thriller/Horror,0 days 01:33:00.000000000,17
62,67,,Babies,25000,118,2010.0,Documentary,0 days 01:19:00.000000000,5
77,88,,William S. Burroughs: A Man Within,500,17,2010.0,Documentary,0 days 01:27:00.000000000,11
40,34,,"A Woman, a Gun and a Noodle Shop",5000,59,2009.0,Comedy/Drama,0 days 01:30:00.000000000,-6
42,36,,Eat Pray Love,100000,204,2010.0,Romance/Drama,0 days 02:20:00.000000000,-6
86,96,,The Social Network,100000,326,2010.0,Drama/Biography,0 days 02:00:00.000000000,10
64,36,,Burlesque,50000,176,2010.0,Drama/Musical,0 days 01:56:00.000000000,-28
34,12,,Yogi Bear,50000,105,2010.0,Comedy/Kids and family,0 days 01:20:00.000000000,-22
61,29,,Life as We Know It,50000,153,2010.0,Romance,0 days 01:53:00.000000000,-32
37,47,https://resizing.flixster.com/Engj9n0FrfXT8CKa68nELp-vAYU=/206x305/v2/https://flxt.tmsimg.com/assets/p8221318_p_v10_aa.jpg,Drive Angry,25000,123,2011.0,Fantasy/Action,0 days 01:44:00.000000000,10
71,72,,Rio,50000,150,2011.0,Comedy/Kids and family,0 days 01:36:00.000000000,1
30,50,https://resizing.flixster.com/QgjW_8rrjCNyjnkqpdLDKWLDDAA=/206x305/v2/https://flxt.tmsimg.com/assets/p8072563_p_v8_ad.jpg,YellowBrickRoad,1000,18,2010.0,Horror/Mystery and thriller,0 days 01:38:00.000000000,20
14,17,https://resizing.flixster.com/b6sVJ-uBO3nPudHJMznrj_nO4qo=/206x305/v2/https://flxt.tmsimg.com/assets/p8298187_p_v10_ab.jpg,30 Days of Night: Dark Days,2500,6,2010.0,Horror,0 days 01:32:00.000000000,3
60,28,,Charlie St. Cloud,50000,125,2010.0,Fantasy/Romance,0 days 01:39:00.000000000,-32
41,42,https://resizing.flixster.com/Ih7B0oXH2JSstI7Asxy0pnls9HA=/206x305/v2/https://flxt.tmsimg.com/assets/p8562659_p_v10_ad.jpg,Ironclad,10000,55,2011.0,Action/Adventure,0 days 02:01:00.000000000,1
86,97,,A Film Unfinished,1000,65,2009.0,Documentary,0 days 01:29:00.000000000,11
73,57,/assets/pizza-pie/images/poster_default.c8c896e70c3.gif,Kenny Chesney: Summer In 3d,500,7,2010.0,,,-16
80,82,/assets/pizza-pie/images/poster_default.c8c896e70c3.gif,Casino Jack and the United States of Money,500,66,2010.0,Documentary,0 days 02:00:00.000000000,2
51,78,https://resizing.flixster.com/yrJJZdQWF_cBUrwLdSQS6AeSccE=/206x305/v2/https://resizing.flixster.com/jWmCaXleXsngEVxk9TUOor6xmTI=/ems.ZW1zLXByZC1hc3NldHMvbW92aWVzLzEwODEyYWZhLTRlZWYtNDcwYi1hYzAwLWQyMTJhNTI1NWFhMi53ZWJw,Daddy Longlegs,500,32,2010.0,,,27
82,92,,Joan Rivers: A Piece of Work,10000,109,2010.0,Documentary/Comedy,0 days 01:24:00.000000000,10
39,60,,Lucky,250,5,2010.0,Documentary,0 days 01:30:00.000000000,21
63,78,https://resizing.flixster.com/zdKD1HIWsSvgxzadO4eGtKGvA4g=/206x305/v2/https://flxt.tmsimg.com/assets/p8069757_p_v8_aa.jpg,Smash His Camera,250,23,2010.0,Documentary,0 days 01:27:00.000000000,15
77,60,,The Sunshine Boy,500,10,2009.0,Documentary,0 days 01:42:00.000000000,-17
49,71,https://resizing.flixster.com/pFp-fpvZsiem6bIbtDegVNBB8bM=/206x305/v2/https://flxt.tmsimg.com/assets/p8136173_p_v8_aa.jpg,Black Death,10000,66,2010.0,Horror/Mystery and thriller,0 days 01:42:00.000000000,22
77,71,,Blood Into Wine,1000,7,2010.0,Documentary,0 days 01:40:00.000000000,-6
66,68,,Heartbreaker,10000,79,2010.0,Romance,0 days 01:45:00.000000000,2
86,88,,Hubble,10000,42,2010.0,Documentary,0 days 00:43:00.000000000,2
72,72,https://resizing.flixster.com/Ik2wG0rUZxSagZ5uqHU46H6C-68=/206x305/v2/https://flxt.tmsimg.com/assets/p8099350_p_v10_bb.jpg,Red,100000,211,2010.0,Comedy/Action,0 days 01:50:00.000000000,0
85,95,https://resizing.flixster.com/vE4sHdpy0zMsFx-s6SUCXEkEZyw=/206x305/v2/https://flxt.tmsimg.com/NowShowing/94721/94721_ab.jpg,True Grit,100000,274,2010.0,Western/Drama,0 days 01:50:00.000000000,10
73,32,https://resizing.flixster.com/1MFIzjbFCM2QV-TlkHlE_hq8aH0=/206x305/v2/https://flxt.tmsimg.com/assets/p8214229_p_v10_ai.jpg,For Colored Girls,25000,109,2010.0,Drama,0 days 02:14:00.000000000,-41
52,78,https://resizing.flixster.com/JUAYhk3E1fa-ol-v4w4dkM90zEk=/206x305/v2/https://flxt.tmsimg.com/assets/p8070850_p_v8_aa.jpg,Cold Weather,1000,63,2010.0,Comedy/Mystery and thriller,0 days 01:37:00.000000000,26
91,96,https://resizing.flixster.com/v2hGJtZQe0nyTGkrO69zPPNAsGM=/206x305/v2/https://flxt.tmsimg.com/assets/p8043121_p_v10_aj.jpg,Exit Through the Gift Shop,10000,114,2010.0,Documentary,0 days 01:27:00.000000000,5
14,40,/assets/pizza-pie/images/poster_default.c8c896e70c3.gif,Repo Chick,100,15,2009.0,Comedy,0 days 01:32:00.000000000,26
36,0,https://resizing.flixster.com/sRtL5s949jYNxuufjlkb-IQ8ME4=/206x305/v2/https://flxt.tmsimg.com/assets/p8020475_p_v8_aa.jpg,The Killing Jar,500,8,2009.0,Mystery and thriller,0 days 01:30:00.000000000,-36
44,34,,Lottery Ticket,25000,82,2010.0,Comedy,0 days 01:35:00.000000000,-10
38,47,,Hereafter,50000,236,2010.0,Drama,0 days 02:09:00.000000000,9
32,0,https://resizing.flixster.com/5h7o5iSqoY6_xIRTrvQa8gSrKIg=/206x305/v2/https://flxt.tmsimg.com/assets/p8061833_p_v10_aa.jpg,Shank,2500,10,2010.0,Action,0 days 01:30:00.000000000,-32
45,60,https://resizing.flixster.com/CcigHEen-1sLz2QGo3Ms5Qm6coc=/206x305/v2/https://flxt.tmsimg.com/assets/p8079025_p_v10_aa.jpg,The Infidel,5000,25,2010.0,Comedy,0 days 01:44:00.000000000,15
88,89,https://resizing.flixster.com/eXOiG9f5AIEMUkW_Y8YP87foos0=/206x305/v2/https://flxt.tmsimg.com/assets/p8071006_p_v13_aa.jpg,The Desert of Forbidden Art,100,18,2010.0,Drama/Documentary,0 days 01:20:00.000000000,1
26,18,,Birdemic: Shock and Terror,1000,17,2008.0,Horror/Mystery and thriller,0 days 01:33:00.000000000,-8
61,46,https://resizing.flixster.com/riNIgsiDkgeriNc9LXZ4smItYeU=/206x305/v2/https://flxt.tmsimg.com/assets/p8040691_p_v10_ak.jpg,Just Wright,100000,109,2010.0,Romance,0 days 01:41:00.000000000,-15
45,18,https://resizing.flixster.com/vpvbEtK6BtoWzuMVDprJ-uEmDSg=/206x305/v2/https://flxt.tmsimg.com/assets/p8039916_p_v10_aa.jpg,Princess Kaiulani,1000,38,2009.0,Drama/History,0 days 02:10:00.000000000,-27
63,52,https://resizing.flixster.com/aENxhIbYqQCB3M-4JTPaJJuq-Os=/206x305/v2/https://flxt.tmsimg.com/assets/p8044701_p_v10_ac.jpg,Legend of the Guardians: The Owls of Ga'Hoole,50000,132,2010.0,Fantasy/Kids and family,0 days 01:31:00.000000000,-11
71,75,https://resizing.flixster.com/BW6Z7za5u-OYn6Ytty4asGysOAc=/206x305/v2/https://flxt.tmsimg.com/assets/p8136869_p_v8_aa.jpg,American Grindhouse,500,8,2010.0,Documentary,0 days 01:20:00.000000000,4
71,82,https://resizing.flixster.com/cDGWRS3IS96CtMZ0Hn0Uc1Mady4=/206x305/v2/https://flxt.tmsimg.com/assets/p8328400_p_v10_aa.jpg,Skeletons,500,17,2010.0,Comedy,0 days 01:33:00.000000000,11
74,77,https://resizing.flixster.com/lyK3jOt5Puaf6OT48NgJUlgqD9o=/206x305/v2/https://flxt.tmsimg.com/assets/p8088981_p_v8_aa.jpg,Strange Powers: Stephin Merritt and the Magnetic Fields,100,31,2010.0,Documentary,0 days 01:24:00.000000000,3
21,50,https://resizing.flixster.com/eMWdwlcMD5SrT_7BL0yCL_3rJiY=/206x305/v2/https://flxt.tmsimg.com/assets/p8133861_p_v10_ae.jpg,Stone,10000,102,2010.0,Drama/Mystery and thriller,0 days 01:45:00.000000000,29
64,40,,Gunless,1000,5,2010.0,Western/Comedy,0 days 01:29:00.000000000,-24
44,79,/assets/pizza-pie/images/poster_default.c8c896e70c3.gif,The Hunter,2500,28,2010.0,Mystery and thriller,0 days 01:30:00.000000000,35
73,91,,R,1000,11,2010.0,Crime/Drama,0 days 01:39:00.000000000,18
40,55,https://resizing.flixster.com/oUC9xQ9GIjcvusLj1swxGnkXLFE=/206x305/v2/https://flxt.tmsimg.com/assets/p7986513_p_v10_au.jpg,The Killer Inside Me,10000,129,2010.0,Crime/Drama,0 days 01:48:00.000000000,15
72,86,https://resizing.flixster.com/yJGErFaUsTfJWwCZkzZATb1AqWw=/206x305/v2/https://flxt.tmsimg.com/assets/p8366511_p_v8_aa.jpg,A Somewhat Gentle Man,2500,28,2010.0,Crime/Comedy,0 days 01:45:00.000000000,14
79,78,,The Parking Lot Movie,500,9,2010.0,Documentary,0 days 01:14:00.000000000,-1
60,76,https://resizing.flixster.com/EdHxfflTlJMfdOxiy59am3H_W7E=/206x305/v2/https://flxt.tmsimg.com/assets/p8361698_p_v8_aa.jpg,Dream Home,1000,21,2010.0,Horror,0 days 01:36:00.000000000,16
72,69,,Brotherhood,250,13,2009.0,Drama,0 days 01:30:00.000000000,-3
67,79,https://resizing.flixster.com/U1grt0YLaPviOxaF-Yt98RBmEw0=/206x305/v2/https://flxt.tmsimg.com/assets/p8078231_p_v10_aa.jpg,How I Ended This Summer,1000,43,2010.0,Drama,0 days 02:04:00.000000000,12
70,77,https://resizing.flixster.com/ag31dS1cYjQpY6_wHlJc31rCJ1I=/206x305/v2/https://flxt.tmsimg.com/assets/p7834807_p_v8_aa.jpg,The Wildest Dream: Conquest of Everest,1000,35,2010.0,Documentary,0 days 01:33:00.000000000,7
54,54,https://resizing.flixster.com/YtTXL_4VxEPXBpveHJ6_TGUyVSQ=/206x305/v2/https://flxt.tmsimg.com/assets/p8514976_p_v10_aa.jpg,Brotherhood,1000,26,2010.0,Crime/Drama,0 days 01:16:00.000000000,0
37,27,,The People I've Slept With,1000,11,2012.0,Comedy,0 days 01:29:00.000000000,-10
64,78,,Behind the Burly Q,100,27,2010.0,Documentary,0 days 01:37:00.000000000,14
53,85,,Tracker,1000,13,2010.0,Action/Adventure,0 days 01:42:00.000000000,32
66,50,https://resizing.flixster.com/17nuRhHX-wN4mzRHOToOhE4dVkc=/206x305/v2/https://flxt.tmsimg.com/assets/p8129788_p_v8_ae.jpg,The Next Three Days,50000,169,2010.0,Crime/Action,0 days 02:13:00.000000000,-16
40,37,,Mars Needs Moms,25000,116,2011.0,Adventure/Kids and family,0 days 01:28:00.000000000,-3
53,72,,Kites,10000,29,2010.0,Romance/Action,0 days 02:13:00.000000000,19
25,50,,Helena From the Wedding,2500,10,2010.0,Other/Drama,0 days 01:39:00.000000000,25
80,74,,When We Leave,1000,31,2010.0,Drama,0 days 01:59:00.000000000,-6
91,93,https://resizing.flixster.com/P01HSH5P7BkkeIDyk2UwZDooQ6k=/206x305/v2/https://flxt.tmsimg.com/assets/p8072785_p_v8_aa.jpg,The Tillman Story,2500,88,2010.0,Documentary,0 days 01:34:00.000000000,2
35,72,,The Last Exorcism,50000,162,2010.0,Horror/Mystery and thriller,0 days 01:30:00.000000000,37
34,46,,You Will Meet a Tall Dark Stranger,10000,137,2010.0,Comedy/Drama,0 days 01:38:00.000000000,12
48,58,,Paranormal Activity 2,100000,137,2010.0,Horror/Mystery and thriller,0 days 01:31:00.000000000,10
26,10,,My Soul to Take,25000,63,2010.0,Horror/Mystery and thriller,0 days 01:47:00.000000000,-16
57,33,,I Am Number Four,100000,168,2011.0,Action/Sci fi,0 days 01:50:00.000000000,-24
56,49,,Super,10000,124,2011.0,,,-7
63,83,https://resizing.flixster.com/b6ZUjWFutXUmWhRbD9ycX5tOR0Y=/206x305/v2/https://flxt.tmsimg.com/assets/p8069744_p_v8_aa.jpg,The Special Relationship,1000,30,2010.0,Drama,0 days 01:32:00.000000000,20
34,48,https://resizing.flixster.com/Q_y0ZGsLBlxe9ZWnnXH0aaK0X4A=/206x305/v2/https://flxt.tmsimg.com/assets/p8146110_p_v10_am.jpg,Meet Monica Velour,500,29,2010.0,Comedy,0 days 01:37:00.000000000,14
21,48,https://resizing.flixster.com/nYS0W6A3lTnyZKI5lK4hC4hQoI8=/206x305/v2/https://flxt.tmsimg.com/assets/p8423746_p_v7_af.jpg,Vanishing on 7th Street,10000,60,2010.0,Horror/Mystery and thriller,0 days 01:25:00.000000000,27
54,17,https://resizing.flixster.com/-VAEI0ccomm6bqvBWW2pBtxU714=/206x305/v2/https://flxt.tmsimg.com/assets/p8123124_p_v10_ag.jpg,Miral,5000,65,2010.0,Drama/History,0 days 01:46:00.000000000,-37
27,48,https://resizing.flixster.com/-39nndBbPChOguMyTcSFT7aIWxg=/206x305/v2/https://flxt.tmsimg.com/assets/p8146142_p_v10_aa.jpg,Monogamy,1000,25,2010.0,Drama,0 days 01:36:00.000000000,21
53,86,,Psychomania,1000,7,1971.0,Horror,0 days 01:35:00.000000000,33
53,50,,Visions of Eight,1,6,1973.0,Documentary,0 days 01:45:00.000000000,-3
82,83,https://resizing.flixster.com/LwVcRhcVNWqqZSgI6EV56oF7eQg=/206x305/v2/https://flxt.tmsimg.com/assets/p8283735_p_v8_ah.jpg,The Lincoln Lawyer,50000,176,2011.0,Crime/Drama,0 days 01:59:00.000000000,1
51,53,,The Mechanic,50000,167,2011.0,Action/Mystery and thriller,0 days 01:32:00.000000000,2
37,30,https://resizing.flixster.com/nl5MLyEPS3egqfW_1F9goMsyPmE=/206x305/v2/https://flxt.tmsimg.com/assets/p8216657_p_v10_ab.jpg,Sanctum,25000,171,2011.0,Mystery and thriller/Action,0 days 01:49:00.000000000,-7
55,55,https://resizing.flixster.com/haUGaDq6pYNVNI68BUJugSElaU8=/206x305/v2/https://flxt.tmsimg.com/assets/p8214163_p_v8_ag.jpg,Unknown,50000,206,2011.0,Drama/Mystery and thriller,0 days 01:53:00.000000000,0
85,93,,127 Hours,50000,236,2010.0,Biography/Drama,0 days 01:33:00.000000000,8
76,78,,Tinker Bell and the Great Fairy Rescue,10000,9,2010.0,Fantasy/Kids and family,0 days 01:13:00.000000000,2
85,67,https://resizing.flixster.com/LPGZyk73TDKOe-e6luRInTZw-ac=/206x305/v2/https://flxt.tmsimg.com/assets/p5031_p_v8_aa.jpg,"America, America",500,9,1963.0,Drama,0 days 02:48:00.000000000,-18
44,25,,Now & Later,100,12,2007.0,Drama,0 days 01:40:00.000000000,-19
79,90,,The Illusionist,10000,134,2010.0,Drama/Animation,0 days 01:30:00.000000000,11
23,17,,Last Day of Summer,100,6,2009.0,Comedy/Drama,0 days 01:45:00.000000000,-6
87,87,,Benazir Bhutto,1000,23,2010.0,Documentary,0 days 01:55:00.000000000,0
42,20,,The Tourist,50000,172,2010.0,Romance/Action,0 days 01:39:00.000000000,-22
87,100,,Last Train Home,5000,54,2009.0,Documentary,0 days 01:25:00.000000000,13
58,88,,The Sun Behind the Clouds: Tibet's Struggle for Freedom,50,17,2010.0,Documentary/Biography,0 days 01:19:00.000000000,30
66,81,,Anton Chekhov's The Duel,250,37,2009.0,Drama,0 days 01:35:00.000000000,15
51,66,,Two in the Wave,250,29,2009.0,Documentary,0 days 01:31:00.000000000,15
76,84,,Stonewall Uprising,250,31,2010.0,Documentary,0 days 01:22:00.000000000,8
70,69,,Oranges and Sunshine,2500,72,2010.0,Drama/History,0 days 01:45:00.000000000,-1
17,3,,Passion Play,2500,33,2010.0,Drama/Mystery and thriller,0 days 01:34:00.000000000,-14
74,69,,Limitless,100000,202,2011.0,Action/Mystery and thriller,0 days 01:45:00.000000000,-5
34,0,,Space Chimps 2: Zartog Strikes Back,10000,8,2010.0,Kids and family/Adventure,0 days 01:15:00.000000000,-34
75,45,,Soul Surfer,25000,106,2011.0,Drama,0 days 01:46:00.000000000,-30
50,68,,Daydream Nation,2500,22,2010.0,Comedy/Drama,0 days 01:38:00.000000000,18
77,86,,Beneath Hill 60,1000,14,2010.0,War/Action,0 days 01:57:00.000000000,9
32,50,,The Orgasm Diaries (Brilliantlove),250,8,2010.0,,,18
66,81,,Red White & Blue,1000,26,2010.0,Drama/Mystery and thriller,0 days 01:43:00.000000000,15
30,64,,Outcast,500,11,2010.0,Horror,0 days 01:38:00.000000000,34
53,73,https://resizing.flixster.com/YtdngPLqKed4xwb8DMPI2FEJaLs=/206x305/v2/https://flxt.tmsimg.com/assets/p8110124_p_v8_ab.jpg,Monsters,25000,161,2010.0,Sci fi/Mystery and thriller,0 days 01:37:00.000000000,20
39,10,https://resizing.flixster.com/nm46I-2BkzP7n7JRYOO_7fzsXfA=/206x305/v2/https://flxt.tmsimg.com/assets/p8329449_p_v10_af.jpg,Red Riding Hood,50000,209,2011.0,Fantasy/Horror,0 days 01:39:00.000000000,-29
73,88,https://resizing.flixster.com/xhuY5QfGbDJoykX6jjjz-TPbCaI=/206x305/v2/https://flxt.tmsimg.com/assets/p8343965_p_v8_aa.jpg,Carancho,1000,48,2010.0,Crime/Romance,0 days 01:47:00.000000000,15
91,97,,Cameraman: The Life & Work of Jack Cardiff,500,29,2010.0,Documentary,0 days 01:26:00.000000000,6
47,32,https://resizing.flixster.com/ct8JPEe6DgBZQ9zS2_CY9QJc6N0=/206x305/v2/https://flxt.tmsimg.com/assets/p8175360_p_v8_aa.jpg,I Spit on Your Grave,10000,63,2010.0,Horror,0 days 01:48:00.000000000,-15
84,96,/assets/pizza-pie/images/poster_default.c8c896e70c3.gif,Yip Man 2,10000,28,2010.0,Drama/History,0 days 01:48:00.000000000,12
71,73,,Heartbeats,5000,73,2010.0,Romance/Gay and lesbian,0 days 01:37:00.000000000,2
79,100,https://resizing.flixster.com/Vb4-D_RVCEc_qDCPI_I8H91sPSY=/206x305/v2/https://flxt.tmsimg.com/assets/p3489393_p_v10_aa.jpg,Daguerréotypes,50,10,1976.0,Documentary,0 days 01:20:00.000000000,21
60,70,https://resizing.flixster.com/VTRaJsJ5a7layoBT0mRPc6pysN0=/206x305/v2/https://flxt.tmsimg.com/assets/p8376734_p_v10_ab.jpg,Illegal,5000,10,2010.0,Drama,0 days 01:30:00.000000000,10
46,69,,Rubber,10000,87,2010.0,Comedy/Horror,0 days 01:22:00.000000000,23
48,72,https://resizing.flixster.com/QK7aAGA1Oa78XVASwj30R2_QlAI=/206x305/v2/https://flxt.tmsimg.com/assets/p8340510_p_v10_ab.jpg,We Are What We Are,2500,47,2010.0,Horror/Drama,0 days 01:30:00.000000000,24
75,80,,Made in Dagenham,10000,132,2010.0,Comedy/Drama,0 days 01:53:00.000000000,5
29,24,https://resizing.flixster.com/LKJHE21dg0Vu7esWrJyoRZgETyo=/206x305/v2/https://flxt.tmsimg.com/assets/p8204720_p_v8_aq.jpg,The Dilemma,50000,164,2011.0,Comedy,0 days 01:51:00.000000000,-5
40,21,https://resizing.flixster.com/D59yADxUA1G6SZD7ilq88rcp5I0=/206x305/v2/https://flxt.tmsimg.com/assets/p8214244_p_v10_al.jpg,The Rite,50000,173,2011.0,Horror/Mystery and thriller,0 days 01:54:00.000000000,-19
40,33,,Hall Pass,50000,177,2011.0,Comedy,0 days 01:46:00.000000000,-7
48,15,,Something Borrowed,25000,117,2011.0,Romance,0 days 01:52:00.000000000,-33
69,86,https://resizing.flixster.com/PyrPqSIW8XAMOd1QdIgjShlOXog=/206x305/v2/https://flxt.tmsimg.com/assets/p3497337_p_v10_am.jpg,The Square,2500,85,2008.0,Mystery and thriller,0 days 01:45:00.000000000,17
55,75,,Nanny McPhee Returns,50000,121,2010.0,Fantasy/Comedy,0 days 01:49:00.000000000,20
69,86,,Kings of Pastry,1000,35,2009.0,Documentary,0 days 01:24:00.000000000,17
50,63,https://resizing.flixster.com/sfoAZQq06KIM4fvIqPZA2wW6mbo=/206x305/v2/https://flxt.tmsimg.com/assets/p8137351_p_v8_aa.jpg,Violet Tendencies,100,8,2010.0,Comedy,0 days 01:39:00.000000000,13
74,93,https://resizing.flixster.com/JbBO7Uzz0Gwro1w61HMzpE6PQDM=/206x305/v2/https://flxt.tmsimg.com/assets/p8175341_p_v10_ar.jpg,Another Year,10000,174,2010.0,Comedy/Drama,0 days 02:09:00.000000000,19
42,65,,Tamara Drewe,5000,127,2010.0,Comedy,0 days 01:50:00.000000000,23
61,89,,Uncle Boonmee Who Can Recall His Past Lives,10000,99,2010.0,Fantasy,0 days 01:54:00.000000000,28
35,9,,Chatroom,2500,23,2010.0,Drama/Mystery and thriller,0 days 01:37:00.000000000,-26
41,60,,Kaboom,5000,105,2010.0,Sci fi/Comedy,0 days 01:26:00.000000000,19
83,90,,Client 9: The Rise and Fall of Eliot Spitzer,1000,70,2010.0,Documentary,0 days 01:57:00.000000000,7
50,86,,Come Undone,250,7,2010.0,Drama,0 days 02:06:00.000000000,36
76,64,,The Lottery,250,14,2010.0,Drama,0 days 01:21:00.000000000,-12
40,25,,Speed-Dating,100,8,2010.0,Romance/Comedy,0 days 01:38:00.000000000,-15
70,70,,Never Let Me Go,25000,183,2010.0,Sci fi/Drama,0 days 01:44:00.000000000,0
76,84,https://resizing.flixster.com/eJhrkTIP3EvG4weUY1Mb21Jpw48=/206x305/v2/https://flxt.tmsimg.com/assets/p8329431_p_v10_ab.jpg,Jane Eyre,25000,167,2011.0,Romance/Drama,0 days 01:58:00.000000000,8
87,86,,Who Is Harry Nilsson (And Why Is Everybody Talkin' About Him)?,500,14,2010.0,Documentary,0 days 01:56:00.000000000,-1
82,92,,Source Code,100000,263,2011.0,Action/Sci fi,0 days 01:29:00.000000000,10
55,62,,The Beaver,10000,185,2011.0,Drama,0 days 01:31:00.000000000,7
44,26,https://resizing.flixster.com/kyC0Pm_MtEnrXa6Aqy0zq2kDGAE=/206x305/v2/https://flxt.tmsimg.com/assets/p8468037_p_v10_am.jpg,Arthur,25000,193,2011.0,Romance,0 days 01:50:00.000000000,-18
32,57,https://resizing.flixster.com/8iZ1HzhGA_aeLCUAs53MI_tGYAE=/206x305/v2/https://flxt.tmsimg.com/assets/p8440917_p_v13_ab.jpg,Bitter Feast,250,7,2010.0,Mystery and thriller,0 days 01:35:00.000000000,25
59,86,,Cedar Rapids,25000,168,2011.0,Comedy,0 days 01:27:00.000000000,27
71,71,https://resizing.flixster.com/z6ENayxKsn_cuh_6ci-8WGBDSzc=/206x305/v2/https://flxt.tmsimg.com/assets/p8331678_p_v10_aa.jpg,Race to Nowhere,500,7,2010.0,Documentary,0 days 01:25:00.000000000,0
61,56,,The Conspirator,10000,171,2010.0,Drama/Mystery and thriller,0 days 02:01:00.000000000,-5
25,42,https://resizing.flixster.com/3h5xzp3iGf26yKUqsIuqbW4_rCE=/206x305/v2/https://flxt.tmsimg.com/assets/p8476699_p_v8_aa.jpg,Henry's Crime,5000,55,2010.0,Comedy/Drama,0 days 01:48:00.000000000,17
31,57,https://resizing.flixster.com/oecEwPxpnyShi1f5TH0HYEEIXIU=/206x305/v2/https://flxt.tmsimg.com/assets/p8212429_p_v8_aa.jpg,The Freebie,1000,28,2010.0,Comedy,0 days 01:18:00.000000000,26
21,17,,The Violent Kind,500,12,2010.0,Horror,0 days 01:40:00.000000000,-4
75,83,/assets/pizza-pie/images/poster_default.c8c896e70c3.gif,Brutal Beauty: Tales of the Rose City Rollers,100,6,2010.0,Documentary,0 days 01:20:00.000000000,8
37,17,https://resizing.flixster.com/oipx44PQP8apvWf-BqYxvh6cCMI=/206x305/v2/https://flxt.tmsimg.com/assets/p8335283_p_v10_ad.jpg,Death Race 2,2500,6,2010.0,Action/Mystery and thriller,0 days 01:36:00.000000000,-20
87,98,https://resizing.flixster.com/YHd54D76HJA165i7Cz3YZ4WxhJU=/206x305/v2/https://flxt.tmsimg.com/assets/p8106392_p_v10_aa.jpg,Marwencol,1000,63,2010.0,Documentary,0 days 01:23:00.000000000,11
29,33,https://resizing.flixster.com/6wovIjAcqQRpmR344RRXDrqgFlk=/206x305/v2/https://flxt.tmsimg.com/assets/p8346057_p_v8_aa.jpg,Meskada,500,6,2010.0,Drama/Mystery and thriller,0 days 01:27:00.000000000,4
22,14,,Release,100,7,2010.0,Drama,0 days 01:27:00.000000000,-8
35,10,,Knucklehead,2500,10,2010.0,Comedy,0 days 01:40:00.000000000,-25
74,38,https://resizing.flixster.com/tnYE6siFC6D3_uH346EppSFj5xM=/206x305/v2/https://flxt.tmsimg.com/assets/p8409273_p_v10_aa.jpg,Tyler Perry's Madea's Big Happy Family,25000,42,2011.0,Comedy/Drama,0 days 01:46:00.000000000,-36
31,0,,Kalamity,2500,17,2010.0,Drama/Mystery and thriller,0 days 01:40:00.000000000,-31
91,98,,Inside Job,25000,148,2010.0,Documentary,0 days 01:48:00.000000000,7
57,79,,Red Hill,2500,68,2010.0,Action/Mystery and thriller,0 days 01:35:00.000000000,22
74,74,https://resizing.flixster.com/zpwmRybOt_rn-FHhD-AHS3z_fOI=/206x305/v2/https://flxt.tmsimg.com/assets/p7926013_p_v10_aa.jpg,John Rabe,500,34,2009.0,War/Drama,0 days 02:14:00.000000000,0
29,4,,Vampires Suck,50000,91,2010.0,Comedy,0 days 01:22:00.000000000,-25
70,68,https://resizing.flixster.com/5FxfpmXpbwhv9Ldhe_2_V299b3I=/206x305/v2/https://flxt.tmsimg.com/assets/p8143098_p_v13_ai.jpg,Conviction,25000,192,2010.0,Drama/Biography,0 days 01:46:00.000000000,-2
24,31,https://resizing.flixster.com/YIfilYTVz54WzESDdoYT6Ghum2c=/206x305/v2/https://flxt.tmsimg.com/assets/p8160351_p_v13_ba.jpg,How Do You Know,25000,151,2010.0,Romance,0 days 02:01:00.000000000,7
71,75,https://resizing.flixster.com/8mZ6Ym5jcw8uBkrsNl2GVLbLZYc=/206x305/v2/https://flxt.tmsimg.com/assets/p8138688_p_v10_aa.jpg,"Ride, Rise, Roar",1,8,2010.0,Documentary/Music,0 days 01:27:00.000000000,4
59,18,,Legendary,2500,44,2010.0,Drama,0 days 01:47:00.000000000,-41
87,86,https://resizing.flixster.com/RKuHzFJH5pomHHBlj-vmzOjTqFU=/206x305/v2/https://flxt.tmsimg.com/assets/p8063167_p_v8_aa.jpg,Jean-Michel Basquiat: The Radiant Child,500,36,2010.0,Documentary,0 days 01:33:00.000000000,-1
55,68,,"If I Want to Whistle, I Whistle",5000,22,2010.0,Drama,0 days 01:34:00.000000000,13
46,6,,Standing Ovation,10000,17,2010.0,Musical,0 days 01:48:00.000000000,-40
55,63,https://resizing.flixster.com/0EgX4-XRtkq1wy9UUEaQlufaBuY=/206x305/v2/https://flxt.tmsimg.com/assets/p8192411_p_v10_am.jpg,Camp Rock 2: The Final Jam,10000,8,2010.0,Comedy/Kids and family,0 days 01:30:00.000000000,8
39,66,https://resizing.flixster.com/Sk4Vwmzy1a5rrCUzfpG3TbMWHfQ=/206x305/v2/https://flxt.tmsimg.com/assets/p8045320_p_v10_aa.jpg,The American,50000,224,2010.0,Action/Drama,0 days 01:45:00.000000000,27
54,50,,BearCity,250,10,2010.0,Romance/Gay and lesbian,0 days 01:45:00.000000000,-4
39,46,/assets/pizza-pie/images/poster_default.c8c896e70c3.gif,Spoken Word,50,13,2009.0,Drama,0 days 01:56:00.000000000,7
24,34,https://resizing.flixster.com/J0ZFyUOOev0TrjadHGW63GoApag=/206x305/v2/https://flxt.tmsimg.com/assets/p8411338_p_v13_ab.jpg,Every Day,2500,32,2010.0,Comedy/Drama,0 days 01:33:00.000000000,10
61,88,https://resizing.flixster.com/aMXY57Lh-4Qs9UA9wkAoUE02aMg=/206x305/v2/https://flxt.tmsimg.com/assets/p8367100_p_v10_aa.jpg,A Screaming Man,500,41,2010.0,Drama,0 days 01:32:00.000000000,27
61,47,https://resizing.flixster.com/GVNser6cdJOmeCvr5FIka80WU88=/206x305/v2/https://flxt.tmsimg.com/assets/p8395384_p_v10_ah.jpg,Diary of a Wimpy Kid: Rodrick Rules,25000,100,2011.0,Comedy/Kids and family,0 days 01:35:00.000000000,-14
58,58,https://resizing.flixster.com/Kfsw1ypdC4SfwvMeVQa5ZvExv6k=/206x305/v2/https://flxt.tmsimg.com/assets/p8472427_p_v10_ae.jpg,Jumping the Broom,10000,85,2011.0,Comedy,0 days 01:48:00.000000000,0
46,33,https://resizing.flixster.com/yfD1mMB7fQzy-hHgu0nn4Ol1DV4=/206x305/v2/https://flxt.tmsimg.com/assets/p8133806_p_v13_ab.jpg,Chain Letter,2500,15,2010.0,Horror/Mystery and thriller,0 days 01:27:00.000000000,-13
36,50,,Ong Bak 3,2500,8,2010.0,Action/Sports and fitness,0 days 01:34:00.000000000,14
85,87,/assets/pizza-pie/images/poster_default.c8c896e70c3.gif,Even the Rain,5000,62,2010.0,Drama,0 days 01:44:00.000000000,2
34,17,https://resizing.flixster.com/WMEyiup6q782iMoUAIkU15SyyjQ=/206x305/v2/https://flxt.tmsimg.com/assets/p8173602_p_v8_ab.jpg,Khatta Meetha,1000,6,2010.0,Comedy/Drama,0 days 02:37:00.000000000,-17
68,33,https://resizing.flixster.com/IB0o4b1Sc-VU-yADi1lvK808TGo=/206x305/v2/https://flxt.tmsimg.com/assets/p8125228_p_v13_ab.jpg,What If ...,500,6,2010.0,Drama,0 days 01:55:00.000000000,-35
43,50,,Devil,50000,98,2010.0,Horror/Mystery and thriller,0 days 01:20:00.000000000,7
18,16,https://resizing.flixster.com/QiJziHrEI2kNsPayQ5VLB2Utg1U=/206x305/v2/https://flxt.tmsimg.com/assets/p8193355_p_v10_ao.jpg,Skyline,50000,83,2010.0,Sci fi/Mystery and thriller,0 days 01:34:00.000000000,-2
53,22,https://resizing.flixster.com/Z4BDcCV17sO8alMII9OnF_DRKHg=/206x305/v2/https://flxt.tmsimg.com/assets/p8175519_p_v10_ar.jpg,Country Strong,25000,134,2010.0,Romance/Drama,0 days 01:57:00.000000000,-31
38,53,https://resizing.flixster.com/xq44qz1_Lnm82GKli0OEZDaYBI8=/206x305/v2/https://flxt.tmsimg.com/assets/p8203350_p_v8_aa.jpg,I'm Still Here,10000,131,2010.0,Documentary/Music,0 days 01:48:00.000000000,15
97,85,,The Two Escobars,500,13,2010.0,Drama/Crime,0 days 01:15:00.000000000,-12
79,59,,Forks Over Knives,2500,37,2011.0,Documentary,0 days 01:36:00.000000000,-20
53,86,https://resizing.flixster.com/d9mVwqPCI_l20QB_c_yL4MluqKU=/206x305/v2/https://flxt.tmsimg.com/assets/p8401456_p_v7_aa.jpg,Meek's Cutoff,5000,130,2010.0,Western,0 days 01:41:00.000000000,33
69,60,https://resizing.flixster.com/VZtHwjSZfgYJsVQTZf9lzF8hOp4=/206x305/v2/https://flxt.tmsimg.com/assets/p8057843_p_v10_aa.jpg,"Hugh Hefner: Playboy, Activist and Rebel",250,43,2009.0,Documentary,0 days 02:15:00.000000000,-9
67,80,https://resizing.flixster.com/9envmwn71J8s_h709Mkmdz4UEYk=/206x305/v2/https://flxt.tmsimg.com/assets/p8445960_p_v8_aa.jpg,No One Killed Jessica,5000,10,2011.0,Drama/Crime,0 days 02:17:00.000000000,13
88,91,/assets/pizza-pie/images/poster_default.c8c896e70c3.gif,Aftershocks (Tangshan dadizhen),2500,11,2010.0,,,3
46,71,,Ticked-Off Trannies With Knives,500,7,2010.0,Mystery and thriller,0 days 01:30:00.000000000,25
35,42,,Hatchet II,2500,36,2010.0,Horror,0 days 01:29:00.000000000,7
46,64,https://resizing.flixster.com/ZrNLk9XytqpZTfFDZcq57mAYsPY=/206x305/v2/https://flxt.tmsimg.com/assets/p188463_p_v13_ab.jpg,Make-Out With Violence,100,14,2008.0,Romance,0 days 01:45:00.000000000,18
71,83,https://resizing.flixster.com/zN8ahJ3xPTO1uQGmw1qBxpwkpiY=/206x305/v2/https://flxt.tmsimg.com/assets/p8304815_p_v10_aa.jpg,Vision: From the Life of Hildegard von Bingen,1000,40,2009.0,Drama/Biography,0 days 01:50:00.000000000,12
43,60,https://resizing.flixster.com/kA-MHxlxDKkOOD5JoOI7szSFCq4=/206x305/v2/https://flxt.tmsimg.com/assets/p8600919_p_v8_ac.jpg,Sharpay's Fabulous Adventure,1000,5,2011.0,Drama/Comedy,0 days 01:29:00.000000000,17
31,29,https://resizing.flixster.com/wTticWDasjsH22fpBMH3I_kaykM=/206x305/v2/https://flxt.tmsimg.com/assets/p8223249_p_v10_ac.jpg,The Virginity Hit,10000,49,2010.0,Comedy,0 days 01:27:00.000000000,-2
72,77,,Copacabana,250,13,2010.0,Comedy,0 days 01:47:00.000000000,5
40,20,,Blue Crush 2,500,5,2011.0,Romance/Drama,0 days 02:00:00.000000000,-20
68,13,https://resizing.flixster.com/E6Gs9kV7tz2o1R40g1Pxbj8vgx8=/206x305/v2/https://flxt.tmsimg.com/assets/p8269322_p_v10_aa.jpg,I Want Your Money,1000,8,2010.0,Documentary,0 days 01:32:00.000000000,-55
88,100,,Precious Life,250,10,2010.0,Documentary,0 days 01:27:00.000000000,12
36,0,,Fred: The Movie,2500,13,2010.0,Comedy/Kids and family,0 days 01:30:00.000000000,-36
54,70,https://resizing.flixster.com/RzXZDGKF0iak3omanbxw_5h0Ll0=/206x305/v2/https://flxt.tmsimg.com/assets/p8304935_p_v8_aa.jpg,The Housemaid,5000,73,2010.0,Mystery and thriller,0 days 01:46:00.000000000,16
31,39,,Ceremony,1000,36,2010.0,Comedy,0 days 01:30:00.000000000,8
86,100,https://resizing.flixster.com/AjHUh0YXodIOceOi_QoJzwyrA-Q=/206x305/v2/https://flxt.tmsimg.com/assets/p8321457_p_v10_aa.jpg,Poetry,5000,72,2010.0,Drama,0 days 02:19:00.000000000,14
62,66,https://resizing.flixster.com/1cIk04vHh_2WU6fUeHMpilqD_vk=/206x305/v2/https://flxt.tmsimg.com/assets/p8494407_p_v10_ak.jpg,Insidious,100000,177,2010.0,Horror/Mystery and thriller,0 days 01:41:00.000000000,4
77,59,,The Kids Grow Up,50,17,2009.0,Documentary,0 days 01:30:00.000000000,-18
62,14,/assets/pizza-pie/images/poster_default.c8c896e70c3.gif,The Hungry Ghosts,1,7,2009.0,Drama,0 days 01:45:00.000000000,-48
39,35,https://resizing.flixster.com/QaSHqXug3xABZtWfrN2yDNkrURw=/206x305/v2/https://flxt.tmsimg.com/assets/p8410084_p_v10_ae.jpg,Prom,10000,91,2011.0,Comedy/Drama,0 days 01:43:00.000000000,-4
78,97,https://resizing.flixster.com/Kv6On5w0BfsjD9edU9tZGE1WL8w=/206x305/v2/https://flxt.tmsimg.com/assets/p8265525_p_v10_aa.jpg,Phil Ochs: There But for Fortune,1000,33,2010.0,Documentary/Biography,0 days 01:36:00.000000000,19
73,90,,Fubar 2,500,10,2010.0,Comedy,0 days 01:25:00.000000000,17
57,66,https://resizing.flixster.com/-uRFsVuQSETqUkp9WPUcvUAknHQ=/206x305/v2/https://flxt.tmsimg.com/assets/p8517103_p_v10_ad.jpg,Hobo With a Shotgun,10000,119,2011.0,Crime/Action,0 days 01:26:00.000000000,9
16,14,https://resizing.flixster.com/X4okJEXECEtJFDbVL6OcQYHfYew=/206x305/v2/https://flxt.tmsimg.com/assets/p8247470_p_v10_ag.jpg,And Soon the Darkness,2500,7,2010.0,Horror/Mystery and thriller,0 days 01:31:00.000000000,-2
86,78,,In a Better World,5000,122,2010.0,Drama,0 days 01:53:00.000000000,-8
18,7,,Immigration Tango,100,14,2010.0,Romance,0 days 01:30:00.000000000,-11
42,86,,Legacy,250,7,2010.0,Mystery and thriller,0 days 01:33:00.000000000,44
53,47,https://resizing.flixster.com/NYsBFm-Hwq6twBaxld0ewWcIxEc=/206x305/v2/https://flxt.tmsimg.com/assets/p8429860_p_v10_aq.jpg,Legend of the Fist: The Return of Chen Zhen,5000,36,2010.0,Action/Drama,0 days 01:45:00.000000000,-6
81,36,,The Grace Card,2500,28,2010.0,Drama,0 days 01:41:00.000000000,-45
24,57,,Sharktopus,1000,7,2010.0,Horror/Sci fi,0 days 01:29:00.000000000,33
100,42,https://resizing.flixster.com/8RuWZJpkJavrBSxF-sprYBhl39s=/206x305/v2/https://flxt.tmsimg.com/assets/p8310584_p_v10_aa.jpg,GhettoPhysics: Will the Real Pimps and Hos Please Stand Up?,100,12,2010.0,Drama,0 days 01:34:00.000000000,-58
28,9,,Bonded by Blood,250,11,2010.0,Crime/Drama,0 days 01:40:00.000000000,-19
60,60,,Dabangg,1000,5,2010.0,Action,0 days 02:06:00.000000000,0
33,0,,Lost Boys: The Thirst,1000,7,2010.0,Horror,0 days 01:22:00.000000000,-33
25,75,,Primal,500,8,2010.0,Horror,0 days 01:24:00.000000000,50
46,38,https://resizing.flixster.com/JV8_i37As8t1Me-BShFBu1JOyFY=/206x305/v2/https://flxt.tmsimg.com/assets/p8292017_p_v8_aa.jpg,Inhale,5000,24,2010.0,Drama/Mystery and thriller,0 days 01:23:00.000000000,-8
61,83,,Trophy Wife,2500,118,2010.0,Comedy,0 days 01:43:00.000000000,22
57,53,https://resizing.flixster.com/MtoKt8hmiTp5OmROVD-mCSpHqIw=/206x305/v2/https://flxt.tmsimg.com/assets/p8503371_p_v10_ac.jpg,The High Cost of Living,500,15,2010.0,Drama,0 days 01:32:00.000000000,-4
81,78,,"Hey, Boo: Harper Lee and To Kill a Mockingbird",250,32,2010.0,Documentary,0 days 01:22:00.000000000,-3
66,82,https://resizing.flixster.com/tbH2od_aL4FLzhwYgArWFk9zkR4=/206x305/v2/https://flxt.tmsimg.com/assets/p8298987_p_v8_ab.jpg,I Will Follow,250,11,2010.0,Drama,0 days 01:28:00.000000000,16
65,79,,Trust,10000,66,2010.0,Mystery and thriller,0 days 01:46:00.000000000,14
74,52,https://resizing.flixster.com/slsTFonH2Cxhks73_6EEzefKWoY=/206x305/v2/https://flxt.tmsimg.com/assets/p8299686_p_v8_aa.jpg,Cool It,1000,44,2010.0,Documentary,0 days 01:29:00.000000000,-22
87,81,,I Saw the Devil,10000,85,2010.0,Mystery and thriller,0 days 02:21:00.000000000,-6
48,79,,Small Town Murder Songs,1000,19,2010.0,Crime/Drama,0 days 01:16:00.000000000,31
65,76,https://resizing.flixster.com/rYUThdw_cjKImWLdOPdK19UF6Nw=/206x305/v2/https://flxt.tmsimg.com/assets/p8346473_p_v8_ad.jpg,Outside the Law,500,42,2010.0,Action/Drama,0 days 02:18:00.000000000,11
73,88,,Machete Maidens Unleashed!,500,8,2010.0,Documentary/Drama,0 days 01:25:00.000000000,15
70,65,/assets/pizza-pie/images/poster_default.c8c896e70c3.gif,Mumbai Diaries,5000,26,2010.0,Drama,0 days 01:40:00.000000000,-5
78,78,,Mooz-lum,500,9,2010.0,Drama,0 days 01:36:00.000000000,0
62,74,,Stake Land,5000,66,2010.0,Horror,0 days 01:36:00.000000000,12
71,94,,Neds,2500,34,2010.0,Drama,0 days 02:04:00.000000000,23
16,20,https://resizing.flixster.com/k6wiWmLk7aHZWYp3xl90fZVk9hU=/206x305/v2/https://flxt.tmsimg.com/assets/p8444968_p_v10_ae.jpg,The Traveler,500,5,2010.0,Horror/Mystery and thriller,0 days 01:31:00.000000000,4
71,47,https://resizing.flixster.com/d4ycTkcLltP9SmzfKr8l-FeJvX8=/206x305/v2/https://flxt.tmsimg.com/assets/p8405177_p_v7_aa.jpg,White Irish Drinkers,2500,34,2010.0,Drama,0 days 01:49:00.000000000,-24
60,60,,A Marine Story,250,5,2010.0,Drama,0 days 01:38:00.000000000,0
90,100,https://resizing.flixster.com/IrHs5mhFTHJECy3_GHnlHIm1kes=/206x305/v2/https://flxt.tmsimg.com/assets/p8334123_p_v8_aa.jpg,This Man,5000,8,2010.0,Crime/Action,0 days 01:59:00.000000000,10
50,38,,Golmaal 3,500,8,2010.0,Comedy,0 days 02:19:00.000000000,-12
56,69,,Forget Me Not,500,13,2010.0,Romance,0 days 01:32:00.000000000,13
63,36,https://resizing.flixster.com/vPXqGKNJ6Q_KCvC9AG5lksSFhbU=/206x305/v2/https://flxt.tmsimg.com/assets/p8365718_p_v10_aa.jpg,Queen of the Lot,500,14,2010.0,Romance/Comedy,0 days 02:00:00.000000000,-27
62,100,https://resizing.flixster.com/04Erdhei-DGkw3PCosbTpjIw4pE=/206x305/v2/https://flxt.tmsimg.com/assets/p8606276_p_v13_ab.jpg,Black Venus,250,5,2010.0,Drama,0 days 02:42:00.000000000,38
24,48,https://resizing.flixster.com/q7nWOrVmYUIOBCLe3TzV0VP0L9w=/206x305/v2/https://flxt.tmsimg.com/assets/p8557279_p_v8_aa.jpg,Wrecked,2500,27,2011.0,Mystery and thriller,0 days 01:31:00.000000000,24
23,0,,Brother's Justice,500,9,2010.0,Comedy,0 days 01:26:00.000000000,-23
65,65,,Justin Bieber: Never Say Never,50000,107,2011.0,Documentary,0 days 01:45:00.000000000,0
18,4,https://resizing.flixster.com/vEviUE9xv7aWtthUB4C2-d_o-74=/206x305/v2/https://flxt.tmsimg.com/assets/p8364566_p_v8_aa.jpg,Hemingway's Garden of Eden,500,23,2008.0,Romance/Drama,0 days 01:51:00.000000000,-14
80,36,https://resizing.flixster.com/REaq4lqAvgSBTiUOh7XdrCxv200=/206x305/v2/https://flxt.tmsimg.com/assets/p8454277_p_v10_ab.jpg,I Am,1000,47,2010.0,Documentary,0 days 01:16:00.000000000,-44
33,17,,After the Break,1000,6,2010.0,Romance/Drama,0 days 01:53:00.000000000,-16
72,81,,Trollhunter,10000,108,2010.0,Mystery and thriller/Action,0 days 01:43:00.000000000,9
72,67,,Guzaarish,1000,9,2010.0,Drama,0 days 02:15:00.000000000,-5
27,0,,Action Replayy,250,5,2010.0,Romance/Sci fi,0 days 02:11:00.000000000,-27
84,92,https://resizing.flixster.com/_4kZUbND3LzecppRGALl5AVu7e0=/206x305/v2/https://flxt.tmsimg.com/assets/p8558960_p_v8_aa.jpg,Public Speaking,1000,12,2010.0,Documentary,0 days 01:22:00.000000000,8
59,89,/assets/pizza-pie/images/poster_default.c8c896e70c3.gif,Siege of the Dead,500,9,2010.0,Horror,0 days 00:59:00.000000000,30
41,80,https://resizing.flixster.com/RnEu7NkSJG4aDg98UrPdHLfebcE=/206x305/v2/https://flxt.tmsimg.com/assets/p8491725_p_v10_aa.jpg,The Reef,1000,20,2010.0,Horror,0 days 01:24:00.000000000,39
36,48,https://resizing.flixster.com/YnUy43drLfjyN7UEsGyMPLs0IOk=/206x305/v2/https://flxt.tmsimg.com/assets/p8405201_p_v10_an.jpg,Blitz,5000,25,2011.0,Crime/Action,0 days 01:33:00.000000000,12
39,73,https://resizing.flixster.com/lh46aA5ail1QZVdxz78W8wA1C0s=/206x305/v2/https://flxt.tmsimg.com/assets/p8418577_p_v10_ac.jpg,Road to Nowhere,500,26,2010.0,Romance/Mystery and thriller,0 days 02:01:00.000000000,34
18,11,https://resizing.flixster.com/Ji6scsiaEpaJ85OCbFK3Hq3f_6M=/206x305/v2/https://flxt.tmsimg.com/assets/p8136032_p_v10_ab.jpg,Tees Maar Khan,1000,9,2010.0,Comedy,0 days 02:15:00.000000000,-7
45,39,,Love and Other Impossible Pursuits,10000,46,2009.0,Comedy/Drama,0 days 01:59:00.000000000,-6
8,10,/assets/pizza-pie/images/poster_default.c8c896e70c3.gif,Cuckoo,100,10,2009.0,Drama/Mystery and thriller,0 days 01:29:00.000000000,2
61,60,/assets/pizza-pie/images/poster_default.c8c896e70c3.gif,Family Guy Presents: It's a Trap,2500,5,2010.0,,,-1
30,44,,Bereavement,2500,18,2010.0,Crime/Horror,0 days 01:43:00.000000000,14
89,83,https://resizing.flixster.com/MRcSI-_W10aipFn8fhCCySzfMt4=/206x305/v2/https://flxt.tmsimg.com/assets/p8063060_p_v10_ae.jpg,Lemmy,1000,23,2010.0,Documentary,0 days 01:56:00.000000000,-6
75,88,https://resizing.flixster.com/pvE9Pcx8HchtqH6GYyhFr-i9ivI=/206x305/v2/https://flxt.tmsimg.com/assets/p8612794_p_v8_aa.jpg,If a Tree Falls: A Story of the Earth Liberation Front,1000,33,2011.0,Crime/Documentary,0 days 01:25:00.000000000,13
43,29,https://resizing.flixster.com/TseOs5wYPt9iVyEqF29dJ5CoWD8=/206x305/v2/https://flxt.tmsimg.com/assets/p8439860_p_v8_aa.jpg,The Chaperone,2500,17,2011.0,Comedy/Drama,0 days 01:44:00.000000000,-14
85,94,,Win Win,25000,177,2011.0,Comedy/Drama,0 days 01:46:00.000000000,9
81,67,https://resizing.flixster.com/OGrmTrFaVvVnLG8oTuzqv0H0OAw=/206x305/v2/https://flxt.tmsimg.com/assets/p8477227_p_v10_aa.jpg,The Music Never Stopped,2500,49,2011.0,Drama,0 days 01:45:00.000000000,-14
43,83,https://resizing.flixster.com/qKWI3IlATHyexCsD5WrVgdwyufI=/206x305/v2/https://flxt.tmsimg.com/assets/p8139364_p_v10_ac.jpg,The Client List,500,6,2010.0,Drama,0 days 01:30:00.000000000,40
51,49,https://resizing.flixster.com/MReZYD1AwF9nyj4H0UDUq_DDFOM=/206x305/v2/https://flxt.tmsimg.com/assets/p8369331_p_v10_ac.jpg,No Strings Attached,50000,173,2011.0,Romance,0 days 01:48:00.000000000,-2
64,72,https://resizing.flixster.com/8dXZ2HbMKNww7pkHYVtCZT5Sfqc=/206x305/v2/https://flxt.tmsimg.com/assets/p8537881_p_v10_ab.jpg,Pom Wonderful Presents: The Greatest Movie Ever Sold,10000,134,2011.0,Documentary/Comedy,0 days 01:26:00.000000000,8
75,74,https://resizing.flixster.com/i47faq7RkQFE8ochaazFgrgNn1s=/206x305/v2/https://flxt.tmsimg.com/assets/p8539711_p_v8_aa.jpg,Cold Fish,1000,23,2010.0,Drama/Mystery and thriller,0 days 02:24:00.000000000,-1
86,64,,Troubadours,250,11,2011.0,Documentary/Biography,0 days 01:41:00.000000000,-22
58,5,https://resizing.flixster.com/f_8ns-Hc7lPXo7x9LfEHMxnGFFc=/206x305/v2/https://flxt.tmsimg.com/assets/p8329393_p_v10_ac.jpg,"Big Mommas: Like Father, Like Son",100000,61,2011.0,Comedy,0 days 01:48:00.000000000,-53
59,19,,Just Go With It,50000,139,2011.0,Romance,0 days 01:55:00.000000000,-40
66,73,,Harvest,500,11,2010.0,Drama,0 days 01:43:00.000000000,7
85,69,,"Fat, Sick & Nearly Dead",1000,13,2010.0,Documentary,0 days 01:37:00.000000000,-16
57,60,,Jackass 3.5,1000,5,2011.0,Comedy,0 days 01:25:00.000000000,3
25,19,,The Big Bang,1000,16,2010.0,Mystery and thriller,0 days 01:41:00.000000000,-6
62,85,https://resizing.flixster.com/msgQ6_kAQEqws_X2GTEFy5H7IAM=/206x305/v2/https://flxt.tmsimg.com/assets/p8557359_p_v8_aa.jpg,Fly Away,100,13,2012.0,Drama,0 days 01:25:00.000000000,23
55,75,https://resizing.flixster.com/oreqgqFm84x9WPsU0DchsItdWXE=/206x305/v2/https://flxt.tmsimg.com/assets/p8600364_p_v8_aa.jpg,Square Grouper: The Godfathers of Ganja,500,12,2011.0,Documentary,0 days 01:40:00.000000000,20
41,77,,Genova,1000,44,2008.0,Drama,0 days 01:34:00.000000000,36
100,20,/assets/pizza-pie/images/poster_default.c8c896e70c3.gif,Mysteries of the Jesus Prayer,1,5,2010.0,Documentary,0 days 01:54:00.000000000,-80
68,60,,That's What I Am,1000,20,2011.0,Comedy/Drama,0 days 01:41:00.000000000,-8
67,72,,Exporting Raymond,1000,25,2010.0,Documentary,0 days 01:26:00.000000000,5
78,72,https://resizing.flixster.com/NNNcKhvlV0w__wUYl3LJRLIrhp0=/206x305/v2/https://flxt.tmsimg.com/assets/p8070888_p_v10_aa.jpg,Dumbstruck,100,29,2010.0,Documentary,0 days 01:25:00.000000000,-6
20,0,,Shadows and Lies,100,5,2010.0,Drama,0 days 01:48:00.000000000,-20
46,39,https://resizing.flixster.com/zTO7tQcLKc0FpnvP7zlWFKJUMhE=/206x305/v2/https://flxt.tmsimg.com/assets/p8783376_p_v10_ab.jpg,Beautiful Lies,500,28,2010.0,Romance/Comedy,0 days 01:45:00.000000000,-7
36,70,,X,250,20,2011.0,Mystery and thriller,,34
21,0,,You Got Served: Beat the World,250,5,2011.0,Drama,0 days 01:31:00.000000000,-21
70,90,,Burn Notice: The Fall of Sam Axe,250,10,2011.0,Action,0 days 01:30:00.000000000,20
50,100,,The Tunnel,500,7,2011.0,Horror/Drama,0 days 01:30:00.000000000,50
82,89,,Delhi Belly,2500,19,2011.0,Action/Comedy,0 days 01:43:00.000000000,7
28,18,https://resizing.flixster.com/_fhCMdvh1dGINAZLi0bMAS9Ga84=/206x305/v2/https://flxt.tmsimg.com/assets/p8668916_p_v8_aa.jpg,Love's Kitchen,500,17,2011.0,Romance,0 days 01:30:00.000000000,-10
34,75,https://resizing.flixster.com/Pary7ZMet9uqvYataKZ3ctyI4BI=/206x305/v2/https://flxt.tmsimg.com/assets/p8655164_p_v10_aj.jpg,Quarantine 2: Terminal,2500,8,2011.0,Sci fi/Horror,0 days 01:26:00.000000000,41
52,74,,Around a Small Mountain,100,23,2009.0,Drama,0 days 01:25:00.000000000,22
67,40,/assets/pizza-pie/images/poster_default.c8c896e70c3.gif,Damn!,100,10,2011.0,Documentary,0 days 01:12:00.000000000,-27
80,100,,Phineas and Ferb: The Movie: Across the 2nd Dimension,1000,5,2011.0,Animation/Comedy,0 days 01:30:00.000000000,20
68,62,,39 Pounds of Love,2500,34,2005.0,Documentary,0 days 01:10:00.000000000,-6
78,98,,Snow White and the Seven Dwarfs,250000,52,1937.0,Fantasy/Kids and family,0 days 01:20:00.000000000,20
95,93,,The Great Dictator,25000,45,1940.0,Comedy,0 days 02:08:00.000000000,-2
64,81,https://resizing.flixster.com/U0JqxZJlIBxv_X4Su0HXVY5c_lM=/206x305/v2/https://flxt.tmsimg.com/assets/p5449_p_v8_ab.jpg,Death Race 2000,25000,37,1975.0,Action/Comedy,0 days 01:18:00.000000000,17
25,29,,Evil Toons,1000,7,1991.0,Horror,0 days 01:26:00.000000000,4
89,80,,Perfect Blue,10000,44,1997.0,Mystery and thriller/Anime,0 days 01:20:00.000000000,-9
83,100,,That Hamilton Woman,1000,11,1941.0,Drama/History,0 days 02:08:00.000000000,17
88,89,https://resizing.flixster.com/3kkdlNzKnv-rJL9bLJdersurzqU=/206x305/v2/https://flxt.tmsimg.com/assets/p30194_p_v10_ad.jpg,Devdas,10000,19,2002.0,Romance/Drama,0 days 03:01:00.000000000,1
92,97,https://resizing.flixster.com/Yga6Io-nFoBJxmlBVSaYnO8JLeM=/206x305/v2/https://flxt.tmsimg.com/assets/p46611_p_v10_ab.jpg,The Hidden Fortress,10000,34,1958.0,Comedy,0 days 02:19:00.000000000,5
45,67,,Stupidity,1000,6,2003.0,Documentary,0 days 01:02:00.000000000,22
78,92,,Matador,10000,26,1986.0,Comedy/Drama,0 days 01:42:00.000000000,14
69,67,,The Belles of St. Trinian's,1000,6,1954.0,Comedy,0 days 01:31:00.000000000,-2
83,50,https://resizing.flixster.com/d9Dug4b2S3zpaU-Zjm8JU4OY7Jo=/206x305/v2/https://flxt.tmsimg.com/assets/p10282_p_v8_aa.jpg,Made in Heaven,2500,12,1987.0,Romance,0 days 01:42:00.000000000,-33
91,83,,As It Is in Heaven,5000,6,2004.0,Comedy/Drama,0 days 02:10:00.000000000,-8
70,74,https://resizing.flixster.com/7AN7B99cMl7BsccF3aw2s-Tf0FA=/206x305/v2/https://flxt.tmsimg.com/assets/p9480_p_v8_ab.jpg,Night of the Creeps,10000,19,1986.0,Comedy/Horror,0 days 01:25:00.000000000,4
78,93,https://resizing.flixster.com/u6Qulx5Br1GIt88mkrV6C9opU8s=/206x305/v2/https://flxt.tmsimg.com/assets/p178009_p_v10_ab.jpg,The Sun,1000,42,2005.0,Drama/History,0 days 01:55:00.000000000,15
74,86,,Homicide: The Movie,1000,7,2000.0,Drama,0 days 01:36:00.000000000,12
82,100,https://resizing.flixster.com/iVYCinh9ljeLIZIKeRrhlz1nNeg=/206x305/v2/https://flxt.tmsimg.com/assets/p59430_p_v8_ab.jpg,Law of Desire,5000,13,1987.0,Comedy/Gay and lesbian,0 days 01:40:00.000000000,18
40,0,,Hot to Trot,2500,16,1988.0,Comedy,0 days 01:24:00.000000000,-40
72,38,https://resizing.flixster.com/G7duwz_a-d0mYCqR2wL8qrTx3mg=/206x305/v2/https://flxt.tmsimg.com/assets/p169933_p_v10_aa.jpg,2:37,10000,8,2006.0,Drama,0 days 01:40:00.000000000,-34
57,40,,Phantasm II,5000,15,1988.0,Horror,0 days 01:37:00.000000000,-17
38,33,/assets/pizza-pie/images/poster_default.c8c896e70c3.gif,Puppet Master II,5000,6,1990.0,Horror,0 days 01:30:00.000000000,-5
71,53,/assets/pizza-pie/images/poster_default.c8c896e70c3.gif,Human Desire,500,15,1954.0,Crime/Drama,0 days 01:30:00.000000000,-18
78,80,,Me,500,5,1968.0,Drama,0 days 01:23:00.000000000,2
84,84,https://resizing.flixster.com/UBzBELwSzIH1WbS4Wn50c4hgJGM=/206x305/v2/https://flxt.tmsimg.com/assets/p164084_p_v13_aa.jpg,Black Gold,1000,50,2006.0,Documentary,0 days 01:17:00.000000000,0
93,93,https://resizing.flixster.com/dlGv4xMv_SSIvkpNFMc6PaDzxQM=/206x305/v2/https://flxt.tmsimg.com/assets/p31330_p_v13_ag.jpg,The Seventh Seal,25000,61,1956.0,Fantasy/Drama,0 days 01:36:00.000000000,0
30,14,,Mr. Right,500,14,2006.0,Documentary,0 days 01:21:00.000000000,-16
86,31,/assets/pizza-pie/images/poster_default.c8c896e70c3.gif,A Touch of Spice,2500,13,2003.0,Comedy/Drama,0 days 01:46:00.000000000,-55
100,100,,Edward Said: The Last Interview,250,5,2004.0,Documentary,0 days 02:00:00.000000000,0
49,33,,The Girl on a Motorcycle,500,6,1968.0,Drama,0 days 01:31:00.000000000,-16
89,100,/assets/pizza-pie/images/poster_default.c8c896e70c3.gif,Cairo Station,250,11,1958.0,Drama,0 days 01:16:00.000000000,11
91,96,https://resizing.flixster.com/weCXG0GdwmtH80o9q6sYVTYEGyk=/206x305/v2/https://flxt.tmsimg.com/assets/p17886_p_v10_aa.jpg,Floating Weeds,2500,23,1959.0,Drama,0 days 01:55:00.000000000,5
86,85,,Jack Smith and the Destruction of Atlantis,1000,20,2006.0,Documentary,0 days 01:35:00.000000000,-1
82,86,,Son of Man,500,7,2006.0,Drama,0 days 01:26:00.000000000,4
76,81,https://resizing.flixster.com/xCmIs6vIL2WkgvU4TO8O6suYrzE=/206x305/v2/https://flxt.tmsimg.com/assets/p167480_p_v8_aa.jpg,Taxidermia,5000,47,2006.0,Drama,0 days 01:31:00.000000000,5
80,86,,Colossal Youth,500,22,2006.0,Drama,0 days 02:30:00.000000000,6
43,53,https://resizing.flixster.com/LHNxm0piOl4nuzNRGCCPJHHfag8=/206x305/v2/https://flxt.tmsimg.com/assets/p172071_p_v8_aa.jpg,David & Layla,5000,19,2006.0,Comedy/Drama,0 days 01:48:00.000000000,10
60,67,,Alice in Wonderland,500,9,1933.0,Fantasy/Kids and family,0 days 01:16:00.000000000,7
45,29,https://resizing.flixster.com/fSHhWUAmNNLIwW6j1xTKuq55kmo=/206x305/v2/https://flxt.tmsimg.com/assets/p3172_p_v8_aa.jpg,Bobby Deerfield,1000,14,1977.0,Romance,0 days 02:04:00.000000000,-16
86,100,,Paisan,1000,10,1946.0,Drama/War,0 days 02:14:00.000000000,14
91,88,/assets/pizza-pie/images/poster_default.c8c896e70c3.gif,Shake Hands With the Devil: The Journey of Roméo Dallaire,1000,50,2004.0,Documentary,0 days 01:31:00.000000000,-3
64,68,,The Brothers Bloom,50000,157,2008.0,Romance/Comedy,0 days 01:49:00.000000000,4
62,16,,I Can't Think Straight,25000,32,2007.0,Romance/Gay and lesbian,0 days 01:20:00.000000000,-46
84,90,https://resizing.flixster.com/4aDRM67KkSICRcFXEKA9RWvGYG0=/206x305/v2/https://flxt.tmsimg.com/assets/p465_p_v10_ai.jpg,Bigger Than Life,1000,29,1956.0,Drama,0 days 01:35:00.000000000,6
73,89,,Night Train to Munich,500,18,1940.0,Mystery and thriller,0 days 01:33:00.000000000,16
86,84,,Let Him Have It,1000,37,1991.0,Crime/Drama,0 days 01:59:00.000000000,-2
76,100,https://resizing.flixster.com/PW7sMxA4QUrGrYb2VeD9fEjTdVM=/206x305/v2/https://flxt.tmsimg.com/assets/p41611_p_v10_aa.jpg,Nightfall,250,9,1956.0,Crime/Drama,0 days 01:18:00.000000000,24
65,88,,The Stepfather,2500,32,1987.0,Mystery and thriller,0 days 01:28:00.000000000,23
45,59,https://resizing.flixster.com/oHvtx-ad-UlHncJfQfkUl92iykQ=/206x305/v2/https://flxt.tmsimg.com/assets/p182372_p_v8_aa.jpg,Expired,500,22,2007.0,Comedy/Drama,0 days 01:44:00.000000000,14
46,89,,Shockproof,100,9,1949.0,Crime/Drama,0 days 01:19:00.000000000,43
57,92,,Diamond Hunters,250,13,1956.0,Action,0 days 01:32:00.000000000,35
76,86,,Kráska v Nesnázích (Beauty in Trouble),500,44,2006.0,,,10
42,86,,Pushover,250,7,1954.0,Crime/Drama,0 days 01:28:00.000000000,44
89,92,,Daybreak,1000,24,1939.0,Crime/Drama,0 days 01:33:00.000000000,3
58,85,,Downhill Racer,1000,27,1969.0,Drama,0 days 01:42:00.000000000,27
43,44,,Live!,10000,16,2007.0,Comedy/Drama,0 days 01:36:00.000000000,1
52,50,https://resizing.flixster.com/ugjNZZQTyGWNga487e81Uav-8rs=/206x305/v2/https://flxt.tmsimg.com/assets/p51_p_v8_aa.jpg,Carny,500,6,1980.0,Drama,0 days 01:47:00.000000000,-2
71,83,https://resizing.flixster.com/BFHTeA_OZ-lfaPJqhl6N-yJcrhk=/206x305/v2/https://flxt.tmsimg.com/assets/p169302_p_v8_ad.jpg,Trick 'r Treat,25000,29,2007.0,Horror/Mystery and thriller,0 days 01:22:00.000000000,12
25,29,,The Open Road,25000,7,2009.0,Comedy/Drama,0 days 01:30:00.000000000,4
77,87,,Barking Dogs Never Bite,1000,15,2000.0,Comedy,0 days 01:48:00.000000000,10
29,0,,Second Sight,500,6,1989.0,Comedy,0 days 01:24:00.000000000,-29
65,60,,Sanshiro Sugata,1000,5,1943.0,Drama,0 days 01:19:00.000000000,-5
67,80,/assets/pizza-pie/images/poster_default.c8c896e70c3.gif,Mummies: Secrets of the Pharaohs,1000,5,2007.0,Documentary,0 days 00:40:00.000000000,13
75,89,,Rocky Road to Dublin,500,9,1968.0,Documentary,0 days 01:10:00.000000000,14
82,82,https://resizing.flixster.com/kACYoBcDXPDb-kl4iTX4kQPUcaM=/206x305/v2/https://flxt.tmsimg.com/assets/p3542039_p_v8_am.jpg,Avatar,250000,319,2009.0,Fantasy/Action,0 days 02:35:00.000000000,0
85,71,/assets/pizza-pie/images/poster_default.c8c896e70c3.gif,Meeting People Is Easy,2500,7,1999.0,Documentary,0 days 01:38:00.000000000,-14
33,25,https://resizing.flixster.com/fldvaQzZuTiv9RD0da5e89MinQ0=/206x305/v2/https://flxt.tmsimg.com/assets/p182386_p_v10_ab.jpg,Blood: The Last Vampire,50000,53,2008.0,Mystery and thriller/Action,0 days 01:29:00.000000000,-8
67,59,/assets/pizza-pie/images/poster_default.c8c896e70c3.gif,The Hip Hop Project,2500,39,2006.0,Documentary,0 days 01:28:00.000000000,-8
36,75,https://resizing.flixster.com/FiodSXrrERyqaJdOlMh9CVONzvE=/206x305/v2/https://flxt.tmsimg.com/NowShowing/61927/61927_aa.jpg,Dinosaurs Alive!,500,8,2007.0,Documentary,0 days 00:40:00.000000000,39
30,44,,Evergreen,100,36,2004.0,Drama,0 days 01:27:00.000000000,14
64,18,,The Elephant King,250,11,2006.0,Drama,0 days 01:32:00.000000000,-46
47,43,,My Mexican Shivah,250,7,2007.0,Comedy,0 days 01:38:00.000000000,-4
34,57,/assets/pizza-pie/images/poster_default.c8c896e70c3.gif,The Dukes,25000,23,2007.0,Comedy/Drama,0 days 01:36:00.000000000,23
71,83,https://resizing.flixster.com/Kz2_NuZxSEZwfr-cmCP3L3kBOG8=/206x305/v2/https://flxt.tmsimg.com/assets/p9880_p_v8_aa.jpg,The Crimson Kimono,250,12,1959.0,Crime/Drama,0 days 01:24:00.000000000,12
67,100,,Wagon Master,500,8,1950.0,Western,0 days 01:26:00.000000000,33
56,72,https://resizing.flixster.com/BPDK0xWhixWEEGnotilImVS20VQ=/206x305/v2/https://flxt.tmsimg.com/assets/p3120_p_v8_aa.jpg,Beyond a Reasonable Doubt,500,18,1956.0,Mystery and thriller,0 days 01:20:00.000000000,16
41,17,,Sunchaser,500,6,1996.0,Drama,0 days 02:02:00.000000000,-24
58,44,https://resizing.flixster.com/biyZqJqfoKPY7bHFx14r-MkNABQ=/206x305/v2/https://flxt.tmsimg.com/assets/p174073_p_v8_aa.jpg,Vivere,250,16,2007.0,Romance/Gay and lesbian,0 days 01:37:00.000000000,-14
86,69,,The First Saturday in May,250,26,2007.0,Documentary,0 days 01:36:00.000000000,-17
95,67,/assets/pizza-pie/images/poster_default.c8c896e70c3.gif,No Greater Love,500,12,1959.0,War,0 days 03:20:00.000000000,-28
88,60,,Kapò,250,5,1959.0,Drama/History,0 days 01:56:00.000000000,-28
90,98,https://resizing.flixster.com/4VN606dk7hkXBpAf9eOtthBGEJ4=/206x305/v2/https://flxt.tmsimg.com/assets/p190662_p_v13_az.jpg,Up,250000,298,2009.0,Animation/Comedy,0 days 01:29:00.000000000,8
88,89,https://resizing.flixster.com/STZpVC6jt4LFwkngzP7Xn0_XGmU=/206x305/v2/https://resizing.flixster.com/iTtUhtQkKbU8yqJ3KjFNbpXh0hU=/ems.ZW1zLXByZC1hc3NldHMvbW92aWVzLzZkYWFiY2VjLTM2ODAtNGU2Yy05NDM2LTk3MGVlYjFlZjc1Yi53ZWJw,Inglourious Basterds,250000,332,2009.0,Comedy/Drama,0 days 02:32:00.000000000,1
57,73,https://resizing.flixster.com/su1wQr3zhjr2f6s-Y7PO2Knkm7g=/206x305/v2/https://flxt.tmsimg.com/assets/p176372_p_v8_ab.jpg,Where the Wild Things Are,250000,270,2009.0,Fantasy/Kids and family,0 days 01:41:00.000000000,16
67,100,https://resizing.flixster.com/hJVEfPCwy1BuiXbsHeypB5TilII=/206x305/v2/https://flxt.tmsimg.com/assets/p4366_p_v8_aa.jpg,The Tall Target,100,5,1951.0,Mystery and thriller,0 days 01:18:00.000000000,33
82,91,https://resizing.flixster.com/Cj5lQEDlG5dQ75wwbksLp2Q7QCA=/206x305/v2/https://flxt.tmsimg.com/assets/p10012_p_v8_aa.jpg,High Tide,250,11,1987.0,Comedy/Drama,0 days 01:44:00.000000000,9
29,31,,Galaxy of Terror,1000,13,1981.0,Sci fi,0 days 01:20:00.000000000,2
71,47,/assets/pizza-pie/images/poster_default.c8c896e70c3.gif,The Living Wake,500,17,2007.0,Comedy,0 days 01:31:00.000000000,-24
82,86,https://resizing.flixster.com/CCqkNLDIlJhk_E-38wAHRmasJLo=/206x305/v2/https://resizing.flixster.com/Rtk6B2pxgL0m1GR-qrExnB_UL4c=/ems.ZW1zLXByZC1hc3NldHMvbW92aWVzLzg3YWZkNTM5LTRjMGMtNDBlMC1iNjdjLTlkNWZkNjdhMWRhZi53ZWJw,Earth,100000,94,2007.0,Documentary,0 days 01:30:00.000000000,4
72,66,,Adam,10000,135,2009.0,Romance,0 days 01:37:00.000000000,-6
41,71,,The Girl in the Park,1000,14,2007.0,Drama,0 days 01:49:00.000000000,30
78,84,,Harry Potter and the Half-Blood Prince,250000,280,2009.0,Fantasy/Kids and family,0 days 02:33:00.000000000,6
91,94,https://resizing.flixster.com/As3LKxkwMaObb8H769912Wt5Hso=/206x305/v2/https://flxt.tmsimg.com/assets/p176379_p_v10_aa.jpg,Star Trek,250000,354,2009.0,Fantasy/Action,0 days 02:06:00.000000000,3
82,89,,California Dreamin' (Nesfarsit),1000,18,2007.0,Comedy/Drama,0 days 02:35:00.000000000,7
31,60,,Forbidden World,500,5,1982.0,Sci fi,0 days 01:26:00.000000000,29
97,100,,The Stranger,500,11,1991.0,Drama,0 days 02:00:00.000000000,3
52,51,https://resizing.flixster.com/az24pKqrVy4nvr9JmVzbemqJCxQ=/206x305/v2/https://flxt.tmsimg.com/assets/p175714_p_v8_ah.jpg,The Taking of Pelham 123,250000,232,2009.0,Mystery and thriller/Crime,0 days 01:46:00.000000000,-1
64,88,,The Sniper,250,8,1952.0,Mystery and thriller,0 days 01:27:00.000000000,24
82,100,https://resizing.flixster.com/KEdqBKwsmXbBp6TVMZvfUQENfas=/206x305/v2/https://flxt.tmsimg.com/assets/p178261_p_v10_aa.jpg,Empties,1000,5,2007.0,Comedy/Drama,0 days 01:40:00.000000000,18
67,59,,Skills Like This,500,29,2007.0,Comedy,0 days 01:26:00.000000000,-8
21,7,https://resizing.flixster.com/skgGFj5uFLjmuDN0dD_B5U8EEn0=/206x305/v2/https://flxt.tmsimg.com/assets/p197836_p_v10_ag.jpg,Whiteout,250000,117,2009.0,Mystery and thriller,0 days 01:41:00.000000000,-14
59,55,,Spiral,5000,11,2007.0,Drama/Mystery and thriller,0 days 01:30:00.000000000,-4
71,44,https://resizing.flixster.com/9rjfktX8kYpBnfhjmfGRgp15mOA=/206x305/v2/https://flxt.tmsimg.com/assets/p174247_p_v13_ab.jpg,Ex Drummer,1000,18,2007.0,Crime/Comedy,0 days 01:44:00.000000000,-27
69,85,,Frownland,250,20,2007.0,Comedy,0 days 01:46:00.000000000,16
80,100,/assets/pizza-pie/images/poster_default.c8c896e70c3.gif,Innocence Unprotected,100,10,1968.0,Drama,0 days 01:27:00.000000000,20
79,100,/assets/pizza-pie/images/poster_default.c8c896e70c3.gif,Man Is Not a Bird,250,6,1966.0,Drama,0 days 01:12:00.000000000,21
85,71,/assets/pizza-pie/images/poster_default.c8c896e70c3.gif,Meetings With Anna,100,7,1978.0,Drama,0 days 02:07:00.000000000,-14
77,60,,One Deadly Summer,500,5,1983.0,Drama,0 days 02:13:00.000000000,-17
52,32,,The Lovely Bones,250000,247,2009.0,Drama/Mystery and thriller,0 days 02:16:00.000000000,-20
58,37,,X-Men Origins: Wolverine,250000,263,2009.0,Sci fi/Adventure,0 days 01:48:00.000000000,-21
39,56,,Randy and the Mob,250,9,2007.0,Comedy,0 days 01:39:00.000000000,17
57,37,,Angels & Demons,250000,260,2009.0,Action/Mystery and thriller,0 days 02:18:00.000000000,-20
69,88,/assets/pizza-pie/images/poster_default.c8c896e70c3.gif,Silent Light,5000,25,2007.0,Drama,0 days 02:07:00.000000000,19
57,20,,Transformers: Revenge of the Fallen,250000,252,2009.0,Action/Sci fi,0 days 02:29:00.000000000,-37
88,88,https://resizing.flixster.com/NT6HECyN2URK0wdPcTZVVpo4ukA=/206x305/v2/https://flxt.tmsimg.com/assets/p22238_p_v10_aa.jpg,The Thief,500,24,1997.0,Drama,0 days 01:37:00.000000000,0
26,40,,Cross My Heart,250,10,1987.0,Romance,0 days 01:36:00.000000000,14
60,80,,Daughters of Wisdom,50,5,2007.0,Documentary,0 days 01:08:00.000000000,20
81,96,,Fados,1000,26,2007.0,Musical,0 days 01:30:00.000000000,15
86,67,/assets/pizza-pie/images/poster_default.c8c896e70c3.gif,Evangerion shin gekijôban: Jo (Evangelion: 1.0 You Are (Not) Alone) (Neon Gensis: Evangelion 1.01 You Are (Not) Alone),5000,6,2007.0,,,-19
54,33,,Terminator Salvation,250000,282,2009.0,Action/Sci fi,0 days 01:56:00.000000000,-21
58,39,https://resizing.flixster.com/5juZopvnPj3nlNhInUzXLhcF3sE=/206x305/v2/https://flxt.tmsimg.com/assets/p174800_p_v8_aa.jpg,Local Color,500,18,2006.0,Drama,0 days 01:39:00.000000000,-19
43,53,,Triangle,1000,15,2007.0,Action,0 days 01:41:00.000000000,10
80,98,/assets/pizza-pie/images/poster_default.c8c896e70c3.gif,"You, the Living",5000,42,2007.0,Drama,0 days 01:35:00.000000000,18
80,100,/assets/pizza-pie/images/poster_default.c8c896e70c3.gif,Violence at Noon,250,10,1966.0,Drama,0 days 01:39:00.000000000,20
71,100,,Variety Lights,500,11,1950.0,Drama,0 days 01:33:00.000000000,29
50,34,,G.I. Joe: The Rise of Cobra,250000,169,2009.0,Action/Adventure,0 days 01:58:00.000000000,-16
41,48,https://resizing.flixster.com/4ctCPADL1r9k-_P6mB6Mr7IqTNQ=/206x305/v2/https://flxt.tmsimg.com/assets/p195007_p_v10_ac.jpg,Battle for Terra,50000,97,2007.0,Animation/Sci fi,0 days 01:25:00.000000000,7
72,64,https://resizing.flixster.com/HI9Nv-BVhNgUzaE42z0JqUeJiG8=/206x305/v2/https://flxt.tmsimg.com/assets/p179836_p_v10_aa.jpg,Loins of Punjab Presents,250,11,2007.0,Comedy,0 days 01:28:00.000000000,-8
56,38,,Let Them Chirp Awhile,100,8,2007.0,Comedy/Drama,0 days 01:31:00.000000000,-18
76,84,,Import/Export,1000,32,2007.0,Drama,0 days 02:15:00.000000000,8
90,40,/assets/pizza-pie/images/poster_default.c8c896e70c3.gif,Breath,100,5,2004.0,Drama,0 days 01:47:00.000000000,-50
17,17,https://resizing.flixster.com/aNza1gR7uOd3ywIiWK5ZF6F001s=/206x305/v2/https://flxt.tmsimg.com/assets/p169057_p_v8_aa.jpg,The Trouble With Romance,1000,12,2007.0,Comedy/Drama,0 days 01:28:00.000000000,0
44,83,,Model Shop,250,6,1969.0,Drama,0 days 01:30:00.000000000,39
88,90,/assets/pizza-pie/images/poster_default.c8c896e70c3.gif,Note by Note: The Making of Steinway L1037,250,21,2007.0,Documentary,0 days 01:21:00.000000000,2
57,56,,Fix,250,9,2008.0,Drama,0 days 01:33:00.000000000,-1
85,81,,Mad Detective,2500,21,2007.0,Crime/Drama,0 days 01:29:00.000000000,-4
66,72,/assets/pizza-pie/images/poster_default.c8c896e70c3.gif,America the Beautiful,500,32,2007.0,Documentary,0 days 01:45:00.000000000,6
84,86,,The Lineup,250,7,1958.0,Crime/Drama,0 days 01:26:00.000000000,2
93,100,/assets/pizza-pie/images/poster_default.c8c896e70c3.gif,Make Way for Tomorrow,500,19,1937.0,Drama,0 days 01:34:00.000000000,7
26,69,/assets/pizza-pie/images/poster_default.c8c896e70c3.gif,Loren Cass,100,13,2006.0,Drama,0 days 01:23:00.000000000,43
96,91,https://resizing.flixster.com/pIOt3tHph_uuqvVwhi81LXSirLc=/206x305/v2/https://flxt.tmsimg.com/assets/p175247_p_v10_aa.jpg,Like Stars on Earth,10000,11,2007.0,Drama,0 days 02:45:00.000000000,-5
38,33,,Citizen Duane,100,6,2006.0,Comedy/Drama,0 days 01:30:00.000000000,-5
21,0,https://resizing.flixster.com/Y1Ix41zdLa5999S7pBr3AmJSIOw=/206x305/v2/https://flxt.tmsimg.com/assets/p7915414_p_v8_aa.jpg,Transylmania,1000,22,2009.0,Comedy,0 days 01:35:00.000000000,-21
47,72,,I Sell the Dead,5000,46,2008.0,Comedy/Horror,0 days 01:25:00.000000000,25
79,88,,The Ister,100,8,2004.0,Documentary,0 days 03:09:00.000000000,9
64,67,,Trapeze,250,6,1956.0,Drama,0 days 01:45:00.000000000,3
61,85,,Nightwatching,1000,27,2007.0,Drama/Mystery and thriller,0 days 02:14:00.000000000,24
86,63,,Bliss,2500,24,2007.0,Drama,0 days 02:06:00.000000000,-23
85,43,,Paraiso Travel,2500,7,2007.0,Drama/Romance,0 days 01:50:00.000000000,-42
59,38,,The Time Traveler's Wife,250000,159,2009.0,Romance/Sci fi,0 days 01:47:00.000000000,-21
43,64,/assets/pizza-pie/images/poster_default.c8c896e70c3.gif,The Disappeared,500,14,2008.0,Horror,0 days 01:37:00.000000000,21
61,41,https://resizing.flixster.com/2BDv_lFOhdjb2cUY2aDG2DSA_6A=/206x305/v2/https://flxt.tmsimg.com/assets/p174838_p_v10_aa.jpg,Wild Child,10000,27,2008.0,Comedy,0 days 01:38:00.000000000,-20
30,47,https://resizing.flixster.com/GpBTExD8rY19oTRs-24SqiV7XnA=/206x305/v2/https://flxt.tmsimg.com/assets/p176367_p_v10_ab.jpg,Management,50000,97,2008.0,Romance,0 days 01:33:00.000000000,17
46,50,https://resizing.flixster.com/vvNLFhSsSvlva7mUhjKEkHeMycw=/206x305/v2/https://flxt.tmsimg.com/assets/p174291_p_v10_ag.jpg,Assassination of a High School President,50000,10,2008.0,Comedy/Drama,0 days 01:39:00.000000000,4
36,100,,Experiment Perilous,100,6,1944.0,Mystery and thriller,0 days 01:31:00.000000000,64
36,6,,The Accidental Husband,100000,17,2008.0,Romance,0 days 01:30:00.000000000,-30
30,6,https://resizing.flixster.com/5HX8RrsqDMOlasQYvmsAXRgELpM=/206x305/v2/https://flxt.tmsimg.com/assets/p181633_p_v10_ah.jpg,All About Steve,250000,140,2009.0,Romance/Comedy,0 days 01:39:00.000000000,-24
77,68,,Shutter Island,250000,259,2010.0,Drama/Mystery and thriller,0 days 02:18:00.000000000,-9
39,30,https://resizing.flixster.com/dXTY6-p7HZN9JrTGwYPKFql-9Xg=/206x305/v2/https://flxt.tmsimg.com/assets/p181759_p_v13_as.jpg,Gamer,250000,81,2009.0,Mystery and thriller/Sci fi,0 days 01:35:00.000000000,-9
83,91,,Ponyo,50000,172,2008.0,Fantasy/Adventure,0 days 01:40:00.000000000,8
62,78,,Shall We Kiss?,1000,74,2007.0,Comedy/Romance,0 days 01:42:00.000000000,16
47,44,https://resizing.flixster.com/HHf8eiSy2rMNk5CgkDdedmXGrXg=/206x305/v2/https://flxt.tmsimg.com/assets/p176652_p_v8_ai.jpg,Night at the Museum: Battle of the Smithsonian,250000,169,2009.0,Fantasy/Comedy,0 days 01:45:00.000000000,-3
62,46,,Ice Age: Dawn of the Dinosaurs,250000,165,2009.0,Animation/Comedy,0 days 01:34:00.000000000,-16
50,50,https://resizing.flixster.com/8axb6vlcbt7stIEPg3qcepMjXio=/206x305/v2/https://flxt.tmsimg.com/assets/p189544_p_v10_aa.jpg,Astro Boy,100000,139,2009.0,Sci fi/Action,0 days 01:34:00.000000000,0
47,94,https://resizing.flixster.com/VbWCRyjedwuNNUDbph6yr6bhIhc=/206x305/v2/https://flxt.tmsimg.com/assets/p178298_p_v8_aa.jpg,La France,250,16,2007.0,Drama,0 days 01:42:00.000000000,47
52,70,https://resizing.flixster.com/QeCsm3LcnVWJNVlfljEkpgZ6Nd4=/206x305/v2/https://flxt.tmsimg.com/assets/p196296_p_v10_aa.jpg,Fermat's Room,1000,27,2007.0,Mystery and thriller,0 days 01:30:00.000000000,18
40,41,,Imagine That,250000,120,2009.0,Fantasy/Comedy,0 days 01:47:00.000000000,1
85,100,https://resizing.flixster.com/SacXIeL3g6NUW8ecZehtzruNhko=/206x305/v2/https://flxt.tmsimg.com/assets/p7852_p_v8_aa.jpg,Scandal Sheet,100,5,1952.0,Crime/Drama,0 days 01:22:00.000000000,15
59,68,,Public Enemies,250000,281,2009.0,Crime/Action,0 days 02:20:00.000000000,9
64,20,https://resizing.flixster.com/nnSIMcFYAvyjxPb2HiRTkxrZuV4=/206x305/v2/https://flxt.tmsimg.com/assets/p192783_p_v13_ab.jpg,Dog Eat Dog,1000,5,2008.0,Mystery and thriller,0 days 01:42:00.000000000,-44
43,19,,Downloading Nancy,5000,32,2008.0,Drama,0 days 01:42:00.000000000,-24
51,50,,Good Dick,5000,42,2008.0,Romance,0 days 01:26:00.000000000,-1
59,58,https://resizing.flixster.com/ZW3B5tIXNoxtQ6zRoNfrjCXiKCQ=/206x305/v2/https://flxt.tmsimg.com/assets/p7876870_p_v8_ah.jpg,She's Out of My League,100000,133,2010.0,Romance,0 days 01:46:00.000000000,-1
73,83,,Under the Bombs,500,6,2007.0,Drama/Romance,0 days 01:38:00.000000000,10
82,100,https://resizing.flixster.com/ytiIMpByqOwtJVWGi8a6H1xR1ns=/206x305/v2/https://flxt.tmsimg.com/assets/p37649_p_v8_aa.jpg,Murder by Contract,100,12,1958.0,Crime/Drama,0 days 01:21:00.000000000,18
76,93,https://resizing.flixster.com/z9wnZz_EjHehLSRLdewJV55djQ4=/206x305/v2/https://flxt.tmsimg.com/assets/p186861_p_v10_aa.jpg,The Secret of the Grain,5000,54,2007.0,Drama,0 days 02:31:00.000000000,17
51,100,,American Son,500,13,2008.0,Drama,0 days 01:25:00.000000000,49
91,98,https://resizing.flixster.com/7Eu-p1VhWYmtYoHnfdYoWyI2PWo=/206x305/v2/https://flxt.tmsimg.com/assets/p180662_p_v8_aa.jpg,Anvil! The Story of Anvil,5000,140,2008.0,Documentary,0 days 01:25:00.000000000,7
53,86,,The Art Star and the Sudanese Twins,100,7,2007.0,Drama,0 days 01:49:00.000000000,33
72,93,,Ballast,2500,80,2008.0,Drama,0 days 01:36:00.000000000,21
72,94,,The Betrayal,250,31,2008.0,Documentary,0 days 01:36:00.000000000,22
34,33,,Blind Date,500,21,2008.0,Drama,0 days 01:20:00.000000000,-1
79,80,https://resizing.flixster.com/-vet1A3BlImqik8Du8yY8O1iqMM=/206x305/v2/https://flxt.tmsimg.com/assets/p182298_p_v10_aa.jpg,Captain Abu Raed,500,35,2007.0,Drama,0 days 01:50:00.000000000,1
33,45,https://resizing.flixster.com/BPuCa5p_oDHkZctSuEfgvgidXoU=/206x305/v2/https://flxt.tmsimg.com/assets/p188476_p_v10_aa.jpg,Death in Love,10000,20,2008.0,Drama,0 days 01:37:00.000000000,12
82,72,,Fuel,5000,18,2008.0,Documentary,0 days 01:51:00.000000000,-10
49,65,,The Merry Gentleman,2500,78,2009.0,Drama,0 days 01:36:00.000000000,16
51,33,,Máncora,250,6,2008.0,Drama,0 days 01:40:00.000000000,-18
16,20,,Pretty Bird,250,5,2008.0,Comedy/Drama,0 days 01:37:00.000000000,4
56,94,https://resizing.flixster.com/he1_5oc-Fhg6unjztvx-V8zfmEs=/206x305/v2/https://flxt.tmsimg.com/assets/p188030_p_v10_aa.jpg,Secrecy,250,17,2008.0,Documentary,0 days 01:25:00.000000000,38
50,70,https://resizing.flixster.com/Q8V9WOmcV9TRTKn4EOK3QHBiAVY=/206x305/v2/https://flxt.tmsimg.com/assets/p179434_p_v10_ac.jpg,Sleep Dealer,100000,33,2008.0,Sci fi,0 days 01:29:00.000000000,20
63,74,https://resizing.flixster.com/yYwkBpSninXDblKYNm8sRG1r4oE=/206x305/v2/https://flxt.tmsimg.com/assets/p183429_p_v10_ae.jpg,Sunshine Cleaning,100000,179,2008.0,Comedy/Drama,0 days 01:42:00.000000000,11
86,96,https://resizing.flixster.com/DCw7PC7LVRoVGsDatifW17wd6gY=/206x305/v2/https://flxt.tmsimg.com/assets/p179723_p_v8_aa.jpg,Trouble the Water,1000,76,2008.0,Documentary,0 days 01:33:00.000000000,10
59,66,,The Yellow Handkerchief,10000,50,2008.0,Romance/Drama,0 days 01:36:00.000000000,7
74,85,https://resizing.flixster.com/BTRc2XcOGbIDdezoZGmunuqBzPg=/206x305/v2/https://flxt.tmsimg.com/assets/p3553501_p_v13_aq.jpg,The Princess and the Frog,250000,201,2009.0,Comedy/Kids and family,0 days 01:35:00.000000000,11
61,85,https://resizing.flixster.com/jJQAe_KjpcNPQo2p1k0oCyS2uiY=/206x305/v2/https://flxt.tmsimg.com/assets/p7849214_p_v10_ae.jpg,Me and Orson Welles,10000,157,2008.0,Drama,0 days 01:47:00.000000000,24
33,50,,Uncertainty,1000,26,2008.0,Drama,0 days 01:44:00.000000000,17
67,60,,Jackie Chan in Shinjuku Incident,10000,5,2009.0,Crime/Drama,0 days 02:00:00.000000000,-7
26,43,/assets/pizza-pie/images/poster_default.c8c896e70c3.gif,Crooked Lake,100,7,2008.0,Mystery and thriller/Drama,0 days 01:27:00.000000000,17
47,25,,Four Christmases,250000,145,2008.0,Romance/Other,0 days 01:28:00.000000000,-22
50,43,https://resizing.flixster.com/AIDTUjtcor3mdDlLx9ZQxBvU77E=/206x305/v2/https://flxt.tmsimg.com/assets/p175416_p_v13_aa.jpg,The Reflecting Pool,100,7,2007.0,Drama,,-7
69,75,,Dillinger Is Dead,250,12,1969.0,Crime/Drama,0 days 01:30:00.000000000,6
83,83,,Yesterday Was a Lie,250,6,2008.0,Mystery and thriller/Drama,0 days 01:29:00.000000000,0
40,28,https://resizing.flixster.com/X3WktCEA3Odrus5MKmMtsRQWIbo=/206x305/v2/https://flxt.tmsimg.com/assets/p174301_p_v10_aa.jpg,Ghosts of Girlfriends Past,250000,144,2009.0,Romance,0 days 01:40:00.000000000,-12
32,26,https://resizing.flixster.com/qZt3Pnsnv68aObNzFn0Mp0S9ZN8=/206x305/v2/https://flxt.tmsimg.com/assets/p174558_p_v10_ac.jpg,Land of the Lost,250000,191,2009.0,Comedy/Adventure,0 days 01:42:00.000000000,-6
60,64,,The Imaginarium of Doctor Parnassus,250000,197,2009.0,Mystery and thriller/Fantasy,0 days 02:02:00.000000000,4
46,60,https://resizing.flixster.com/P-m2aG9ZUUsAX8jCBaPAUzdH9Kg=/206x305/v2/https://flxt.tmsimg.com/assets/p9266_p_v8_aa.jpg,Streamers,250,10,1983.0,Drama,0 days 01:58:00.000000000,14
71,67,https://resizing.flixster.com/cZO558YtD1frAmFllzu0gsegoSE=/206x305/v2/https://flxt.tmsimg.com/assets/p182927_p_v10_ab.jpg,Where God Left His Shoes,250,12,2007.0,Other/Drama,0 days 01:50:00.000000000,-4
69,27,https://resizing.flixster.com/8Sa-B8sEy51GnApuoW01JBbSV_c=/206x305/v2/https://flxt.tmsimg.com/assets/p178213_p_v10_aa.jpg,The World Unseen,1000,26,2007.0,Romance/Gay and lesbian,0 days 01:44:00.000000000,-42
67,80,,Dolphins and Whales: Tribes of the Ocean,250,5,2008.0,Adventure/Documentary,0 days 00:42:00.000000000,13
41,86,https://resizing.flixster.com/a5Nhv1zQP4n6W3GPzEBfwf1y6y4=/206x305/v2/https://flxt.tmsimg.com/assets/p2284_p_v10_ab.jpg,Crack in the World,100,7,1965.0,Sci fi,0 days 01:36:00.000000000,45
55,51,https://resizing.flixster.com/WkWJqh496xlgo08Euo478UFDBGg=/206x305/v2/https://flxt.tmsimg.com/assets/p3546062_p_v8_am.jpg,Alice in Wonderland,250000,278,2010.0,Fantasy/Kids and family,0 days 01:49:00.000000000,-4
37,65,https://resizing.flixster.com/hrTXoaBdOlwoC7NMTrds241-hSU=/206x305/v2/https://flxt.tmsimg.com/assets/p180166_p_v10_ae.jpg,Duplicity,250000,192,2009.0,Mystery and thriller/Crime,0 days 02:05:00.000000000,28
75,88,,Burning the Future: Coal in America,100,8,2008.0,Documentary,0 days 01:29:00.000000000,13
98,89,,The English Surgeon,2500,19,2007.0,Documentary,0 days 01:34:00.000000000,-9
62,93,,Munyurangabo,500,27,2007.0,Drama,0 days 01:37:00.000000000,31
81,79,/assets/pizza-pie/images/poster_default.c8c896e70c3.gif,Owl and the Sparrow,500,19,2007.0,Drama,0 days 01:37:00.000000000,-2
27,8,https://resizing.flixster.com/U3fTkaP8JXkkLRyCc8VgxqotBzg=/206x305/v2/https://flxt.tmsimg.com/assets/p194937_p_v8_ab.jpg,Post Grad,100000,100,2009.0,Comedy,0 days 01:29:00.000000000,-19
55,93,,Major Barbara,100,15,1941.0,Comedy,0 days 02:15:00.000000000,38
61,89,https://resizing.flixster.com/2H6TCrZ9V7X9ELsUQH_LwEFJSRM=/206x305/v2/https://flxt.tmsimg.com/assets/p191158_p_v10_as.jpg,Adventureland,250000,219,2009.0,Romance/Comedy,0 days 01:46:00.000000000,28
55,40,,"Bert Rigby, You're a Fool",50,5,1989.0,Comedy/Musical,0 days 01:34:00.000000000,-15
66,78,https://resizing.flixster.com/2oj1PDtia-4wnF9Z81n1P_k1v-A=/206x305/v2/https://flxt.tmsimg.com/assets/p190733_p_v10_ac.jpg,Quiet Chaos,2500,37,2008.0,Drama/Romance,0 days 01:45:00.000000000,12
71,73,https://resizing.flixster.com/uxoW2DFHQyhY9xC0hFZrU2IbKwE=/206x305/v2/https://flxt.tmsimg.com/assets/p183403_p_v10_az.jpg,"Angus, Thongs and Perfect Snogging",10000,26,2008.0,Comedy,0 days 01:39:00.000000000,2
56,100,,Who Is KK Downey?,100,5,2008.0,Comedy,0 days 01:30:00.000000000,44
50,100,/assets/pizza-pie/images/poster_default.c8c896e70c3.gif,The New Year Parade,100,5,2008.0,Drama,0 days 01:25:00.000000000,50
38,44,,The Toe Tactic,100,9,2008.0,Drama,0 days 01:23:00.000000000,6
85,93,https://resizing.flixster.com/eQUcdZ8cyuyDk1slmbKMy_Dnyz8=/206x305/v2/https://flxt.tmsimg.com/NowShowing/79315/79315_aa.jpg,Fantastic Mr. Fox,100000,243,2009.0,Animation/Comedy,0 days 01:28:00.000000000,8
35,28,,The Final Destination,250000,100,2009.0,Mystery and thriller/Horror,0 days 01:22:00.000000000,-7
84,85,,The Black Balloon,2500,41,2008.0,Drama,0 days 01:37:00.000000000,1
24,44,https://resizing.flixster.com/H2RS6LO68RKX-klKQL6sCvwOuw4=/206x305/v2/https://flxt.tmsimg.com/assets/p182352_p_v8_af.jpg,The Box,250000,156,2009.0,Mystery and thriller/Sci fi,0 days 01:53:00.000000000,20
64,82,,Bandslam,100000,105,2009.0,Comedy/Romance,0 days 01:51:00.000000000,18
44,19,https://resizing.flixster.com/0FyP9SYHuV1QxufR1z08nt3Xbbo=/206x305/v2/https://flxt.tmsimg.com/assets/p3633840_p_v8_aa.jpg,Gentlemen Broncos,10000,79,2009.0,Comedy,0 days 01:29:00.000000000,-25
75,80,https://resizing.flixster.com/ENtqppF46U_P0nUHVAjgfa5gqjQ=/206x305/v2/https://flxt.tmsimg.com/assets/p3574307_p_v10_aa.jpg,Thirst,10000,116,2009.0,Mystery and thriller/Horror,0 days 02:13:00.000000000,5
66,66,,Paris,10000,71,2008.0,Romance/Comedy,0 days 02:08:00.000000000,0
35,14,/assets/pizza-pie/images/poster_default.c8c896e70c3.gif,This Beautiful City,250,7,2007.0,Drama,0 days 01:25:00.000000000,-21
48,59,,Eleven Minutes,10000,27,2008.0,Documentary/Gay and lesbian,0 days 01:43:00.000000000,11
43,33,,Aliens in the Attic,250000,75,2009.0,Kids and family/Comedy,0 days 01:26:00.000000000,-10
38,15,,Fireball,500,13,2009.0,Action/Sports and fitness,0 days 01:37:00.000000000,-23
39,56,,The Invention of Lying,250000,189,2009.0,Comedy,0 days 01:39:00.000000000,17
57,83,https://resizing.flixster.com/xfSZYJVFNcY9CQ2rMT6CikAsGFQ=/206x305/v2/https://flxt.tmsimg.com/NowShowing/83487/83487_aa.jpg,Paranormal Activity,250000,204,2007.0,Horror/Mystery and thriller,0 days 01:26:00.000000000,26
82,86,https://resizing.flixster.com/Wp9jm9PLVmP2gdGl0TTo36notWY=/206x305/v2/https://flxt.tmsimg.com/assets/p196681_p_v10_ab.jpg,Flame & Citron,5000,70,2008.0,Mystery and thriller/Drama,0 days 02:12:00.000000000,4
36,39,,Fighting,250000,130,2009.0,Drama/Action,0 days 01:45:00.000000000,3
54,80,/assets/pizza-pie/images/poster_default.c8c896e70c3.gif,Not Your Typical Bigfoot Movie,100,5,2008.0,Documentary,0 days 01:03:00.000000000,26
60,81,/assets/pizza-pie/images/poster_default.c8c896e70c3.gif,Sex Positive,10000,16,2008.0,Gay and lesbian/Documentary,0 days 01:15:00.000000000,21
29,50,,We Are Wizards,250,22,2008.0,Documentary,0 days 01:19:00.000000000,21
83,80,/assets/pizza-pie/images/poster_default.c8c896e70c3.gif,Throw Down Your Heart,100,25,2008.0,Documentary,0 days 01:37:00.000000000,-3
42,25,,Filth and Wisdom,1000,63,2008.0,Comedy/Drama,0 days 01:21:00.000000000,-17
63,64,https://resizing.flixster.com/LUgUNFC4ARPaoMIEhwJk7sOGjR8=/206x305/v2/https://flxt.tmsimg.com/assets/p181397_p_v8_aa.jpg,The Escapist,10000,45,2008.0,Drama,0 days 01:43:00.000000000,1
40,83,https://resizing.flixster.com/B5YmE1zask16Ctdx0mIkv-XPx9o=/206x305/v2/https://flxt.tmsimg.com/assets/p188918_p_v10_aa.jpg,Left Bank,500,6,2008.0,Mystery and thriller/Drama,0 days 01:42:00.000000000,43
83,91,https://resizing.flixster.com/Folj1MZT1AnpwjskT5jJOek31ok=/206x305/v2/https://flxt.tmsimg.com/assets/p188067_p_v10_ab.jpg,Lemon Tree,5000,68,2008.0,Drama,0 days 01:46:00.000000000,8
49,60,,Road to Fame,500,10,2008.0,Comedy,0 days 01:46:00.000000000,11
46,67,,Google Me,100,12,2007.0,Documentary,0 days 01:37:00.000000000,21
43,20,https://resizing.flixster.com/phVu_uY59uHOXQYU2jcT_h9r2X4=/206x305/v2/https://flxt.tmsimg.com/assets/p3533348_p_v10_af.jpg,The Red Baron,10000,25,2008.0,Drama/Adventure,0 days 01:46:00.000000000,-23
53,33,https://resizing.flixster.com/fEq0lxUHFpmoA-gkJANpXMq0ln4=/206x305/v2/https://flxt.tmsimg.com/assets/p188492_p_v8_aa.jpg,Tennessee,2500,21,2008.0,Drama,0 days 01:39:00.000000000,-20
73,88,,Off and Running,100,16,2009.0,Documentary,0 days 01:16:00.000000000,15
21,55,,See You in the Morning,100,11,1989.0,Romance,0 days 01:59:00.000000000,34
98,100,https://resizing.flixster.com/LMOEMmE8C7hTxcj1vqYwH-c-9LI=/206x305/v2/https://flxt.tmsimg.com/assets/p13981_p_v8_aa.jpg,Marlene,100,7,1984.0,Documentary,0 days 01:35:00.000000000,2
39,15,https://resizing.flixster.com/L_mZg3-pMFcQnJolEKmob5KYVhs=/206x305/v2/https://flxt.tmsimg.com/assets/p11805_p_v8_aa.jpg,Cookie,100,13,1989.0,Comedy,0 days 01:33:00.000000000,-24
35,50,https://resizing.flixster.com/wJwj17ReRkLGl-2O7X1D-5yTZWA=/206x305/v2/https://flxt.tmsimg.com/assets/p6487_p_v10_aa.jpg,Donovan's Brain,100,12,1953.0,Sci fi,0 days 01:23:00.000000000,15
50,43,https://resizing.flixster.com/tcChGrDm59utdLWQ9C8bD5ilnQU=/206x305/v2/https://flxt.tmsimg.com/assets/p5217_p_v13_ab.jpg,Androcles and the Lion,50,7,1952.0,Comedy,0 days 01:38:00.000000000,-7
58,59,https://resizing.flixster.com/vA8KBZq51X9Kq9NhCXRwdCVSjNY=/206x305/v2/https://flxt.tmsimg.com/assets/p3505573_p_v8_aa.jpg,Trucker,1000,37,2008.0,Drama,0 days 01:33:00.000000000,1
49,64,,Crank: High Voltage,250000,70,2009.0,Action,0 days 01:37:00.000000000,15
78,84,,Trumbo,25000,55,2007.0,Documentary,0 days 01:36:00.000000000,6
67,100,,"I, You, She, He",250,7,1974.0,Drama,0 days 01:30:00.000000000,33
41,22,,Repo Men,100000,153,2010.0,Action/Sci fi,0 days 01:51:00.000000000,-19
83,83,,Collapse,2500,42,2009.0,Documentary,0 days 01:20:00.000000000,0
48,69,,Funny People,250000,238,2009.0,Comedy/Drama,0 days 02:26:00.000000000,21
20,11,https://resizing.flixster.com/73P7kgsmY8sV1z880rhCpCFxIZw=/206x305/v2/https://flxt.tmsimg.com/assets/p8110516_p_v8_aa.jpg,The Cry of the Owl,5000,9,2009.0,Drama/Mystery and thriller,0 days 01:40:00.000000000,-9
78,78,/assets/pizza-pie/images/poster_default.c8c896e70c3.gif,Road to Victory,50,9,2007.0,Drama,0 days 01:39:00.000000000,0
80,92,https://resizing.flixster.com/7FuGo_hj6Am3rk1GR95cyWb_T44=/206x305/v2/https://flxt.tmsimg.com/assets/p192238_p_v10_ac.jpg,Il Divo,2500,51,2008.0,Drama/History,0 days 01:50:00.000000000,12
30,89,,The Rashevski Tango,50,9,2003.0,Romance,0 days 01:30:00.000000000,59
38,17,/assets/pizza-pie/images/poster_default.c8c896e70c3.gif,Six Sex Scenes & a Murder,250,6,2008.0,Mystery and thriller,0 days 01:15:00.000000000,-21
80,92,,Sugar,10000,138,2008.0,Drama,0 days 01:58:00.000000000,12
56,20,,Duska (Dushka),100,5,2007.0,,,-36
30,80,,Clive Barker's Book of Blood,1000,5,2008.0,Mystery and thriller/Drama,0 days 01:40:00.000000000,50
74,66,,Away We Go,50000,191,2009.0,Comedy/Drama,0 days 01:37:00.000000000,-8
44,10,,My Life in Ruins,250000,126,2009.0,Romance,0 days 01:36:00.000000000,-34
42,38,,Cirque du Freak: The Vampire's Assistant,250000,141,2009.0,Action/Adventure,0 days 01:49:00.000000000,-4
34,55,https://resizing.flixster.com/4vucNXtVvgATcKDKGVXR43cNi_c=/206x305/v2/https://flxt.tmsimg.com/assets/p7943548_p_v10_aa.jpg,The Descent: Part 2,10000,38,2009.0,Horror/Mystery and thriller,0 days 01:34:00.000000000,21
33,34,https://resizing.flixster.com/utaOVWkQjHo_aGD1H0jG0wx-mQk=/206x305/v2/https://flxt.tmsimg.com/assets/p188355_p_v13_az.jpg,The Wolfman,100000,221,2010.0,Mystery and thriller/Action,0 days 01:42:00.000000000,1
66,86,https://resizing.flixster.com/YyGNwXszqS2xtOC-5pDLvIRm7C0=/206x305/v2/https://flxt.tmsimg.com/assets/p186860_p_v10_ad.jpg,A Christmas Tale,10000,132,2008.0,Other/Drama,0 days 02:30:00.000000000,20
72,100,/assets/pizza-pie/images/poster_default.c8c896e70c3.gif,Take Out,250,23,2004.0,Drama,0 days 01:30:00.000000000,28
56,57,https://resizing.flixster.com/i-4xVjLGS6lRY17oJn4r6fvcP9M=/206x305/v2/https://flxt.tmsimg.com/assets/p182095_p_v10_ac.jpg,9,250000,187,2009.0,Fantasy/War,0 days 01:19:00.000000000,1
68,82,,Bright Star,10000,177,2009.0,Romance/Drama,0 days 01:59:00.000000000,14
72,77,,Three Monkeys,2500,62,2008.0,Drama,0 days 01:49:00.000000000,5
51,80,,Serbis,500,30,2008.0,Drama,0 days 01:31:00.000000000,29
70,91,,Gomorra,25000,157,2008.0,Crime/Drama,0 days 02:17:00.000000000,21
37,37,https://resizing.flixster.com/3w-FFl_eHkNJxLA_PAViE7eqrgw=/206x305/v2/https://flxt.tmsimg.com/assets/p3532291_p_v10_aa.jpg,"New York, I Love You",100000,99,2009.0,Romance/Drama,0 days 01:43:00.000000000,0
73,84,,State of Play,100000,217,2009.0,Crime/Drama,0 days 02:07:00.000000000,11
75,82,https://resizing.flixster.com/kMryP4taxqUTh9hVzMFCVMVQdxU=/206x305/v2/https://flxt.tmsimg.com/assets/p3549933_p_v10_av.jpg,Broken Embraces,10000,157,2009.0,Mystery and thriller/Drama,0 days 02:08:00.000000000,7
56,76,https://resizing.flixster.com/keb2osG7gIu8elQMU4OBfI19DhE=/206x305/v2/https://flxt.tmsimg.com/NowShowing/72473/72473_aa.jpg,The Headless Woman,1000,54,2008.0,Drama/Mystery and thriller,0 days 01:29:00.000000000,20
69,96,https://resizing.flixster.com/dj2eWltdaICZy3tCC6ciBLvTZbA=/206x305/v2/https://flxt.tmsimg.com/assets/p189686_p_v8_aa.jpg,Tulpan,2500,71,2008.0,Comedy/Drama,0 days 01:40:00.000000000,27
58,89,https://resizing.flixster.com/OgwLKAyb6janhTciVmfIWfsLj0I=/206x305/v2/https://flxt.tmsimg.com/assets/p193261_p_v8_aa.jpg,Cloud 9,250,44,2008.0,Drama/Romance,0 days 01:38:00.000000000,31
100,56,/assets/pizza-pie/images/poster_default.c8c896e70c3.gif,As Seen Through These Eyes,50,9,2008.0,Documentary,0 days 01:10:00.000000000,-44
71,89,https://resizing.flixster.com/NZ-SO4xi3qcnz6T2AgCZZRHVTz8=/206x305/v2/https://flxt.tmsimg.com/assets/p189245_p_v10_aa.jpg,24 City,1000,44,2008.0,Documentary/Drama,0 days 01:52:00.000000000,18
80,94,https://resizing.flixster.com/JK6iiKqOfMU97B24LqKWdMcuLWU=/206x305/v2/https://flxt.tmsimg.com/assets/p189688_p_v8_aa.jpg,Tokyo Sonata,10000,89,2008.0,Drama,0 days 01:59:00.000000000,14
86,100,https://resizing.flixster.com/O_grVdLs3Mdi9Gs5eEPhaJ1Dtx0=/206x305/v2/https://flxt.tmsimg.com/assets/p182512_p_v8_aa.jpg,Pray the Devil Back to Hell,1000,36,2008.0,Documentary,0 days 01:12:00.000000000,14
75,96,https://resizing.flixster.com/uD2m0WXt2XKO8MgPuPLSDuS9zW0=/206x305/v2/https://flxt.tmsimg.com/assets/p183650_p_v13_aa.jpg,Somers Town,10000,55,2008.0,Comedy/Drama,0 days 01:15:00.000000000,21
41,67,https://resizing.flixster.com/cTexbB6FmkJxnDZZkg_8fwqEwhA=/206x305/v2/https://flxt.tmsimg.com/assets/p182954_p_v10_aq.jpg,Brüno,250000,230,2009.0,Comedy/Gay and lesbian,0 days 01:22:00.000000000,26
48,44,,The Amazing Truth About Queen Raquela,100,9,2008.0,Drama,0 days 01:20:00.000000000,-4
75,90,,The Messenger,10000,163,2009.0,Romance/Drama,0 days 01:52:00.000000000,15
42,54,https://resizing.flixster.com/Q9TPiKvoc2IBls-dJxn7JX-o7ws=/206x305/v2/https://flxt.tmsimg.com/assets/p179379_p_v8_aa.jpg,Nothing Like the Holidays,25000,99,2008.0,Other/Drama,0 days 01:38:00.000000000,12
80,95,,Visual Acoustics: The Modernism of Julius Shulman,250,19,2008.0,Documentary,0 days 01:23:00.000000000,15
54,26,https://resizing.flixster.com/4UgJtBqK3yLPMVzh-W4TTt6Rw5M=/206x305/v2/https://flxt.tmsimg.com/assets/p182349_p_v10_ad.jpg,Ninja Assassin,100000,117,2009.0,Action/Sports and fitness,0 days 01:39:00.000000000,-28
39,50,,Chéri,10000,140,2009.0,Romance/Drama,0 days 01:32:00.000000000,11
36,27,https://resizing.flixster.com/JKm7SDL4c-6k_b-44bbKkIJSaqY=/206x305/v2/https://flxt.tmsimg.com/assets/p189728_p_v10_aa.jpg,The Pleasure of Being Robbed,250,11,2008.0,Comedy/Drama,0 days 01:11:00.000000000,-9
83,100,,They Killed Sister Dorothy,100,8,2008.0,Documentary,0 days 01:34:00.000000000,17
84,77,,Full Battle Rattle,100,31,2008.0,Documentary,0 days 01:32:00.000000000,-7
59,73,,Monsters vs. Aliens,250000,218,2009.0,Comedy/Animation,0 days 01:34:00.000000000,14
72,90,,Lion's Den,5000,29,2008.0,Drama,0 days 01:53:00.000000000,18
70,94,,Summer Hours,10000,106,2008.0,Drama,0 days 01:42:00.000000000,24
46,44,,Brooklyn's Finest,100000,153,2009.0,Crime/Drama,0 days 02:05:00.000000000,-2
89,90,https://resizing.flixster.com/USq8WqUcnWeBT5nbyKQ6SRMYZ8I=/206x305/v2/https://flxt.tmsimg.com/NowShowing/76581/76581_aa.jpg,Moon,100000,194,2009.0,Mystery and thriller/Sci fi,0 days 01:37:00.000000000,1
40,23,,Planet 51,250000,110,2009.0,Comedy/Animation,0 days 01:31:00.000000000,-17
68,74,,The Road,100000,217,2009.0,Mystery and thriller/Drama,0 days 01:50:00.000000000,6
52,66,,Youth in Revolt,100000,172,2009.0,Romance,0 days 01:30:00.000000000,14
53,49,,Ong Bak 2: The Beginning,10000,70,2008.0,Action/Sports and fitness,0 days 01:37:00.000000000,-4
70,70,,The Vicious Kind,1000,10,2009.0,Comedy/Drama,0 days 01:32:00.000000000,0
83,90,https://resizing.flixster.com/sbkKM7WAKyjg1CXacTkz7OsWyJQ=/206x305/v2/https://flxt.tmsimg.com/assets/p189244_p_v10_aa.jpg,Hunger,50000,131,2008.0,Drama/History,0 days 01:32:00.000000000,7
42,60,,Second Skin,250,5,2008.0,Documentary,0 days 01:34:00.000000000,18
49,24,https://resizing.flixster.com/Gnzv5O4Favcsm_bBAib5LO8YHgg=/206x305/v2/https://flxt.tmsimg.com/assets/p182294_p_v8_aa.jpg,Little Ashes,50000,70,2008.0,Gay and lesbian/Drama,0 days 01:37:00.000000000,-25
37,39,,Nine,100000,207,2009.0,Romance/Musical,0 days 01:58:00.000000000,2
80,95,https://resizing.flixster.com/89DOAODQE2nc3oLq5of10xY-Ekw=/206x305/v2/https://flxt.tmsimg.com/assets/p188938_p_v8_aa.jpg,"Not Quite Hollywood: The Wild, Untold Story of Ozploitation!",1000,66,2008.0,Documentary,0 days 01:43:00.000000000,15
73,88,,Terribly Happy,1000,48,2008.0,Drama/Mystery and thriller,0 days 01:40:00.000000000,15
29,29,https://resizing.flixster.com/QGpanGkWX63h3xTNMffQIrl8zs8=/206x305/v2/https://flxt.tmsimg.com/assets/p7884775_p_v8_ad.jpg,Bitch Slap,10000,17,2009.0,Action,0 days 01:44:00.000000000,0
80,85,https://resizing.flixster.com/AjL1RVd2pRiVGPmkbmpADKjTBfc=/206x305/v2/https://flxt.tmsimg.com/assets/p189479_p_v10_ad.jpg,The Baader Meinhof Complex,10000,101,2008.0,Crime/Drama,0 days 02:30:00.000000000,5
35,45,,Jennifer's Body,250000,207,2009.0,Comedy/Horror,0 days 01:41:00.000000000,10
71,59,,Pirate Radio,250000,167,2009.0,Comedy/Drama,0 days 02:09:00.000000000,-12
67,71,https://resizing.flixster.com/sBY_q9A5FkwwlSIxGJTRPnE1Ssc=/206x305/v2/https://flxt.tmsimg.com/assets/p7887556_p_v10_at.jpg,The Last Station,10000,149,2009.0,Drama/History,0 days 01:50:00.000000000,4
57,86,,Bad Lieutenant: Port of Call New Orleans,50000,153,2009.0,Crime/Drama,0 days 02:01:00.000000000,29
63,84,,Lake Tahoe,500,19,2008.0,Drama,0 days 01:25:00.000000000,21
56,60,https://resizing.flixster.com/UN3nlA4pP0941JQ_wizg8_d3LXk=/206x305/v2/https://flxt.tmsimg.com/assets/p3588894_p_v10_aa.jpg,Greta,2500,5,2009.0,Drama,0 days 01:32:00.000000000,4
57,53,https://resizing.flixster.com/xiCKZ32ikENCznPwS86S-5i9L8g=/206x305/v2/https://flxt.tmsimg.com/assets/p194534_p_v10_ac.jpg,Green Zone,100000,190,2010.0,Mystery and thriller/Action,0 days 01:55:00.000000000,-4
44,79,,The Informant!,250000,233,2009.0,Comedy/Drama,0 days 01:48:00.000000000,35
67,33,/assets/pizza-pie/images/poster_default.c8c896e70c3.gif,Twentieth Century Boys,1000,12,2008.0,Mystery and thriller/Sci fi,0 days 02:22:00.000000000,-34
40,29,,Deadgirl,2500,17,2008.0,Horror,0 days 01:41:00.000000000,-11
49,69,,Daybreakers,100000,154,2009.0,Sci fi/Horror,0 days 01:38:00.000000000,20
74,76,,Bronson,10000,82,2008.0,Drama/Biography,0 days 01:32:00.000000000,2
82,94,https://resizing.flixster.com/6AaSXOxkIIPGotozZ1v0DwgPxrs=/206x305/v2/https://flxt.tmsimg.com/assets/p196286_p_v10_ad.jpg,In the Loop,100000,179,2009.0,Comedy,0 days 01:46:00.000000000,12
43,42,https://resizing.flixster.com/WGHtZQqf1lHQoP-_QncVT8AoMuY=/206x305/v2/https://flxt.tmsimg.com/NowShowing/75919/75919_aa.jpg,The Limits of Control,25000,130,2009.0,Drama,0 days 01:56:00.000000000,-1
47,25,,The Narrows,250,12,2008.0,Drama,0 days 01:46:00.000000000,-22
57,40,https://resizing.flixster.com/dAcRrmB0b2WMaTg4aqbrOYp05PA=/206x305/v2/https://flxt.tmsimg.com/assets/p190135_p_v10_ad.jpg,Passchendaele,2500,15,2008.0,History/War,,-17
83,96,,Revanche,2500,83,2008.0,Crime/Drama,0 days 02:01:00.000000000,13
43,57,,Franklyn,5000,30,2008.0,Fantasy/Romance,0 days 01:38:00.000000000,14
31,38,/assets/pizza-pie/images/poster_default.c8c896e70c3.gif,The Art of Being Straight,250,8,2008.0,Comedy/Drama,0 days 01:11:00.000000000,7
39,39,,Tru Loved,250,18,2008.0,Comedy/Drama,0 days 01:39:00.000000000,0
31,19,,Legion,250000,105,2010.0,Mystery and thriller/Fantasy,0 days 01:44:00.000000000,-12
62,92,https://resizing.flixster.com/Ym24BApJYccrd1r4n0h-30G88KU=/206x305/v2/https://flxt.tmsimg.com/NowShowing/70064/70064_ab.jpg,Drag Me to Hell,250000,269,2009.0,Horror/Mystery and thriller,0 days 01:39:00.000000000,30
18,12,,The Informers,10000,106,2009.0,Crime/Drama,0 days 01:38:00.000000000,-6
32,33,,The Objective,2500,12,2008.0,Mystery and thriller/Sci fi,0 days 01:30:00.000000000,1
44,5,https://resizing.flixster.com/nNYKWa55QS7CF8FmpOSmuPIpc8A=/206x305/v2/https://flxt.tmsimg.com/assets/p194030_p_v10_aa.jpg,Old Dogs,100000,110,2009.0,Kids and family/Comedy,0 days 01:28:00.000000000,-39
54,50,,Life Is Hot in Cracktown,1000,6,2009.0,Drama,0 days 01:39:00.000000000,-4
72,81,/assets/pizza-pie/images/poster_default.c8c896e70c3.gif,The Country Teacher,1000,27,2008.0,Comedy/Drama,0 days 01:55:00.000000000,9
67,44,,The Proposal,250000,189,2009.0,Romance,0 days 01:48:00.000000000,-23
72,48,https://resizing.flixster.com/tOGZ5Lzi_7UdLgnReCDkoICoYTM=/206x305/v2/https://flxt.tmsimg.com/assets/p192287_p_v10_aa.jpg,My Sister's Keeper,250000,138,2009.0,Drama,0 days 01:48:00.000000000,-24
49,44,https://resizing.flixster.com/XlB675KWoCE21gXKjlb63nA9Tks=/206x305/v2/https://flxt.tmsimg.com/assets/p7964480_p_v10_aa.jpg,Helen,500,9,2009.0,Drama,0 days 02:00:00.000000000,-5
74,84,,Whip It,100000,189,2009.0,Comedy/Drama,0 days 01:51:00.000000000,10
47,35,,The Slammin' Salmon,5000,26,2009.0,Comedy,0 days 01:38:00.000000000,-12
88,81,,Under Our Skin,500,32,2008.0,Documentary,0 days 01:44:00.000000000,-7
79,50,https://resizing.flixster.com/b4Yd7p7DSltKELvwYdogwH3M4YM=/206x305/v2/https://flxt.tmsimg.com/assets/p182509_p_v10_aa.jpg,War Child,100,6,2008.0,Documentary,0 days 01:34:00.000000000,-29
31,40,https://resizing.flixster.com/3jvHbBeFweZmCORYBN9-wt8Vu4M=/206x305/v2/https://flxt.tmsimg.com/assets/p180437_p_v10_aq.jpg,Armored,100000,55,2009.0,Drama/Mystery and thriller,0 days 01:28:00.000000000,9
68,89,,A Serious Man,50000,225,2009.0,Comedy/Drama,0 days 01:45:00.000000000,21
81,76,https://resizing.flixster.com/mREaRvkqLG6s5RuH069kFlL0I4A=/206x305/v2/https://flxt.tmsimg.com/assets/p7876199_p_v10_ak.jpg,Kick-Ass,250000,266,2010.0,Action/Comedy,0 days 01:57:00.000000000,-5
56,38,,The Burning Plain,5000,80,2008.0,Drama,0 days 01:46:00.000000000,-18
60,14,https://resizing.flixster.com/Hy0d1BqWAxzXoOjwaF39GCWduis=/206x305/v2/https://flxt.tmsimg.com/assets/p190676_p_v13_am.jpg,The Ugly Truth,250000,175,2009.0,Romance,0 days 01:35:00.000000000,-46
37,27,,The Goods: Live Hard. Sell Hard.,50000,103,2009.0,Comedy,0 days 01:29:00.000000000,-10
84,97,,The Hurt Locker,50000,289,2008.0,Mystery and thriller/Drama,0 days 02:07:00.000000000,13
71,68,,Blessed Is the Match: The Life and Death of Hannah Senesh,250,22,2008.0,Documentary,0 days 01:26:00.000000000,-3
32,47,,Shorts,100000,103,2009.0,Comedy/Action,0 days 01:29:00.000000000,15
28,47,https://resizing.flixster.com/zcq9N1u2ZCSWYLwMYF-kZD0zE0E=/206x305/v2/https://flxt.tmsimg.com/assets/p194749_p_v10_ac.jpg,The Girl From Monaco,5000,53,2008.0,Comedy/Drama,0 days 01:34:00.000000000,19
87,98,,The Song of Sparrows,1000,42,2008.0,Drama,0 days 01:36:00.000000000,11
36,100,/assets/pizza-pie/images/poster_default.c8c896e70c3.gif,Sex Addict,1000,5,2008.0,,,64
47,48,,Taking Woodstock,250000,183,2009.0,Gay and lesbian/Drama,0 days 02:00:00.000000000,1
33,13,/assets/pizza-pie/images/poster_default.c8c896e70c3.gif,Steam,100,8,2007.0,Drama,0 days 02:00:00.000000000,-20
60,84,,Tony Manero,5000,38,2008.0,Drama,0 days 01:38:00.000000000,24
53,48,https://resizing.flixster.com/v5WrFWF_Wqoq1MT8pkW6oTzPLDE=/206x305/v2/https://flxt.tmsimg.com/assets/p3502545_p_v10_az.jpg,Everybody's Fine,50000,143,2009.0,Comedy/Drama,0 days 01:35:00.000000000,-5
80,93,/assets/pizza-pie/images/poster_default.c8c896e70c3.gif,"Moscow, Belgium",1000,40,2008.0,Comedy/Drama,0 days 01:42:00.000000000,13
55,53,https://resizing.flixster.com/U4m79MIjzH10Dk45P_KJQQSb6V4=/206x305/v2/https://flxt.tmsimg.com/NowShowing/81708/81708_aa.jpg,Antichrist,25000,177,2009.0,Horror/Drama,0 days 01:49:00.000000000,-2
44,35,https://resizing.flixster.com/Hmyra0iFdgSyG3HRqTlm5CYqxeM=/206x305/v2/https://flxt.tmsimg.com/assets/p190335_p_v10_aa.jpg,Adam Resurrected,500,37,2008.0,Drama/War,0 days 01:46:00.000000000,-9
62,64,https://resizing.flixster.com/gyxo5qbpJ1G2E-lwDnYg9fn38C4=/206x305/v2/https://flxt.tmsimg.com/NowShowing/69454/69454_aa.jpg,Brothers,100000,159,2009.0,Drama/Mystery and thriller,0 days 01:44:00.000000000,2
45,25,https://resizing.flixster.com/YMjumNGhNCsGHO7Ip6NcGyEgfXI=/206x305/v2/https://flxt.tmsimg.com/assets/p182756_p_v8_aa.jpg,Ciao,500,12,2008.0,Gay and lesbian/Drama,0 days 01:27:00.000000000,-20
47,52,https://resizing.flixster.com/g0IwSXZQNjlN_SIiQV0oKjCdzFc=/206x305/v2/https://flxt.tmsimg.com/assets/p191478_p_v13_ak.jpg,Easy Virtue,25000,126,2008.0,Romance,0 days 01:36:00.000000000,5
60,62,,A Film With Me in It,500,13,2008.0,Comedy/Mystery and thriller,0 days 01:29:00.000000000,2
51,85,,Nights and Weekends,500,20,2008.0,Drama,0 days 01:20:00.000000000,34
50,56,/assets/pizza-pie/images/poster_default.c8c896e70c3.gif,Enlighten Up!,5000,39,2008.0,Documentary,0 days 01:22:00.000000000,6
39,51,https://resizing.flixster.com/txJcmkWJJAtrtEP0BtRXIc_Y8FM=/206x305/v2/https://flxt.tmsimg.com/assets/p3630333_p_v10_av.jpg,The Men Who Stare at Goats,100000,217,2009.0,Comedy,0 days 01:33:00.000000000,12
79,90,https://resizing.flixster.com/Rx3b_GZSvLbjxjBUiZ5rKK7IHm0=/206x305/v2/https://flxt.tmsimg.com/assets/p3600392_p_v10_aa.jpg,Up in the Air,100000,288,2009.0,Comedy/Drama,0 days 01:49:00.000000000,11
55,73,,$9.99,5000,55,2008.0,Fantasy/Animation,0 days 01:18:00.000000000,18
50,80,,Three Blind Mice,100,5,2008.0,Comedy/Drama,0 days 01:34:00.000000000,30
38,62,https://resizing.flixster.com/LV69zH_XD5p66zf6vm878vRHBMo=/206x305/v2/https://flxt.tmsimg.com/assets/p3500313_p_v10_ae.jpg,Extract,100000,189,2009.0,Comedy,0 days 01:31:00.000000000,24
55,65,https://resizing.flixster.com/-QfIj3wPvmAgQYJ0GJBQlkfPtFA=/206x305/v2/https://flxt.tmsimg.com/assets/p196280_p_v8_aa.jpg,Is Anybody There?,5000,117,2008.0,Drama,0 days 01:32:00.000000000,10
68,83,/assets/pizza-pie/images/poster_default.c8c896e70c3.gif,Fifty Dead Men Walking,2500,52,2008.0,Mystery and thriller/Action,0 days 01:57:00.000000000,15
32,13,,"I Love You, Beth Cooper",250000,120,2009.0,Comedy,0 days 01:42:00.000000000,-19
41,67,,The Auteur,250,6,2008.0,Comedy,0 days 01:20:00.000000000,26
48,40,,Familiar Strangers,250,5,2008.0,Comedy/Drama,0 days 01:27:00.000000000,-8
77,77,,Virtual JFK: Vietnam If Kennedy Had Lived,250,22,2008.0,Documentary,0 days 01:22:00.000000000,0
60,74,,I'm Going to Explode,250,27,2008.0,Comedy/Drama,0 days 01:42:00.000000000,14
65,85,,Rumba,500,26,2008.0,Comedy,0 days 01:17:00.000000000,20
48,80,,Afterschool,1000,44,2008.0,Drama,0 days 02:01:00.000000000,32
79,93,,Boogie Man: The Lee Atwater Story,250,30,2008.0,Documentary/Biography,0 days 01:26:00.000000000,14
84,90,https://resizing.flixster.com/GAf9lcvq0ozNw9r88PrzVVUiiwE=/206x305/v2/https://flxt.tmsimg.com/assets/p192779_p_v8_ab.jpg,Everlasting Moments,2500,105,2008.0,Drama,0 days 02:11:00.000000000,6
41,17,,Tooth Fairy,100000,116,2010.0,Fantasy/Comedy,0 days 01:42:00.000000000,-24
89,96,https://resizing.flixster.com/7NXm6uV8sEY0c-ucK-zI5qe7P4A=/206x305/v2/https://flxt.tmsimg.com/assets/p197112_p_v10_aa.jpg,The Beaches of Agnès,1000,72,2008.0,Documentary/Biography,0 days 01:50:00.000000000,7
58,29,/assets/pizza-pie/images/poster_default.c8c896e70c3.gif,White Night Wedding,250,7,2008.0,Drama,0 days 01:36:00.000000000,-29
58,89,https://resizing.flixster.com/FisTj2TXV_vMJt7E2SX0-uDNehQ=/206x305/v2/https://flxt.tmsimg.com/assets/p193162_p_v8_aa.jpg,Jerichow,10000,36,2008.0,Drama,0 days 01:29:00.000000000,31
65,82,,Laila's Birthday,100,11,2008.0,Comedy/Drama,0 days 01:11:00.000000000,17
81,93,https://resizing.flixster.com/QwI3csP0YNsYxt2dJiX1r7j7fD0=/206x305/v2/https://flxt.tmsimg.com/assets/p3507292_p_v10_ac.jpg,The Maid,2500,75,2009.0,Drama,0 days 01:36:00.000000000,12
47,39,https://resizing.flixster.com/5bktwCwQvnb_7EM30qymgYcrUi0=/206x305/v2/https://flxt.tmsimg.com/assets/p193479_p_v10_aa.jpg,2012,250000,247,2009.0,Mystery and thriller/Drama,0 days 02:38:00.000000000,-8
31,20,https://resizing.flixster.com/KHpV8nemcVAmJ4T_dtjCCr0op1g=/206x305/v2/https://flxt.tmsimg.com/assets/p3532101_p_v10_ad.jpg,Amelia,50000,166,2009.0,Drama/History,0 days 01:51:00.000000000,-11
72,86,,Treeless Mountain,1000,64,2008.0,Drama,0 days 01:29:00.000000000,14
73,77,,Examined Life,5000,35,2008.0,Documentary,0 days 01:27:00.000000000,4
100,89,/assets/pizza-pie/images/poster_default.c8c896e70c3.gif,Ice People,1,9,2008.0,Documentary,0 days 01:17:00.000000000,-11
46,91,/assets/pizza-pie/images/poster_default.c8c896e70c3.gif,Fire and Ice,100,11,1961.0,Drama,0 days 01:44:00.000000000,45
36,50,https://resizing.flixster.com/FQH8ELoBclFSgTudajudv4fHObo=/206x305/v2/https://flxt.tmsimg.com/assets/p183728_p_v8_aa.jpg,Antarctica,100,12,2008.0,Gay and lesbian/Romance,0 days 01:50:00.000000000,14
55,28,https://resizing.flixster.com/bSWHNPyfsK1tl0VdyteqTj48FsI=/206x305/v2/https://flxt.tmsimg.com/assets/p7820906_p_v10_ax.jpg,Dear John,250000,137,2010.0,Romance/Drama,0 days 01:47:00.000000000,-27
77,69,,Sherlock Holmes,250000,247,2009.0,Mystery and thriller/Action,0 days 02:08:00.000000000,-8
90,100,https://resizing.flixster.com/iEMo9wonr6FWf-KMKxgowcQXoPM=/206x305/v2/https://flxt.tmsimg.com/assets/p190706_p_v8_aa.jpg,Still Walking,2500,64,2008.0,Drama,0 days 01:54:00.000000000,10
65,97,/assets/pizza-pie/images/poster_default.c8c896e70c3.gif,35 Shots of Rum,1000,66,2008.0,Drama,0 days 01:40:00.000000000,32
92,80,https://resizing.flixster.com/BrmB1JI_f9NCYmZGjhwIYRyLnLg=/206x305/v2/https://flxt.tmsimg.com/assets/p194201_p_v10_af.jpg,Departures,50000,108,2008.0,Drama,0 days 02:10:00.000000000,-12
48,50,/assets/pizza-pie/images/poster_default.c8c896e70c3.gif,Frontier of Dawn,250,6,2008.0,Drama,0 days 01:47:00.000000000,2
65,40,,The Paranoids,250,10,2008.0,Comedy/Drama,0 days 01:44:00.000000000,-25
88,92,,Every Little Step,2500,96,2008.0,Music/Documentary,0 days 01:36:00.000000000,4
39,22,https://resizing.flixster.com/kbX7XRDTcp-S7t-eK7LtfJsVMY0=/206x305/v2/https://flxt.tmsimg.com/assets/p193508_p_v10_aa.jpg,G-Force,250000,127,2009.0,Kids and family/Comedy,0 days 01:28:00.000000000,-17
88,81,,Unmistaken Child,1000,36,2008.0,Documentary,0 days 01:44:00.000000000,-7
72,82,,A Woman in Berlin,50000,33,2008.0,Drama/War,0 days 02:11:00.000000000,10
86,95,,"Food, Inc.",50000,114,2008.0,Documentary,0 days 01:34:00.000000000,9
87,59,,The Stoning of Soraya M.,5000,86,2008.0,Drama,0 days 01:56:00.000000000,-28
51,61,,Newcastle,500,18,2008.0,Drama,0 days 01:47:00.000000000,10
49,55,,Edge of Darkness,250000,217,2010.0,Mystery and thriller/Crime,0 days 01:57:00.000000000,6
45,65,,Made in Jamaica,100,17,2006.0,Documentary,0 days 02:00:00.000000000,20
55,39,,Saw VI,250000,74,2009.0,Horror/Mystery and thriller,0 days 01:31:00.000000000,-16
50,75,https://resizing.flixster.com/rrLc6iFAfcEY19Ma0ckCK3uELuI=/206x305/v2/https://flxt.tmsimg.com/assets/p192542_p_v10_aa.jpg,The Children,2500,16,2008.0,Horror,0 days 01:24:00.000000000,25
86,71,https://resizing.flixster.com/TNqGWq_ALrS2sAhTfPr-Hc3-Jqk=/206x305/v2/https://flxt.tmsimg.com/assets/p3522544_p_v10_aa.jpg,More Than a Game,5000,51,2008.0,Documentary,0 days 01:45:00.000000000,-15
62,83,https://resizing.flixster.com/HfaJxD8Ai96da_FSvGTBsmgNvw0=/206x305/v2/https://flxt.tmsimg.com/assets/p196300_p_v10_ab.jpg,Disgrace,1000,60,2008.0,Drama,0 days 01:58:00.000000000,21
75,94,https://resizing.flixster.com/TLHdJJHEvvhX5dogtm5k8yrZLbo=/206x305/v2/https://flxt.tmsimg.com/assets/p190736_p_v10_aa.jpg,Under the Sea,10000,50,2009.0,Documentary,0 days 00:35:00.000000000,19
85,79,,It Might Get Loud,10000,115,2008.0,Music/Documentary,0 days 01:37:00.000000000,-6
32,25,https://resizing.flixster.com/N2dvY3T4k0gjTtMUFYHoxnqGKCI=/206x305/v2/https://flxt.tmsimg.com/assets/p190180_p_v10_aa.jpg,Sorority Row,250000,81,2009.0,Mystery and thriller/Horror,0 days 01:41:00.000000000,-7
52,64,,Lymelife,10000,110,2008.0,Drama,0 days 01:35:00.000000000,12
79,84,https://resizing.flixster.com/wlI_pEQUEF9v4IctLbGT7PI4rwc=/206x305/v2/https://flxt.tmsimg.com/assets/p195469_p_v8_aa.jpg,Soul Power,2500,74,2008.0,Documentary/Music,0 days 01:33:00.000000000,5
27,67,https://resizing.flixster.com/EddiwrNK2upUD1Z7kGg795sIdZI=/206x305/v2/https://flxt.tmsimg.com/assets/p7901330_p_v13_aa.jpg,The Dungeon Masters,100,6,2008.0,Drama/Documentary,0 days 01:33:00.000000000,40
34,11,,The Stepfather,250000,63,2009.0,Mystery and thriller/Horror,0 days 01:41:00.000000000,-23
58,30,,The Good Heart,1000,37,2009.0,Drama,0 days 01:38:00.000000000,-28
87,85,,The Girl With the Dragon Tattoo,50000,191,2009.0,Crime/Drama,0 days 02:32:00.000000000,-2
80,88,,Séraphine,10000,95,2008.0,Drama/War,0 days 02:05:00.000000000,8
71,89,https://resizing.flixster.com/NxTwgTbSq-0I04fl3xcjXSlzPKg=/206x305/v2/https://resizing.flixster.com/bn0qmirMhjJSVmY-QH0q7mNQbNk=/ems.ZW1zLXByZC1hc3NldHMvbW92aWVzLzEwZTc3YWU0LTI4YTEtNDljNC1iOTJmLWU0MTJjYWY0MDhmMC5qcGc=,The Exiles,250,38,1961.0,Drama,0 days 01:20:00.000000000,18
82,96,/assets/pizza-pie/images/poster_default.c8c896e70c3.gif,Herb and Dorothy,500,28,2008.0,Documentary,0 days 01:31:00.000000000,14
30,18,,Dance Flick,250000,96,2009.0,Comedy,0 days 01:23:00.000000000,-12
40,50,https://resizing.flixster.com/aGan0gaergXKr8iaptil4dMhxKg=/206x305/v2/https://flxt.tmsimg.com/assets/p6617_p_v8_aa.jpg,Sodom and Gomorrah,100,8,1963.0,Drama/History,0 days 02:34:00.000000000,10
79,87,https://resizing.flixster.com/q6TRUAMQNBIN8KRUr1nMCBsuh0I=/206x305/v2/https://flxt.tmsimg.com/assets/p196292_p_v8_aa.jpg,Prodigal Sons,250,30,2008.0,Documentary,0 days 01:26:00.000000000,8
54,33,,Free Style,500,18,2009.0,Drama,0 days 01:34:00.000000000,-21
49,30,,Pandorum,100000,88,2009.0,Horror/Action,0 days 01:48:00.000000000,-19
20,30,,Survival of the Dead,5000,91,2009.0,Horror,0 days 01:28:00.000000000,10
67,75,,The Vanished Empire,100,12,2008.0,Drama,0 days 01:45:00.000000000,8
50,27,https://resizing.flixster.com/3IFdMMHTMhpWoXkkEznlBUL96to=/206x305/v2/https://flxt.tmsimg.com/assets/p194085_p_v13_ab.jpg,Shrink,25000,64,2009.0,Drama,0 days 01:44:00.000000000,-23
92,95,https://resizing.flixster.com/wpNrP8NLnnCoeZ6b6NFNwLP6FHU=/206x305/v2/https://flxt.tmsimg.com/assets/p192938_p_v13_ab.jpg,Mary and Max,25000,65,2009.0,Drama/Comedy,0 days 01:32:00.000000000,3
47,56,https://resizing.flixster.com/HJuO56I21EqdKeeGmsVszH4tnKs=/206x305/v2/https://flxt.tmsimg.com/assets/p7997132_p_v8_aa.jpg,Perrier's Bounty,5000,43,2009.0,Crime/Comedy,0 days 01:28:00.000000000,9
82,84,,North Face,2500,58,2008.0,Romance/Adventure,0 days 02:06:00.000000000,2
82,92,,Pressure Cooker,1000,25,2008.0,Documentary,0 days 01:39:00.000000000,10
56,69,https://resizing.flixster.com/QPcKibTl3hWDJwq0b32L4AXcRmo=/206x305/v2/https://flxt.tmsimg.com/NowShowing/78031/78031_aa.jpg,Dead Snow,10000,77,2009.0,Comedy/Horror,0 days 01:28:00.000000000,13
85,83,https://resizing.flixster.com/tnOHyi6HLIwa3E6eanyXUibx4nY=/206x305/v2/https://flxt.tmsimg.com/assets/p3509219_p_v8_ab.jpg,Black Dynamite,10000,63,2009.0,Comedy/Action,0 days 01:30:00.000000000,-2
63,45,https://resizing.flixster.com/BwcVz2X3WDw-H8k5Gr9LApYgECE=/206x305/v2/https://flxt.tmsimg.com/assets/p7815759_p_v10_ah.jpg,Mammoth,5000,42,2009.0,Drama,0 days 02:05:00.000000000,-18
71,80,/assets/pizza-pie/images/poster_default.c8c896e70c3.gif,Into Temptation,250,5,2009.0,Drama,0 days 01:35:00.000000000,9
42,32,,The Answer Man,10000,47,2009.0,Romance,0 days 01:36:00.000000000,-10
66,73,/assets/pizza-pie/images/poster_default.c8c896e70c3.gif,The Beautiful Game,10000,113,2008.0,Comedy/Drama,0 days 01:43:00.000000000,7
49,46,https://resizing.flixster.com/vn1Z8CEiJw3BlZsFewYZAS9wnKQ=/206x305/v2/https://flxt.tmsimg.com/assets/p7853261_p_v10_ac.jpg,Creation,10000,114,2009.0,Drama/Biography,0 days 01:48:00.000000000,-3
61,28,,The Twilight Saga: New Moon,250000,229,2009.0,Romance/Fantasy,0 days 02:10:00.000000000,-33
38,37,https://resizing.flixster.com/0CPbP0Uz-dCA6aoGd-ABfGywn5A=/206x305/v2/https://flxt.tmsimg.com/assets/p194791_p_v10_aa.jpg,Surrogates,250000,117,2009.0,Mystery and thriller/Sci fi,0 days 01:28:00.000000000,-1
76,90,https://resizing.flixster.com/EmN3LozpO0e1cm9Lnb8w0twLMbY=/206x305/v2/https://flxt.tmsimg.com/assets/p7921689_p_v10_at.jpg,Crazy Heart,100000,211,2009.0,Romance/Drama,0 days 01:52:00.000000000,14
54,67,https://resizing.flixster.com/8JbIaWIibAPyeodiF7RQ-3_z06U=/206x305/v2/https://flxt.tmsimg.com/assets/p18624_p_v8_aa.jpg,The Last Big Thing,50,6,1996.0,Comedy,0 days 01:38:00.000000000,13
41,17,https://resizing.flixster.com/cB4_H5QPPfnorPTQGfdMWcSrDOc=/206x305/v2/https://flxt.tmsimg.com/assets/p193554_p_v10_aa.jpg,When in Rome,100000,114,2010.0,Romance,0 days 01:31:00.000000000,-24
54,38,,From Paris With Love,100000,162,2010.0,Adventure/Action,0 days 01:32:00.000000000,-16
28,21,,Spread,10000,61,2009.0,Comedy/Drama,0 days 01:37:00.000000000,-7
76,87,https://resizing.flixster.com/aHR7iFijNIkWcF2ohbH1sHOogvY=/206x305/v2/https://flxt.tmsimg.com/assets/p3498208_p_v10_aa.jpg,Amreeka,2500,71,2009.0,Comedy/Drama,0 days 01:36:00.000000000,11
84,85,https://resizing.flixster.com/8i1x_KdhF1jwBOcQksF8JBv9fIE=/206x305/v2/https://flxt.tmsimg.com/assets/p193428_p_v10_af.jpg,(500) Days of Summer,250000,233,2009.0,Comedy/Drama,0 days 01:35:00.000000000,1
37,51,https://resizing.flixster.com/EfW4zmCLqWKlSBNZyQCqoneTKaY=/206x305/v2/https://flxt.tmsimg.com/assets/p190670_p_v10_ag.jpg,Observe and Report,250000,214,2009.0,Comedy,0 days 01:26:00.000000000,14
84,78,https://resizing.flixster.com/IAntAK-5jevkQ98NoNGcIDzreas=/206x305/v2/https://flxt.tmsimg.com/assets/p192248_p_v10_ap.jpg,The Hangover,250000,240,2009.0,Comedy,0 days 01:39:00.000000000,-6
63,56,,Orphan,250000,155,2009.0,Mystery and thriller/Horror,0 days 02:03:00.000000000,-7
50,70,,The Private Lives of Pippa Lee,10000,76,2009.0,Comedy/Drama,0 days 01:33:00.000000000,20
40,71,https://resizing.flixster.com/UpiVdgxpTdFUbdMTEKxD0VYzLR0=/206x305/v2/https://flxt.tmsimg.com/assets/p7860484_p_v10_ab.jpg,The Killing Room,2500,7,2009.0,Mystery and thriller/Horror,0 days 01:33:00.000000000,31
54,75,https://resizing.flixster.com/ILho6o1XVPIe5tWSd2ZwvISbhcU=/206x305/v2/https://flxt.tmsimg.com/assets/p194084_p_v10_aa.jpg,Cold Souls,25000,126,2009.0,Comedy/Drama,0 days 01:41:00.000000000,21
31,21,,Next Day Air,100000,66,2009.0,Comedy/Drama,0 days 01:24:00.000000000,-10
44,67,https://resizing.flixster.com/McMGXtXFMjJJCm7f2F7cpbRsh7o=/206x305/v2/https://flxt.tmsimg.com/assets/p3539035_p_v8_aa.jpg,The Missing Person,5000,27,2009.0,Mystery and thriller/Drama,0 days 01:35:00.000000000,23
89,88,https://resizing.flixster.com/OXk3vJ1D6qNRBoVq8BGNXrlYyJ4=/206x305/v2/https://flxt.tmsimg.com/assets/p194175_p_v10_ab.jpg,Sin nombre,10000,120,2009.0,Mystery and thriller/Drama,0 days 01:36:00.000000000,-1
56,65,https://resizing.flixster.com/BrFYRBzicRvujEisQZkIYhDtejM=/206x305/v2/https://flxt.tmsimg.com/assets/p7837448_p_v10_ad.jpg,Peter and Vandy,500,20,2009.0,Romance,0 days 01:18:00.000000000,9
72,50,/assets/pizza-pie/images/poster_default.c8c896e70c3.gif,Mission Street Rhapsody,5000,26,2009.0,Gay and lesbian/Drama,0 days 01:57:00.000000000,-22
85,92,https://resizing.flixster.com/ehVepFAp63m_EKzZPIyuQum9IMY=/206x305/v2/https://flxt.tmsimg.com/assets/p3497404_p_v10_ac.jpg,The Damned United,50000,139,2009.0,Drama/Biography,0 days 01:37:00.000000000,7
64,60,,Mystery Team,5000,20,2009.0,Comedy,0 days 01:46:00.000000000,-4
82,61,https://resizing.flixster.com/jH56xvN_mNTTWHaTsU1mvG_2GBs=/206x305/v2/https://flxt.tmsimg.com/assets/p8031113_p_v8_ab.jpg,The Doors: When You're Strange,500,70,2009.0,Documentary,0 days 01:30:00.000000000,-21
67,88,,World's Greatest Dad,50000,118,2009.0,Comedy/Drama,0 days 01:39:00.000000000,21
49,62,,Toe to Toe,250,13,2009.0,Drama,0 days 01:44:00.000000000,13
16,20,https://resizing.flixster.com/-8hFrRjEbN5Pn5OQnP4Red2ZaMM=/206x305/v2/https://flxt.tmsimg.com/assets/p3568107_p_v8_aa.jpg,Motherhood,2500,51,2009.0,Comedy,0 days 01:29:00.000000000,4
53,53,https://resizing.flixster.com/Ir7az7A6gUKkOlIaOGgkvAykoEc=/206x305/v2/https://flxt.tmsimg.com/assets/p7972132_p_v13_ba.jpg,The Greatest,5000,58,2009.0,Drama,0 days 01:40:00.000000000,0
74,76,https://resizing.flixster.com/Ui_4o-lr6Y47dcPlRUj-lmhnNwY=/206x305/v2/https://flxt.tmsimg.com/assets/p197002_p_v10_aa.jpg,The Young Victoria,100000,156,2009.0,Drama/History,0 days 01:44:00.000000000,2
52,62,https://resizing.flixster.com/y-PYxSFcJOBei-9jB_Hc1_wjXAQ=/206x305/v2/https://flxt.tmsimg.com/assets/p190259_p_v10_aa.jpg,The Blue Tooth Virgin,250,13,2008.0,Comedy,0 days 01:20:00.000000000,10
80,93,,An Education,50000,196,2009.0,Drama,0 days 01:40:00.000000000,13
62,86,,Big Fan,25000,88,2009.0,Comedy/Drama,0 days 01:28:00.000000000,24
91,97,/assets/pizza-pie/images/poster_default.c8c896e70c3.gif,Burma VJ: Reporting From a Closed Country,1000,62,2008.0,Documentary,0 days 01:24:00.000000000,6
78,79,,William Kunstler: Disturbing the Universe,250,28,2009.0,Documentary,0 days 01:25:00.000000000,1
60,75,https://resizing.flixster.com/cOCRF6SQp2eg5Hz4BGYC18LfP2k=/206x305/v2/https://flxt.tmsimg.com/assets/p194066_p_v10_am.jpg,Five Minutes of Heaven,10000,44,2009.0,Drama,0 days 01:30:00.000000000,15
69,95,,Good Hair,25000,83,2009.0,Documentary,0 days 01:35:00.000000000,26
76,83,,Nollywood Babylon,100,6,2008.0,Documentary,0 days 01:14:00.000000000,7
89,100,https://resizing.flixster.com/5nUDEXl18u6Jpr5H2VHhENPR-j4=/206x305/v2/https://flxt.tmsimg.com/assets/p7829438_p_v10_aa.jpg,Passing Strange The Movie,500,25,2009.0,Musical,0 days 02:16:00.000000000,11
75,94,,The Wedding Song,250,16,2008.0,Drama/War,0 days 01:40:00.000000000,19
86,89,,Zombieland,250000,257,2009.0,Comedy/Horror,0 days 01:27:00.000000000,3
51,79,,Humpday,10000,138,2009.0,Comedy,0 days 01:34:00.000000000,28
70,77,https://resizing.flixster.com/n1OPsGeEYv8HduSd44DyKaJAMjw=/206x305/v2/https://flxt.tmsimg.com/assets/p186815_p_v10_al.jpg,Julie & Julia,250000,227,2009.0,Comedy/Drama,0 days 02:04:00.000000000,7
34,57,,Dare,25000,21,2009.0,Gay and lesbian/Drama,0 days 01:30:00.000000000,23
31,72,,Grace,10000,32,2009.0,Comedy/Horror,0 days 01:34:00.000000000,41
60,79,,Children of Invention,500,14,2009.0,Drama,0 days 01:26:00.000000000,19
45,60,,Paper Heart,25000,111,2009.0,Drama/Romance,0 days 01:28:00.000000000,15
65,57,https://resizing.flixster.com/MG504DYdw3AouwiClVuRGa82LCg=/206x305/v2/https://flxt.tmsimg.com/assets/p3498909_p_v10_ab.jpg,Art & Copy,500,28,2009.0,Documentary,0 days 01:28:00.000000000,-8
94,95,https://resizing.flixster.com/jhfK5QGqtwpJwh1vTuOdl5ya9sY=/206x305/v2/https://flxt.tmsimg.com/assets/p3489397_p_v10_ac.jpg,The Cove,25000,133,2009.0,Documentary,0 days 01:34:00.000000000,1
85,95,,Crude,1000,66,2009.0,Documentary,0 days 01:44:00.000000000,10
82,78,,The End of the Line,2500,46,2009.0,Documentary,0 days 01:22:00.000000000,-4
63,83,,No Impact Man,1000,48,2009.0,Documentary,0 days 01:32:00.000000000,20
84,92,/assets/pizza-pie/images/poster_default.c8c896e70c3.gif,Old Partner,100,12,2009.0,Documentary,,8
75,76,,Over the Hills and Far Away,500,34,2009.0,Documentary,0 days 01:34:00.000000000,1
71,83,,The September Issue,25000,114,2009.0,Documentary,0 days 01:30:00.000000000,12
79,82,,We Live in Public,10000,51,2009.0,Documentary,0 days 01:30:00.000000000,3
78,75,/assets/pizza-pie/images/poster_default.c8c896e70c3.gif,The Yes Men Fix the World,1000,57,2009.0,Documentary,0 days 01:30:00.000000000,-3
72,86,https://resizing.flixster.com/2uQS8i5QrzIlVBOAEHbqTkkrJXQ=/206x305/v2/https://flxt.tmsimg.com/NowShowing/77488/77488_ab.jpg,Cloudy With a Chance of Meatballs,250000,144,2009.0,Kids and family/Comedy,0 days 01:30:00.000000000,14
77,100,/assets/pizza-pie/images/poster_default.c8c896e70c3.gif,Afghan Star,5000,62,2009.0,Documentary,0 days 01:28:00.000000000,23
59,82,https://resizing.flixster.com/NSAHdUZ67fwP9oX6u0erGDoL78Q=/206x305/v2/https://flxt.tmsimg.com/assets/p197203_p_v8_aa.jpg,Earth Days,1000,33,2009.0,Documentary,0 days 01:42:00.000000000,23
52,62,,A Perfect Getaway,100000,138,2009.0,Mystery and thriller/Action,0 days 01:37:00.000000000,10
79,75,https://resizing.flixster.com/VVUEFWPdCZQgVuz0Q5Ud4h4ekCE=/206x305/v2/https://flxt.tmsimg.com/assets/p192284_p_v10_aa.jpg,American Violet,10000,59,2008.0,Drama,0 days 01:42:00.000000000,-4
39,10,,Couples Retreat,250000,164,2009.0,Comedy,0 days 01:54:00.000000000,-29
45,21,,Halloween II,250000,80,2009.0,Mystery and thriller/Horror,0 days 01:45:00.000000000,-24
81,92,https://resizing.flixster.com/pREQo4oC8XopurHzJnR49rMjF6w=/206x305/v2/https://flxt.tmsimg.com/assets/p195165_p_v10_ae.jpg,"Precious: Based on the Novel ""Push"" by Sapphire",100000,238,2009.0,Drama,0 days 01:49:00.000000000,11
54,100,https://resizing.flixster.com/emoNx1N70NmUKYiDjNAXdncXicg=/206x305/v2/https://flxt.tmsimg.com/assets/p194739_p_v13_aa.jpg,Know Your Mushrooms,250,8,2008.0,Documentary,0 days 01:14:00.000000000,46
80,73,,The Meerkats,500,11,2008.0,Documentary,0 days 01:23:00.000000000,-7
68,70,https://resizing.flixster.com/to8a7hApbZKD0GjapkM00eAlSrI=/206x305/v2/https://flxt.tmsimg.com/assets/p194952_p_v8_aa.jpg,Brothers at War,1000,20,2009.0,Documentary/War,0 days 01:52:00.000000000,2
44,60,https://resizing.flixster.com/VK0ktmsRTmKgMffHZpyb12rRwV8=/206x305/v2/https://flxt.tmsimg.com/assets/p194668_p_v10_ac.jpg,Billu Barber,2500,5,2009.0,Comedy/Drama,0 days 02:17:00.000000000,16
55,75,,District 13: Ultimatum,2500,75,2009.0,Action,0 days 01:40:00.000000000,20
17,15,,Not Forgotten,2500,13,2009.0,Mystery and thriller,0 days 01:37:00.000000000,-2
74,83,,Youssou N'Dour: I Bring What I Love,1000,24,2008.0,Music/Documentary,0 days 01:42:00.000000000,9
35,66,,The Girlfriend Experience,25000,140,2008.0,Drama,0 days 01:17:00.000000000,31
64,46,,The Book of Eli,250000,207,2010.0,Action/Adventure,0 days 01:52:00.000000000,-18
72,95,,Katalin Varga,500,21,2009.0,Crime/Drama,0 days 01:22:00.000000000,23
61,94,https://resizing.flixster.com/q4n53ksY2xk_ndG3M-bgCpRI0GI=/206x305/v2/https://flxt.tmsimg.com/assets/p7849693_p_v13_ad.jpg,Gigante,500,16,2009.0,Drama,0 days 01:24:00.000000000,33
40,38,,Rage,250,8,2009.0,Drama,0 days 01:39:00.000000000,-2
36,57,,Perestroika,50,14,2007.0,Drama,0 days 01:56:00.000000000,21
27,29,https://resizing.flixster.com/KwB1qglYjXO7zPT2_FA9aB3yZCU=/206x305/v2/https://flxt.tmsimg.com/assets/p3626069_p_v10_ab.jpg,Women in Trouble,1000,24,2009.0,Drama/Comedy,0 days 01:35:00.000000000,2
22,27,,Happy Tears,1000,33,2009.0,Drama,0 days 01:36:00.000000000,5
50,68,,My One and Only,10000,72,2009.0,Comedy/Drama,0 days 01:48:00.000000000,18
87,88,,Gogol Bordello Non-Stop,100,8,2008.0,Documentary,0 days 01:33:00.000000000,1
32,43,https://resizing.flixster.com/rn5eo5KjnGUY8SZKVHvR9FzMJGU=/206x305/v2/https://flxt.tmsimg.com/assets/p3574607_p_v10_az.jpg,New Town Killers,500,21,2008.0,Drama,0 days 01:37:00.000000000,11
78,77,https://resizing.flixster.com/L4N6pMS2SyzO94QReWGmyk3nwCg=/206x305/v2/https://flxt.tmsimg.com/assets/p194001_p_v10_ab.jpg,Valentino: The Last Emperor,10000,75,2008.0,Documentary,0 days 01:36:00.000000000,-1
61,28,,Play the Game,10000,32,2008.0,Comedy/Romance,0 days 01:45:00.000000000,-33
82,93,https://resizing.flixster.com/P7spryhrrKGJTFO01LwPzDW35ZY=/206x305/v2/https://flxt.tmsimg.com/assets/p193073_p_v10_aa.jpg,Goodbye Solo,2500,107,2008.0,Comedy/Drama,0 days 01:31:00.000000000,11
33,25,,After.Life,10000,56,2009.0,Drama/Mystery and thriller,0 days 01:43:00.000000000,-8
75,26,https://resizing.flixster.com/4kEs38KnnS1iALiOq_b8eHmguG0=/206x305/v2/https://flxt.tmsimg.com/assets/p3632501_p_v10_ai.jpg,Law Abiding Citizen,250000,162,2009.0,Mystery and thriller/Crime,0 days 01:48:00.000000000,-49
37,16,,Love Happens,100000,110,2009.0,Drama/Romance,0 days 01:49:00.000000000,-21
17,7,,Ghosted,100,14,2009.0,Mystery and thriller/Drama,0 days 01:32:00.000000000,-10
50,27,https://resizing.flixster.com/ulq9rZxL2sUMXGNereootGih6JQ=/206x305/v2/https://flxt.tmsimg.com/assets/p7836892_p_v8_aa.jpg,Splinterheads,500,11,2009.0,Comedy,0 days 01:34:00.000000000,-23
43,74,,Beeswax,1000,47,2009.0,Comedy/Drama,0 days 01:40:00.000000000,31
43,80,https://resizing.flixster.com/HtICPLEIiwlTJY4Sib_GR_1mDog=/206x305/v2/https://flxt.tmsimg.com/assets/p7966935_p_v10_aa.jpg,High Life,500,5,2009.0,Comedy/Crime,0 days 01:20:00.000000000,37
36,7,https://resizing.flixster.com/1PBbV8htKbqneBvsAbTrR9Q6GfQ=/206x305/v2/https://flxt.tmsimg.com/assets/p3495408_p_v7_ag.jpg,Beyond a Reasonable Doubt,10000,28,2009.0,Crime/Drama,0 days 01:45:00.000000000,-29
27,8,,The Skeptic,10000,12,2009.0,Mystery and thriller/Horror,0 days 01:29:00.000000000,-19
36,24,https://resizing.flixster.com/50mOZCGsA34Y2pA4HdBYx-Mbd2Q=/206x305/v2/https://flxt.tmsimg.com/assets/p176362_p_v10_ae.jpg,Fame,100000,122,2009.0,Drama/Musical,0 days 01:47:00.000000000,-12
61,50,,Whatever Works,25000,167,2009.0,Romance,0 days 01:32:00.000000000,-11
63,95,https://resizing.flixster.com/Cl-G6sqFHHhGmd4W9EmrR-rIbq4=/206x305/v2/https://flxt.tmsimg.com/assets/p3497284_p_v10_aa.jpg,Lake Mungo,2500,21,2008.0,Mystery and thriller/Horror,0 days 01:29:00.000000000,32
57,64,,Coco Before Chanel,25000,136,2009.0,Drama/Biography,0 days 01:45:00.000000000,7
32,28,https://resizing.flixster.com/b3YBRKhlxmxlQ0PTSjy1IcMnH5Y=/206x305/v2/https://flxt.tmsimg.com/assets/p3490597_p_v10_ac.jpg,Lesbian Vampire Killers,5000,25,2009.0,Comedy/Horror,0 days 01:26:00.000000000,-4
76,82,https://resizing.flixster.com/g-gFYowoCt9xAbBhO9lMLI4Ksjs=/206x305/v2/https://flxt.tmsimg.com/assets/p3499047_p_v8_aa.jpg,That Evening Sun,500,38,2009.0,Drama,0 days 01:49:00.000000000,6
27,67,,Alexander the Last,1000,12,2009.0,Drama,0 days 01:12:00.000000000,40
70,71,,Tetro,10000,109,2009.0,Drama,0 days 02:07:00.000000000,1
82,90,https://resizing.flixster.com/LFpNCNhw2tumFRCjd5gLfvRyBEs=/206x305/v2/https://flxt.tmsimg.com/assets/p177953_p_v10_ad.jpg,District 9,250000,314,2009.0,Sci fi,0 days 01:51:00.000000000,8
59,0,,12 in a Box,2500,6,2006.0,Comedy,0 days 01:33:00.000000000,-59
56,70,,The Crazies,100000,155,2010.0,Mystery and thriller/Horror,0 days 01:41:00.000000000,14
33,50,https://resizing.flixster.com/47KQcrjP1FMSWCib7bm9EwT5cGA=/206x305/v2/https://flxt.tmsimg.com/assets/p197720_p_v10_ab.jpg,Change of Plans,1000,16,2009.0,Drama/Comedy,0 days 01:40:00.000000000,17
37,89,,Inspector Bellamy,1000,27,2009.0,Crime/Drama,0 days 01:50:00.000000000,52
27,12,https://resizing.flixster.com/GtaOQ9ruZAnpLY3M4_Pbd7hllRA=/206x305/v2/https://flxt.tmsimg.com/assets/p3559035_p_v13_al.jpg,Did You Hear About the Morgans?,250000,123,2009.0,Comedy/Romance,0 days 01:43:00.000000000,-15
49,20,,Alvin and the Chipmunks: The Squeakquel,250000,84,2009.0,Comedy/Kids and family,0 days 01:29:00.000000000,-29
39,19,,Cop Out,250000,163,2010.0,Comedy/Crime,0 days 01:43:00.000000000,-20
53,49,https://resizing.flixster.com/TWOjNO3YUJnDtwUNvslfxQQBO3w=/206x305/v2/https://flxt.tmsimg.com/assets/p177957_p_v10_ao.jpg,Percy Jackson & the Olympians: The Lightning Thief,250000,150,2010.0,Kids and family/Adventure,0 days 01:59:00.000000000,-4
40,27,,Clash of the Titans,250000,265,2010.0,Action/Adventure,0 days 01:46:00.000000000,-13
74,76,https://resizing.flixster.com/YfC-9VC2z0jdc5m8pEXp-flUxMo=/206x305/v2/https://flxt.tmsimg.com/assets/p182515_p_v10_aa.jpg,Chevolution,1000,17,2008.0,Documentary,0 days 01:39:00.000000000,2
43,76,,The Girl on the Train,1000,62,2009.0,Drama,0 days 01:45:00.000000000,33
47,40,,Veer,1000,5,2010.0,Romance/Drama,0 days 02:36:00.000000000,-7
66,80,,Triangle,25000,40,2009.0,Mystery and thriller/Horror,0 days 01:39:00.000000000,14
81,100,,Ink,5000,6,2009.0,Sci fi/Fantasy,0 days 01:42:00.000000000,19
21,0,,C Me Dance,500,6,2009.0,Drama/Mystery and thriller,0 days 01:29:00.000000000,-21
67,80,,Milton Glaser: To Inform & Delight,2500,15,2008.0,Documentary,0 days 01:13:00.000000000,13
80,87,https://resizing.flixster.com/gopFE3w4jiLAHkCN_Zntx8OZ1t4=/206x305/v2/https://flxt.tmsimg.com/assets/p193077_p_v10_aa.jpg,Kabei: Our Mother,500,15,2008.0,Drama,0 days 02:13:00.000000000,7
45,43,,Death at a Funeral,100000,138,2010.0,Comedy,0 days 01:28:00.000000000,-2
47,18,https://resizing.flixster.com/b7W65Y5YSBPlzC5ZUla3YeXHiWE=/206x305/v2/https://flxt.tmsimg.com/assets/p3582399_p_v10_aa.jpg,Valentine's Day,250000,190,2010.0,Gay and lesbian/Romance,0 days 01:59:00.000000000,-29
45,40,,A Wink and a Smile,500,15,2008.0,Documentary,0 days 01:31:00.000000000,-5
36,33,,Weather Girl,5000,9,2009.0,Comedy,0 days 01:33:00.000000000,-3
42,76,https://resizing.flixster.com/mYSKnA3JCy447iL7zRjsnhs5QnM=/206x305/v2/https://flxt.tmsimg.com/assets/p3537042_p_v10_ay.jpg,Greenberg,25000,175,2010.0,Comedy/Drama,0 days 01:47:00.000000000,34
72,70,https://resizing.flixster.com/-an3lYVuB_P8wkR0kiL5J4GJygY=/206x305/v2/https://flxt.tmsimg.com/assets/p3579349_p_v10_ac.jpg,An Englishman in New York,250,10,2009.0,Gay and lesbian/Drama,0 days 01:15:00.000000000,-2
63,85,,The House of the Devil,50000,101,2009.0,Horror,0 days 01:33:00.000000000,22
67,67,/assets/pizza-pie/images/poster_default.c8c896e70c3.gif,Here and There,100,12,2009.0,Comedy/Drama,0 days 01:25:00.000000000,0
33,42,,Wonderful World,1000,31,2009.0,Drama/Romance,0 days 01:35:00.000000000,9
30,35,,The Good Guy,2500,26,2009.0,Comedy/Drama,0 days 01:30:00.000000000,5
25,22,,Serious Moonlight,2500,37,2009.0,Comedy/Drama,0 days 01:24:00.000000000,-3
55,0,,Midgets vs. Mascots,250,9,2009.0,Comedy,0 days 01:25:00.000000000,-55
43,60,https://resizing.flixster.com/1f-9PHuYXfDsrtmkothYlDQqAoE=/206x305/v2/https://flxt.tmsimg.com/assets/p8164843_p_v10_at.jpg,Accidents Happen,500,10,2009.0,Comedy/Drama,0 days 01:35:00.000000000,17
23,38,/assets/pizza-pie/images/poster_default.c8c896e70c3.gif,Don McKay,500,26,2009.0,Mystery and thriller,0 days 01:27:00.000000000,15
82,39,https://resizing.flixster.com/PROyj7BIusK2cQaIUOELZJgrzA8=/206x305/v2/https://flxt.tmsimg.com/assets/p3511589_p_v8_aa.jpg,To Save a Life,10000,23,2010.0,Drama,0 days 02:00:00.000000000,-43
79,93,https://resizing.flixster.com/HPP4g1nATCoT-dWwDpugypf-7KI=/206x305/v2/https://flxt.tmsimg.com/assets/p3504155_p_v10_aa.jpg,In Search of Beethoven,250,41,2009.0,Documentary,0 days 02:19:00.000000000,14
59,56,https://resizing.flixster.com/rxm9FzIhA0himcBxxtiE5iDeJjk=/206x305/v2/https://flxt.tmsimg.com/assets/p3508281_p_v10_aa.jpg,Waveriders,100,16,2008.0,Adventure/Documentary,0 days 01:20:00.000000000,-3
87,92,,The Way We Get By,1000,25,2009.0,Documentary,0 days 01:24:00.000000000,5
28,19,,I Hate Valentine's Day,25000,27,2009.0,Romance,0 days 01:38:00.000000000,-9
63,64,/assets/pizza-pie/images/poster_default.c8c896e70c3.gif,TiMER,2500,14,2009.0,Romance,0 days 01:39:00.000000000,1
48,83,/assets/pizza-pie/images/poster_default.c8c896e70c3.gif,Daytime Drinking,1000,6,2008.0,Comedy/Drama,0 days 01:56:00.000000000,35
40,12,https://resizing.flixster.com/k8C6AGmZ0H3LHaUq6B52lz6sBJQ=/206x305/v2/https://flxt.tmsimg.com/assets/p3582379_p_v10_ah.jpg,The Spy Next Door,100000,90,2010.0,Kids and family/Comedy,0 days 01:32:00.000000000,-28
58,23,https://resizing.flixster.com/OjjyAuvlGUALmY-U8FUcyCHCQ0s=/206x305/v2/https://flxt.tmsimg.com/assets/p7839451_p_v10_ag.jpg,The Boondock Saints II: All Saints Day,100000,44,2009.0,Crime/Action,0 days 01:55:00.000000000,-35
78,85,,Looking for Eric,5000,99,2009.0,Comedy/Drama,0 days 01:56:00.000000000,7
36,41,https://resizing.flixster.com/1QBnFVVDV-Nl7U2aDk9TD43Kf34=/206x305/v2/https://flxt.tmsimg.com/assets/p7865439_p_v10_ay.jpg,44 Inch Chest,10000,81,2009.0,Drama/Mystery and thriller,0 days 01:35:00.000000000,5
76,77,https://resizing.flixster.com/deAB_wti7qrUXCPNMKD-I77XCcw=/206x305/v2/https://flxt.tmsimg.com/assets/p3490200_p_v10_aa.jpg,Outrage,5000,60,2009.0,Gay and lesbian/Documentary,0 days 01:30:00.000000000,1
70,67,https://resizing.flixster.com/7wj8UY-MxCaVGmTti6VK32z2_0k=/206x305/v2/https://flxt.tmsimg.com/assets/p7985592_p_v13_aa.jpg,Beer Wars,1000,6,2009.0,Documentary,0 days 01:25:00.000000000,-3
38,38,/assets/pizza-pie/images/poster_default.c8c896e70c3.gif,"Naked Ambition, an R-Rated Look at an X-Rated Industry",1000,8,2009.0,Documentary,0 days 01:21:00.000000000,0
72,61,https://resizing.flixster.com/WyNXyIOPQ1ZN01KD5ycUkaeg2z8=/206x305/v2/https://resizing.flixster.com/G39XPWRGNYHrr7GZt_uNdC163ek=/ems.ZW1zLXByZC1hc3NldHMvbW92aWVzLzVjNDVlNjBhLTNjNzAtNGU3NS1iOWY0LTk3NWU1MGM5MDhlMy53ZWJw,Love the Beast,500,23,2009.0,Documentary,0 days 01:32:00.000000000,-11
28,25,https://resizing.flixster.com/CvMnYwGh2mzkhPqa5h2HctZtM1E=/206x305/v2/https://flxt.tmsimg.com/assets/p7932806_p_v10_ap.jpg,Staten Island,1000,8,2009.0,Crime/Drama,0 days 01:36:00.000000000,-3
61,73,https://resizing.flixster.com/cg9W7TNO_XcAVJiffLodyZOTh7E=/206x305/v2/https://flxt.tmsimg.com/assets/p3500329_p_v10_ac.jpg,The Boys Are Back,10000,126,2009.0,Comedy/Drama,0 days 01:44:00.000000000,12
79,79,https://resizing.flixster.com/99uperE71tCykQdYEUKlaK9CgJY=/206x305/v2/https://flxt.tmsimg.com/assets/p197375_p_v10_aa.jpg,Chasing a Dream,1000,24,2009.0,Drama,0 days 01:30:00.000000000,0
42,17,https://resizing.flixster.com/Jk18fxwRNEBWcfbShIUuol9x7es=/206x305/v2/https://flxt.tmsimg.com/assets/p193999_p_v13_ay.jpg,Love N' Dancing,25000,12,2008.0,Drama/Romance,0 days 01:35:00.000000000,-25
32,58,https://resizing.flixster.com/ElqGCrUsCGGpsYkWGcq8eczH1Cg=/206x305/v2/https://flxt.tmsimg.com/assets/p3499043_p_v10_aa.jpg,Greek Pete,100,12,2009.0,Drama,0 days 01:12:00.000000000,26
44,100,,I Can See You,500,5,2008.0,Horror,0 days 01:37:00.000000000,56
14,18,,The Marc Pease Experience,1000,11,2009.0,Comedy/Drama,0 days 01:20:00.000000000,4
57,66,,(Untitled),2500,41,2009.0,Romance,0 days 01:36:00.000000000,9
73,100,https://resizing.flixster.com/l6Gw7cgL2_upwD8jfjOvCw6Q9mI=/206x305/v2/https://flxt.tmsimg.com/assets/p7841115_p_v10_aa.jpg,Tinker Bell and the Lost Treasure,2500,5,2009.0,Kids and family/Animation,0 days 01:16:00.000000000,27
52,45,,White on Rice,1000,11,2009.0,Comedy,0 days 01:30:00.000000000,-7
49,54,,Diary of a Wimpy Kid,100000,106,2010.0,Kids and family/Comedy,0 days 01:32:00.000000000,5
55,66,,Date Night,100000,231,2010.0,Romance/Action,0 days 01:28:00.000000000,11
59,78,,Ichi,500,9,2008.0,Action,0 days 02:00:00.000000000,19
56,20,,Santa Buddies,1000,5,2009.0,Kids and family/Other,0 days 01:28:00.000000000,-36
85,66,https://resizing.flixster.com/LiLJm-PJ4YgsPjCwK_2w1tFSg1Y=/206x305/v2/https://flxt.tmsimg.com/assets/p3538632_p_v10_aq.jpg,The Blind Side,250000,206,2009.0,Drama/Biography,0 days 02:08:00.000000000,-19
39,66,https://resizing.flixster.com/GaGBmpYSRjjhutZ972uM9lE0AF8=/206x305/v2/https://flxt.tmsimg.com/assets/p3535141_p_v10_ab.jpg,Carriers,50000,38,2009.0,Mystery and thriller/Horror,0 days 01:24:00.000000000,27
66,21,,The Last Song,100000,121,2010.0,Drama,0 days 01:48:00.000000000,-45
82,93,https://resizing.flixster.com/Q_8q9iQl0nUFgY7oeHYgzE73nb4=/206x305/v2/https://flxt.tmsimg.com/assets/p3529168_p_v8_aa.jpg,"Yoo-Hoo, Mrs. Goldberg",1000,68,2009.0,Documentary,0 days 01:32:00.000000000,11
54,76,,The Exploding Girl,1000,37,2009.0,Drama/Romance,0 days 01:20:00.000000000,22
84,89,,Between Us,500,9,2009.0,Drama,0 days 01:20:00.000000000,5
48,75,https://resizing.flixster.com/ULringloPsFa8xC-_Uy7Tr8_biE=/206x305/v2/https://flxt.tmsimg.com/assets/p7883249_p_v8_aa.jpg,The Eclipse,1000,84,2009.0,Mystery and thriller/Drama,0 days 01:28:00.000000000,27
27,25,,Saint John of Las Vegas,1000,53,2009.0,Comedy/Drama,0 days 01:25:00.000000000,-2
81,86,,A Single Man,50000,195,2009.0,Gay and lesbian/Drama,0 days 01:39:00.000000000,5
52,14,https://resizing.flixster.com/XLcEUEb6xTRC4qzAx7-QBMUrpQo=/206x305/v2/https://flxt.tmsimg.com/assets/p7902208_p_v10_ap.jpg,Dead Man Running,5000,22,2009.0,Crime/Drama,0 days 01:32:00.000000000,-38
76,81,,Objectified,1000,16,2009.0,Documentary,0 days 01:15:00.000000000,5
79,86,,The White Ribbon,50000,149,2009.0,Drama/War,0 days 02:24:00.000000000,7
48,29,,Irene in Time,1000,17,2009.0,Romance/Comedy,0 days 01:35:00.000000000,-19
22,40,https://resizing.flixster.com/CFDyYbTHm0ZSbCyQUSsgXq3635g=/206x305/v2/https://flxt.tmsimg.com/assets/p3595964_p_v10_ad.jpg,Tenderness,1000,15,2008.0,Crime/Drama,0 days 01:41:00.000000000,18
89,96,https://resizing.flixster.com/wNrxjkp4D2drXiKBcmTNLwYACO8=/206x305/v2/https://flxt.tmsimg.com/assets/p3607427_p_v10_af.jpg,A Prophet,10000,161,2009.0,Crime/Drama,0 days 02:34:00.000000000,7
24,33,,The New Daughter,2500,9,2009.0,Mystery and thriller/Horror,0 days 01:48:00.000000000,9
68,92,,Vincere,10000,92,2009.0,Drama/History,0 days 02:08:00.000000000,24
79,91,,Fish Tank,10000,149,2009.0,Drama,0 days 02:04:00.000000000,12
20,50,https://resizing.flixster.com/L78st_lkbkd7sx8VTSMUB4Vk76I=/206x305/v2/https://flxt.tmsimg.com/assets/p8060816_p_v8_aa.jpg,Godspeed,250,10,2009.0,Mystery and thriller,0 days 01:39:00.000000000,30
50,93,,My Year Without Sex,250,14,2009.0,Comedy/Drama,0 days 01:36:00.000000000,43
20,65,,Act of God,250,17,2009.0,Documentary,0 days 01:15:00.000000000,45
84,64,https://resizing.flixster.com/nSF6WQ_0hUDbacPU9JykmHjqnyE=/206x305/v2/https://flxt.tmsimg.com/assets/p8051212_p_v8_ax.jpg,Hachiko: A Dog's Story,10000,28,2009.0,Drama,0 days 01:33:00.000000000,-20
88,96,https://resizing.flixster.com/AqsEq1DmjPCMlWztH3JkIkMCaSQ=/206x305/v2/https://flxt.tmsimg.com/NowShowing/84821/84821_aa.jpg,Mother,10000,118,2009.0,Crime/Drama,0 days 02:08:00.000000000,8
33,0,https://resizing.flixster.com/wsHV6Op594G-vzGcpwXS9gZXORs=/206x305/v2/https://flxt.tmsimg.com/assets/p3574295_p_v8_aa.jpg,Homecoming,50000,24,2009.0,Horror/Mystery and thriller,0 days 01:28:00.000000000,-33
65,71,,Kinatay,250,7,2009.0,Crime/Drama,0 days 01:45:00.000000000,6
74,92,https://resizing.flixster.com/vAHgajv68ke0vZwf5EUaNvTF-94=/206x305/v2/https://flxt.tmsimg.com/assets/p3592091_p_v8_aa.jpg,Red Riding: 1980,1000,12,2009.0,Crime/Drama,0 days 01:33:00.000000000,18
76,91,,Red Riding: 1983,1000,11,2009.0,Crime/Drama,0 days 01:43:00.000000000,15
86,87,,Welcome,1000,30,2009.0,Drama,0 days 01:49:00.000000000,1
57,60,,Shank,500,5,2009.0,Drama,0 days 01:29:00.000000000,3
46,48,,Doghouse,2500,23,2009.0,Comedy/Horror,0 days 01:29:00.000000000,2
34,67,https://resizing.flixster.com/NW6q1sCPNhmgRxlBtLoD3YrmTYw=/206x305/v2/https://flxt.tmsimg.com/assets/p7850460_p_v10_ac.jpg,ZMD: Zombies of Mass Destruction,2500,6,2009.0,Comedy/Gay and lesbian,0 days 01:32:00.000000000,33
63,40,/assets/pizza-pie/images/poster_default.c8c896e70c3.gif,Make the Yuletide Gay,500,5,2009.0,Comedy/Other,0 days 01:29:00.000000000,-23
70,88,,Easier With Practice,500,34,2009.0,Drama,0 days 01:40:00.000000000,18
40,33,/assets/pizza-pie/images/poster_default.c8c896e70c3.gif,40 Is the New 20,1,6,2009.0,Comedy,0 days 01:33:00.000000000,-7
76,89,,It Came From Kuchar,100,18,2009.0,Comedy/Documentary,0 days 01:26:00.000000000,13
16,80,https://resizing.flixster.com/d9RkvU6FEVMrtDkDO0HLaGXffI0=/206x305/v2/https://flxt.tmsimg.com/assets/p3542177_p_v10_ab.jpg,Penance,250,5,2008.0,Mystery and thriller/Horror,0 days 01:25:00.000000000,64
42,19,,I Hope They Serve Beer in Hell,5000,36,2009.0,Comedy,0 days 01:46:00.000000000,-23
69,69,https://resizing.flixster.com/YnvuaNFFQkqA2axDFW0IRN_lvP0=/206x305/v2/https://flxt.tmsimg.com/assets/p8033833_p_v8_aa.jpg,Phyllis and Harold,50,26,2008.0,Documentary,0 days 01:24:00.000000000,0
57,50,,A Boy Called Dad,100,10,2009.0,Drama,0 days 01:20:00.000000000,-7
72,25,https://resizing.flixster.com/l63x6VPiUHi0Zl3Rb641MiTJx98=/206x305/v2/https://flxt.tmsimg.com/assets/p7897127_p_v8_aa.jpg,Falling Awake,100,8,2009.0,Drama,0 days 01:50:00.000000000,-47
70,84,,The Ghost Writer,50000,209,2010.0,Mystery and thriller/Drama,0 days 02:09:00.000000000,14
75,76,,Invictus,100000,246,2009.0,Drama/Biography,0 days 02:14:00.000000000,1
65,97,,Sweetgrass,500,64,2009.0,Documentary,0 days 01:42:00.000000000,32
48,29,https://resizing.flixster.com/71fK0lP7cUc84nSpYfybrMpyqJQ=/206x305/v2/https://flxt.tmsimg.com/assets/p3589813_p_v10_ab.jpg,The Collector,50000,73,2009.0,Mystery and thriller/Horror,0 days 01:28:00.000000000,-19
22,44,https://resizing.flixster.com/vJg_MD39DveC72W0LAgDETbyeak=/206x305/v2/https://flxt.tmsimg.com/assets/p7947727_p_v10_ab.jpg,Smokin' Aces 2: Assassins' Ball,2500,9,2010.0,Action,0 days 01:26:00.000000000,22
63,55,,Cemetery Junction,10000,40,2010.0,Comedy,0 days 01:35:00.000000000,-8
74,74,https://resizing.flixster.com/gaCq7rmSbdiNPswV5aclquvGah0=/206x305/v2/https://flxt.tmsimg.com/assets/p3564806_p_v8_ai.jpg,Capitalism: A Love Story,50000,189,2009.0,Documentary,0 days 02:07:00.000000000,0
58,60,https://resizing.flixster.com/40yeWS2AcaS_-ctBFxHaEn7ZB-E=/206x305/v2/https://flxt.tmsimg.com/assets/p189396_p_v10_aa.jpg,The Horseman,1000,30,2008.0,Mystery and thriller,0 days 01:50:00.000000000,2
48,40,,The Haunted World of El Superbeasto,1000,5,2009.0,Animation/Comedy,0 days 01:17:00.000000000,-8
56,63,,Dil Bole Hadippa!,1000,8,2009.0,Romance,0 days 02:28:00.000000000,7
83,85,,My Name Is Khan,10000,27,2010.0,Drama,0 days 02:45:00.000000000,2
78,100,,Inside Planet Earth,50,13,2008.0,,,22
39,51,,Chloe,25000,163,2009.0,Mystery and thriller/Drama,0 days 01:36:00.000000000,12
58,81,https://resizing.flixster.com/vNKOOscrdsu42hd5YANcmIBc6rQ=/206x305/v2/https://flxt.tmsimg.com/assets/p8018573_p_v10_ab.jpg,Tony,250,16,2009.0,Comedy/Crime,0 days 01:12:00.000000000,23
67,92,https://resizing.flixster.com/MZPD61xbbvjA7d1FVafrAgxxrjc=/206x305/v2/https://resizing.flixster.com/ykM7xLS_Pr7ajJJdW7jMJ_D1Aa0=/ems.ZW1zLXByZC1hc3NldHMvbW92aWVzLzBkNmQ1NDk5LTk2NTctNDZmNC05ZTE1LTQwNmU5NzcxNjAxZi53ZWJw,Motherland,50,12,2008.0,Documentary,0 days 01:20:00.000000000,25
47,20,https://resizing.flixster.com/7sF5DPiw_gJhuEa5VIyyFlRltkc=/206x305/v2/https://flxt.tmsimg.com/assets/p3593719_p_v13_ab.jpg,Hannah Free,100,10,2009.0,Gay and lesbian/Drama,0 days 01:26:00.000000000,-27
58,71,https://resizing.flixster.com/Dg3wWWM9YhlP2XpYEj3XYA960GQ=/206x305/v2/https://flxt.tmsimg.com/assets/p194072_p_v8_aa.jpg,Endgame,500,7,2009.0,Drama,0 days 01:49:00.000000000,13
56,63,,Hot Tub Time Machine,100000,210,2010.0,Comedy/Fantasy,0 days 01:39:00.000000000,7
48,56,https://resizing.flixster.com/pAO9Dka5M5wFcxyqKKFcmptKI0A=/206x305/v2/https://flxt.tmsimg.com/assets/p3506946_p_v8_aa.jpg,New World Order,250,9,2009.0,Documentary,0 days 01:25:00.000000000,8
66,38,,X Games: The Movie,5000,29,2009.0,Documentary,0 days 01:32:00.000000000,-28
71,75,https://resizing.flixster.com/LMd51Ol_7Y4EFHeDwNbWerQRw2Q=/206x305/v2/https://flxt.tmsimg.com/assets/p3632141_p_v10_aa.jpg,Tales From the Script,500,20,2009.0,Documentary,0 days 01:56:00.000000000,4
35,68,,The Firm,1000,25,2009.0,Drama,0 days 01:30:00.000000000,33
74,100,,Love Affair; Or the Case of the Missing Switchboard Operator,250,10,1967.0,Comedy/Drama,0 days 01:15:00.000000000,26
41,18,,The Fourth Kind,100000,115,2009.0,Mystery and thriller,0 days 01:38:00.000000000,-23
39,0,https://resizing.flixster.com/q73R1dzMRkfWqF4TagXXmuG2tSM=/206x305/v2/https://flxt.tmsimg.com/assets/p7883425_p_v10_ac.jpg,Stolen,2500,20,2009.0,Mystery and thriller,0 days 01:37:00.000000000,-39
32,27,https://resizing.flixster.com/Ibj4_EnnijoUKuoOaUi2Oj7VNuw=/206x305/v2/https://flxt.tmsimg.com/assets/p7854506_p_v13_ab.jpg,The Canyon,500,15,2009.0,Mystery and thriller,0 days 01:42:00.000000000,-5
65,22,,Raajneeti,1000,9,2010.0,Drama,0 days 02:43:00.000000000,-43
55,34,https://resizing.flixster.com/kmZC7HbcapkqCBOJb_RqylGEdnU=/206x305/v2/https://flxt.tmsimg.com/assets/p7883288_p_v8_aa.jpg,Formosa Betrayed,250,29,2009.0,Crime/Drama,0 days 01:48:00.000000000,-21
69,27,,Remember Me,250000,139,2010.0,Drama/Romance,0 days 01:53:00.000000000,-42
82,81,https://resizing.flixster.com/nXkeOVv6QZWS-jhwWjosN1bBBFc=/206x305/v2/https://flxt.tmsimg.com/assets/p7815591_p_v13_ap.jpg,Michael Jackson's This Is It,100000,187,2009.0,Documentary,0 days 01:51:00.000000000,-1
18,14,,Stan Helsing,5000,21,2009.0,Comedy,0 days 01:30:00.000000000,-4
30,70,,Coffin Rock,2500,20,2009.0,Mystery and thriller,0 days 01:32:00.000000000,40
62,60,/assets/pizza-pie/images/poster_default.c8c896e70c3.gif,Will Ferrell: You're Welcome America - A Final Night with George W Bush,1000,5,2009.0,,,-2
60,58,,It's Complicated,100000,182,2009.0,Romance,0 days 02:00:00.000000000,-2
53,50,https://resizing.flixster.com/xhFgrL8dgUqwG--l3Vc_Br9FbRI=/206x305/v2/https://flxt.tmsimg.com/assets/p3519133_p_v10_aa.jpg,Sikandar,5000,8,2009.0,Mystery and thriller/Drama,0 days 01:50:00.000000000,-3
62,57,https://resizing.flixster.com/tRMFMI8yEZVLBM0Stib15dUB9fM=/206x305/v2/https://flxt.tmsimg.com/assets/p7857093_p_v10_aa.jpg,Food Beware: The French Organic Revolution,100,14,2008.0,Documentary,0 days 01:52:00.000000000,-5
68,93,,Lourdes,1000,43,2009.0,Drama,0 days 01:39:00.000000000,25
63,57,https://resizing.flixster.com/dBcPV5DXcv2TmKo2vurYT7HP6z4=/206x305/v2/https://flxt.tmsimg.com/assets/p3542905_p_v8_aa.jpg,Preacher's Kid,1000,7,2009.0,Drama,0 days 01:41:00.000000000,-6
47,63,,The Joneses,10000,129,2009.0,Comedy/Drama,0 days 01:33:00.000000000,16
85,81,,A Town Called Panic,2500,75,2009.0,Comedy/Fantasy,0 days 01:15:00.000000000,-4
33,57,https://resizing.flixster.com/EZJIHlwRdiMDxwjTUiPLD3wdEQs=/206x305/v2/https://flxt.tmsimg.com/assets/p3580825_p_v8_aa.jpg,The Hills Run Red,1000,7,2009.0,Mystery and thriller/Horror,0 days 01:21:00.000000000,24
57,46,https://resizing.flixster.com/LV5VPu_j2aRl8aptyq1G0Hp9Sd4=/206x305/v2/https://flxt.tmsimg.com/assets/p7888658_p_v8_aa.jpg,Ten9eight,50,13,2009.0,Documentary,0 days 01:25:00.000000000,-11
58,74,https://resizing.flixster.com/U7YGSbSCoJ_USUa_kCq6-S7NbwE=/206x305/v2/https://flxt.tmsimg.com/assets/p7996887_p_v10_ae.jpg,Defendor,10000,23,2009.0,Comedy/Drama,0 days 01:35:00.000000000,16
67,100,https://resizing.flixster.com/Lt2EhctiNyoer3SqnuRQBjNLzPA=/206x305/v2/https://flxt.tmsimg.com/assets/p7816839_p_v8_aa.jpg,The Big Gay Musical,500,7,2009.0,Gay and lesbian/Musical,0 days 01:30:00.000000000,33
87,100,/assets/pizza-pie/images/poster_default.c8c896e70c3.gif,American Radical: The Trials of Norman Finkelstein,250,11,2009.0,Documentary/Mystery and thriller,0 days 01:24:00.000000000,13
55,22,,"Oh, My God!!",1000,18,2009.0,Comedy/Drama,0 days 02:01:00.000000000,-33
48,15,https://resizing.flixster.com/E5TZdS_MAoSlnEI265KEhGhXJKA=/206x305/v2/https://flxt.tmsimg.com/assets/p7876862_p_v10_aa.jpg,Our Family Wedding,50000,87,2010.0,Romance,0 days 01:41:00.000000000,-33
47,23,,Leap Year,100000,140,2010.0,Romance,0 days 01:40:00.000000000,-24
90,91,,The White Stripes Under Great White Northern Lights,500,11,2009.0,Documentary,0 days 01:33:00.000000000,1
81,40,,For My Father,100,10,2008.0,Drama,0 days 01:40:00.000000000,-41
90,96,,The Most Dangerous Man in America: Daniel Ellsberg and the Pentagon Papers,1000,56,2009.0,Documentary,0 days 01:32:00.000000000,6
29,36,/assets/pizza-pie/images/poster_default.c8c896e70c3.gif,Give Me Your Hand,100,11,2004.0,Documentary,0 days 02:02:00.000000000,7
30,43,,Town Creek,1000,7,2009.0,Mystery and thriller/Horror,0 days 01:30:00.000000000,13
53,17,,Eating Out: All You Can Eat,500,6,2009.0,Comedy,0 days 01:20:00.000000000,-36
60,79,https://resizing.flixster.com/yq8FbxQZ6hv1d7tnp40wQOjsckM=/206x305/v2/https://flxt.tmsimg.com/assets/p7847069_p_v8_aa.jpg,"Police, Adjective",1000,76,2009.0,Drama,0 days 01:50:00.000000000,19
18,29,,Pornography,250,7,2009.0,Mystery and thriller,0 days 01:53:00.000000000,11
23,20,https://resizing.flixster.com/5uBjRcz5rq8qB1-vVST28M9drs8=/206x305/v2/https://flxt.tmsimg.com/assets/p7837430_p_v8_aa.jpg,Do Knot Disturb,250,5,2009.0,Comedy/Musical,0 days 02:06:00.000000000,-3
76,52,https://resizing.flixster.com/8-rZFwup5Cs_mnT7fqYyL3i7ncw=/206x305/v2/https://flxt.tmsimg.com/assets/p196604_p_v13_aa.jpg,The End of Poverty?,250,23,2008.0,Documentary,0 days 01:46:00.000000000,-24
54,49,,The Losers,100000,167,2010.0,Adventure/Action,0 days 01:37:00.000000000,-5
16,0,https://resizing.flixster.com/-fs7SDKgWM66ALiEl5qzAUJSED0=/206x305/v2/https://flxt.tmsimg.com/assets/p3635497_p_v10_aa.jpg,Children of the Corn,500,6,2009.0,Horror,0 days 01:32:00.000000000,-16
53,28,,Extraordinary Measures,50000,144,2010.0,Drama,0 days 01:46:00.000000000,-25
28,8,https://resizing.flixster.com/JSaM3gvTPKOsMN6gFMPIlVntk2w=/206x305/v2/https://flxt.tmsimg.com/assets/p7873041_p_v10_af.jpg,Crazy on the Outside,2500,12,2010.0,Comedy,0 days 01:36:00.000000000,-20
30,30,,Finding Bliss,500,20,2009.0,Comedy,0 days 01:38:00.000000000,0
48,52,,The Thorn in the Heart,250,31,2009.0,Documentary,0 days 01:26:00.000000000,4
73,60,,Little Nicholas,1000,10,2009.0,Comedy,0 days 01:31:00.000000000,-13
100,81,/assets/pizza-pie/images/poster_default.c8c896e70c3.gif,Prima Ballerina,1,26,2009.0,,,-19
67,50,https://resizing.flixster.com/8FcSfrpboWXmQaM9PgDoBsrc74s=/206x305/v2/https://flxt.tmsimg.com/assets/p7924537_p_v8_aa.jpg,Paa,1000,8,2009.0,Drama,0 days 02:13:00.000000000,-17
66,82,,Storm,500,22,2009.0,Drama,0 days 01:45:00.000000000,16
46,40,,Pyaar Impossible,500,5,2010.0,Romance,0 days 02:21:00.000000000,-6
20,0,https://resizing.flixster.com/ehiCaKHp4xAovf4NwkSZgZ4YCHo=/206x305/v2/https://flxt.tmsimg.com/assets/p7912623_p_v10_aa.jpg,Breaking Point,250,8,2009.0,Crime/Action,0 days 01:33:00.000000000,-20
67,88,,Rocket Singh: Salesman of the Year,1000,8,2009.0,Comedy,0 days 02:36:00.000000000,21
41,80,,Waiting for Armageddon,250,20,2009.0,Documentary,0 days 01:14:00.000000000,39
55,69,https://resizing.flixster.com/zjbPCcnpWoIbr7m_qm-GECq5QUo=/206x305/v2/https://flxt.tmsimg.com/assets/p7964470_p_v8_ac.jpg,The Runaways,50000,192,2010.0,Drama/Biography,0 days 01:45:00.000000000,14
72,64,,8: The Mormon Proposition,500,36,2010.0,Documentary,0 days 01:20:00.000000000,-8
85,80,https://resizing.flixster.com/jEvmH9FXdCInduhu1-cPiUXAE7A=/206x305/v2/https://flxt.tmsimg.com/assets/p8058300_p_v10_ab.jpg,180 Degrees South,500,5,2010.0,Documentary,0 days 01:25:00.000000000,-5
51,12,,The Bounty Hunter,250000,149,2010.0,Romance/Action,0 days 01:51:00.000000000,-39
78,33,,Celine: Through the Eyes of the World,1000,6,2010.0,Documentary,0 days 02:00:00.000000000,-45
75,25,,Letters to God,10000,24,2010.0,Drama,0 days 01:54:00.000000000,-50
24,9,,Multiple Sarcasms,1000,22,2010.0,Drama,0 days 01:37:00.000000000,-15
33,13,,The Final,1000,8,2010.0,Mystery and thriller/Drama,,-20
61,52,,Blood Done Sign My Name,250,29,2010.0,Drama,0 days 02:08:00.000000000,-9
87,85,https://resizing.flixster.com/yA8C7_E0cSQVwuUIukCZLpzp4nY=/206x305/v2/https://flxt.tmsimg.com/assets/p7907329_p_v8_aa.jpg,The Art of the Steal,1000,60,2009.0,Documentary,0 days 01:41:00.000000000,-2
49,80,https://resizing.flixster.com/4xpliDuQZvXXz7RyP4RJmFTSyf0=/206x305/v2/https://flxt.tmsimg.com/assets/p8015466_p_v8_aa.jpg,Karthik Calling Karthik,1000,5,2010.0,Comedy/Mystery and thriller,0 days 02:15:00.000000000,31
50,10,/assets/pizza-pie/images/poster_default.c8c896e70c3.gif,Harlem Aria,50,10,1999.0,Drama,0 days 01:40:00.000000000,-40
91,100,,Hamlet,500,6,2009.0,Drama,0 days 03:02:00.000000000,9
37,17,,Happiness Runs,250,12,2010.0,Drama,0 days 01:28:00.000000000,-20
50,33,https://resizing.flixster.com/YQtbrdJy3Nv-wKJ7Elb2_xFh30g=/206x305/v2/https://flxt.tmsimg.com/assets/p93288_p_v13_aa.jpg,Girly,100,6,1970.0,Mystery and thriller,0 days 01:41:00.000000000,-17
67,57,/assets/pizza-pie/images/poster_default.c8c896e70c3.gif,Princess,1000,14,2006.0,,,-10
44,83,,Gretchen,1,6,2006.0,Comedy,0 days 01:38:00.000000000,39
49,10,/assets/pizza-pie/images/poster_default.c8c896e70c3.gif,Malice in Wonderland,500,10,2009.0,Drama/Crime,0 days 01:27:00.000000000,-39
93,93,,No Distance Left to Run,250,14,2010.0,Music/Documentary,0 days 01:42:00.000000000,0
20,86,,Salvage,250,7,2009.0,Horror,0 days 01:19:00.000000000,66
47,79,https://resizing.flixster.com/3bGNkWdMN0F5NpVtpslYu2NAwPs=/206x305/v2/https://flxt.tmsimg.com/assets/p7917167_p_v8_aa.jpg,Bluebeard,500,38,2009.0,Mystery and thriller/Fantasy,0 days 01:20:00.000000000,32
46,54,https://resizing.flixster.com/Al3LCFSMnlLb12ZrqCwNhJmMlm4=/206x305/v2/https://flxt.tmsimg.com/assets/p8524416_p_v13_ab.jpg,I Love You Too,1000,13,2010.0,Comedy,0 days 01:47:00.000000000,8
94,90,,Rush: Beyond the Lighted Stage,1000,10,2010.0,Music/Documentary,0 days 01:47:00.000000000,-4
13,0,,Pimp,100,13,2010.0,Mystery and thriller,0 days 01:31:00.000000000,-13
92,100,https://resizing.flixster.com/TTQnZ3CJFS5oqmEEUK1bczsvbxY=/206x305/v2/https://flxt.tmsimg.com/assets/p8129393_p_v10_ay.jpg,Batman: Under the Red Hood,10000,7,2010.0,Animation/Adventure,0 days 01:15:00.000000000,8
25,40,https://resizing.flixster.com/plFKzIDlHtOjKGUwpAntqYhiiiI=/206x305/v2/https://flxt.tmsimg.com/assets/p8090133_p_v8_ae.jpg,Operation: Endgame,1000,5,2010.0,Action/Comedy,0 days 01:22:00.000000000,15
16,8,,Mega Piranha,500,13,2010.0,Mystery and thriller/Sci fi,0 days 01:30:00.000000000,-8
30,0,,Two on a Guillotine,1,6,1965.0,Horror,0 days 01:47:00.000000000,-30
74,91,https://resizing.flixster.com/XSt4Ngcr0fzYEZK5PizEXyFS8kM=/206x305/v2/https://flxt.tmsimg.com/assets/p13206_p_v10_aa.jpg,Homicide,250,23,1991.0,Crime/Drama,0 days 01:40:00.000000000,17
81,22,/assets/pizza-pie/images/poster_default.c8c896e70c3.gif,Alice,100,9,2010.0,,,-59
